Id,Label,timeset,indegree,outdegree,Degree,weighted indegree,weighted outdegree,Weighted Degree,Authority,Hub,componentnumber,strongcompnum,modularity_class,pageranks,Eccentricity,closnesscentrality,harmonicclosnesscentrality,betweenesscentrality,clustering,eigencentrality
1001,1001,,10,83,93,10,83,93,0.002262,0.013579,0,8675,0,0.000012,12,0.205822,0.239403,31325.987485,0.083918,0.003194
9304045,9304045,,16,1,17,16,1,17,0.000369,0.000004,0,594,0,0.000064,1,1,1,301.901755,0.044118,0.005746
9308122,9308122,,115,7,122,115,7,122,0.008593,0.000302,0,587,0,0.000283,1,1,1,6156.357774,0.057309,0.057921
9309097,9309097,,140,4,144,140,4,144,0.009141,0.000266,0,211,0,0.001294,1,1,1,11604.829042,0.034625,0.077625
9311042,9311042,,55,2,57,55,2,57,0.004387,0.000242,0,787,0,0.000163,1,1,1,367.57373,0.072995,0.036253
9401139,9401139,,421,40,461,421,40,461,0.03813,0.001178,0,125,13,0.002571,4,0.455696,0.608025,623063.18257,0.011525,0.218734
9404151,9404151,,77,2,79,77,2,79,0.008645,0.000179,0,323,0,0.000559,4,0.402062,0.442308,12546.061285,0.061181,0.059789
9407087,9407087,,1299,9,1308,1299,9,1308,0.087375,0.001107,0,128,4,0.006891,5,0.352778,0.427034,257938.605777,0.009961,0.607171
9408099,9408099,,1006,7,1013,1006,7,1013,0.070924,0.001621,0,129,4,0.003438,6,0.283186,0.34987,39791.387146,0.012014,0.44819
9501030,9501030,,126,27,153,126,27,153,0.015617,0.005527,0,370,0,0.001357,6,0.327155,0.391218,144397.604647,0.06566,0.123279
9503124,9503124,,1114,10,1124,1114,10,1124,0.126501,0.002524,0,484,0,0.00524,7,0.269714,0.317554,321053.984754,0.010842,0.693146
9504090,9504090,,337,4,341,337,4,341,0.036671,0.001167,0,601,0,0.002428,5,0.291304,0.328234,41464.090472,0.025539,0.280774
9504145,9504145,,192,2,194,192,2,194,0.02005,0.000315,0,212,0,0.000929,2,0.625,0.7,1662.973166,0.033465,0.13285
9505025,9505025,,30,14,44,30,14,44,0.003065,0.00501,0,906,0,0.000268,8,0.246664,0.294764,23820.154396,0.117336,0.026727
9505054,9505054,,63,10,73,63,10,73,0.00457,0.003845,0,880,0,0.000213,8,0.236319,0.277597,9865.548944,0.065068,0.031798
9505105,9505105,,327,21,348,327,21,348,0.033374,0.007245,0,649,0,0.000841,8,0.253021,0.309228,126807.500545,0.042615,0.195985
9505162,9505162,,205,25,230,205,25,230,0.021213,0.008236,0,654,0,0.00053,8,0.255969,0.314866,53435.035679,0.058268,0.122884
9506048,9506048,,49,7,56,49,7,56,0.003961,0.003515,0,881,0,0.000201,9,0.233868,0.273948,3022.088961,0.108442,0.031442
9506112,9506112,,189,17,206,189,17,206,0.018319,0.003986,0,872,0,0.000371,9,0.229715,0.271186,104768.16742,0.066256,0.103595
9506144,9506144,,77,15,92,77,15,92,0.007375,0.005806,0,1145,0,0.000218,9,0.226518,0.268607,26683.634971,0.061753,0.046309
9507050,9507050,,160,19,179,160,19,179,0.014785,0.006048,0,891,0,0.000932,9,0.229344,0.277995,59858.468276,0.062237,0.116854
9507158,9507158,,301,16,317,301,16,317,0.02476,0.005642,0,1146,0,0.000912,8,0.237493,0.27989,105084.706884,0.022391,0.179219
9508094,9508094,,90,29,119,90,29,119,0.00937,0.006267,0,1232,13,0.000181,11,0.230607,0.294625,45412.429456,0.07271,0.048294
9508155,9508155,,192,53,245,192,53,245,0.020034,0.010844,0,1201,0,0.000245,12,0.232355,0.308449,474216.288347,0.053931,0.107809
9510142,9510142,,35,28,63,35,28,63,0.002908,0.008085,0,1359,0,0.000156,13,0.219109,0.27652,38413.830991,0.132873,0.030988
9510225,9510225,,175,22,197,175,22,197,0.020975,0.008205,0,1377,0,0.000866,12,0.227005,0.278075,276784.122861,0.047395,0.155514
9510234,9510234,,92,37,129,92,37,129,0.009906,0.007165,0,1508,0,0.00009,13,0.218606,0.283459,25039.293958,0.097989,0.044365
9511030,9511030,,329,21,350,329,21,350,0.037949,0.009299,0,1254,0,0.001124,12,0.209629,0.258677,88632.875455,0.026279,0.243154
9511171,9511171,,49,22,71,49,22,71,0.00437,0.008307,0,1543,0,0.000079,13,0.220753,0.272324,4087.725042,0.146479,0.027245
9601108,9601108,,95,39,134,95,39,134,0.008729,0.010659,0,1630,0,0.000143,11,0.237891,0.292229,76620.167707,0.08237,0.056405
9602022,9602022,,520,25,545,520,25,545,0.051067,0.009519,0,1536,0,0.00095,9,0.238695,0.277863,340931.686531,0.019313,0.287225
9602114,9602114,,252,34,286,252,34,286,0.02375,0.007741,0,1684,0,0.000427,9,0.252717,0.297169,259007.379488,0.044988,0.138857
9603003,9603003,,194,20,214,194,20,214,0.01957,0.004926,0,1762,0,0.000471,9,0.22492,0.260346,190199.860296,0.049164,0.13848
9603150,9603150,,148,26,174,148,26,174,0.012216,0.006069,0,1902,0,0.000291,9,0.235496,0.273725,68241.905364,0.047605,0.080103
9603161,9603161,,274,32,306,274,32,306,0.024868,0.007775,0,1785,0,0.0004,9,0.235488,0.277271,95209.033905,0.039634,0.140562
9603167,9603167,,467,16,483,467,16,483,0.058886,0.006286,0,1793,52,0.00078,10,0.232347,0.269487,169970.188659,0.021533,0.273926
9605184,9605184,,148,22,170,148,22,170,0.014655,0.010439,0,2212,0,0.000211,9,0.228025,0.265674,21034.149366,0.063975,0.081254
9605222,9605222,,24,23,47,24,23,47,0.001321,0.004333,0,2724,0,0.000029,10,0.223029,0.262289,46253.939154,0.103608,0.009044
9606017,9606017,,110,14,124,110,14,124,0.01153,0.006245,0,2194,0,0.00028,9,0.218782,0.248967,38770.480134,0.054747,0.069054
9606040,9606040,,118,6,124,118,6,124,0.008264,0.001242,0,2717,0,0.000162,10,0.206877,0.237201,28051.481257,0.029045,0.057469
9607163,9607163,,186,7,193,186,7,193,0.013531,0.002918,0,2835,4,0.00034,10,0.200207,0.224824,37301.50597,0.030926,0.092936
9607207,9607207,,127,11,138,127,11,138,0.010831,0.003764,0,3022,4,0.000209,10,0.204849,0.232165,37711.266845,0.051465,0.062339
9608086,9608086,,28,10,38,28,10,38,0.001967,0.002815,0,3129,0,0.000042,12,0.205007,0.236377,9322.02435,0.094595,0.012342
9609070,9609070,,81,15,96,81,15,96,0.007012,0.002826,0,3056,0,0.0001,12,0.208333,0.243563,22372.042387,0.058443,0.039421
9609071,9609071,,65,30,95,65,30,95,0.005507,0.006883,0,3033,0,0.000073,12,0.22749,0.267263,39714.429113,0.08981,0.032944
9609239,9609239,,145,41,186,145,41,186,0.014736,0.011182,0,3055,0,0.000104,13,0.220225,0.267682,84072.096341,0.050218,0.060913
9611137,9611137,,139,65,204,139,65,204,0.018491,0.018148,0,3435,0,0.000098,14,0.216316,0.279168,185775.905917,0.049092,0.050653
9612108,9612108,,37,25,62,37,25,62,0.003242,0.007719,0,3700,0,0.000046,13,0.211029,0.249964,6910.894422,0.13009,0.015379
9701162,9701162,,114,23,137,114,23,137,0.006872,0.002284,0,3712,0,0.000114,12,0.217772,0.253316,96276.275934,0.049646,0.041255
9702094,9702094,,62,37,99,62,37,99,0.005515,0.005667,0,3688,4,0.000067,12,0.213662,0.256563,260942.577869,0.051948,0.020267
9702155,9702155,,63,30,93,63,30,93,0.00847,0.0102,0,3431,0,0.000068,13,0.204631,0.247646,43095.427723,0.049322,0.0233
9702198,9702198,,59,31,90,59,31,90,0.005718,0.00454,0,3699,0,0.000058,12,0.223269,0.264172,45216.873977,0.072534,0.024786
9703082,9703082,,49,30,79,49,30,79,0.005008,0.003532,0,4031,0,0.000044,11,0.210014,0.244496,85665.333143,0.056313,0.015113
9703166,9703166,,424,22,446,424,22,446,0.049818,0.006119,0,4040,4,0.000337,13,0.196018,0.233683,171267.624652,0.02423,0.178838
9704097,9704097,,29,30,59,29,30,59,0.001979,0.003216,0,4202,0,0.000028,13,0.212411,0.252959,37225.660103,0.120397,0.009931
9705030,9705030,,70,26,96,70,26,96,0.008592,0.008213,0,4192,0,0.000064,12,0.210303,0.246373,15757.030603,0.081579,0.031588
9705044,9705044,,71,27,98,71,27,98,0.008601,0.006253,0,4191,0,0.000054,12,0.210717,0.243487,484497.15295,0.07206,0.030643
9705104,9705104,,65,34,99,65,34,99,0.005584,0.007271,0,4203,0,0.000079,12,0.220368,0.257927,114947.144288,0.083591,0.027045
9705220,9705220,,39,56,95,39,56,95,0.003422,0.007763,0,4204,4,0.000032,12,0.223447,0.267031,52907.388879,0.091825,0.015993
9706005,9706005,,11,15,26,11,15,26,0.000959,0.005219,0,4337,0,0.000016,13,0.197851,0.230164,1223.876378,0.195385,0.004679
9707014,9707014,,16,20,36,16,20,36,0.001722,0.00689,0,4959,0,0.00002,13,0.199388,0.235233,30060.600554,0.119841,0.006364
9707042,9707042,,43,18,61,43,18,61,0.004852,0.006882,0,4286,2,0.000044,15,0.194495,0.230726,19641.464151,0.07377,0.017374
9707049,9707049,,16,25,41,16,25,41,0.000897,0.00351,0,5030,0,0.000025,13,0.203838,0.241353,23433.593784,0.162805,0.004212
9710230,9710230,,139,10,149,139,10,149,0.011869,0.003952,0,5163,3,0.000149,14,0.175544,0.203721,33677.078658,0.046209,0.070004
9711036,9711036,,8,23,31,8,23,31,0.00045,0.001442,0,7317,0,0.000019,15,0.187094,0.220896,53938.092587,0.112903,0.002693
9711104,9711104,,17,7,24,17,7,24,0.001179,0.000416,0,4919,0,0.000024,13,0.185447,0.210544,2841.913069,0.161232,0.006706
9712028,9712028,,129,26,155,129,26,155,0.009154,0.007271,0,4950,0,0.000167,12,0.204911,0.239252,185596.578858,0.042941,0.052479
9712042,9712042,,14,7,21,14,7,21,0.000785,0.001479,0,6074,4,0.000017,13,0.184048,0.211105,13326.726248,0.078571,0.004162
9802194,9802194,,22,22,44,22,22,44,0.001481,0.002982,0,5858,0,0.000023,13,0.193758,0.226549,14755.67198,0.124736,0.007044
9805056,9805056,,17,13,30,17,13,30,0.001394,0.002244,0,7289,0,0.000017,16,0.186181,0.215409,13235.238106,0.131034,0.005266
9805206,9805206,,11,20,31,11,20,31,0.000749,0.004436,0,7615,0,0.000015,16,0.179909,0.21159,7527.831411,0.190323,0.003255
9806094,9806094,,22,21,43,22,21,43,0.001277,0.003045,0,8551,0,0.000022,17,0.171465,0.206611,9642.517536,0.108527,0.007422
9810188,9810188,,328,30,358,328,30,358,0.021418,0.007922,0,7982,3,0.00035,14,0.212864,0.240983,413569.536586,0.034333,0.157636
9811217,9811217,,24,58,82,24,58,82,0.001544,0.007643,0,8563,0,0.00002,15,0.199091,0.241258,22861.251983,0.104938,0.007682
9905036,9905036,,14,18,32,14,18,32,0.001373,0.003389,0,8674,0,0.000019,14,0.168895,0.200116,2620.09201,0.089718,0.003706
9907041,9907041,,12,4,16,12,4,16,0.000614,0.000645,0,8548,0,0.000016,13,0.173062,0.190478,2272.886556,0.108333,0.003886
9908007,9908007,,11,27,38,11,27,38,0.000281,0.004724,0,8673,0,0.000018,15,0.171935,0.201532,14528.13102,0.072546,0.003345
9908144,9908144,,54,41,95,54,41,95,0.004139,0.017337,0,8670,3,0.000041,14,0.197478,0.229937,95998.740904,0.080627,0.017389
9909108,9909108,,23,24,47,23,24,47,0.001514,0.004446,0,8583,52,0.000034,14,0.195798,0.223772,37737.706004,0.087419,0.006981
9909120,9909120,,22,4,26,22,4,26,0.001038,0.000035,0,8584,52,0.00003,15,0.168218,0.185935,3098.811952,0.130769,0.006254
9909229,9909229,,18,27,45,18,27,45,0.001758,0.005897,0,8552,0,0.000018,12,0.215345,0.241621,77316.893635,0.091919,0.005137
9910238,9910238,,11,21,32,11,21,32,0.001118,0.004743,0,8558,0,0.000014,13,0.185745,0.206917,5294.071138,0.150202,0.0033
9910248,9910248,,5,31,36,5,31,36,0.000515,0.005322,0,8559,0,0.000012,13,0.190331,0.215301,2197.745694,0.135714,0.001498
9910268,9910268,,5,27,32,5,27,32,0.000569,0.003967,0,8569,0,0.000012,13,0.193707,0.218637,20783.840019,0.184476,0.001546
9204040,9204040,,11,0,11,11,0,11,0.000379,0,0,119,0,0.000147,0,0,0,0,0.045455,0.007594
9203084,9203084,,33,0,33,33,0,33,0.000978,0,0,204,0,0.000573,0,0,0,0,0.09375,0.018514
9204035,9204035,,40,0,40,40,0,40,0.002318,0,0,121,0,0.000435,0,0,0,0,0.073077,0.025018
9205041,9205041,,34,0,34,34,0,34,0.001047,0,0,203,0,0.00055,0,0,0,0,0.079323,0.018167
9207049,9207049,,16,0,16,16,0,16,0.000174,0,0,116,0,0.000121,0,0,0,0,0.020833,0.010361
9207111,9207111,,18,0,18,18,0,18,0.000603,0,0,115,0,0.000144,0,0,0,0,0.098039,0.011099
9301042,9301042,,344,0,344,344,0,344,0.017677,0,0,109,52,0.001886,0,0,0,0,0.019128,0.171973
9301043,9301043,,69,0,69,69,0,69,0.002924,0,0,108,0,0.000803,0,0,0,0,0.028133,0.035111
9201015,9201015,,14,0,14,14,0,14,0.000076,0,0,13,13,0.002001,0,0,0,0,0.148352,0.011359
9201040,9201040,,35,0,35,35,0,35,0.001103,0,0,21,3,0.000607,0,0,0,0,0.048739,0.01923
9201047,9201047,,12,0,12,12,0,12,0.000164,0,0,124,0,0.000096,0,0,0,0,0.05303,0.008156
9202046,9202046,,91,0,91,91,0,91,0.001538,0,0,28,0,0.000897,0,0,0,0,0.03602,0.03633
9202059,9202059,,33,0,33,33,0,33,0.000428,0,0,37,0,0.000413,0,0,0,0,0.113636,0.01591
9202092,9202092,,64,0,64,64,0,64,0.001805,0,0,48,13,0.000533,0,0,0,0,0.03869,0.028501
9203008,9203008,,9,0,9,9,0,9,0.000236,0,0,123,28,0.000151,0,0,0,0,0.069444,0.007149
9203031,9203031,,17,0,17,17,0,17,0.001278,0,0,122,0,0.000198,0,0,0,0,0.102941,0.025737
9204037,9204037,,4,0,4,4,0,4,0.000022,0,0,120,0,0.000072,0,0,0,0,0,0.005305
9204046,9204046,,66,0,66,66,0,66,0.002755,0,0,70,13,0.000772,0,0,0,0,0.034266,0.034966
9205046,9205046,,58,0,58,58,0,58,0.001832,0,0,76,13,0.000312,0,0,0,0,0.040835,0.027375
9205060,9205060,,3,0,3,3,0,3,0.00007,0,0,118,25,0.000083,0,0,0,0,0,0.006199
9205062,9205062,,8,2,10,8,2,10,0.00003,0.000001,0,44,13,0.000316,1,1,1,2984.049742,0.222222,0.007767
9205068,9205068,,158,0,158,158,0,158,0.005262,0,0,31,0,0.00119,0,0,0,0,0.029711,0.066914
9206023,9206023,,3,0,3,3,0,3,0.000015,0,0,117,9,0.00012,0,0,0,0,0,0.005538
9206051,9206051,,19,0,19,19,0,19,0.000086,0,0,57,13,0.00021,0,0,0,0,0.046784,0.010587
9206078,9206078,,76,2,78,76,2,78,0.001481,0.000007,0,45,13,0.00035,2,0.666667,0.75,5711.612914,0.036464,0.031569
9207016,9207016,,218,1,219,218,1,219,0.016812,0.000001,0,14,13,0.001735,1,1,1,5346.824535,0.024632,0.131098
9208076,9208076,,22,0,22,22,0,22,0.000312,0,0,54,13,0.000129,0,0,0,0,0.0671,0.01295
9209052,9209052,,40,4,44,40,4,44,0.000961,0.000015,0,74,13,0.00028,2,0.833333,0.9,6443.263579,0.045983,0.018261
9210015,9210015,,37,0,37,37,0,37,0.001379,0,0,73,13,0.000223,0,0,0,0,0.093093,0.020436
9210021,9210021,,104,0,104,104,0,104,0.002689,0,0,114,13,0.000641,0,0,0,0,0.084018,0.040583
9210121,9210121,,39,4,43,39,4,43,0.000452,0.000035,0,72,13,0.000319,1,1,1,12243.099106,0.063123,0.019637
9211021,9211021,,199,0,199,199,0,199,0.004725,0,0,113,0,0.000696,0,0,0,0,0.044871,0.074677
9211041,9211041,,7,2,9,7,2,9,0.000188,0.000033,0,112,13,0.000079,1,1,1,18.558372,0.083333,0.006185
9212089,9212089,,3,1,4,3,1,4,0.000028,0.000018,0,111,0,0.000073,1,1,1,0.166667,0.416667,0.005193
9301005,9301005,,13,2,15,13,2,15,0.000129,0.000006,0,110,13,0.00011,2,0.6,0.666667,107.716664,0.161905,0.009926
9302033,9302033,,80,9,89,80,9,89,0.001825,0.000138,0,78,13,0.000366,2,0.714286,0.8,30582.959274,0.050689,0.036243
9302069,9302069,,4,5,9,4,5,9,0.000149,0.00005,0,107,13,0.000077,2,0.727273,0.8125,2541.956581,0.152778,0.005328
9302126,9302126,,111,10,121,111,10,121,0.009154,0.000555,0,106,13,0.000465,3,0.446154,0.517241,111145.169146,0.030923,0.052307
9303032,9303032,,20,7,27,20,7,27,0.002471,0.000471,0,61,13,0.000082,1,1,1,34626.972402,0.074074,0.010501
9304155,9304155,,15,6,21,15,6,21,0.001451,0.000032,0,56,13,0.000098,4,0.52,0.679487,17808.652452,0.083333,0.010527
9305185,9305185,,171,13,184,171,13,184,0.014495,0.000944,0,22,13,0.002477,2,0.740741,0.825,24576.18498,0.044458,0.13526
9308042,9308042,,22,3,25,22,3,25,0.000772,0.000012,0,53,13,0.000105,4,0.464286,0.564103,13152.898027,0.105,0.01388
9305139,9305139,,51,0,51,51,0,51,0.003927,0,0,182,13,0.000576,0,0,0,0,0.041961,0.044176
9309140,9309140,,194,19,213,194,19,213,0.011285,0.000616,0,178,0,0.000652,3,0.637931,0.743243,151871.288899,0.031181,0.094417
9204102,9204102,,71,0,71,71,0,71,0.002804,0,0,34,4,0.002208,0,0,0,0,0.026559,0.052404
9211097,9211097,,81,1,82,81,1,82,0.0048,0.000001,0,127,4,0.001367,1,1,1,10467.950917,0.041102,0.060796
9402002,9402002,,282,14,296,282,14,296,0.023863,0.000987,0,40,13,0.003447,3,0.69697,0.797101,45267.609491,0.025596,0.203995
9402005,9402005,,58,7,65,58,7,65,0.002674,0.000279,0,38,0,0.001501,2,0.769231,0.85,33019.672071,0.05625,0.054024
9402044,9402044,,257,0,257,257,0,257,0.012325,0,0,0,4,0.00451,0,0,0,0,0.035688,0.135976
9403195,9403195,,88,1,89,88,1,89,0.003777,0.000038,0,27,4,0.001046,1,1,1,2965.021779,0.048391,0.041904
9403198,9403198,,124,1,125,124,1,125,0.004128,0.000145,0,25,4,0.001797,1,1,1,33.748127,0.064194,0.081135
9406128,9406128,,29,5,34,29,5,34,0.001685,0.000434,0,24,4,0.001101,3,0.52381,0.590909,4169.992942,0.107843,0.033384
9205081,9205081,,77,0,77,77,0,77,0.004427,0,0,5,13,0.001942,0,0,0,0,0.046822,0.052172
9207053,9207053,,102,0,102,102,0,102,0.008317,0,0,9,13,0.002581,0,0,0,0,0.058241,0.088961
9208055,9208055,,32,1,33,32,1,33,0.001702,0.000003,0,3,13,0.001868,1,1,1,3704.327614,0.096591,0.034176
9209016,9209016,,75,0,75,75,0,75,0.006147,0,0,8,13,0.001894,0,0,0,0,0.071712,0.058906
9211056,9211056,,68,4,72,68,4,72,0.004596,0.00025,0,10,13,0.00184,1,1,1,1184.807078,0.070227,0.069616
9303057,9303057,,54,10,64,54,10,64,0.003716,0.000698,0,16,13,0.00148,2,0.857143,0.916667,3898.158141,0.096726,0.054991
9305142,9305142,,87,4,91,87,4,91,0.008024,0.000106,0,7,13,0.000953,2,0.833333,0.9,6158.673817,0.057021,0.068118
9306052,9306052,,101,6,107,101,6,107,0.010935,0.0004,0,288,13,0.000647,2,0.666667,0.75,21607.690188,0.042321,0.084615
9306125,9306125,,6,3,9,6,3,9,0.00025,0.00027,0,286,13,0.000117,3,0.457143,0.53125,66.89774,0.194444,0.008675
9311120,9311120,,60,7,67,60,7,67,0.003848,0.000644,0,285,13,0.000569,3,0.538462,0.634921,1495.906916,0.088422,0.053696
9402032,9402032,,240,4,244,240,4,244,0.023122,0.000368,0,190,0,0.00199,3,0.488889,0.55303,12065.352345,0.022701,0.164708
9406105,9406105,,87,9,96,87,9,96,0.007344,0.001069,0,339,13,0.000557,3,0.553571,0.629032,2409.141792,0.085197,0.061402
9406198,9406198,,41,25,66,41,25,66,0.005611,0.001477,0,369,0,0.000388,3,0.61039,0.737589,59947.950608,0.076457,0.034522
9407021,9407021,,9,9,18,9,9,18,0.000691,0.000733,0,359,13,0.000131,3,0.611111,0.69697,284.836875,0.160131,0.008983
9407111,9407111,,38,7,45,38,7,45,0.003128,0.000492,0,305,0,0.000955,3,0.580645,0.675926,4455.364308,0.101515,0.048016
9408040,9408040,,31,16,47,31,16,47,0.001905,0.000557,0,358,13,0.000159,5,0.353147,0.412624,60596.190549,0.084644,0.023173
9408074,9408074,,290,9,299,290,9,299,0.027868,0.000846,0,192,4,0.001744,5,0.358779,0.424823,180088.274134,0.018204,0.195927
9408083,9408083,,82,27,109,82,27,109,0.005085,0.00326,0,329,13,0.000875,6,0.313475,0.405807,145717.301188,0.053772,0.062182
9409021,9409021,,101,14,115,101,14,115,0.006173,0.000572,0,345,13,0.000286,4,0.382812,0.468537,35362.595406,0.04119,0.051691
9410167,9410167,,748,25,773,748,25,773,0.088918,0.002949,0,340,0,0.003912,6,0.332,0.412249,228947.418264,0.01548,0.498389
9410210,9410210,,3,6,9,3,6,9,0.000134,0.000434,0,300,13,0.000065,3,0.534884,0.608696,167.233987,0.180556,0.003374
9412184,9412184,,426,36,462,426,36,462,0.050075,0.003083,0,299,13,0.001743,5,0.385305,0.473333,370915.011706,0.013095,0.226178
9205027,9205027,,191,0,191,191,0,191,0.011048,0,0,15,13,0.003095,0,0,0,0,0.035575,0.134327
9406012,9406012,,13,0,13,13,0,13,0.00106,0,0,483,0,0.000668,0,0,0,0,0.096154,0.020664
9411149,9411149,,411,11,422,411,11,422,0.026464,0.003092,0,195,4,0.001648,6,0.276989,0.337265,39032.550945,0.023781,0.194772
9411178,9411178,,30,17,47,30,17,47,0.00304,0.004838,0,482,0,0.000869,6,0.306291,0.362252,205004.438969,0.105458,0.037698
9201059,9201059,,47,0,47,47,0,47,0.001867,0,0,101,13,0.001142,0,0,0,0,0.017114,0.021758
9309152,9309152,,8,3,11,8,3,11,0.000917,0.000051,0,600,13,0.000561,4,0.306122,0.357407,17384.55878,0.063636,0.007842
9310067,9310067,,9,3,12,9,3,12,0.000325,0.000113,0,905,0,0.000048,2,0.8,0.875,4274.966462,0.075758,0.003277
9412115,9412115,,6,14,20,6,14,20,0.00051,0.000945,0,811,0,0.000035,4,0.440678,0.521368,9019.445072,0.115789,0.004392
9501068,9501068,,385,6,391,385,6,391,0.0528,0.001107,0,569,2,0.001984,3,0.476923,0.548387,11655.620076,0.020592,0.267752
9502072,9502072,,151,23,174,151,23,174,0.011395,0.00518,0,584,0,0.000667,7,0.26901,0.340927,45101.669975,0.060428,0.093588
9504027,9504027,,142,20,162,142,20,162,0.0159,0.005417,0,582,0,0.001112,7,0.282405,0.330749,155080.381711,0.055326,0.112702
9504047,9504047,,158,22,180,158,22,180,0.018447,0.006781,0,586,0,0.001807,8,0.268497,0.321261,61159.364629,0.057387,0.151607
9304154,9304154,,229,9,238,229,9,238,0.014647,0.000566,0,19,2,0.002838,2,0.714286,0.8,12407.922707,0.028011,0.132854
9501022,9501022,,36,4,40,36,4,40,0.002958,0.000899,0,571,4,0.000253,6,0.284024,0.334722,588.952259,0.077564,0.023088
9502057,9502057,,33,20,53,33,20,53,0.002544,0.004454,0,574,4,0.000158,7,0.280727,0.347335,38619.577545,0.095791,0.014759
9503179,9503179,,138,18,156,138,18,156,0.006985,0.004004,0,207,4,0.000384,6,0.283951,0.357166,13485.357037,0.070182,0.067229
9308083,9308083,,104,4,108,104,4,108,0.005797,0.000085,0,588,0,0.000336,1,1,1,3840.630849,0.055556,0.059084
9411048,9411048,,314,2,316,314,2,316,0.023808,0.001091,0,201,4,0.000917,6,0.271008,0.310336,5202.755353,0.042465,0.17981
9411057,9411057,,268,2,270,268,2,270,0.020319,0.00186,0,199,4,0.000844,6,0.263804,0.29832,613.974566,0.047721,0.15824
9501111,9501111,,19,7,26,19,7,26,0.00062,0.000795,0,648,0,0.000065,5,0.336761,0.400636,22065.093926,0.163077,0.009687
9502077,9502077,,68,24,92,68,24,92,0.00364,0.001133,0,616,0,0.000158,5,0.380252,0.469982,99259.548081,0.070592,0.034048
9503163,9503163,,144,9,153,144,9,153,0.01413,0.002846,0,209,4,0.000403,7,0.250617,0.301361,4952.495,0.066477,0.091776
9504006,9504006,,145,23,168,145,23,168,0.010279,0.004372,0,642,0,0.000317,8,0.251969,0.326597,73982.046726,0.066759,0.070787
9504034,9504034,,111,9,120,111,9,120,0.009893,0.00313,0,602,0,0.000213,8,0.235737,0.292816,4053.988089,0.084524,0.060332
9505023,9505023,,35,14,49,35,14,49,0.002733,0.003887,0,597,0,0.000444,8,0.242188,0.290418,15178.037076,0.123299,0.037415
9505053,9505053,,136,6,142,136,6,142,0.012647,0.002224,0,598,0,0.001242,8,0.238577,0.276225,14247.541841,0.04585,0.115898
9505062,9505062,,174,14,188,174,14,188,0.015523,0.003475,0,210,4,0.000462,7,0.260546,0.328617,15818.122676,0.055467,0.108072
9302103,9302103,,133,1,134,133,1,134,0.008366,0.000033,0,35,0,0.000894,1,1,1,1160.578817,0.041017,0.073584
9305069,9305069,,29,2,31,29,2,31,0.001506,0.000192,0,39,13,0.000469,3,0.457143,0.510417,92.569019,0.078495,0.025467
9406032,9406032,,13,8,21,13,8,21,0.000595,0.000757,0,653,0,0.000103,4,0.434783,0.498611,4380.146814,0.109524,0.013178
9409188,9409188,,87,2,89,87,2,89,0.006428,0.000224,0,651,52,0.000131,2,0.75,0.833333,3164.849633,0.057074,0.039967
9406055,9406055,,68,15,83,68,15,83,0.004061,0.000756,0,596,0,0.000188,2,0.741935,0.826087,24423.754493,0.073612,0.034864
9408036,9408036,,64,8,72,64,8,72,0.005484,0.002036,0,200,4,0.00063,5,0.349727,0.419792,5877.674609,0.098005,0.044922
9411234,9411234,,31,2,33,31,2,33,0.002308,0.000149,0,871,0,0.00011,3,0.461538,0.5,737.445711,0.110795,0.016884
9412200,9412200,,26,23,49,26,23,49,0.002603,0.005202,0,640,0,0.000096,7,0.269478,0.341329,9124.119983,0.130952,0.018859
9506075,9506075,,36,31,67,36,31,67,0.003455,0.007839,0,870,0,0.000086,9,0.251251,0.308827,89010.719304,0.147445,0.02374
9506091,9506091,,23,36,59,23,36,59,0.001988,0.004046,0,794,0,0.000056,9,0.243484,0.301884,113633.83561,0.114845,0.013888
9506024,9506024,,15,13,28,15,13,28,0.001221,0.004964,0,813,0,0.000041,8,0.246198,0.288778,7532.095214,0.198413,0.009477
9506077,9506077,,37,32,69,37,32,69,0.003108,0.005089,0,890,4,0.000257,9,0.207508,0.274768,73463.154217,0.118286,0.028755
9506110,9506110,,96,23,119,96,23,119,0.01081,0.00399,0,879,0,0.000185,9,0.236071,0.295448,85725.705353,0.113873,0.054599
9506160,9506160,,84,11,95,84,11,95,0.011106,0.005263,0,883,0,0.000866,8,0.245019,0.29087,8323.748155,0.092049,0.098461
9506194,9506194,,102,16,118,102,16,118,0.013503,0.005348,0,884,0,0.000943,8,0.246086,0.293465,41525.435246,0.07743,0.107862
9507027,9507027,,47,14,61,47,14,61,0.003986,0.005126,0,882,0,0.000155,9,0.233519,0.275766,4221.969418,0.120492,0.028823
9207060,9207060,,54,0,54,54,0,54,0.00704,0,0,215,2,0.001605,0,0,0,0,0.067086,0.063592
9503212,9503212,,46,10,56,46,10,56,0.002253,0.000537,0,920,0,0.000186,7,0.256614,0.304921,134504.639307,0.076623,0.024156
9506126,9506126,,159,41,200,159,41,200,0.017883,0.00726,0,1137,0,0.000854,8,0.266326,0.337518,185734.998345,0.038593,0.115629
9506150,9506150,,74,13,87,74,13,87,0.005154,0.004835,0,909,10,0.000193,8,0.24505,0.288935,25569.203541,0.06509,0.041971
9507048,9507048,,159,9,168,159,9,168,0.017642,0.003785,0,1142,0,0.000721,9,0.218895,0.255022,8743.430058,0.039279,0.106171
9303106,9303106,,3,4,7,3,4,7,0.000148,0.000217,0,1231,13,0.000023,3,0.402597,0.462366,2230.168945,0.142857,0.002337
9410073,9410073,,150,6,156,150,6,156,0.018371,0.000684,0,303,13,0.000937,4,0.475,0.592105,29452.750351,0.028453,0.126598
9411187,9411187,,118,28,146,118,28,146,0.008793,0.003332,0,576,13,0.000334,6,0.334545,0.394611,103139.231211,0.054086,0.063184
9504081,9504081,,228,13,241,228,13,241,0.026931,0.004125,0,855,13,0.000664,8,0.248929,0.302324,80398.604634,0.026746,0.127906
9504095,9504095,,41,14,55,41,14,55,0.005169,0.004582,0,1028,0,0.000333,8,0.239337,0.284122,21523.382656,0.103704,0.043095
9506057,9506057,,57,20,77,57,20,77,0.007525,0.004847,0,1134,13,0.000201,8,0.259766,0.3172,38906.745189,0.092618,0.042075
9507090,9507090,,150,28,178,150,28,178,0.015881,0.005641,0,1138,13,0.000402,10,0.244401,0.306821,117437.077705,0.059703,0.088646
9508056,9508056,,6,10,16,6,10,16,0.000558,0.004251,0,1230,0,0.000022,8,0.242857,0.291043,131.041538,0.266667,0.002882
9304135,9304135,,37,4,41,37,4,41,0.003536,0.000064,0,837,52,0.000074,4,0.47619,0.633333,10998.262834,0.032927,0.017127
9412209,9412209,,47,18,65,47,18,65,0.004163,0.000745,0,638,0,0.000073,5,0.338645,0.420294,113469.789673,0.084375,0.023812
9505073,9505073,,113,25,138,113,25,138,0.013193,0.005332,0,869,13,0.000443,8,0.254866,0.311279,51598.659786,0.040728,0.071547
9505150,9505150,,176,18,194,176,18,194,0.010999,0.006745,0,667,4,0.00021,9,0.229622,0.279147,35571.161341,0.075183,0.077121
9506084,9506084,,20,13,33,20,13,33,0.000893,0.003313,0,1200,4,0.000061,10,0.184954,0.240886,1213.459357,0.170455,0.012173
9506102,9506102,,155,11,166,155,11,166,0.0086,0.002219,0,1199,4,0.000211,10,0.194065,0.232935,18438.487413,0.078751,0.06625
9507113,9507113,,38,34,72,38,34,72,0.003878,0.009378,0,1194,0,0.000053,9,0.245122,0.308614,6887.868766,0.156299,0.021796
9507115,9507115,,103,17,120,103,17,120,0.011769,0.003019,0,966,0,0.000187,9,0.221156,0.26375,37422.825255,0.095798,0.059209
9507121,9507121,,304,13,317,304,13,317,0.037801,0.003002,0,923,0,0.000986,9,0.226084,0.266198,106964.299379,0.022441,0.199522
9507151,9507151,,27,13,40,27,13,40,0.002517,0.004926,0,1193,0,0.000038,9,0.221175,0.263671,4750.233598,0.164103,0.015196
9507153,9507153,,29,9,38,29,9,38,0.002857,0.001341,0,1192,0,0.000041,9,0.209046,0.245417,513.05517,0.187055,0.018014
9507168,9507168,,30,17,47,30,17,47,0.002432,0.005746,0,910,0,0.000078,9,0.232462,0.277073,8650.40822,0.145698,0.016735
9508044,9508044,,5,22,27,5,22,27,0.000315,0.004655,0,1191,0,0.000021,9,0.227885,0.282429,136839.748973,0.082621,0.003848
9508064,9508064,,47,42,89,47,42,89,0.004729,0.01009,0,979,0,0.000219,8,0.248522,0.306354,51913.992009,0.087462,0.0261
9508071,9508071,,16,14,30,16,14,30,0.00077,0.002741,0,1183,0,0.000048,10,0.209544,0.252052,33283.858422,0.070115,0.00787
9508096,9508096,,2,17,19,2,17,19,0.000231,0.004566,0,1176,0,0.000015,10,0.221814,0.268079,1679.264587,0.239766,0.002664
9508143,9508143,,373,15,388,373,15,388,0.046827,0.005809,0,1147,0,0.001387,11,0.21106,0.258157,188704.060317,0.023649,0.240683
9508144,9508144,,30,15,45,30,15,45,0.002813,0.004546,0,1175,0,0.000072,9,0.228679,0.269569,1791.280452,0.162626,0.019725
9409110,9409110,,22,10,32,22,10,32,0.0009,0.000521,0,810,0,0.000063,5,0.361702,0.447549,40746.942538,0.092742,0.01064
9503208,9503208,,16,9,25,16,9,25,0.001356,0.000542,0,1358,52,0.000026,8,0.23184,0.275034,3656.442835,0.146667,0.007111
9507012,9507012,,148,9,157,148,9,157,0.019427,0.003578,0,907,0,0.000558,8,0.238114,0.276305,15430.054455,0.039156,0.106163
9508154,9508154,,126,24,150,126,24,150,0.018775,0.006617,0,1234,0,0.000449,12,0.213504,0.27115,68015.743217,0.054183,0.091016
9509009,9509009,,37,19,56,37,19,56,0.004612,0.006448,0,1314,0,0.000053,13,0.206878,0.263123,2497.895709,0.222727,0.01977
9510093,9510093,,64,18,82,64,18,82,0.007797,0.006167,0,1315,0,0.000087,13,0.21396,0.26769,18504.054918,0.154321,0.036323
9201056,9201056,,118,0,118,118,0,118,0.001776,0,0,144,9,0.000986,0,0,0,0,0.017384,0.043335
9206080,9206080,,9,0,9,9,0,9,0.000585,0,0,939,0,0.000062,0,0,0,0,0.138889,0.006036
9301083,9301083,,50,6,56,50,6,56,0.001413,0.000026,0,168,4,0.000163,1,1,1,32578.159173,0.038961,0.022695
9307158,9307158,,82,4,86,82,4,86,0.006033,0.000222,0,156,0,0.000291,2,0.75,0.833333,5440.4037,0.063201,0.046327
9308062,9308062,,5,12,17,5,12,17,0.00029,0.000064,0,964,5,0.000063,3,0.44898,0.55303,64491.36718,0.095588,0.00588
9407031,9407031,,136,9,145,136,9,145,0.014483,0.000194,0,901,2,0.001717,4,0.355856,0.42827,143564.284113,0.040613,0.144203
9506122,9506122,,56,17,73,56,17,73,0.005048,0.001174,0,965,0,0.000121,9,0.218014,0.267317,318247.929768,0.064117,0.029637
9509066,9509066,,223,38,261,223,38,261,0.013428,0.005173,0,1376,4,0.000483,9,0.21248,0.288948,179795.881614,0.030872,0.086487
9510135,9510135,,775,14,789,775,14,789,0.096438,0.007521,0,1253,2,0.002802,12,0.201871,0.246893,219602.238927,0.013699,0.501494
9510169,9510169,,388,8,396,388,8,396,0.04624,0.003415,0,1166,0,0.001356,11,0.20215,0.241246,80143.342364,0.023776,0.265047
9204030,9204030,,75,0,75,75,0,75,0.004213,0,0,32,0,0.000615,0,0,0,0,0.095856,0.039117
9205009,9205009,,42,0,42,42,0,42,0.002195,0,0,36,0,0.000335,0,0,0,0,0.066202,0.019937
9510017,9510017,,1155,9,1164,1155,9,1164,0.140564,0.003834,0,903,2,0.004812,9,0.211674,0.249838,118489.656681,0.009821,0.721543
9510173,9510173,,41,6,47,41,6,47,0.005165,0.002422,0,1170,0,0.000278,12,0.185185,0.216454,11113.152297,0.109158,0.038386
9510182,9510182,,172,63,235,172,63,235,0.013453,0.012064,0,1356,0,0.000303,14,0.224622,0.314244,497104.015485,0.043481,0.080547
9412236,9412236,,63,19,82,63,19,82,0.003109,0.000989,0,788,0,0.000101,7,0.29007,0.358247,339301.326113,0.046823,0.028007
9511164,9511164,,144,23,167,144,23,167,0.015452,0.007003,0,1514,0,0.000256,12,0.22077,0.269073,224431.849931,0.037804,0.079367
9511222,9511222,,273,15,288,273,15,288,0.030428,0.007,0,1521,0,0.000891,12,0.220245,0.260726,92534.078101,0.030754,0.20463
9512016,9512016,,10,11,21,10,11,21,0.000879,0.001359,0,1533,0,0.000117,9,0.199338,0.231193,9034.031486,0.140476,0.013629
9512017,9512017,,15,20,35,15,20,35,0.001451,0.008879,0,1629,0,0.000023,12,0.223804,0.273038,9971.07537,0.185714,0.007763
9512059,9512059,,325,22,347,325,22,347,0.04018,0.009857,0,1522,2,0.000973,10,0.226403,0.26845,117176.195977,0.027161,0.24823
9512145,9512145,,35,17,52,35,17,52,0.004261,0.007913,0,1592,0,0.000085,11,0.21977,0.258663,14453.363507,0.075792,0.021649
9601014,9601014,,54,26,80,54,26,80,0.005888,0.005081,0,1628,0,0.000089,13,0.21756,0.268842,39708.406509,0.133544,0.037057
9601038,9601038,,329,7,336,329,7,336,0.034925,0.002829,0,1385,0,0.000778,12,0.200029,0.231497,20256.48901,0.038557,0.221472
9206101,9206101,,7,0,7,7,0,7,0.000399,0,0,1535,28,0.000072,0,0,0,0,0.095238,0.007969
9409111,9409111,,57,0,57,57,0,57,0.002456,0,0,911,13,0.000369,0,0,0,0,0.037281,0.026928
9505183,9505183,,37,14,51,37,14,51,0.001838,0.001728,0,1520,28,0.000142,7,0.277344,0.326604,145193.712979,0.064314,0.021625
9506101,9506101,,65,4,69,65,4,69,0.005676,0.002342,0,916,0,0.000231,8,0.216682,0.243188,14419.80489,0.036232,0.034859
9510086,9510086,,232,23,255,232,23,255,0.028649,0.009507,0,1255,0,0.000938,12,0.217667,0.270365,67059.601245,0.036112,0.157749
9510161,9510161,,172,15,187,172,15,187,0.020014,0.008764,0,1403,2,0.000772,12,0.203502,0.247586,15285.524946,0.047726,0.149289
9510209,9510209,,788,17,805,788,17,805,0.077324,0.006794,0,1313,0,0.001908,10,0.227581,0.270668,419806.903706,0.012535,0.391926
9511080,9511080,,121,9,130,121,9,130,0.016546,0.005471,0,1426,0,0.000281,12,0.197589,0.233951,79642.111472,0.030411,0.064372
9512077,9512077,,379,14,393,379,14,393,0.052901,0.008468,0,1534,2,0.001111,10,0.216383,0.251804,57302.755002,0.027341,0.289362
9512181,9512181,,88,37,125,88,37,125,0.010407,0.011505,0,1505,0,0.000343,9,0.228482,0.279085,402426.489078,0.061935,0.066073
9512196,9512196,,92,26,118,92,26,118,0.010194,0.008055,0,1441,0,0.00029,11,0.225334,0.268092,63136.134226,0.068811,0.069393
9512219,9512219,,169,15,184,169,15,184,0.017202,0.006699,0,1507,0,0.00067,9,0.211971,0.246859,62074.36965,0.040746,0.123209
9601036,9601036,,139,25,164,139,25,164,0.014191,0.007826,0,1513,0,0.000354,9,0.236971,0.280804,80428.291404,0.065016,0.092505
9602010,9602010,,39,25,64,39,25,64,0.003732,0.008972,0,1531,0,0.000153,9,0.225745,0.266128,86813.399072,0.131448,0.033513
9210127,9210127,,158,0,158,158,0,158,0.013874,0,0,977,0,0.000489,0,0,0,0,0.060429,0.096673
9304104,9304104,,45,1,46,45,1,46,0.004436,0.000017,0,362,0,0.000137,1,1,1,4652.87991,0.070048,0.028487
9506156,9506156,,19,22,41,19,22,41,0.001587,0.004638,0,1247,13,0.000171,9,0.26788,0.334981,112484.159631,0.087805,0.018645
9508107,9508107,,21,13,34,21,13,34,0.001292,0.002564,0,1683,0,0.000062,7,0.274809,0.32218,77806.518211,0.067736,0.0144
9509106,9509106,,15,67,82,15,67,82,0.001555,0.013901,0,1310,0,0.00016,9,0.267861,0.337224,470823.436316,0.096206,0.021154
9512129,9512129,,46,45,91,46,45,91,0.005094,0.009757,0,1512,0,0.000064,9,0.250453,0.303657,44879.894623,0.130891,0.022643
9512178,9512178,,35,7,42,35,7,42,0.003427,0.002695,0,1681,13,0.000061,10,0.212827,0.244462,18658.956781,0.065621,0.019307
9602049,9602049,,110,15,125,110,15,125,0.006123,0.003932,0,1599,0,0.000337,9,0.226254,0.262806,163832.982635,0.042194,0.055949
9602064,9602064,,185,30,215,185,30,215,0.021818,0.01088,0,1609,2,0.000567,9,0.236243,0.27797,143959.706334,0.042621,0.137314
9602097,9602097,,42,25,67,42,25,67,0.004665,0.00575,0,1550,0,0.000108,10,0.236775,0.283772,19581.631184,0.138399,0.031043
9512053,9512053,,46,15,61,46,15,61,0.003806,0.010004,0,1357,0,0.000246,11,0.220292,0.265006,11425.225049,0.098361,0.03443
9602030,9602030,,79,14,93,79,14,93,0.007989,0.004663,0,1537,0,0.000232,9,0.21575,0.246731,13820.790154,0.114189,0.056711
9602070,9602070,,325,18,343,325,18,343,0.024329,0.003659,0,1744,0,0.000561,9,0.234751,0.271427,377376.081768,0.024977,0.141075
9602098,9602098,,2,2,4,2,2,4,0.000058,0.000006,0,1761,26,0.000032,4,0.384615,0.483333,50739.502063,0.25,0.002934
9602118,9602118,,32,16,48,32,16,48,0.003967,0.005446,0,1750,0,0.000087,10,0.221679,0.25847,5447.186236,0.195035,0.026031
9602120,9602120,,122,18,140,122,18,140,0.010456,0.008256,0,1749,0,0.000256,10,0.229631,0.265869,98247.00348,0.058171,0.071851
9404060,9404060,,9,4,13,9,4,13,0.000495,0.000418,0,809,0,0.00005,2,0.7,0.785714,550.823049,0.224359,0.009084
9511108,9511108,,73,26,99,73,26,99,0.007618,0.006267,0,1435,0,0.00014,11,0.22559,0.274207,37711.321475,0.077407,0.042892
9511157,9511157,,24,31,55,24,31,55,0.002108,0.010339,0,1591,0,0.000059,10,0.24833,0.297809,135821.405861,0.077778,0.011126
9602102,9602102,,38,30,68,38,30,68,0.004063,0.008206,0,1844,0,0.000062,10,0.235065,0.27916,17534.038186,0.092186,0.019792
9603037,9603037,,70,20,90,70,20,90,0.008851,0.005643,0,1784,0,0.000172,9,0.230342,0.268866,96559.596864,0.086142,0.047186
9511204,9511204,,25,14,39,25,14,39,0.001661,0.006379,0,1610,0,0.000041,12,0.207436,0.244309,2772.957465,0.116059,0.012929
9512078,9512078,,101,20,121,101,20,121,0.017847,0.008048,0,1605,13,0.000493,10,0.230446,0.267216,78754.796701,0.085055,0.106414
9509151,9509151,,53,13,66,53,13,66,0.002567,0.000557,0,1604,4,0.000197,10,0.220148,0.257049,195771.327949,0.041958,0.028649
9511026,9511026,,79,7,86,79,7,86,0.013139,0.004484,0,1429,13,0.000609,13,0.199875,0.238172,8907.676463,0.106019,0.095424
9511088,9511088,,79,11,90,79,11,90,0.014385,0.005682,0,1515,13,0.000551,12,0.207446,0.248757,10015.179193,0.098377,0.089135
9601029,9601029,,651,27,678,651,27,678,0.084376,0.006345,0,1693,13,0.001537,9,0.251172,0.295625,573397.800069,0.018836,0.375472
9601162,9601162,,16,7,23,16,7,23,0.001676,0.000544,0,1792,4,0.000075,10,0.21912,0.254877,24020.841612,0.073123,0.010843
9602052,9602052,,406,50,456,406,50,456,0.049698,0.015836,0,1695,2,0.001434,9,0.246718,0.298092,354697.790811,0.02447,0.282453
9603142,9603142,,494,4,498,494,4,498,0.041722,0.001469,0,1906,0,0.000703,10,0.191565,0.219121,21475.564321,0.015446,0.194252
9309110,9309110,,55,9,64,55,9,64,0.001726,0.000296,0,319,0,0.000165,2,0.764706,0.846154,57731.039596,0.074653,0.020055
9403054,9403054,,12,4,16,12,4,16,0.000581,0.000251,0,321,0,0.000036,3,0.5,0.595238,2256.515975,0.141667,0.00399
9406090,9406090,,19,6,25,19,6,25,0.000383,0.000264,0,322,0,0.000092,3,0.533333,0.645833,9664.563628,0.183333,0.007682
9412117,9412117,,23,14,37,23,14,37,0.001106,0.000459,0,790,0,0.000034,3,0.567164,0.662281,36734.097862,0.103604,0.009011
9502012,9502012,,19,12,31,19,12,31,0.000478,0.000345,0,1727,0,0.000023,7,0.267684,0.310708,3603.310595,0.124731,0.005396
9510055,9510055,,16,18,34,16,18,34,0.000469,0.001862,0,1734,0,0.000021,13,0.222326,0.265948,46595.175339,0.147059,0.005127
9605036,9605036,,23,16,39,23,16,39,0.002379,0.002497,0,2723,0,0.000035,10,0.220662,0.258885,15277.90245,0.116059,0.010332
9603081,9603081,,132,23,155,132,23,155,0.015926,0.0114,0,2130,2,0.000588,10,0.237143,0.276794,196465.707494,0.063469,0.102249
9603127,9603127,,141,21,162,141,21,162,0.018364,0.008854,0,2132,2,0.000615,9,0.231644,0.268966,59911.762527,0.063875,0.11005
9604198,9604198,,120,8,128,120,8,128,0.018618,0.005054,0,1910,2,0.000331,10,0.209651,0.238283,4043.751292,0.050258,0.089564
9605150,9605150,,228,20,248,228,20,248,0.027233,0.007848,0,1909,0,0.000352,9,0.229062,0.264022,86330.842688,0.037955,0.125471
9605199,9605199,,139,17,156,139,17,156,0.019945,0.005468,0,1918,0,0.000274,9,0.226794,0.259512,59624.78277,0.052026,0.088439
9406178,9406178,,12,5,17,12,5,17,0.000121,0.000578,0,1682,13,0.000054,5,0.321839,0.382292,2709.079709,0.121324,0.004543
9510227,9510227,,129,7,136,129,7,136,0.009556,0.002573,0,1420,0,0.000458,12,0.179834,0.210208,42663.886917,0.048856,0.089164
9512062,9512062,,333,21,354,333,21,354,0.039001,0.009456,0,1428,2,0.001237,11,0.210748,0.25206,91853.546495,0.027152,0.239762
9603042,9603042,,98,20,118,98,20,118,0.006562,0.005472,0,1917,4,0.000226,16,0.169496,0.221396,86356.628978,0.061712,0.053626
9602167,9602167,,69,11,80,69,11,80,0.002608,0.002354,0,2144,4,0.000183,12,0.180556,0.21414,12635.860971,0.08212,0.030069
9509132,9509132,,76,51,127,76,51,127,0.009985,0.011727,0,1387,2,0.000278,13,0.227123,0.305976,217292.281468,0.047932,0.049903
9608039,9608039,,34,21,55,34,21,55,0.002164,0.008749,0,2843,0,0.00007,11,0.227039,0.264514,89815.296323,0.079125,0.016565
9608079,9608079,,54,7,61,54,7,61,0.004688,0.001028,0,2844,0,0.000077,12,0.198445,0.224955,19676.18446,0.052459,0.025835
9604097,9604097,,62,31,93,62,31,93,0.006254,0.00683,0,1905,0,0.000123,9,0.237857,0.278781,95052.975845,0.088476,0.034339
9605154,9605154,,49,45,94,49,45,94,0.005121,0.008889,0,2215,0,0.000059,9,0.23794,0.284181,36557.246704,0.122855,0.025064
9608111,9608111,,116,18,134,116,18,134,0.010862,0.005373,0,3032,0,0.00017,12,0.207413,0.242181,32119.735525,0.052407,0.054752
9605131,9605131,,56,21,77,56,21,77,0.004778,0.007208,0,1790,0,0.000104,9,0.229575,0.265939,12270.902406,0.122693,0.033492
9605200,9605200,,118,32,150,118,32,150,0.009533,0.009661,0,2264,0,0.00012,9,0.249428,0.290879,163769.546171,0.07566,0.052556
9606044,9606044,,64,12,76,64,12,76,0.006877,0.003368,0,2314,0,0.000078,9,0.224564,0.253228,7380.089799,0.085789,0.03182
9606086,9606086,,59,8,67,59,8,67,0.004465,0.001637,0,2325,0,0.000069,9,0.21988,0.247295,91344.420254,0.082542,0.029356
9607020,9607020,,25,21,46,25,21,46,0.001614,0.005291,0,2330,0,0.000047,11,0.220295,0.256406,94203.667717,0.132367,0.011926
9607139,9607139,,58,32,90,58,32,90,0.00344,0.007836,0,2435,0,0.000058,11,0.233481,0.275219,182773.683505,0.069413,0.023454
9608024,9608024,,383,51,434,383,51,434,0.048586,0.015563,0,2511,2,0.001048,9,0.249338,0.296146,439600.951393,0.025936,0.240493
9608047,9608047,,33,8,41,33,8,41,0.001906,0.003231,0,3021,0,0.000049,10,0.202261,0.228159,6244.520344,0.146341,0.014586
9608109,9608109,,36,23,59,36,23,59,0.002847,0.006134,0,3031,0,0.000052,11,0.218319,0.253127,49848.621489,0.12332,0.020139
9509042,9509042,,24,13,37,24,13,37,0.003179,0.003501,0,1510,0,0.000028,13,0.206982,0.257916,526.783163,0.257508,0.01402
9509161,9509161,,201,17,218,201,17,218,0.012809,0.003861,0,1225,4,0.000227,13,0.198442,0.249953,288237.413351,0.072338,0.093376
9510106,9510106,,44,15,59,44,15,59,0.002162,0.003481,0,2291,0,0.000137,9,0.239464,0.287635,146830.068901,0.056984,0.02187
9602051,9602051,,201,17,218,201,17,218,0.025961,0.006116,0,1806,13,0.000689,10,0.232476,0.26754,34220.006551,0.056251,0.156436
9603108,9603108,,42,43,85,42,43,85,0.005337,0.008624,0,1850,0,0.000039,9,0.244472,0.293725,55567.42247,0.142017,0.022773
9608194,9608194,,24,20,44,24,20,44,0.002358,0.003435,0,3054,0,0.000038,11,0.220943,0.256941,21422.479128,0.131078,0.013453
9511077,9511077,,13,7,20,13,7,20,0.000456,0.000043,0,2547,3,0.000036,6,0.342105,0.415171,52977.016636,0.086842,0.005043
9512226,9512226,,6,37,43,6,37,43,0.000613,0.010458,0,3434,0,0.000014,11,0.236517,0.288903,40599.961584,0.147841,0.003446
9603170,9603170,,64,39,103,64,39,103,0.005747,0.00588,0,1789,0,0.000065,9,0.231167,0.276304,99927.298702,0.109366,0.030048
9604034,9604034,,216,56,272,216,56,272,0.023374,0.012965,0,1901,4,0.000195,9,0.25824,0.307189,512248.750793,0.042463,0.108659
9609161,9609161,,59,17,76,59,17,76,0.006187,0.004436,0,3114,0,0.00014,13,0.200402,0.236319,61660.759061,0.067193,0.036307
9604129,9604129,,136,23,159,136,23,159,0.013559,0.007995,0,1794,0,0.000233,10,0.224551,0.265407,16956.791285,0.08196,0.075344
9606165,9606165,,102,11,113,102,11,113,0.013012,0.00332,0,2213,0,0.000244,10,0.205492,0.235047,7715.130315,0.077197,0.076238
9610111,9610111,,20,20,40,20,20,40,0.001769,0.00388,0,3155,0,0.000033,12,0.213567,0.246375,17072.416281,0.158974,0.010576
9602065,9602065,,137,10,147,137,10,147,0.017251,0.004886,0,1822,13,0.000441,10,0.219774,0.251842,28523.406916,0.070171,0.111024
9604030,9604030,,116,15,131,116,15,131,0.007541,0.003828,0,1908,0,0.000224,9,0.228791,0.263728,42120.923419,0.047093,0.056136
9605053,9605053,,107,11,118,107,11,118,0.009241,0.002917,0,1926,0,0.000125,10,0.206102,0.236007,21810.723463,0.059032,0.04942
9606122,9606122,,112,23,135,112,23,135,0.007545,0.005741,0,1932,0,0.000136,10,0.22845,0.267213,37249.277989,0.059093,0.048099
9606148,9606148,,27,30,57,27,30,57,0.002071,0.006459,0,2328,0,0.000032,10,0.228615,0.269419,21669.114526,0.14787,0.011938
9607091,9607091,,42,4,46,42,4,46,0.003203,0.000491,0,2331,0,0.000046,12,0.191279,0.216692,3401.825769,0.095169,0.017179
9607105,9607105,,16,22,38,16,22,38,0.002152,0.005377,0,2329,0,0.000027,11,0.217715,0.256685,13237.299936,0.146515,0.008843
9610195,9610195,,19,55,74,19,55,74,0.001421,0.00772,0,3151,0,0.000028,12,0.236822,0.285263,137054.445183,0.114217,0.008285
9610251,9610251,,55,46,101,55,46,101,0.004699,0.008448,0,3126,0,0.000062,12,0.232467,0.277459,101275.749276,0.089307,0.027926
9611090,9611090,,80,28,108,80,28,108,0.006274,0.003819,0,3542,0,0.0001,12,0.224285,0.263322,162583.183419,0.062825,0.037252
9612052,9612052,,71,26,97,71,26,97,0.005621,0.003781,0,3543,4,0.000096,13,0.210505,0.249135,57878.68015,0.076031,0.037993
9701015,9701015,,40,23,63,40,23,63,0.00277,0.006959,0,3546,4,0.000073,11,0.223248,0.259096,57436.684411,0.116487,0.026097
9701023,9701023,,45,41,86,45,41,86,0.002868,0.004891,0,3710,0,0.00004,12,0.227047,0.26917,53760.865837,0.09699,0.015548
9503115,9503115,,113,7,120,113,7,120,0.006283,0.002452,0,197,4,0.000221,7,0.245,0.288909,1943.858318,0.076401,0.050271
9505006,9505006,,96,7,103,96,7,103,0.004454,0.002667,0,885,4,0.000175,7,0.248101,0.294691,885.344103,0.089473,0.038925
9505075,9505075,,204,15,219,204,15,219,0.013324,0.00348,0,664,4,0.00037,9,0.199596,0.247202,23996.543032,0.069813,0.102588
9505082,9505082,,23,3,26,23,3,26,0.000528,0.00025,0,1374,4,0.000052,1,1,1,30.165494,0.227692,0.009283
9505100,9505100,,178,6,184,178,6,184,0.012273,0.002746,0,665,4,0.000334,10,0.174296,0.212468,1850.431657,0.075641,0.092019
9506098,9506098,,56,7,63,56,7,63,0.002629,0.001605,0,1371,4,0.000101,7,0.2211,0.263971,10124.983376,0.058628,0.022403
9507013,9507013,,52,13,65,52,13,65,0.002282,0.000867,0,2169,4,0.000067,9,0.193264,0.232214,2795.492771,0.11274,0.016245
9507018,9507018,,45,19,64,45,19,64,0.001787,0.002813,0,1373,4,0.000074,9,0.202344,0.253702,5270.768588,0.190972,0.020224
9507032,9507032,,70,6,76,70,6,76,0.004737,0.002679,0,1226,4,0.00009,10,0.174525,0.213048,26.41501,0.157368,0.03271
9507169,9507169,,38,11,49,38,11,49,0.000813,0.002627,0,1375,4,0.000084,10,0.1822,0.230864,5176.692424,0.17602,0.016044
9510148,9510148,,46,19,65,46,19,65,0.001078,0.002796,0,1617,4,0.000059,9,0.20264,0.253898,2372.350252,0.190385,0.015925
9510228,9510228,,37,21,58,37,21,58,0.001164,0.003082,0,1618,4,0.000044,9,0.203028,0.25628,3471.442575,0.203872,0.013158
9511154,9511154,,111,7,118,111,7,118,0.009803,0.002953,0,1911,4,0.000214,15,0.148125,0.179154,14742.585123,0.053745,0.057695
9603086,9603086,,61,25,86,61,25,86,0.006987,0.006097,0,2148,4,0.00009,12,0.17974,0.231101,58513.719532,0.045691,0.02397
9603136,9603136,,120,17,137,120,17,137,0.007466,0.003501,0,2833,4,0.00014,12,0.190731,0.22596,52065.384808,0.081097,0.044469
9603158,9603158,,41,10,51,41,10,51,0.000833,0.001771,0,3053,4,0.000068,10,0.185087,0.23269,13120.787709,0.126667,0.013726
9607076,9607076,,52,14,66,52,14,66,0.0038,0.003257,0,3064,4,0.000048,13,0.170754,0.201918,3286.009131,0.182284,0.020892
9607202,9607202,,89,14,103,89,14,103,0.006962,0.002412,0,3068,4,0.000079,13,0.176667,0.209836,29352.711067,0.102513,0.034173
9610132,9610132,,1,0,1,1,0,1,0.000067,0,0,3687,4,0.000011,0,0,0,0,0,0.00071
9611190,9611190,,91,165,256,91,165,256,0.010824,0.021715,0,3502,4,0.000072,11,0.249231,0.320977,909051.573055,0.057782,0.03488
9611197,9611197,,26,22,48,26,22,48,0.000992,0.00356,0,3674,4,0.00003,11,0.187159,0.217128,41631.828869,0.188387,0.010105
9612114,9612114,,22,2,24,22,2,24,0.002488,0.001027,0,3686,23,0.000026,7,0.271772,0.30659,64238.622646,0.03442,0.006011
9612207,9612207,,46,39,85,46,39,85,0.001236,0.001161,0,3679,4,0.000052,11,0.172883,0.205228,76806.451554,0.122269,0.01284
9204060,9204060,,41,0,41,41,0,41,0.001608,0,0,595,0,0.000079,0,0,0,0,0.094512,0.01565
9205004,9205004,,46,0,46,46,0,46,0.001488,0,0,316,0,0.000243,0,0,0,0,0.080676,0.017252
9304026,9304026,,43,0,43,43,0,43,0.001946,0,0,318,0,0.000106,0,0,0,0,0.038206,0.015185
9509049,9509049,,4,9,13,4,9,13,0.000201,0.00101,0,2217,0,0.000015,6,0.24586,0.294473,4581.31259,0.128205,0.002032
9511230,9511230,,22,8,30,22,8,30,0.001482,0.000773,0,1616,0,0.000024,13,0.192452,0.223925,1847.335581,0.162069,0.008237
9606112,9606112,,151,14,165,151,14,165,0.009541,0.00477,0,2756,52,0.000226,10,0.20615,0.24155,70527.064236,0.048374,0.081289
9606008,9606008,,17,11,28,17,11,28,0.001139,0.002515,0,2216,0,0.000029,9,0.224523,0.254606,1800.284424,0.113757,0.007357
9609219,9609219,,72,30,102,72,30,102,0.005212,0.004768,0,3112,4,0.00006,11,0.224342,0.26489,272184.518357,0.080179,0.028598
9207091,9207091,,49,0,49,49,0,49,0.004845,0,0,641,0,0.000108,0,0,0,0,0.08801,0.025197
9210068,9210068,,43,0,43,43,0,43,0.002827,0,0,583,0,0.000104,0,0,0,0,0.073643,0.017954
9504102,9504102,,126,7,133,126,7,133,0.008446,0.002654,0,666,4,0.000246,7,0.253333,0.301481,798.030931,0.108225,0.068602
9505097,9505097,,24,8,32,24,8,32,0.002249,0.000345,0,2164,0,0.000036,8,0.216629,0.258119,10007.760197,0.110887,0.010739
9507008,9507008,,117,10,127,117,10,127,0.007634,0.003154,0,1202,4,0.000171,10,0.175494,0.219662,484.136635,0.11786,0.058375
9509175,9509175,,154,16,170,154,16,170,0.010037,0.003769,0,1228,4,0.000165,14,0.170086,0.210804,25598.479407,0.079568,0.06662
9509176,9509176,,101,17,118,101,17,118,0.006433,0.004072,0,1227,4,0.0001,14,0.170086,0.211081,14633.483668,0.125598,0.043991
9510074,9510074,,48,6,54,48,6,54,0.002304,0.00332,0,1419,0,0.000176,11,0.199624,0.228047,21721.786537,0.099231,0.019782
9511180,9511180,,40,15,55,40,15,55,0.002477,0.002735,0,1853,4,0.000042,15,0.157846,0.195375,973.807815,0.219529,0.015676
9512005,9512005,,37,14,51,37,14,51,0.002602,0.002928,0,2751,4,0.000032,14,0.187182,0.22927,33814.053271,0.20549,0.015691
9512006,9512006,,61,4,65,61,4,65,0.003376,0.001404,0,2159,2,0.000236,12,0.169924,0.189867,4626.333161,0.065385,0.027801
9512139,9512139,,15,26,41,15,26,41,0.001382,0.003676,0,2189,0,0.000023,11,0.209628,0.253317,72399.581251,0.112805,0.004981
9603004,9603004,,49,19,68,49,19,68,0.004763,0.006656,0,2166,0,0.000063,10,0.232123,0.273029,19725.042495,0.096795,0.023344
9604062,9604062,,10,5,15,10,5,15,0.001093,0.001444,0,2161,13,0.000021,13,0.155168,0.176573,350.656936,0.195238,0.004729
9605032,9605032,,95,41,136,95,41,136,0.008897,0.008496,0,2168,0,0.000084,10,0.238051,0.289622,58498.39791,0.059477,0.033888
9606043,9606043,,34,13,47,34,13,47,0.002384,0.003022,0,3436,4,0.000025,14,0.177447,0.217705,2223.405765,0.26087,0.012546
9606073,9606073,,7,5,12,7,5,12,0.001432,0.000348,0,2467,0,0.000015,11,0.197179,0.224053,226.172075,0.25,0.003438
9607032,9607032,,28,27,55,28,27,55,0.001607,0.004264,0,2190,0,0.00004,12,0.196787,0.239521,54843.393594,0.107071,0.009433
9608183,9608183,,35,24,59,35,24,59,0.002625,0.006201,0,3125,4,0.000031,10,0.224565,0.265482,120849.91666,0.130333,0.014711
9609059,9609059,,33,28,61,33,28,61,0.002371,0.004412,0,3484,4,0.000024,10,0.222174,0.258461,53351.850128,0.169945,0.0126
9611112,9611112,,6,6,12,6,6,12,0.00037,0.000283,0,4030,0,0.000014,11,0.199736,0.227969,2951.933581,0.151515,0.001932
9611188,9611188,,4,32,36,4,32,36,0.000098,0.004501,0,4029,0,0.000014,13,0.199147,0.236539,14280.997197,0.159524,0.001402
9612105,9612105,,40,44,84,40,44,84,0.006246,0.011576,0,4026,0,0.00004,10,0.240932,0.287049,71843.706594,0.096816,0.022511
9505035,9505035,,204,12,216,204,12,216,0.01359,0.001829,0,661,4,0.000232,6,0.27947,0.336809,91077.872259,0.058506,0.088278
9506011,9506011,,86,16,102,86,16,102,0.006458,0.004011,0,918,4,0.000291,9,0.245555,0.299418,37610.8356,0.042419,0.050399
9509162,9509162,,108,4,112,108,4,112,0.006559,0.001618,0,1174,4,0.000126,6,0.252816,0.293317,27070.94107,0.11036,0.052928
9510101,9510101,,225,14,239,225,14,239,0.020836,0.003085,0,1229,4,0.000399,14,0.170659,0.211256,117937.413894,0.046148,0.106879
9608085,9608085,,37,7,44,37,7,44,0.002099,0.000253,0,3383,4,0.000096,11,0.177362,0.197365,18438.335939,0.070296,0.023018
9611230,9611230,,438,20,458,438,20,458,0.046851,0.002403,0,3387,4,0.000447,12,0.2042,0.236533,200300.943083,0.022202,0.19491
9612131,9612131,,68,23,91,68,23,91,0.00715,0.002997,0,3564,4,0.000084,12,0.206718,0.242525,70225.801973,0.078999,0.03519
9702014,9702014,,156,14,170,156,14,170,0.016257,0.00219,0,3547,4,0.000168,12,0.195987,0.2248,37927.189816,0.078176,0.07877
9702154,9702154,,61,13,74,61,13,74,0.005006,0.001814,0,3658,4,0.000084,13,0.199628,0.230724,129805.054409,0.135876,0.035993
9509146,9509146,,25,18,43,25,18,43,0.003258,0.003623,0,1511,0,0.000028,13,0.207707,0.260746,4301.420314,0.22979,0.013823
9606133,9606133,,21,37,58,21,37,58,0.001454,0.006106,0,2306,0,0.000023,10,0.2367,0.278839,20154.923041,0.152148,0.007069
9610154,9610154,,23,11,34,23,11,34,0.00164,0.002905,0,3138,0,0.000023,10,0.197857,0.228851,8476.539475,0.135472,0.008251
9701147,9701147,,17,29,46,17,29,46,0.001169,0.003795,0,4197,0,0.00002,12,0.225216,0.26431,28983.630995,0.158937,0.005891
9701165,9701165,,74,34,108,74,34,108,0.005088,0.006886,0,3711,0,0.000079,12,0.225258,0.265711,95035.514337,0.075805,0.030013
9701175,9701175,,18,24,42,18,24,42,0.001015,0.003699,0,4201,0,0.000021,12,0.21925,0.256742,26252.549658,0.147503,0.005486
9703007,9703007,,27,47,74,27,47,74,0.001991,0.005998,0,4200,0,0.000026,13,0.227321,0.275445,47249.255001,0.119585,0.008517
9703148,9703148,,9,27,36,9,27,36,0.000513,0.003447,0,4193,0,0.000015,11,0.230743,0.269645,6713.222271,0.211111,0.002729
9310035,9310035,,21,1,22,21,1,22,0.001914,0.00002,0,360,0,0.000193,2,0.666667,0.75,251.701972,0.080087,0.023325
9604178,9604178,,127,22,149,127,22,149,0.013168,0.006131,0,1797,0,0.000214,9,0.22386,0.259241,17965.38823,0.087656,0.068956
9606176,9606176,,38,31,69,38,31,69,0.005002,0.009182,0,2307,0,0.000053,11,0.226394,0.26787,15429.003567,0.159847,0.021198
9607019,9607019,,63,12,75,63,12,75,0.00745,0.002228,0,2310,0,0.000065,12,0.202939,0.232866,1790.033653,0.120901,0.032655
9607057,9607057,,56,38,94,56,38,94,0.005639,0.007191,0,2335,0,0.000061,11,0.22965,0.26963,64686.193501,0.10501,0.02747
9607229,9607229,,61,28,89,61,28,89,0.005601,0.006989,0,3559,0,0.000063,12,0.217994,0.258698,15906.838205,0.110955,0.028031
9608053,9608053,,47,30,77,47,30,77,0.005346,0.008638,0,2716,0,0.00005,13,0.212409,0.252992,12987.606369,0.1338,0.023382
9611050,9611050,,701,71,772,701,71,772,0.086474,0.024463,0,2758,2,0.001101,11,0.242582,0.296238,1640261.371393,0.013271,0.322517
9612126,9612126,,125,18,143,125,18,143,0.016938,0.008859,0,3304,2,0.000219,11,0.212267,0.248465,36011.933136,0.054516,0.067579
9702038,9702038,,54,19,73,54,19,73,0.006394,0.004609,0,3701,0,0.000052,11,0.218016,0.250276,11217.574574,0.104452,0.025186
9605030,9605030,,30,24,54,30,24,54,0.000081,0.000034,0,4190,20,0.000049,7,0.250509,0.343167,463799.433657,0.096785,0.008783
9609159,9609159,,19,13,32,19,13,32,0.001464,0.002563,0,3115,0,0.000031,12,0.209033,0.238667,2495.253461,0.199597,0.010141
9610140,9610140,,107,19,126,107,19,126,0.013125,0.007419,0,2683,52,0.000207,10,0.206244,0.244863,54603.577356,0.053143,0.064655
9703098,9703098,,18,31,49,18,31,49,0.001335,0.005649,0,3702,0,0.000028,12,0.22239,0.258237,32939.963068,0.129252,0.008155
9703167,9703167,,16,15,31,16,15,31,0.001373,0.001773,0,3704,0,0.000036,12,0.211175,0.240539,42356.493822,0.146237,0.009719
9609111,9609111,,15,18,33,15,18,33,0.001333,0.003788,0,3160,0,0.000019,12,0.221921,0.26126,2944.39328,0.177083,0.005596
9701129,9701129,,5,25,30,5,25,30,0.000565,0.005564,0,3713,0,0.000016,13,0.219803,0.25874,7062.518827,0.201149,0.002707
9702061,9702061,,23,31,54,23,31,54,0.003342,0.007872,0,3714,0,0.000028,13,0.210613,0.247847,25423.936694,0.156184,0.012658
9610076,9610076,,30,14,44,30,14,44,0.001668,0.003042,0,3557,0,0.00003,12,0.214235,0.244344,7900.758353,0.141649,0.010992
9611063,9611063,,66,26,92,66,26,92,0.005862,0.005702,0,3384,4,0.000099,11,0.224333,0.26116,105510.088699,0.079431,0.034231
9611201,9611201,,35,15,50,35,15,50,0.003739,0.003644,0,3385,4,0.000058,12,0.20062,0.230815,7798.635476,0.126939,0.018918
9612085,9612085,,28,39,67,28,39,67,0.002152,0.00576,0,4037,0,0.000026,11,0.234785,0.280668,25387.056277,0.113297,0.012893
9702180,9702180,,78,17,95,78,17,95,0.006541,0.00389,0,3565,4,0.000089,12,0.207076,0.242412,33987.889784,0.117245,0.04276
9703100,9703100,,36,8,44,36,8,44,0.003253,0.001243,0,3659,4,0.000045,13,0.196424,0.223505,67875.974632,0.100951,0.01472
9703110,9703110,,74,26,100,74,26,100,0.005155,0.004511,0,3692,4,0.000088,11,0.210316,0.245314,396873.249863,0.063838,0.030046
9703210,9703210,,108,23,131,108,23,131,0.010725,0.00754,0,4041,4,0.000088,11,0.21123,0.24757,22451.267277,0.109924,0.051339
9704043,9704043,,73,22,95,73,22,95,0.007211,0.002804,0,4045,4,0.000066,11,0.20613,0.238133,34363.836275,0.153527,0.038351
9704044,9704044,,80,27,107,80,27,107,0.007026,0.00383,0,4042,4,0.000069,11,0.218549,0.257822,96336.733106,0.125022,0.037578
9704061,9704061,,29,19,48,29,19,48,0.00249,0.002289,0,4046,4,0.00003,12,0.19728,0.229979,1021.737935,0.296099,0.016864
9704104,9704104,,100,49,149,100,49,149,0.01043,0.011228,0,4047,4,0.000077,11,0.213846,0.254555,48640.094363,0.101215,0.046545
9704170,9704170,,87,31,118,87,31,118,0.009204,0.005818,0,4048,4,0.000079,11,0.208687,0.245118,40881.131647,0.097204,0.043881
9705004,9705004,,23,25,48,23,25,48,0.002038,0.002619,0,4055,4,0.000023,12,0.200282,0.235092,3840.964617,0.285018,0.012622
9609176,9609176,,66,48,114,66,48,114,0.009749,0.012377,0,2718,0,0.000085,14,0.227827,0.282786,364390.838767,0.079336,0.031576
9610043,9610043,,1199,19,1218,1199,19,1218,0.130748,0.009623,0,2684,2,0.002904,10,0.217812,0.252345,382703.366326,0.010694,0.612174
9705113,9705113,,18,27,45,18,27,45,0.003103,0.007857,0,3878,2,0.00005,14,0.210191,0.245513,552697.365787,0.197475,0.014744
9705175,9705175,,28,35,63,28,35,63,0.00474,0.007821,0,3879,2,0.000055,13,0.205226,0.2423,55161.297591,0.12596,0.017499
9706155,9706155,,14,20,34,14,20,34,0.001607,0.009997,0,4307,4,0.000017,13,0.184358,0.220357,1802.205603,0.144385,0.007234
9506052,9506052,,57,3,60,57,3,60,0.002444,0.000297,0,1250,4,0.000262,7,0.240678,0.281556,23490.105864,0.05565,0.023815
9601003,9601003,,134,15,149,134,15,149,0.01458,0.009657,0,1600,2,0.000508,11,0.214142,0.251329,18060.227471,0.055006,0.100041
9602077,9602077,,76,12,88,76,12,88,0.009269,0.005424,0,1686,2,0.000183,10,0.208562,0.238682,7204.119315,0.064786,0.059487
9702136,9702136,,98,23,121,98,23,121,0.015178,0.004765,0,3583,2,0.000328,14,0.191663,0.226299,84033.238762,0.087259,0.081196
9704089,9704089,,144,21,165,144,21,165,0.021981,0.005695,0,3698,2,0.000324,13,0.200418,0.23067,77475.934547,0.060421,0.096466
9705162,9705162,,87,43,130,87,43,130,0.006865,0.01019,0,3426,2,0.000097,14,0.210042,0.255467,189820.31161,0.045975,0.031017
9705212,9705212,,26,10,36,26,10,36,0.001825,0.002178,0,3537,2,0.000043,15,0.179471,0.209573,9844.841112,0.069048,0.010151
9706117,9706117,,52,9,61,52,9,61,0.003391,0.002465,0,3536,2,0.000058,12,0.201367,0.2303,23821.229597,0.081148,0.017761
9706144,9706144,,19,8,27,19,8,27,0.001036,0.002738,0,3541,2,0.000037,13,0.186114,0.213157,11824.882578,0.122507,0.007483
9706207,9706207,,39,26,65,39,26,65,0.002038,0.002583,0,4284,13,0.000063,16,0.190851,0.232769,195919.749083,0.047115,0.013579
9605033,9605033,,196,12,208,196,12,208,0.023325,0.004547,0,1930,2,0.000277,10,0.211919,0.243988,15495.604885,0.034142,0.114077
9609017,9609017,,97,41,138,97,41,138,0.00814,0.010481,0,2725,0,0.000128,10,0.239723,0.286479,216039.382223,0.042632,0.046133
9610234,9610234,,151,11,162,151,11,162,0.010569,0.002868,0,2986,2,0.000278,12,0.199595,0.226123,54546.477321,0.033701,0.066328
9710206,9710206,,82,29,111,82,29,111,0.007092,0.005551,0,5162,2,0.000114,13,0.198719,0.234989,377866.778017,0.048403,0.042738
9406091,9406091,,11,3,14,11,3,14,0.000093,0.000042,0,320,0,0.000066,3,0.483871,0.555556,1954.34341,0.082418,0.00402
9609167,9609167,,19,32,51,19,32,51,0.000494,0.006873,0,3140,0,0.000025,9,0.227921,0.267627,35220.66544,0.096471,0.006013
9611172,9611172,,8,17,25,8,17,25,0.00012,0.000528,0,4341,0,0.000017,10,0.201098,0.231727,6542.266282,0.181667,0.002291
9702199,9702199,,8,24,32,8,24,32,0.000323,0.001917,0,6602,0,0.000017,13,0.205747,0.241568,44825.572332,0.176411,0.002399
9705174,9705174,,23,26,49,23,26,49,0.001347,0.005289,0,5852,0,0.000024,13,0.209215,0.249699,8055.825028,0.161139,0.007058
9705210,9705210,,9,27,36,9,27,36,0.000497,0.003571,0,5850,0,0.000017,13,0.202859,0.242392,13026.876407,0.140476,0.00274
9709178,9709178,,10,12,22,10,12,22,0.000186,0.002576,0,7316,10,0.00002,14,0.184584,0.216364,6221.532226,0.151515,0.002368
9709193,9709193,,49,25,74,49,25,74,0.003695,0.004598,0,5964,4,0.000038,12,0.221711,0.26141,76123.882646,0.082932,0.014988
9710021,9710021,,8,23,31,8,23,31,0.000097,0.000729,0,7314,0,0.000017,14,0.192498,0.230453,18084.991718,0.196774,0.002228
9710031,9710031,,6,12,18,6,12,18,0.000076,0.000592,0,7315,0,0.000014,14,0.187586,0.218864,12006.921621,0.22549,0.001603
9711013,9711013,,70,29,99,70,29,99,0.005365,0.004717,0,4508,0,0.00005,14,0.203807,0.242974,86016.621072,0.057102,0.024181
9611092,9611092,,13,4,17,13,4,17,0.000362,0.000021,0,4652,52,0.000026,4,0.433962,0.51087,19832.642783,0.117647,0.004571
9309124,9309124,,17,2,19,17,2,19,0.001444,0.000099,0,1311,0,0.000145,2,0.75,0.833333,5570.742809,0.064327,0.02032
9703157,9703157,,27,22,49,27,22,49,0.002387,0.003647,0,4921,0,0.000048,15,0.193253,0.230672,13713.740044,0.164541,0.015614
9707123,9707123,,58,32,90,58,32,90,0.00628,0.009397,0,4293,2,0.000066,15,0.215277,0.255531,211476.307202,0.05593,0.026658
9708118,9708118,,70,50,120,70,50,120,0.006766,0.011462,0,4870,4,0.000048,14,0.22174,0.260994,103140.061524,0.112185,0.026457
9711201,9711201,,56,64,120,56,64,120,0.004407,0.014538,0,4949,0,0.000053,11,0.20206,0.246954,152163.263316,0.080042,0.025441
9512043,9512043,,18,27,45,18,27,45,0.002155,0.004828,0,2167,0,0.000029,12,0.194746,0.242167,22718.172197,0.115152,0.007918
9709180,9709180,,33,46,79,33,46,79,0.002136,0.017015,0,5969,4,0.000049,12,0.218599,0.263497,270915.894647,0.063453,0.009349
9712023,9712023,,10,17,27,10,17,27,0.00081,0.0022,0,5857,0,0.000017,13,0.207101,0.240456,5821.52576,0.165242,0.004148
9801057,9801057,,21,27,48,21,27,48,0.001065,0.002834,0,5855,0,0.000029,11,0.21441,0.249706,15696.605252,0.163564,0.006538
9802093,9802093,,6,10,16,6,10,16,0.000448,0.001687,0,5856,0,0.000016,12,0.193285,0.220905,2207.51879,0.275,0.003118
9711162,9711162,,788,17,805,788,17,805,0.061007,0.004498,0,5497,30,0.001293,15,0.191147,0.222963,891142.795816,0.015976,0.344259
9711165,9711165,,456,6,462,456,6,462,0.043364,0.003994,0,5572,30,0.000661,15,0.175914,0.198458,39305.65309,0.025443,0.213434
9805189,9805189,,17,25,42,17,25,42,0.001059,0.003838,0,7326,0,0.000018,15,0.191731,0.224794,30597.466669,0.134727,0.005244
9403040,9403040,,94,1,95,94,1,95,0.010837,0.000002,0,895,2,0.001222,2,0.666667,0.75,4629.97837,0.064278,0.104538
9511194,9511194,,115,1,116,115,1,116,0.011975,0.001652,0,1539,3,0.000508,10,0.174855,0.194201,46.120641,0.060945,0.107899
9604091,9604091,,142,27,169,142,27,169,0.012474,0.008561,0,1942,2,0.000335,10,0.22356,0.265097,203960.944602,0.045294,0.09282
9604156,9604156,,105,27,132,105,27,132,0.012788,0.012299,0,2441,2,0.000247,9,0.235634,0.276239,67923.806592,0.061011,0.07695
9612215,9612215,,19,28,47,19,28,47,0.001622,0.008545,0,3263,3,0.000144,11,0.211303,0.247264,375572.551597,0.10592,0.02663
9704006,9704006,,60,9,69,60,9,69,0.003808,0.004879,0,4699,3,0.000137,12,0.193585,0.222733,7979.481481,0.056692,0.042223
9708147,9708147,,230,17,247,230,17,247,0.022551,0.006642,0,4895,2,0.000342,16,0.191947,0.226969,158605.059506,0.026283,0.103604
9803194,9803194,,123,53,176,123,53,176,0.010056,0.011069,0,6355,3,0.000192,11,0.222294,0.259687,354487.030822,0.050617,0.062869
9805019,9805019,,235,29,264,235,29,264,0.015899,0.004784,0,6374,3,0.000337,12,0.221318,0.251706,389799.595164,0.045887,0.12188
9805112,9805112,,173,24,197,173,24,197,0.031847,0.022031,0,6082,1,0.000185,13,0.215246,0.245441,917125.310285,0.038719,0.086994
9805170,9805170,,297,15,312,297,15,312,0.019303,0.002632,0,6375,3,0.000346,12,0.199288,0.223191,134528.826702,0.035772,0.147871
9806155,9806155,,105,5,110,105,5,110,0.008906,0.001729,0,7825,3,0.000151,12,0.194857,0.215469,6725.641982,0.1,0.061621
9807138,9807138,,39,10,49,39,10,49,0.002952,0.003835,0,7976,3,0.000108,13,0.189355,0.211614,3494.61687,0.173044,0.036961
9807235,9807235,,70,25,95,70,25,95,0.006249,0.006028,0,6954,52,0.000068,14,0.199727,0.227735,93009.999835,0.076708,0.030423
9808141,9808141,,229,27,256,229,27,256,0.015316,0.005484,0,7980,3,0.000268,12,0.205365,0.233128,195072.17942,0.050061,0.115119
9809111,9809111,,104,11,115,104,11,115,0.008448,0.00347,0,7981,3,0.000135,12,0.198679,0.221312,17375.9612,0.09611,0.057917
9810163,9810163,,15,4,19,15,4,19,0.001743,0.001408,0,7274,2,0.00003,13,0.180995,0.200117,11051.066413,0.096491,0.008064
9402119,9402119,,33,3,36,33,3,36,0.00188,0.000051,0,593,0,0.000055,1,1,1,765.89178,0.061111,0.012584
9610162,9610162,,51,65,116,51,65,116,0.003941,0.010423,0,3136,0,0.000046,11,0.242254,0.292855,124629.038835,0.086657,0.018669
9706110,9706110,,125,74,199,125,74,199,0.011112,0.010278,0,4289,4,0.000103,10,0.235477,0.283164,537854.67973,0.052155,0.05028
9706226,9706226,,17,19,36,17,19,36,0.000902,0.004903,0,7325,0,0.000019,13,0.201883,0.235935,11545.598398,0.150794,0.004799
9801139,9801139,,14,11,25,14,11,25,0.000663,0.00163,0,6473,0,0.000025,12,0.198159,0.228909,5886.697514,0.145,0.004925
9802202,9802202,,26,20,46,26,20,46,0.001653,0.001308,0,6221,0,0.000024,16,0.192993,0.227677,7726.755966,0.131884,0.008591
9803224,9803224,,31,17,48,31,17,48,0.001522,0.001143,0,8099,0,0.000028,14,0.18585,0.21869,18835.687719,0.139184,0.010095
9804176,9804176,,32,46,78,32,46,78,0.0028,0.00663,0,7323,0,0.000024,14,0.208944,0.251086,95472.576742,0.079587,0.010132
9807096,9807096,,18,35,53,18,35,53,0.002476,0.011491,0,8562,0,0.000016,16,0.192787,0.23247,11542.55385,0.117925,0.005661
9602154,9602154,,11,18,29,11,18,29,0.001153,0.003181,0,1852,0,0.00002,10,0.230373,0.272224,4503.479302,0.263547,0.007367
9405012,9405012,,5,0,5,5,0,5,0.000127,0,0,8547,3,0.000026,0,0,0,0,0.15,0.002655
9403096,9403096,,28,12,40,28,12,40,0.004525,0.000583,0,2290,0,0.000029,5,0.337047,0.419972,30682.453977,0.047436,0.012034
9403187,9403187,,41,11,52,41,11,52,0.001498,0.000479,0,592,0,0.000101,2,0.72,0.805556,7631.653432,0.076546,0.016982
9508091,9508091,,59,18,77,59,18,77,0.007216,0.003705,0,1144,13,0.000206,10,0.224229,0.272662,133825.702578,0.055707,0.039754
9610151,9610151,,56,20,76,56,20,76,0.003112,0.003798,0,2677,0,0.000047,10,0.216401,0.25011,14211.926542,0.099649,0.023853
9706195,9706195,,42,9,51,42,9,51,0.003229,0.001456,0,5588,0,0.000059,15,0.173876,0.202525,3383.020669,0.078039,0.017763
9707013,9707013,,28,25,53,28,25,53,0.002378,0.003207,0,4874,0,0.000048,15,0.202323,0.242112,34161.854223,0.06894,0.012647
9707044,9707044,,35,12,47,35,12,47,0.005122,0.000898,0,5156,2,0.00005,11,0.207722,0.235054,32668.10155,0.112858,0.021403
9801009,9801009,,2,10,12,2,10,12,0.000095,0.001984,0,8672,0,0.000011,15,0.166325,0.196277,716.042139,0.128788,0.000537
9806140,9806140,,35,10,45,35,10,45,0.004996,0.00064,0,6562,2,0.000033,15,0.171461,0.197087,29984.399572,0.087374,0.017399
9812170,9812170,,5,8,13,5,8,13,0.001008,0.000375,0,7726,2,0.000012,13,0.174269,0.192418,4218.687883,0.230769,0.001646
9901126,9901126,,16,20,36,16,20,36,0.000695,0.00428,0,8557,0,0.00002,14,0.175278,0.205945,46233.36523,0.120635,0.004904
9901137,9901137,,7,22,29,7,22,29,0.000211,0.00229,0,8671,0,0.000015,15,0.163665,0.194694,5462.482017,0.131773,0.002144
9610148,9610148,,152,40,192,152,40,192,0.014917,0.015114,0,2979,2,0.000272,12,0.230036,0.276961,556287.875021,0.051402,0.071819
9610249,9610249,,154,17,171,154,17,171,0.014438,0.008871,0,2983,2,0.000276,13,0.20769,0.243323,85111.537516,0.05418,0.073617
9611159,9611159,,186,29,215,186,29,215,0.017851,0.01066,0,2988,2,0.00025,12,0.21097,0.251986,104765.263763,0.044403,0.085125
9611173,9611173,,214,12,226,214,12,226,0.021356,0.004078,0,2991,2,0.00028,13,0.19056,0.221769,27047.534563,0.037522,0.096216
9612080,9612080,,178,22,200,178,22,200,0.016324,0.009875,0,3324,2,0.000334,13,0.20272,0.241566,90651.940065,0.040704,0.096452
9709027,9709027,,169,17,186,169,17,186,0.015058,0.001597,0,5235,2,0.000235,15,0.18354,0.214479,173475.529824,0.03281,0.066699
9711098,9711098,,24,18,42,24,18,42,0.002556,0.004843,0,5659,2,0.000027,14,0.192229,0.22402,40092.591097,0.114983,0.010416
9711200,9711200,,2414,54,2468,2414,54,2468,0.484296,0.014593,0,5305,1,0.003568,13,0.216003,0.255694,3461609.828325,0.005496,1
9712086,9712086,,31,31,62,31,31,62,0.004256,0.008938,0,5660,2,0.000037,14,0.200497,0.236973,89512.917306,0.102062,0.013898
9812135,9812135,,164,34,198,164,34,198,0.011168,0.008374,0,7986,3,0.000182,12,0.211042,0.240963,114839.669088,0.064605,0.0832
9901042,9901042,,37,26,63,37,26,63,0.002759,0.013607,0,7990,3,0.000054,12,0.220466,0.255245,98309.022673,0.141321,0.020382
9902160,9902160,,30,24,54,30,24,54,0.002227,0.002874,0,8620,3,0.00003,12,0.205745,0.233278,13835.811516,0.187631,0.014128
9903123,9903123,,68,30,98,68,30,98,0.005209,0.004647,0,8624,3,0.000053,13,0.203261,0.235197,34412.370672,0.115506,0.028356
9904207,9904207,,282,73,355,282,73,355,0.017279,0.011667,0,8629,3,0.000211,14,0.213701,0.252355,712371.046948,0.032012,0.112453
9905006,9905006,,86,35,121,86,35,121,0.007135,0.006911,0,8630,3,0.000056,14,0.202171,0.234367,94495.585463,0.077066,0.030928
9905080,9905080,,7,24,31,7,24,31,0.000804,0.002637,0,8631,3,0.000013,14,0.198499,0.227285,2001.419785,0.217204,0.002666
9905195,9905195,,38,26,64,38,26,64,0.002953,0.004693,0,8669,3,0.000028,16,0.19436,0.22625,50106.837297,0.121776,0.013877
9907061,9907061,,1,12,13,1,12,13,0.000204,0.005563,0,8660,2,0.000011,15,0.178997,0.20987,227.051349,0.282051,0.000643
9908091,9908091,,5,6,11,5,6,11,0.000343,0.000772,0,8659,3,0.000012,15,0.185346,0.208567,108.093038,0.309091,0.001738
9908126,9908126,,21,29,50,21,29,50,0.001412,0.005148,0,8658,3,0.000023,13,0.19957,0.227361,43879.78489,0.142449,0.008535
9403123,9403123,,35,3,38,35,3,38,0.001993,0.000258,0,652,52,0.000137,2,0.8,0.875,3961.592851,0.072546,0.019956
9605201,9605201,,21,27,48,21,27,48,0.003797,0.007771,0,2199,0,0.000061,10,0.238693,0.2777,72119.297566,0.08289,0.017328
9803205,9803205,,41,11,52,41,11,52,0.00284,0.000921,0,7287,2,0.000058,14,0.190118,0.219262,122419.35393,0.065611,0.013841
9807040,9807040,,15,28,43,15,28,43,0.001146,0.006272,0,7914,52,0.000018,14,0.19458,0.228125,10709.314993,0.08804,0.004383
9902098,9902098,,77,29,106,77,29,106,0.010876,0.00861,0,7705,41,0.000105,14,0.192381,0.22064,284045.271384,0.060198,0.033137
9903031,9903031,,76,13,89,76,13,89,0.005707,0.003323,0,8346,52,0.000058,15,0.187057,0.20876,8540.865352,0.082737,0.028734
9904104,9904104,,17,15,32,17,15,32,0.004425,0.009427,0,7797,41,0.000025,14,0.190221,0.21625,14974.168755,0.125,0.012894
9905032,9905032,,15,30,45,15,30,45,0.003719,0.017701,0,7800,41,0.000019,13,0.199395,0.228531,58693.073355,0.142929,0.010849
9907189,9907189,,67,7,74,67,7,74,0.003251,0.001199,0,8582,3,0.000066,13,0.187135,0.207059,22945.585042,0.063865,0.022575
9907200,9907200,,25,22,47,25,22,47,0.003277,0.002136,0,8580,41,0.000043,13,0.188225,0.212248,64198.09347,0.113784,0.008407
9908041,9908041,,18,11,29,18,11,29,0.001802,0.000887,0,8581,41,0.000043,14,0.177485,0.199133,26921.537229,0.155172,0.005535
9212115,9212115,,8,0,8,8,0,8,0.000318,0,0,6467,22,0.000038,0,0,0,0,0,0.002206
9511169,9511169,,5,0,5,5,0,5,0.000032,0,0,5389,3,0.000035,0,0,0,0,0,0.00156
9810157,9810157,,11,16,27,11,16,27,0.001078,0.006508,0,7741,0,0.000029,15,0.190551,0.22201,11936.389989,0.118234,0.00373
9810064,9810064,,10,13,23,10,13,23,0.000407,0.001586,0,8550,52,0.000018,14,0.178625,0.208445,21261.962973,0.108696,0.004416
9903224,9903224,,119,30,149,119,30,149,0.019084,0.017755,0,8263,1,0.000103,12,0.204455,0.237508,157454.186367,0.042672,0.05058
9907178,9907178,,51,33,84,51,33,84,0.004949,0.006257,0,8544,1,0.000036,11,0.236824,0.273232,131074.184718,0.072719,0.015525
9908142,9908142,,1142,75,1217,1142,75,1217,0.066838,0.011716,0,8530,30,0.001371,12,0.22531,0.256229,4110736.245091,0.010561,0.391245
9909101,9909101,,35,51,86,35,51,86,0.004585,0.028162,0,8546,2,0.000031,11,0.243955,0.279251,317057.303567,0.087278,0.013111
9904115,9904115,,11,48,59,11,48,59,0.000908,0.008538,0,8565,0,0.000014,14,0.197893,0.232206,26215.96951,0.12858,0.00342
9910216,9910216,,1,28,29,1,28,29,0.000047,0.004199,0,8568,0,0.00001,13,0.195118,0.220907,8335.096706,0.194581,0.000258
1002,1002,,43,36,79,43,36,79,0.005193,0.005172,0,8941,25,0.000048,11,0.208864,0.23593,55160.219414,0.087958,0.018214
9201007,9201007,,83,0,83,83,0,83,0.005668,0,0,292,25,0.000268,0,0,0,0,0.048046,0.032894
9204031,9204031,,21,0,21,21,0,21,0.000489,0,0,290,13,0.000323,0,0,0,0,0.1,0.011586
9210123,9210123,,13,6,19,13,6,19,0.000298,0.000306,0,293,13,0.000128,2,0.6875,0.772727,6086.538723,0.152047,0.007368
9304062,9304062,,14,4,18,14,4,18,0.000434,0.000206,0,294,13,0.000233,3,0.48,0.597222,16226.035938,0.147059,0.012627
9306005,9306005,,2,0,2,2,0,2,0.000097,0,0,8940,25,0.000011,0,0,0,0,0.5,0.000849
9402089,9402089,,4,8,12,4,8,12,0.000147,0.000318,0,1113,13,0.000022,3,0.551724,0.697917,325.101844,0.166667,0.001643
9604090,9604090,,106,37,143,106,37,143,0.009494,0.004609,0,2505,25,0.000617,11,0.23667,0.28778,343172.338328,0.032059,0.063094
9803235,9803235,,208,40,248,208,40,248,0.015787,0.003565,0,7675,25,0.000288,12,0.203927,0.237583,296162.534572,0.040486,0.085157
9807051,9807051,,30,24,54,30,24,54,0.003264,0.001575,0,7493,25,0.000044,13,0.190647,0.22248,86868.723425,0.048567,0.011248
9809015,9809015,,11,18,29,11,18,29,0.001792,0.007803,0,7954,1,0.000028,12,0.20129,0.229506,20624.88928,0.081281,0.005527
9810063,9810063,,11,21,32,11,21,32,0.002165,0.018047,0,7328,1,0.000025,13,0.193479,0.22117,14931.133141,0.172379,0.006396
9812035,9812035,,79,19,98,79,19,98,0.017831,0.019299,0,7618,1,0.000094,11,0.200965,0.227512,67029.705901,0.094151,0.045064
9902125,9902125,,56,23,79,56,23,79,0.014014,0.020772,0,7956,1,0.000072,13,0.203763,0.230307,70901.626938,0.140214,0.036172
9902155,9902155,,50,16,66,50,16,66,0.012623,0.020335,0,7957,1,0.000067,14,0.191099,0.216256,5315.573206,0.161305,0.034546
9904017,9904017,,230,42,272,230,42,272,0.043407,0.025749,0,7975,1,0.000237,13,0.209823,0.240055,207348.016101,0.043873,0.099939
9905012,9905012,,223,7,230,223,7,230,0.015815,0.001584,0,8725,25,0.000274,13,0.189865,0.211657,82220.832207,0.032675,0.077955
9905210,9905210,,168,29,197,168,29,197,0.014706,0.008833,0,8735,25,0.000373,14,0.208503,0.240266,301058.682928,0.055812,0.077574
9906064,9906064,,1031,5,1036,1031,5,1036,0.078875,0.007775,0,8701,25,0.00164,11,0.230117,0.260379,3092352.814731,0.010066,0.350218
9906194,9906194,,135,29,164,135,29,164,0.026889,0.021772,0,8698,1,0.000123,14,0.20441,0.232148,112598.657265,0.067111,0.05681
9907070,9907070,,29,47,76,29,47,76,0.004475,0.021444,0,8759,1,0.000045,11,0.222913,0.255789,126009.023524,0.073684,0.015477
9907209,9907209,,108,4,112,108,4,112,0.007491,0.001167,0,8737,25,0.000185,12,0.196967,0.214892,24089.582499,0.059363,0.041843
9908076,9908076,,115,6,121,115,6,121,0.009492,0.008885,0,8736,25,0.00024,11,0.228159,0.257552,206217.989717,0.056887,0.047935
9908116,9908116,,64,17,81,64,17,81,0.007006,0.018774,0,8709,25,0.000119,12,0.204699,0.230223,40079.885312,0.090278,0.032064
9908186,9908186,,53,15,68,53,15,68,0.003477,0.003614,0,8739,25,0.000155,12,0.20059,0.223071,16748.633587,0.124451,0.023667
9909001,9909001,,35,11,46,35,11,46,0.002634,0.003242,0,8743,25,0.000052,12,0.193509,0.213668,2029.551322,0.171498,0.015233
9909041,9909041,,47,28,75,47,28,75,0.00715,0.020597,0,8749,1,0.000061,12,0.210642,0.237519,41193.042669,0.118378,0.021236
9909053,9909053,,125,8,133,125,8,133,0.011459,0.00172,0,8742,25,0.000193,12,0.201655,0.223437,22488.953608,0.073935,0.054972
9909058,9909058,,108,24,132,108,24,132,0.013221,0.003918,0,8764,25,0.000181,12,0.211107,0.237614,126374.510645,0.068413,0.048705
9909121,9909121,,49,32,81,49,32,81,0.008508,0.020591,0,8841,1,0.000045,12,0.212437,0.240505,34948.154448,0.105401,0.017727
9909134,9909134,,232,25,257,232,25,257,0.025666,0.020233,0,8772,25,0.000297,12,0.209182,0.235277,187310.451809,0.037132,0.091515
9910149,9910149,,171,17,188,171,17,188,0.015618,0.002904,0,8813,25,0.000144,11,0.206399,0.229014,99148.878669,0.048413,0.061311
9910219,9910219,,211,9,220,211,9,220,0.014557,0.001934,0,8768,25,0.000246,12,0.199389,0.220051,41735.475103,0.043898,0.072745
9912012,9912012,,136,18,154,136,18,154,0.027744,0.01991,0,8830,1,0.000093,12,0.207164,0.230818,74768.925215,0.059375,0.048265
9912118,9912118,,96,17,113,96,17,113,0.008689,0.002588,0,8829,25,0.00011,11,0.198637,0.220077,25627.106245,0.075537,0.035806
9912132,9912132,,37,52,89,37,52,89,0.004569,0.024527,0,8939,1,0.000045,12,0.219987,0.250825,126152.356903,0.088355,0.015057
9912187,9912187,,32,30,62,32,30,62,0.004609,0.005183,0,8831,25,0.000029,11,0.211691,0.2388,13936.370543,0.107086,0.012688
9202037,9202037,,9,0,9,9,0,9,0.001536,0,0,291,13,0.000115,0,0,0,0,0.055556,0.010519
9206004,9206004,,17,1,18,17,1,18,0.001498,0.000062,0,289,13,0.000091,1,1,1,264.964635,0.058824,0.006233
9209116,9209116,,44,5,49,44,5,49,0.005795,0.000193,0,214,13,0.001203,1,1,1,21871.615418,0.076531,0.048651
9202014,9202014,,104,0,104,104,0,104,0.005956,0,0,218,13,0.000733,0,0,0,0,0.023245,0.055931
9203083,9203083,,39,0,39,39,0,39,0.0004,0,0,96,13,0.000354,0,0,0,0,0.024291,0.014158
9212020,9212020,,11,2,13,11,2,13,0.000407,0.000072,0,297,13,0.000088,1,1,1,2514.847441,0.134615,0.008976
9307049,9307049,,172,2,174,172,2,174,0.029294,0.000151,0,216,1,0.002253,2,0.583333,0.642857,10509.759216,0.033254,0.156727
9309089,9309089,,10,0,10,10,0,10,0.000054,0,0,1859,41,0.0001,0,0,0,0,0.2,0.003657
9402085,9402085,,23,0,23,23,0,23,0.00059,0,0,1178,25,0.000097,0,0,0,0,0.023715,0.007934
9403058,9403058,,33,7,40,33,7,40,0.00188,0.0007,0,327,0,0.000122,3,0.534483,0.596774,15289.031974,0.059615,0.014361
9405124,9405124,,79,1,80,79,1,80,0.011773,0.000344,0,217,13,0.001213,3,0.4,0.458333,1515.338634,0.058703,0.083498
9409119,9409119,,19,11,30,19,11,30,0.001637,0.000487,0,1123,13,0.000082,4,0.353933,0.453704,29543.949151,0.116092,0.01163
9411170,9411170,,9,10,19,9,10,19,0.00076,0.000299,0,1120,13,0.000039,6,0.313993,0.403261,46300.251315,0.134503,0.004592
9501073,9501073,,8,3,11,8,3,11,0.000054,0.000001,0,2504,41,0.000055,1,1,1,25101.111636,0.190909,0.003089
9503114,9503114,,34,7,41,34,7,41,0.001297,0.000138,0,1179,0,0.000079,4,0.392,0.467687,20746.859093,0.065244,0.013781
9510097,9510097,,95,34,129,95,34,129,0.011875,0.004923,0,1409,13,0.000263,9,0.25145,0.30706,201044.886599,0.060138,0.060626
9511131,9511131,,3,16,19,3,16,19,0.000131,0.000178,0,2455,0,0.000033,8,0.225112,0.268637,10345.473847,0.154971,0.003006
9512031,9512031,,176,34,210,176,34,210,0.020104,0.006001,0,1691,13,0.000456,10,0.244857,0.3005,261539.747048,0.060105,0.111971
9512127,9512127,,62,27,89,62,27,89,0.006771,0.00241,0,1808,13,0.000101,10,0.221552,0.268351,28724.769108,0.079545,0.035405
9601075,9601075,,7,1,8,7,1,8,0.000484,0.000021,0,2501,13,0.000036,7,0.225434,0.254823,473.369426,0.035714,0.003011
9602126,9602126,,14,5,19,14,5,19,0.000303,0.000175,0,2500,25,0.000065,11,0.169909,0.200029,7421.462086,0.122807,0.006856
9603074,9603074,,31,71,102,31,71,102,0.001832,0.003989,0,2456,0,0.000067,10,0.256553,0.322677,325253.45117,0.042225,0.015095
9511203,9511203,,53,5,58,53,5,58,0.005616,0.002921,0,1631,13,0.000168,12,0.181001,0.215695,1829.417711,0.069268,0.031238
9601150,9601150,,190,11,201,190,11,201,0.01766,0.004823,0,1697,13,0.000361,11,0.206669,0.239613,23176.820533,0.035448,0.103146
9605136,9605136,,108,18,126,108,18,126,0.006075,0.006548,0,2528,0,0.000198,10,0.218034,0.258048,107187.396803,0.077905,0.050847
9606036,9606036,,48,24,72,48,24,72,0.003346,0.006202,0,2429,0,0.000146,10,0.2254,0.266582,740790.095924,0.091354,0.02681
9608019,9608019,,86,20,106,86,20,106,0.004202,0.002583,0,2680,0,0.000161,10,0.239509,0.276982,113718.647595,0.083738,0.039092
9608173,9608173,,59,12,71,59,12,71,0.004142,0.001458,0,2506,13,0.000116,11,0.213746,0.244947,34665.628144,0.073038,0.026619
9609209,9609209,,59,17,76,59,17,76,0.002827,0.00306,0,4421,0,0.000126,13,0.214229,0.249579,23732.281322,0.10614,0.029095
9611134,9611134,,32,19,51,32,19,51,0.003126,0.004561,0,2509,13,0.000044,10,0.219252,0.249812,11145.575907,0.11451,0.015705
9611196,9611196,,14,24,38,14,24,38,0.000869,0.004489,0,7671,0,0.000034,12,0.229042,0.267033,29991.004839,0.110242,0.008302
9701048,9701048,,23,16,39,23,16,39,0.000968,0.00451,0,4422,0,0.000047,14,0.212195,0.25356,45799.800832,0.194332,0.012256
9704177,9704177,,71,18,89,71,18,89,0.002961,0.003944,0,4429,0,0.000122,12,0.209636,0.243302,66456.701566,0.106869,0.031695
9706171,9706171,,25,15,40,25,15,40,0.001,0.001685,0,7633,0,0.000058,15,0.185614,0.223355,31097.922029,0.209615,0.01449
9707143,9707143,,68,11,79,68,11,79,0.003116,0.001943,0,7634,0,0.000107,16,0.173023,0.20768,11988.228676,0.146219,0.029493
9707208,9707208,,53,10,63,53,10,63,0.002604,0.002042,0,7635,0,0.000072,17,0.164331,0.199644,2197.409105,0.15489,0.022965
9707223,9707223,,43,12,55,43,12,55,0.002052,0.001232,0,7636,0,0.000066,17,0.166429,0.205304,8319.90728,0.198316,0.020191
9708031,9708031,,25,6,31,25,6,31,0.001684,0.001782,0,5921,0,0.00004,12,0.199077,0.226617,1086.621699,0.177419,0.012314
9709043,9709043,,34,17,51,34,17,51,0.001897,0.002165,0,7637,0,0.000053,16,0.176257,0.20994,18624.589536,0.209412,0.017671
9709049,9709049,,27,18,45,27,18,45,0.001068,0.001932,0,7630,0,0.000044,12,0.22035,0.254451,31625.083552,0.124242,0.012917
9709214,9709214,,23,7,30,23,7,30,0.001168,0.003821,0,7629,0,0.000044,12,0.195043,0.222815,14097.284148,0.21954,0.013014
9710208,9710208,,76,18,94,76,18,94,0.003463,0.002638,0,7638,0,0.000082,14,0.195117,0.228045,25297.697438,0.111645,0.030039
9711080,9711080,,12,26,38,12,26,38,0.000487,0.007857,0,7665,0,0.000027,11,0.225106,0.262361,86003.735648,0.190612,0.007197
9711197,9711197,,51,15,66,51,15,66,0.001918,0.00212,0,7640,0,0.000065,14,0.183909,0.212288,5718.797889,0.169697,0.022211
9712214,9712214,,73,16,89,73,16,89,0.003206,0.002109,0,7672,0,0.000129,15,0.179785,0.212531,52421.271216,0.075332,0.026295
9801030,9801030,,55,19,74,55,19,74,0.002403,0.002196,0,7641,0,0.000061,14,0.183392,0.214861,8793.418421,0.15124,0.022441
9801087,9801087,,22,30,52,22,30,52,0.00099,0.003343,0,7666,0,0.000032,12,0.201461,0.234044,9334.130512,0.173831,0.011374
9801123,9801123,,12,24,36,12,24,36,0.000622,0.001375,0,7674,0,0.000024,12,0.199716,0.228473,40556.509298,0.307937,0.008062
9801204,9801204,,10,12,22,10,12,22,0.000515,0.003135,0,7673,0,0.000024,15,0.182522,0.214218,5282.603444,0.264069,0.00652
9802111,9802111,,8,10,18,8,10,18,0.000496,0.001645,0,7668,0,0.000021,14,0.174738,0.198927,188.808053,0.434641,0.006306
9802148,9802148,,9,25,34,9,25,34,0.000526,0.002503,0,7667,0,0.000022,13,0.19581,0.23226,33199.98281,0.174688,0.006555
9504019,9504019,,37,8,45,37,8,45,0.002261,0.00046,0,1167,13,0.000435,8,0.279919,0.353244,13499.828045,0.027273,0.012877
9607011,9607011,,53,19,72,53,19,72,0.006541,0.006436,0,2529,0,0.000119,10,0.242961,0.285952,531867.201635,0.072183,0.033984
9607043,9607043,,10,20,30,10,20,30,0.000607,0.001539,0,3518,13,0.000022,12,0.188002,0.229053,56805.471036,0.090805,0.003767
9611079,9611079,,19,6,25,19,6,25,0.001508,0.000554,0,2507,13,0.000026,12,0.184943,0.206366,241.818255,0.16,0.007266
9704186,9704186,,30,17,47,30,17,47,0.004481,0.009629,0,5748,1,0.000048,12,0.21416,0.248664,29709.517258,0.078168,0.013688
9707207,9707207,,21,18,39,21,18,39,0.001652,0.002609,0,4516,13,0.000041,15,0.175865,0.213342,32361.33164,0.087719,0.008417
9710244,9710244,,16,22,38,16,22,38,0.001492,0.003417,0,5701,13,0.000026,16,0.198469,0.235789,20191.846075,0.103841,0.005528
9801160,9801160,,13,22,35,13,22,35,0.000852,0.00233,0,6133,13,0.000021,12,0.216767,0.251411,43772.865074,0.112605,0.004234
9802030,9802030,,33,1,34,33,1,34,0.000825,0.000004,0,7479,0,0.000209,2,0.6,0.666667,8341.101823,0.0918,0.010872
9803084,9803084,,17,1,18,17,1,18,0.000167,0.00001,0,7484,0,0.000082,3,0.444444,0.541667,0,0.22549,0.005109
9803116,9803116,,73,63,136,73,63,136,0.009602,0.013157,0,6134,13,0.000069,16,0.194039,0.243841,267757.929693,0.03927,0.025282
9803156,9803156,,25,3,28,25,3,28,0.000577,0.000012,0,7486,0,0.000063,3,0.545455,0.694444,9287.456074,0.12037,0.008595
9803239,9803239,,20,19,39,20,19,39,0.003267,0.004901,0,6870,13,0.000029,14,0.194515,0.227803,58130.001668,0.075574,0.008708
9803259,9803259,,38,38,76,38,38,76,0.004654,0.004558,0,6871,13,0.000044,12,0.2059,0.239782,170861.859571,0.06386,0.014695
9805012,9805012,,4,7,11,4,7,11,0.000022,0.000022,0,7490,0,0.000016,3,0.666667,0.816667,4071.081105,0.390909,0.001208
9805032,9805032,,4,7,11,4,7,11,0.000023,0.000025,0,7492,0,0.000015,2,0.733333,0.818182,894.33084,0.309091,0.001152
9805167,9805167,,5,10,15,5,10,15,0.00028,0.000227,0,7491,0,0.000021,14,0.192166,0.219333,87638.753157,0.180952,0.00217
9204099,9204099,,380,0,380,380,0,380,0.039812,0,0,60,1,0.001079,0,0,0,0,0.015935,0.166189
9308131,9308131,,15,3,18,15,3,18,0.001354,0.000036,0,2296,0,0.00003,4,0.421053,0.583333,1395.095836,0.153595,0.005753
9310159,9310159,,27,21,48,27,21,48,0.000664,0.000152,0,250,13,0.00006,3,0.708333,0.803922,81144.636156,0.083333,0.01034
9512222,9512222,,19,4,23,19,4,23,0.002646,0.000324,0,5956,1,0.000029,10,0.209542,0.240217,1845.976289,0.081028,0.005993
9706174,9706174,,7,2,9,7,2,9,0.001208,0.000575,0,6090,1,0.000024,4,0.31383,0.347458,20.515512,0.291667,0.00302
9706192,9706192,,57,30,87,57,30,87,0.011272,0.007958,0,5255,13,0.000357,13,0.203893,0.243111,161426.103986,0.066961,0.067393
9711161,9711161,,85,14,99,85,14,99,0.015127,0.002048,0,5370,1,0.00036,16,0.1866,0.216342,155261.071594,0.067924,0.072046
9803090,9803090,,27,41,68,27,41,68,0.005819,0.020379,0,5811,1,0.000038,13,0.211686,0.247794,65827.783068,0.116769,0.016061
9805087,9805087,,19,11,30,19,11,30,0.003283,0.012102,0,7073,1,0.000032,13,0.18401,0.206208,16470.502393,0.098851,0.007068
9806195,9806195,,20,59,79,20,59,79,0.005056,0.024976,0,7160,1,0.000024,12,0.218778,0.258088,112146.16674,0.072217,0.01303
9807137,9807137,,85,22,107,85,22,107,0.014786,0.021136,0,6284,1,0.000082,12,0.200905,0.231378,48984.62303,0.04911,0.038329
9807187,9807187,,36,11,47,36,11,47,0.006644,0.015704,0,7865,1,0.000039,14,0.187181,0.213446,8838.110411,0.16605,0.013115
9808016,9808016,,93,23,116,93,23,116,0.021058,0.017999,0,6649,1,0.000101,12,0.206638,0.236102,127843.286976,0.053523,0.044225
9808097,9808097,,27,10,37,27,10,37,0.004844,0.006709,0,7871,1,0.000036,15,0.177529,0.201921,35781.588016,0.145646,0.010601
9808149,9808149,,113,29,142,113,29,142,0.018674,0.023832,0,6286,1,0.000116,12,0.2229,0.256801,239708.418614,0.048197,0.054738
9607060,9607060,,44,2,46,44,2,46,0.007575,0.000181,0,3454,1,0.000117,16,0.139074,0.165876,15834.113511,0.165217,0.025837
9608125,9608125,,45,7,52,45,7,52,0.008723,0.000938,0,5006,1,0.000099,17,0.132428,0.166415,8422.236367,0.078808,0.023582
9611014,9611014,,41,21,62,41,21,62,0.005688,0.0052,0,3586,13,0.000041,12,0.216705,0.253725,20550.902107,0.083818,0.015855
9705024,9705024,,12,41,53,12,41,53,0.00261,0.00653,0,5287,13,0.000018,10,0.219291,0.262983,10129.172325,0.135704,0.005474
9711048,9711048,,10,11,21,10,11,21,0.001134,0.000338,0,6645,0,0.00002,13,0.19383,0.225215,32248.766827,0.088095,0.003881
9802109,9802109,,1641,12,1653,1641,12,1653,0.386523,0.011515,0,5387,1,0.002173,14,0.193457,0.223703,362919.922981,0.008624,0.716547
9802150,9802150,,1775,22,1797,1775,22,1797,0.405175,0.01242,0,5545,1,0.002352,14,0.196864,0.230268,976687.620833,0.007499,0.748002
9802203,9802203,,131,17,148,131,17,148,0.034723,0.012328,0,5569,1,0.000255,14,0.19553,0.226456,177088.192558,0.074738,0.090952
9803171,9803171,,75,24,99,75,24,99,0.01955,0.020117,0,5823,1,0.000095,13,0.196749,0.226095,20045.049822,0.122655,0.047302
9804170,9804170,,129,17,146,129,17,146,0.029704,0.02101,0,5941,1,0.000221,12,0.204032,0.231256,102610.270266,0.062589,0.074728
9806074,9806074,,155,18,173,155,18,173,0.036381,0.019637,0,6154,1,0.000159,12,0.198564,0.225077,28116.920269,0.084958,0.075756
9807090,9807090,,35,21,56,35,21,56,0.008332,0.013726,0,6674,1,0.000051,12,0.200681,0.227626,28775.776766,0.12013,0.021357
9807097,9807097,,75,26,101,75,26,101,0.018594,0.020613,0,7054,1,0.000087,12,0.204242,0.231878,57337.738906,0.131089,0.040367
9807098,9807098,,106,21,127,106,21,127,0.025191,0.019355,0,6567,1,0.000104,12,0.199621,0.225131,41942.869398,0.11786,0.053654
9808006,9808006,,74,15,89,74,15,89,0.017962,0.018408,0,7165,1,0.000092,12,0.192272,0.21578,20127.714501,0.151685,0.040911
9808162,9808162,,55,11,66,55,11,66,0.011032,0.008006,0,7283,1,0.000053,12,0.187023,0.210906,11526.825899,0.164569,0.023398
9809067,9809067,,34,19,53,34,19,53,0.009547,0.020051,0,7282,1,0.000036,12,0.198789,0.224406,16225.523138,0.209361,0.022325
9809122,9809122,,19,16,35,19,16,35,0.00174,0.004719,0,7327,0,0.000023,12,0.19128,0.221393,20237.292333,0.059664,0.006044
9809179,9809179,,49,8,57,49,8,57,0.011662,0.016838,0,7281,1,0.000067,12,0.188596,0.211055,9604.76287,0.183271,0.027673
9810051,9810051,,36,19,55,36,19,55,0.009848,0.01893,0,7284,1,0.000039,12,0.199593,0.22595,19749.22961,0.208418,0.023178
9508072,9508072,,172,7,179,172,7,179,0.018695,0.000789,0,1676,13,0.000399,10,0.215848,0.253969,46974.139253,0.051943,0.116661
9601023,9601023,,40,13,53,40,13,53,0.005637,0.001065,0,3453,1,0.000201,10,0.206344,0.262011,125590.131433,0.079826,0.028822
9602111,9602111,,88,12,100,88,12,100,0.009226,0.003328,0,1830,13,0.000141,10,0.23645,0.275183,13881.104564,0.090404,0.040284
9602136,9602136,,172,17,189,172,17,189,0.019321,0.002288,0,1832,13,0.000293,11,0.226829,0.26355,53667.06101,0.051418,0.087369
9802183,9802183,,301,17,318,301,17,318,0.059942,0.019746,0,5605,1,0.000415,14,0.200612,0.23381,182158.927323,0.037101,0.174324
9806087,9806087,,233,21,254,233,21,254,0.04674,0.021286,0,6634,1,0.000267,13,0.203232,0.231258,199524.956314,0.039417,0.104562
9807080,9807080,,233,23,256,233,23,256,0.044957,0.023444,0,7040,1,0.000202,12,0.207532,0.23615,116629.875662,0.043275,0.10951
9807087,9807087,,47,84,131,47,84,131,0.004015,0.021098,0,7617,0,0.00005,11,0.228685,0.272189,262197.309965,0.059014,0.016303
9807164,9807164,,77,22,99,77,22,99,0.018736,0.023333,0,7405,1,0.000089,12,0.206534,0.234687,38877.031572,0.101835,0.046754
9809192,9809192,,31,6,37,31,6,37,0.004809,0.000505,0,7608,1,0.000047,12,0.175286,0.194145,16862.834408,0.129129,0.012592
9810126,9810126,,177,13,190,177,13,190,0.037598,0.016859,0,7069,1,0.000181,12,0.200216,0.224644,134965.570831,0.056001,0.085637
9810206,9810206,,99,16,115,99,16,115,0.02413,0.020109,0,7072,1,0.000109,13,0.193237,0.218385,17756.899587,0.099008,0.057482
9811149,9811149,,20,11,31,20,11,31,0.002828,0.00543,0,7609,1,0.000038,12,0.18023,0.20322,19583.65306,0.109677,0.008459
9603133,9603133,,134,20,154,134,20,154,0.011076,0.007183,0,2458,0,0.00024,9,0.243565,0.283061,65057.14869,0.041592,0.054774
9803001,9803001,,247,3,250,247,3,250,0.058507,0.014992,0,5712,1,0.000287,15,0.176857,0.199185,5419.900227,0.038859,0.126555
9803002,9803002,,315,14,329,315,14,329,0.073955,0.018571,0,5711,1,0.000385,14,0.192455,0.224637,85214.429406,0.033073,0.15708
9803137,9803137,,73,33,106,73,33,106,0.01813,0.017873,0,5817,1,0.000093,13,0.208936,0.240294,25556.908111,0.095418,0.037414
9805114,9805114,,294,6,300,294,6,300,0.067995,0.016783,0,6109,1,0.000441,15,0.180305,0.205327,18454.771882,0.026901,0.139594
9805129,9805129,,113,30,143,113,30,143,0.027072,0.025072,0,6098,1,0.000144,12,0.20982,0.240205,137555.330766,0.072048,0.056626
9809022,9809022,,149,23,172,149,23,172,0.034149,0.021907,0,6656,1,0.000162,13,0.212978,0.242619,386812.030713,0.04386,0.073333
9811035,9811035,,136,28,164,136,28,164,0.021811,0.02547,0,7436,1,0.000116,13,0.199319,0.231047,125968.811461,0.055551,0.056516
9811156,9811156,,81,23,104,81,23,104,0.019236,0.021111,0,7437,1,0.000072,13,0.202001,0.228633,31297.160013,0.113051,0.038961
9811208,9811208,,32,21,53,32,21,53,0.007349,0.021131,0,7441,1,0.000036,13,0.196318,0.223743,10868.205011,0.165094,0.018205
9812017,9812017,,28,7,35,28,7,35,0.006184,0.012035,0,7955,1,0.000026,13,0.186938,0.211894,21057.725687,0.137815,0.010088
9812089,9812089,,95,22,117,95,22,117,0.017117,0.022927,0,7442,1,0.000083,13,0.196538,0.224257,35478.704431,0.086354,0.045609
9812144,9812144,,14,23,37,14,23,37,0.001219,0.002838,0,7953,2,0.000017,15,0.186487,0.218974,29709.7106,0.135135,0.004771
9901041,9901041,,42,15,57,42,15,57,0.011177,0.015459,0,7920,1,0.000043,11,0.199246,0.225365,20583.156814,0.136905,0.026477
9901101,9901101,,76,23,99,76,23,99,0.01417,0.0206,0,7905,1,0.000062,12,0.203504,0.231948,73216.268747,0.096269,0.034746
9902012,9902012,,21,20,41,21,20,41,0.0036,0.020123,0,7912,1,0.000031,13,0.212864,0.245467,79904.002708,0.138415,0.007644
9902074,9902074,,63,42,105,63,42,105,0.013067,0.025338,0,7949,1,0.000064,12,0.210796,0.240086,91484.685921,0.106777,0.03555
9702076,9702076,,172,27,199,172,27,199,0.044818,0.008139,0,3812,1,0.00062,13,0.214061,0.255962,105109.698212,0.055073,0.168483
9803023,9803023,,76,32,108,76,32,108,0.020086,0.023522,0,5713,1,0.000108,14,0.198651,0.233011,57933.687445,0.098217,0.049952
9803131,9803131,,474,58,532,474,58,532,0.107063,0.03212,0,5818,1,0.000528,13,0.216165,0.255238,616453.225922,0.022089,0.202817
9805140,9805140,,46,22,68,46,22,68,0.009198,0.02233,0,6285,1,0.000051,12,0.205079,0.234063,49774.641568,0.102722,0.023832
9806021,9806021,,89,23,112,89,23,112,0.022211,0.021371,0,6726,1,0.000133,13,0.205474,0.23367,104480.697636,0.085023,0.044845
9806171,9806171,,32,7,39,32,7,39,0.008187,0.017068,0,6727,1,0.000054,13,0.189124,0.212533,2836.368053,0.195682,0.019659
9503121,9503121,,142,6,148,142,6,148,0.01792,0.002404,0,196,4,0.000363,7,0.244694,0.286358,3201.773175,0.044815,0.078029
9507170,9507170,,28,6,34,28,6,34,0.001813,0.001402,0,3452,4,0.000115,7,0.220358,0.260164,2023.922029,0.093583,0.014038
9708042,9708042,,93,10,103,93,10,103,0.015777,0.000789,0,5932,1,0.000125,18,0.137914,0.175118,31864.276149,0.051685,0.044434
9802042,9802042,,308,38,346,308,38,346,0.065831,0.014855,0,5364,1,0.000504,13,0.207915,0.244468,444710.018428,0.026171,0.1751
9803015,9803015,,229,11,240,229,11,240,0.046765,0.003288,0,5607,1,0.000273,15,0.190558,0.224767,210752.790684,0.041858,0.131117
9803060,9803060,,36,28,64,36,28,64,0.009842,0.017062,0,5771,1,0.000052,13,0.205081,0.23744,14979.402282,0.15501,0.025849
9803251,9803251,,84,34,118,84,34,118,0.020931,0.024245,0,5920,1,0.000137,13,0.207364,0.236849,57186.166802,0.114515,0.049883
9805015,9805015,,29,8,37,29,8,37,0.003987,0.000382,0,6653,1,0.000048,13,0.158403,0.17738,185075.480078,0.095345,0.01869
9805082,9805082,,40,42,82,40,42,82,0.009537,0.026425,0,6281,1,0.000068,12,0.210029,0.243259,63087.446272,0.09199,0.024646
9807046,9807046,,26,14,40,26,14,40,0.007192,0.018513,0,7542,1,0.000032,12,0.193889,0.217812,1310.68261,0.261538,0.018131
9807226,9807226,,76,16,92,76,16,92,0.017064,0.020787,0,6654,1,0.00007,13,0.190949,0.216187,32194.986973,0.08624,0.035955
9809009,9809009,,28,23,51,28,23,51,0.007987,0.020048,0,7169,1,0.000031,12,0.19742,0.222735,12795.370966,0.223922,0.018094
9811097,9811097,,16,24,40,16,24,40,0.005049,0.018666,0,7551,1,0.000023,12,0.198569,0.224247,23720.919703,0.201923,0.013791
9811230,9811230,,39,22,61,39,22,61,0.007724,0.02109,0,7974,1,0.000035,11,0.208271,0.236519,21708.844944,0.142077,0.024677
9812092,9812092,,13,33,46,13,33,46,0.003839,0.021949,0,7969,1,0.000022,11,0.202503,0.233131,30080.808663,0.116425,0.012932
9812238,9812238,,21,21,42,21,21,42,0.006121,0.018404,0,7553,1,0.000026,12,0.193294,0.216854,5435.65676,0.290941,0.015587
9901109,9901109,,14,13,27,14,13,27,0.001479,0.000801,0,7972,4,0.000039,14,0.140913,0.159345,41115.595271,0.076923,0.007471
9901134,9901134,,20,31,51,20,31,51,0.005363,0.021449,0,7970,1,0.00003,12,0.221471,0.255441,58844.842536,0.124314,0.014875
9902129,9902129,,6,7,13,6,7,13,0.001443,0.015401,0,7968,1,0.000017,14,0.188946,0.212792,2402.384183,0.160256,0.003944
9903026,9903026,,73,25,98,73,25,98,0.017931,0.022031,0,7959,1,0.000078,13,0.198544,0.224481,73691.831694,0.121818,0.042116
9903059,9903059,,27,11,38,27,11,38,0.002509,0.000534,0,7967,1,0.000044,13,0.16003,0.178088,33224.420292,0.103841,0.009386
9711027,9711027,,24,48,72,24,48,72,0.00122,0.003975,0,7034,0,0.000066,12,0.217641,0.256839,171202.611488,0.135955,0.011242
9806022,9806022,,80,13,93,80,13,93,0.004537,0.002412,0,7676,25,0.000124,13,0.187339,0.214381,12434.635466,0.082749,0.032522
9809124,9809124,,56,7,63,56,7,63,0.002512,0.002373,0,7750,25,0.000212,11,0.218593,0.24611,148799.221747,0.048643,0.025441
9811141,9811141,,52,10,62,52,10,62,0.003265,0.001747,0,8102,25,0.000166,13,0.192134,0.215197,27489.570941,0.083554,0.024635
9902071,9902071,,68,58,126,68,58,126,0.004217,0.003574,0,8724,0,0.000176,12,0.219317,0.254152,341482.093434,0.067048,0.031168
9310151,9310151,,44,0,44,44,0,44,0.001965,0,0,1149,0,0.000146,0,0,0,0,0.053911,0.018143
9607164,9607164,,56,10,66,56,10,66,0.007248,0.001657,0,2508,1,0.000192,9,0.22298,0.249826,45312.503122,0.040093,0.028352
9611213,9611213,,102,3,105,102,3,105,0.005827,0.000109,0,3995,25,0.00028,12,0.165143,0.184479,28511.23035,0.045696,0.038268
9801206,9801206,,105,16,121,105,16,121,0.022455,0.008418,0,5383,1,0.000476,14,0.199353,0.229844,331095.931526,0.074036,0.091455
9805157,9805157,,115,24,139,115,24,139,0.009194,0.006923,0,7621,0,0.000464,14,0.190716,0.220904,146999.64294,0.08044,0.057625
9809147,9809147,,99,51,150,99,51,150,0.009267,0.006893,0,8093,0,0.000435,13,0.206871,0.24121,674513.881366,0.064161,0.050049
9810155,9810155,,71,25,96,71,25,96,0.004867,0.003029,0,8095,0,0.000099,13,0.202045,0.230879,181032.793182,0.052522,0.024955
9811089,9811089,,35,43,78,35,43,78,0.002186,0.009746,0,8111,0,0.000059,13,0.225661,0.262559,256297.805268,0.085082,0.01477
9811193,9811193,,34,54,88,34,54,88,0.003581,0.010423,0,8112,0,0.000038,13,0.219262,0.256671,85167.976104,0.116249,0.013207
9812093,9812093,,37,30,67,37,30,67,0.002656,0.008169,0,7753,0,0.000045,14,0.217574,0.252246,146285.100141,0.082768,0.015255
9812118,9812118,,51,40,91,51,40,91,0.004155,0.004941,0,8096,0,0.000048,13,0.202742,0.235099,51088.85571,0.10757,0.020574
9812163,9812163,,28,55,83,28,55,83,0.003227,0.007061,0,8115,0,0.000035,13,0.213461,0.249103,132000.929652,0.121951,0.010174
9903019,9903019,,13,19,32,13,19,32,0.000747,0.001278,0,8734,0,0.000032,13,0.199336,0.225867,54564.407843,0.105847,0.005487
9903225,9903225,,130,14,144,130,14,144,0.011448,0.002516,0,8729,25,0.00017,13,0.18757,0.211112,34240.876888,0.051088,0.050044
9904021,9904021,,10,16,26,10,16,26,0.000585,0.001561,0,8728,25,0.000039,12,0.201327,0.226223,32334.023122,0.1,0.005432
9905096,9905096,,25,21,46,25,21,46,0.004048,0.017795,0,8706,1,0.000041,14,0.19462,0.221714,18175.709111,0.100966,0.010639
9905111,9905111,,806,562,1368,806,562,1368,0.14951,0.098487,0,8477,1,0.000937,10,0.289562,0.362934,17944198.319148,0.009763,0.26984
9612146,9612146,,141,25,166,141,25,166,0.02385,0.007465,0,3572,13,0.000192,12,0.22302,0.2639,148357.40821,0.048375,0.072789
9708005,9708005,,167,50,217,167,50,217,0.042805,0.011698,0,5009,1,0.000738,11,0.216803,0.256353,393997.063783,0.051715,0.174552
9711035,9711035,,48,30,78,48,30,78,0.005831,0.001639,0,5933,1,0.000074,12,0.185147,0.214331,145696.027554,0.059441,0.021155
9805104,9805104,,23,11,34,23,11,34,0.006495,0.009337,0,6507,1,0.000032,14,0.194722,0.222343,14172.174538,0.146168,0.017271
9810186,9810186,,46,18,64,46,18,64,0.01158,0.019339,0,7409,1,0.000063,13,0.194252,0.221283,10852.242263,0.161706,0.029533
9810227,9810227,,47,17,64,47,17,64,0.009157,0.015898,0,7872,1,0.000051,13,0.186071,0.214687,30920.701949,0.114087,0.019642
9811120,9811120,,83,27,110,83,27,110,0.018743,0.021632,0,7429,1,0.000087,11,0.207557,0.236207,93265.648112,0.084987,0.043652
9902170,9902170,,57,31,88,57,31,88,0.012785,0.020391,0,7894,1,0.000063,12,0.200625,0.229452,66760.536791,0.08268,0.0306
9902195,9902195,,52,19,71,52,19,71,0.011039,0.015826,0,7903,1,0.000055,12,0.197247,0.22425,17046.731012,0.10664,0.027627
9903109,9903109,,25,28,53,25,28,53,0.006757,0.022271,0,8130,1,0.000028,13,0.208095,0.234305,18913.863452,0.187228,0.016803
9903132,9903132,,32,27,59,32,27,59,0.007725,0.019959,0,7958,1,0.000034,13,0.209485,0.238846,18143.944197,0.14173,0.018312
9905075,9905075,,57,17,74,57,17,74,0.010705,0.018062,0,8145,1,0.000061,16,0.194755,0.22098,52459.068544,0.094039,0.02842
9905104,9905104,,148,32,180,148,32,180,0.032661,0.023447,0,8648,1,0.000108,17,0.207971,0.239619,126983.541145,0.048324,0.056163
9906030,9906030,,43,37,80,43,37,80,0.00964,0.021963,0,8697,1,0.000035,14,0.191487,0.220579,104916.858231,0.120728,0.015993
9603090,9603090,,152,25,177,152,25,177,0.017313,0.006193,0,1833,13,0.0002,10,0.234713,0.277963,55156.903094,0.058648,0.074232
9603100,9603100,,70,19,89,70,19,89,0.008764,0.005141,0,2013,13,0.000113,10,0.233827,0.276175,12095.584715,0.087079,0.039788
9606049,9606049,,46,49,95,46,49,95,0.005577,0.008021,0,2305,0,0.000045,9,0.240431,0.289212,127589.493861,0.116461,0.020454
9607108,9607108,,36,6,42,36,6,42,0.004768,0.001816,0,2192,13,0.000064,13,0.192582,0.224057,28297.295235,0.130081,0.016618
9702103,9702103,,61,33,94,61,33,94,0.009771,0.00264,0,4569,13,0.000174,11,0.222231,0.263529,258799.246383,0.079616,0.049026
9702165,9702165,,30,18,48,30,18,48,0.003335,0.003263,0,4413,0,0.000038,14,0.19743,0.23165,5701.802681,0.135638,0.014547
9704142,9704142,,43,37,80,43,37,80,0.004294,0.005973,0,4585,13,0.000048,10,0.224701,0.268398,54849.191513,0.089082,0.016657
9705169,9705169,,54,54,108,54,54,108,0.006116,0.006743,0,4625,13,0.000038,12,0.215731,0.264321,90146.581034,0.079958,0.017147
9801161,9801161,,27,18,45,27,18,45,0.003383,0.002709,0,6588,13,0.000034,13,0.206487,0.242618,34875.444145,0.131818,0.009249
9806051,9806051,,156,50,206,156,50,206,0.011265,0.004073,0,7677,0,0.000125,15,0.194806,0.234281,196485.04631,0.048425,0.051566
9807014,9807014,,19,30,49,19,30,49,0.002344,0.006617,0,7613,0,0.000019,14,0.187278,0.222963,11640.540529,0.144983,0.00594
9811133,9811133,,17,23,40,17,23,40,0.001088,0.002613,0,8711,0,0.00003,16,0.173943,0.207653,6078.820644,0.207051,0.007481
9812032,9812032,,43,8,51,43,8,51,0.00938,0.016477,0,7898,1,0.000059,14,0.183792,0.206845,5787.379798,0.11098,0.023328
9901149,9901149,,40,30,70,40,30,70,0.008205,0.019069,0,7875,1,0.000044,12,0.197297,0.228702,139790.93383,0.100621,0.022008
9903214,9903214,,57,38,95,57,38,95,0.010429,0.019971,0,7962,1,0.00006,14,0.199614,0.23189,73505.827585,0.090817,0.027993
9903269,9903269,,15,20,35,15,20,35,0.003081,0.00919,0,8705,1,0.000022,15,0.19795,0.228233,11005.89856,0.130252,0.007019
9904036,9904036,,12,10,22,12,10,22,0.003983,0.012968,0,8366,1,0.000016,14,0.193894,0.218604,9929.015558,0.214286,0.010198
9905134,9905134,,19,30,49,19,30,49,0.003392,0.00983,0,8636,1,0.000024,11,0.216923,0.251109,33114.727851,0.096088,0.00665
9905139,9905139,,15,12,27,15,12,27,0.000602,0.001979,0,8758,0,0.000021,14,0.181701,0.204917,6381.556414,0.237892,0.004391
9905143,9905143,,10,40,50,10,40,50,0.001275,0.00757,0,8757,13,0.000014,13,0.209543,0.242731,55164.963272,0.129388,0.003233
9907006,9907006,,25,53,78,25,53,78,0.004118,0.02356,0,8753,1,0.000027,11,0.239661,0.276741,145615.650176,0.064269,0.008444
9905221,9905221,,63,3,66,63,3,66,0.006606,0.001862,0,8710,25,0.000181,6,0.265306,0.303718,4751.02038,0.014219,0.023807
9906182,9906182,,141,10,151,141,10,151,0.022205,0.021268,0,8702,25,0.000232,11,0.230965,0.261883,160533.250752,0.052848,0.062177
9808117,9808117,,37,20,57,37,20,57,0.0092,0.016796,0,7408,1,0.000056,12,0.203927,0.232325,32752.528791,0.156015,0.023649
9811167,9811167,,29,46,75,29,46,75,0.004388,0.023588,0,7887,1,0.000038,11,0.208595,0.242179,73562.091437,0.065586,0.010912
9901056,9901056,,35,13,48,35,13,48,0.00864,0.00864,0,7888,1,0.000044,12,0.193785,0.217936,23564.832029,0.172872,0.021302
9906201,9906201,,60,28,88,60,28,88,0.014309,0.020787,0,8679,1,0.000051,12,0.204643,0.23025,22085.207128,0.107628,0.025318
9906204,9906204,,27,18,45,27,18,45,0.002008,0.018637,0,8708,25,0.000099,12,0.203971,0.228513,15191.205869,0.108586,0.015729
9906224,9906224,,26,28,54,26,28,54,0.006494,0.022762,0,8699,1,0.000033,11,0.230488,0.262016,20365.899368,0.149546,0.011065
9907204,9907204,,21,15,36,21,15,36,0.004478,0.019856,0,8700,1,0.000031,11,0.226775,0.257201,39858.235745,0.168254,0.00934
9908104,9908104,,35,10,45,35,10,45,0.002058,0.004284,0,8738,25,0.000058,12,0.198213,0.219779,5262.603025,0.156566,0.013006
9703040,9703040,,146,51,197,146,51,197,0.037627,0.012833,0,3813,1,0.000589,13,0.224137,0.267084,361194.819089,0.058635,0.154013
9704189,9704189,,23,19,42,23,19,42,0.003524,0.003073,0,4624,13,0.000076,12,0.195014,0.229608,28377.211646,0.059814,0.013347
9908175,9908175,,16,53,69,16,53,69,0.003088,0.028006,0,8747,1,0.000032,11,0.234566,0.268854,81585.720661,0.125746,0.007014
9908196,9908196,,11,18,29,11,18,29,0.001939,0.018251,0,8748,1,0.000027,12,0.201161,0.223907,3618.932515,0.229064,0.005462
9808122,9808122,,14,16,30,14,16,30,0.000623,0.002074,0,8718,0,0.000041,12,0.189565,0.217136,16064.602532,0.165517,0.005635
9209117,9209117,,2,2,4,2,2,4,0.000271,0.000072,0,8763,25,0.000017,1,1,1,8.479154,0.083333,0.001569
9909047,9909047,,128,37,165,128,37,165,0.028145,0.024696,0,8745,1,0.000095,12,0.217107,0.245376,104463.420066,0.079675,0.051899
9804006,9804006,,24,58,82,24,58,82,0.006518,0.027668,0,5917,1,0.000038,11,0.225246,0.260339,134838.322887,0.157031,0.018747
9902208,9902208,,35,22,57,35,22,57,0.006814,0.014133,0,8254,13,0.000043,13,0.210791,0.241737,83578.260483,0.10589,0.019702
9905148,9905148,,23,15,38,23,15,38,0.004616,0.020804,0,8750,1,0.00003,11,0.228639,0.259829,16549.33159,0.138691,0.008336
9906168,9906168,,25,8,33,25,8,33,0.00403,0.016859,0,8760,1,0.00004,14,0.183681,0.206464,4337.348492,0.204545,0.010474
9906221,9906221,,34,14,48,34,14,48,0.0046,0.017537,0,8761,1,0.000037,11,0.228913,0.2599,32846.889339,0.115691,0.01203
9909070,9909070,,116,28,144,116,28,144,0.017123,0.006234,0,8762,1,0.000142,12,0.214087,0.240483,137259.721369,0.052836,0.049181
9702056,9702056,,22,3,25,22,3,25,0.00252,0.00048,0,5925,1,0.000066,18,0.120794,0.152939,1359.859785,0.131667,0.012731
9907080,9907080,,20,8,28,20,8,28,0.001922,0.001755,0,8766,25,0.00004,13,0.185372,0.206371,4681.622857,0.116402,0.010847
9908174,9908174,,11,13,24,11,13,24,0.000657,0.009068,0,8765,25,0.000031,11,0.22922,0.260064,14706.883474,0.197464,0.005844
9909076,9909076,,24,14,38,24,14,38,0.001968,0.002568,0,8744,25,0.000045,13,0.187446,0.208071,14210.248236,0.153627,0.011123
9808032,9808032,,65,17,82,65,17,82,0.011094,0.019836,0,7074,1,0.000072,13,0.191243,0.217731,31813.102078,0.065041,0.030816
9903238,9903238,,78,28,106,78,28,106,0.01268,0.02167,0,7899,1,0.000086,14,0.19775,0.225003,52737.104159,0.075741,0.027865
9906040,9906040,,18,31,49,18,31,49,0.003008,0.019656,0,8812,1,0.000029,13,0.202107,0.228422,52458.614308,0.108418,0.007046
9908047,9908047,,26,14,40,26,14,40,0.001721,0.002988,0,8791,25,0.000036,14,0.177006,0.201067,50314.62365,0.085897,0.01017
9910081,9910081,,21,28,49,21,28,49,0.001771,0.008838,0,8778,25,0.000042,12,0.21172,0.237444,24190.119739,0.162415,0.01127
9909103,9909103,,24,30,54,24,30,54,0.003144,0.004471,0,8767,25,0.00007,12,0.207633,0.233134,54105.596702,0.124738,0.012742
9910093,9910093,,140,3,143,140,3,143,0.009141,0.000968,0,8741,25,0.000261,12,0.188344,0.204324,10255.634946,0.04708,0.05398
9806217,9806217,,49,23,72,49,23,72,0.011997,0.026597,0,6655,1,0.000052,14,0.196745,0.230744,30190.940201,0.085485,0.025062
9903190,9903190,,74,17,91,74,17,91,0.017707,0.018838,0,8409,1,0.000069,14,0.192718,0.218249,32498.496581,0.099267,0.034946
9903241,9903241,,27,13,40,27,13,40,0.004184,0.001439,0,8704,1,0.000033,12,0.198377,0.223863,33754.342216,0.060897,0.009435
9301052,9301052,,131,0,131,131,0,131,0.015031,0,0,295,25,0.00043,0,0,0,0,0.043218,0.066859
9612014,9612014,,5,11,16,5,11,16,0.000121,0.000296,0,7546,13,0.000025,12,0.193751,0.221615,13289.493822,0.108333,0.002306
9705223,9705223,,12,7,19,12,7,19,0.001696,0.000552,0,7547,25,0.000043,13,0.165483,0.186075,20909.250844,0.049708,0.006038
9909130,9909130,,93,5,98,93,5,98,0.007658,0.00174,0,8773,25,0.000207,12,0.19696,0.216878,19849.426853,0.071008,0.040845
9909205,9909205,,111,11,122,111,11,122,0.007707,0.002149,0,8826,25,0.000195,12,0.199557,0.220586,53857.15532,0.0693,0.04262
9911043,9911043,,89,10,99,89,10,99,0.00661,0.00205,0,8827,25,0.000157,12,0.197578,0.21837,16361.673613,0.086271,0.034264
9911055,9911055,,190,5,195,190,5,195,0.012017,0.001356,0,8828,25,0.000282,12,0.190379,0.207237,12984.533774,0.047766,0.066926
9912001,9912001,,138,39,177,138,39,177,0.023025,0.028636,0,8825,25,0.000134,11,0.235358,0.269273,233730.622654,0.057556,0.051516
9405029,9405029,,113,6,119,113,6,119,0.001704,0.000004,0,2129,22,0.000418,1,1,1,79968.704248,0.012463,0.031984
9705117,9705117,,110,32,142,110,32,142,0.019969,0.009155,0,3705,2,0.000351,12,0.210368,0.249197,190128.710902,0.049296,0.091129
9902067,9902067,,25,19,44,25,19,44,0.006586,0.018382,0,7900,1,0.00003,12,0.195237,0.220256,25669.465539,0.202431,0.016145
9903091,9903091,,26,55,81,26,55,81,0.006221,0.028549,0,8128,1,0.000024,13,0.219603,0.254683,184710.662824,0.089969,0.015146
9905081,9905081,,25,54,79,25,54,79,0.007341,0.026539,0,8141,1,0.000023,13,0.21385,0.243693,55677.648139,0.137131,0.015912
9908110,9908110,,10,21,31,10,21,31,0.002021,0.01883,0,8835,1,0.000016,15,0.198578,0.22676,20013.068466,0.133333,0.00321
9910252,9910252,,15,13,28,15,13,28,0.002193,0.015935,0,8938,1,0.000021,12,0.198946,0.221253,3275.281509,0.255291,0.005109
9911040,9911040,,31,17,48,31,17,48,0.007218,0.018935,0,8840,1,0.00003,13,0.199377,0.222834,6725.250953,0.191933,0.015103
9911161,9911161,,138,49,187,138,49,187,0.021894,0.016787,0,8935,1,0.000088,12,0.221389,0.253581,230490.178954,0.044851,0.050417
9911199,9911199,,12,19,31,12,19,31,0.002018,0.017065,0,8839,1,0.000018,11,0.204998,0.22895,21097.665143,0.145161,0.003538
1003,1003,,15,1,16,15,1,16,0.000659,0.000011,0,8949,25,0.00003,13,0.160026,0.16966,21.397655,0.241667,0.006339
9912242,9912242,,21,7,28,21,7,28,0.000934,0.001239,0,8948,25,0.000059,12,0.190491,0.207436,9112.928794,0.205026,0.008308
9909127,9909127,,13,18,31,13,18,31,0.000695,0.002545,0,8776,25,0.000036,12,0.197936,0.218916,3095.261068,0.198925,0.005962
9910269,9910269,,3,8,11,3,8,11,0.000111,0.002327,0,8947,25,0.000021,12,0.196982,0.218224,8512.562086,0.127273,0.001923
9912160,9912160,,75,5,80,75,5,80,0.004045,0.001248,0,8945,25,0.000143,12,0.19014,0.20578,8211.592948,0.065823,0.02506
1004,1004,,1,1,2,1,1,2,0,0,0,8951,5,0.000012,1,1,1,0,0.5,0.000219
9810131,9810131,,3,0,3,3,0,3,0,0,0,8950,5,0.000024,0,0,0,0,0.166667,0.000671
1005,1005,,1,21,22,1,21,22,0.000012,0.000468,0,9036,52,0.000011,15,0.18988,0.211641,4313.791221,0.12987,0.000293
9311183,9311183,,52,0,52,52,0,52,0.004609,0,0,1380,0,0.00024,0,0,0,0,0.150075,0.023639
9506135,9506135,,32,1,33,32,1,33,0.00035,0,0,2912,52,0.000109,2,0.571429,0.625,6908.442768,0.121212,0.012661
9601078,9601078,,43,6,49,43,6,49,0.000665,0.000015,0,4035,52,0.00011,4,0.5,0.594697,53162.530869,0.077806,0.015223
9603097,9603097,,121,12,133,121,12,133,0.006562,0.005775,0,1903,52,0.000172,10,0.214364,0.245905,62187.201904,0.068125,0.052803
9611194,9611194,,8,4,12,8,4,12,0.000125,0.000013,0,4660,52,0.000018,5,0.379747,0.456667,1103.007567,0.174242,0.002783
9712257,9712257,,68,28,96,68,28,96,0.003333,0.002826,0,6344,52,0.000112,11,0.216504,0.249651,547272.354989,0.068421,0.034004
9805026,9805026,,5,8,13,5,8,13,0.000051,0.000185,0,8952,52,0.000017,12,0.186589,0.207535,1471.236244,0.179487,0.001939
9811178,9811178,,43,8,51,43,8,51,0.001166,0.000312,0,8501,52,0.000067,13,0.164631,0.18116,81251.486742,0.112941,0.018784
9901099,9901099,,25,11,36,25,11,36,0.000077,0.000012,0,9035,22,0.000077,8,0.193901,0.241239,48007.355533,0.143651,0.007042
9902132,9902132,,50,18,68,50,18,68,0.001757,0.002038,0,8955,52,0.000051,12,0.18959,0.212701,21820.7944,0.118306,0.017694
9904145,9904145,,52,6,58,52,6,58,0.002011,0.001139,0,8999,52,0.000052,14,0.173319,0.195315,33248.083535,0.107985,0.017152
9908025,9908025,,36,25,61,36,25,61,0.001393,0.001075,0,9010,52,0.00003,15,0.189549,0.217752,82920.313747,0.095628,0.011282
9908036,9908036,,94,32,126,94,32,126,0.002698,0.00049,0,8981,52,0.000102,12,0.201663,0.226307,402463.543899,0.052571,0.030643
9908040,9908040,,102,38,140,102,38,140,0.005689,0.004168,0,9005,52,0.000084,15,0.211632,0.242702,350332.180996,0.047225,0.035487
9909030,9909030,,84,16,100,84,16,100,0.003731,0.000598,0,9006,52,0.000069,15,0.190432,0.213204,126818.92293,0.077778,0.027711
9909114,9909114,,26,9,35,26,9,35,0.001268,0.000464,0,8965,52,0.000028,15,0.172223,0.190046,14359.874298,0.171429,0.007147
9909140,9909140,,33,5,38,33,5,38,0.000859,0.001714,0,8964,52,0.000036,14,0.176566,0.195722,25024.515382,0.08037,0.010347
9909163,9909163,,45,14,59,45,14,59,0.002106,0.0006,0,9012,52,0.000037,15,0.193806,0.217897,31083.956077,0.127703,0.014345
9910148,9910148,,10,10,20,10,10,20,0.000437,0.000101,0,8980,52,0.000019,15,0.158359,0.174795,78398.927864,0.139474,0.002944
9912239,9912239,,29,11,40,29,11,40,0.000615,0.000342,0,9007,52,0.000038,16,0.175835,0.195561,96683.483649,0.096795,0.009268
9307107,9307107,,8,3,11,8,3,11,0.000001,0.000007,0,2911,52,0.000142,1,1,1,6130.133753,0.063636,0.002544
9306145,9306145,,28,0,28,28,0,28,0.000212,0,0,776,52,0.000065,0,0,0,0,0.06746,0.008029
9309093,9309093,,9,0,9,9,0,9,0.000028,0,0,2918,52,0.000046,0,0,0,0,0.152778,0.002838
9410010,9410010,,13,7,20,13,7,20,0.000039,0.000015,0,4034,52,0.000046,2,0.733333,0.818182,16568.697896,0.105263,0.003694
9509105,9509105,,30,6,36,30,6,36,0.000668,0.000015,0,2920,52,0.000079,3,0.551724,0.65625,43063.313806,0.061905,0.009144
9409165,9409165,,7,1,8,7,1,8,0.000074,0,0,1379,52,0.000181,1,1,1,13388.992275,0.089286,0.004568
9410209,9410209,,18,3,21,18,3,21,0.000287,0.00003,0,1382,52,0.000121,4,0.433962,0.496377,34382.90458,0.138095,0.008404
9503207,9503207,,89,2,91,89,2,91,0.006522,0.000055,0,1381,52,0.0002,2,0.75,0.833333,8465.931083,0.086325,0.039291
9506014,9506014,,89,4,93,89,4,93,0.006342,0.000135,0,1383,52,0.00017,5,0.341463,0.42381,24430.4051,0.094086,0.039507
9511043,9511043,,213,18,231,213,18,231,0.025443,0.006812,0,1402,2,0.000708,13,0.228322,0.277983,234318.767812,0.03642,0.147332
9411134,9411134,,9,2,11,9,2,11,0.000093,0.000008,0,2914,52,0.000034,2,0.75,0.833333,19102.717096,0.081818,0.002792
9506186,9506186,,7,3,10,7,3,10,0.000085,0,0,4658,52,0.000032,2,0.8,0.875,29916.869731,0.077778,0.002889
9610192,9610192,,21,0,21,21,0,21,0.000255,0,0,4654,52,0.000058,0,0,0,0,0.15,0.006863
9611124,9611124,,9,4,13,9,4,13,0.000082,0.000012,0,4659,52,0.000037,5,0.376623,0.455172,9446.197194,0.166667,0.003443
9309105,9309105,,10,2,12,10,2,12,0.000146,0.000002,0,3756,9,0.000029,2,0.625,0.7,14584.925965,0.166667,0.003795
9509171,9509171,,13,13,26,13,13,26,0.000426,0.000695,0,1940,3,0.000046,6,0.312394,0.379529,67172.145245,0.053846,0.007428
9605042,9605042,,33,23,56,33,23,56,0.002036,0.007544,0,4668,52,0.000044,9,0.212968,0.246382,36374.684768,0.108766,0.012327
9611064,9611064,,4,0,4,4,0,4,0.000145,0,0,6343,9,0.000015,0,0,0,0,0.083333,0.002016
9612148,9612148,,48,7,55,48,7,55,0.002652,0.001223,0,5511,52,0.000105,12,0.21154,0.239905,69327.356094,0.099327,0.023988
9701190,9701190,,50,11,61,50,11,61,0.003532,0.004104,0,4127,2,0.000083,11,0.208694,0.238481,60745.178013,0.103005,0.022667
9702037,9702037,,36,16,52,36,16,52,0.002344,0.005914,0,5500,2,0.00005,11,0.205884,0.237136,11249.614241,0.111237,0.015806
9702194,9702194,,5,45,50,5,45,50,0.000097,0.000387,0,6342,52,0.000027,12,0.228975,0.277552,624274.014134,0.020408,0.00255
9702195,9702195,,2,5,7,2,5,7,0.000226,0.000018,0,4036,13,0.000014,16,0.15962,0.188287,26020.741609,0.119048,0.001734
9706057,9706057,,13,18,31,13,18,31,0.001996,0.00546,0,4869,52,0.000021,11,0.222296,0.257846,25740.632827,0.136559,0.007593
9707068,9707068,,109,20,129,109,20,129,0.008309,0.005517,0,5501,3,0.000127,14,0.199653,0.235396,80034.914434,0.057776,0.05194
9708040,9708040,,82,13,95,82,13,95,0.0075,0.002577,0,5051,0,0.000095,12,0.193146,0.220362,18242.86326,0.156775,0.041611
9708141,9708141,,44,5,49,44,5,49,0.001594,0.000164,0,5517,52,0.000078,11,0.178475,0.1975,13584.965434,0.126276,0.019186
9708166,9708166,,28,18,46,28,18,46,0.001842,0.002248,0,5516,52,0.000054,13,0.201754,0.236759,145485.714911,0.100483,0.018024
9711029,9711029,,8,25,33,8,25,33,0.00217,0.008095,0,5826,2,0.000018,13,0.230102,0.27697,127087.440833,0.122159,0.004786
9711069,9711069,,18,57,75,18,57,75,0.001439,0.010066,0,6289,0,0.000025,12,0.206084,0.247981,89718.778353,0.06991,0.009416
9712186,9712186,,141,38,179,141,38,179,0.008455,0.012305,0,5524,52,0.000134,16,0.207686,0.248828,345762.33877,0.056243,0.06112
9305010,9305010,,33,1,34,33,1,34,0.00058,0.000038,0,236,4,0.000131,1,1,1,495.370703,0.035651,0.010421
9712197,9712197,,30,10,40,30,10,40,0.000148,0.000006,0,7830,6,0.000055,10,0.210364,0.266247,162491.936002,0.104487,0.010462
9807142,9807142,,13,3,16,13,3,16,0.000074,0.000003,0,7816,52,0.000042,13,0.160837,0.174453,62342.254725,0.2,0.005117
9809097,9809097,,41,11,52,41,11,52,0.000664,0.000253,0,7824,52,0.000072,12,0.189464,0.211642,112889.161537,0.101433,0.014793
9604128,9604128,,23,1,24,23,1,24,0.000004,0,0,9015,22,0.000111,1,1,1,434.174674,0.20471,0.006465
9607174,9607174,,29,4,33,29,4,33,0.000007,0.000002,0,9016,22,0.000115,1,1,1,5486.657271,0.121212,0.007798
9609128,9609128,,26,4,30,26,4,30,0.000014,0,0,9017,22,0.000084,2,0.7,0.785714,855.492514,0.178161,0.007058
9612010,9612010,,8,8,16,8,8,16,0,0.000003,0,9023,22,0.000036,3,0.592593,0.71875,2607.320131,0.2375,0.002294
9612011,9612011,,8,10,18,8,10,18,0.000001,0.000007,0,9022,22,0.000034,7,0.228674,0.28137,17937.458726,0.163399,0.002267
9612012,9612012,,8,7,15,8,7,15,0.000004,0.000002,0,9021,22,0.000028,2,0.733333,0.818182,1478.104283,0.228571,0.002205
9709216,9709216,,14,2,16,14,2,16,0.000002,0,0,9029,22,0.000066,1,1,1,9712.5,0.120833,0.003598
9806174,9806174,,6,7,13,6,7,13,0,0,0,9030,22,0.00003,9,0.162229,0.197121,5934.158462,0.24359,0.001706
9808042,9808042,,42,1,43,42,1,43,0.000763,0,0,6811,22,0.000137,1,1,1,7737.366537,0.117386,0.012259
9810022,9810022,,22,2,24,22,2,24,0.000217,0.000009,0,9013,22,0.000061,1,1,1,289.572806,0.237319,0.006418
9810087,9810087,,19,15,34,19,15,34,0.000045,0.000015,0,9034,22,0.000054,8,0.194107,0.246918,47085.922486,0.188948,0.005544
9806121,9806121,,10,6,16,10,6,16,0.000218,0.000242,0,7801,52,0.000036,12,0.186988,0.208012,11041.100845,0.183333,0.004913
9811211,9811211,,15,18,33,15,18,33,0.000355,0.002054,0,8954,52,0.000027,12,0.190626,0.21457,15235.165091,0.14678,0.006378
9609112,9609112,,56,30,86,56,30,86,0.002273,0.00266,0,3319,13,0.000071,14,0.192564,0.234428,113312.78076,0.088919,0.019112
9803101,9803101,,4,3,7,4,3,7,0.000017,0.000021,0,8998,4,0.000022,16,0.129748,0.149478,3429.394305,0.166667,0.001312
9812193,9812193,,109,3,112,109,3,112,0.004969,0.000086,0,7832,52,0.000109,12,0.19304,0.210565,59159.263221,0.070946,0.038444
9903139,9903139,,14,10,24,14,10,24,0.000563,0.002979,0,8997,52,0.000028,13,0.19801,0.223607,25900.582089,0.166667,0.006625
9311168,9311168,,3,3,6,3,3,6,0.000017,0.000005,0,6598,52,0.000013,2,0.714286,0.8,624.723073,0.1,0.000964
9412109,9412109,,1,0,1,1,0,1,0.000013,0,0,9009,52,0.000011,0,0,0,0,0,0.000498
9606177,9606177,,6,1,7,6,1,7,0.000163,0.001652,0,8963,52,0.000024,10,0.174855,0.194201,1807.746653,0.119048,0.001998
9609124,9609124,,2,3,5,2,3,5,0.000017,0.000001,0,6320,52,0.000011,3,0.485714,0.54902,6122.063738,0.1,0.000767
9612078,9612078,,15,10,25,15,10,25,0.000051,0.00001,0,6317,52,0.000034,4,0.494118,0.577381,53114.221498,0.051667,0.004154
9712230,9712230,,112,19,131,112,19,131,0.014902,0.00569,0,6225,52,0.000097,15,0.195167,0.230595,64855.910341,0.05367,0.053287
9905038,9905038,,44,10,54,44,10,54,0.001399,0.000269,0,8956,52,0.000045,12,0.180134,0.198863,22490.753698,0.107268,0.016018
9905078,9905078,,9,21,30,9,21,30,0.000402,0.003233,0,9008,52,0.000015,13,0.204229,0.233075,16761.722411,0.12069,0.003435
9204036,9204036,,15,0,15,15,0,15,0.000061,0,0,2023,6,0.000144,0,0,0,0,0.071429,0.004492
9205040,9205040,,10,0,10,10,0,10,0.000092,0,0,2359,52,0.000045,0,0,0,0,0.111111,0.003596
9211130,9211130,,9,3,12,9,3,12,0.00001,0,0,1043,9,0.000033,1,1,1,15317.502463,0.106061,0.003277
9212060,9212060,,28,0,28,28,0,28,0.000381,0,0,2915,52,0.000095,0,0,0,0,0.084656,0.008176
9301026,9301026,,9,1,10,9,1,10,0.00006,0.000001,0,2024,6,0.000103,1,1,1,2959.50707,0.122222,0.00309
9304009,9304009,,8,0,8,8,0,8,0.000066,0,0,6766,52,0.000031,0,0,0,0,0.178571,0.003
9306002,9306002,,188,2,190,188,2,190,0.000234,0.000077,0,1412,6,0.000549,1,1,1,11358.951029,0.026761,0.052664
9404108,9404108,,63,2,65,63,2,65,0.000098,0.000002,0,2414,6,0.000145,2,0.625,0.7,6636.189761,0.079567,0.018761
9404185,9404185,,12,11,23,12,11,23,0.000371,0.000014,0,4666,52,0.000031,2,0.866667,0.923077,24105.129743,0.077075,0.003911
9405019,9405019,,9,0,9,9,0,9,0.000066,0,0,7806,52,0.00004,0,0,0,0,0.222222,0.003388
9510175,9510175,,19,7,26,19,7,26,0.000221,0.000074,0,7817,52,0.000056,5,0.392857,0.465758,5969.575651,0.103077,0.006155
9512218,9512218,,8,7,15,8,7,15,0.000012,0.000003,0,7815,52,0.000033,8,0.240126,0.277859,170043.239833,0.061905,0.002835
9611071,9611071,,6,2,8,6,2,8,0.00001,0,0,5874,6,0.000019,4,0.416667,0.508333,2113.18494,0.160714,0.002249
9805023,9805023,,13,8,21,13,8,21,0.000337,0.000013,0,7822,52,0.000034,6,0.320513,0.396,30345.829655,0.121429,0.004499
9811237,9811237,,91,33,124,91,33,124,0.003978,0.004182,0,7831,3,0.000172,11,0.235091,0.268012,759168.904653,0.060386,0.058238
9812110,9812110,,15,10,25,15,10,25,0.000404,0.000026,0,8639,52,0.000038,6,0.35124,0.434118,14273.228865,0.118333,0.005066
9904100,9904100,,6,5,11,6,5,11,0.000066,0.000022,0,8979,52,0.000021,13,0.161208,0.175073,9494.42547,0.136364,0.002293
9310187,9310187,,17,5,22,17,5,22,0.000778,0.000379,0,5414,30,0.00008,2,0.608696,0.678571,6184.782699,0.064935,0.011121
9401042,9401042,,9,1,10,9,1,10,0.000079,0,0,2055,52,0.00003,1,1,1,7974.489718,0.1,0.003088
9402039,9402039,,21,0,21,21,0,21,0.000335,0,0,2739,9,0.000054,0,0,0,0,0.138095,0.008087
9403066,9403066,,7,7,14,7,7,14,0.000054,0.000009,0,6452,15,0.000021,2,0.888889,0.9375,38314.379419,0.043956,0.002513
9505175,9505175,,60,0,60,60,0,60,0.001708,0,0,2832,30,0.000215,0,0,0,0,0.071186,0.023626
9510177,9510177,,13,4,17,13,4,17,0.000422,0.001174,0,5489,52,0.000042,13,0.172375,0.199102,27664.875841,0.139706,0.005397
9610066,9610066,,7,6,13,7,6,13,0.000233,0.00002,0,6306,52,0.000016,14,0.13777,0.160612,46146.093196,0.121795,0.00279
9706132,9706132,,23,20,43,23,20,43,0.001795,0.009908,0,5520,30,0.000051,12,0.198432,0.232661,64975.23944,0.06423,0.014584
9711005,9711005,,64,14,78,64,14,78,0.009782,0.005064,0,5100,2,0.000096,14,0.191099,0.220257,52902.286958,0.097902,0.033963
9801195,9801195,,47,8,55,47,8,55,0.001166,0.000741,0,9004,30,0.00006,14,0.162382,0.183494,26794.01175,0.102357,0.015317
9802052,9802052,,43,12,55,43,12,55,0.004628,0.003707,0,6660,30,0.000186,14,0.187348,0.210717,38931.695931,0.171717,0.044162
9802069,9802069,,42,18,60,42,18,60,0.005077,0.006303,0,6749,30,0.000091,14,0.20107,0.229285,52686.841045,0.108475,0.031855
9803031,9803031,,157,13,170,157,13,170,0.013816,0.006036,0,6748,30,0.000296,14,0.182153,0.207839,53652.59671,0.068465,0.089574
9803067,9803067,,74,22,96,74,22,96,0.006142,0.005799,0,6806,30,0.000164,13,0.203052,0.232994,445344.282546,0.098575,0.049928
9804188,9804188,,23,37,60,23,37,60,0.001912,0.006905,0,7000,30,0.000063,11,0.226617,0.261301,438590.217775,0.09096,0.014853
9806194,9806194,,173,37,210,173,37,210,0.027722,0.023483,0,7043,1,0.000163,12,0.204985,0.238235,209966.876575,0.050103,0.07149
9810072,9810072,,188,30,218,188,30,218,0.014854,0.008347,0,6808,30,0.000233,13,0.206787,0.239386,123911.166506,0.043694,0.085964
9812046,9812046,,82,19,101,82,19,101,0.012464,0.020367,0,7536,1,0.00008,13,0.195967,0.22426,60655.868311,0.097129,0.038922
9812219,9812219,,257,18,275,257,18,275,0.019848,0.005028,0,7002,30,0.00028,13,0.193687,0.21881,78879.326994,0.033683,0.107605
9903205,9903205,,251,17,268,251,17,268,0.018413,0.003204,0,8502,30,0.000291,14,0.204012,0.231811,398081.888537,0.033917,0.111949
9903219,9903219,,81,23,104,81,23,104,0.0116,0.018467,0,7798,1,0.000067,12,0.194112,0.222443,93551.344021,0.089619,0.03463
9906200,9906200,,122,58,180,122,58,180,0.006611,0.01354,0,9002,52,0.000083,14,0.214347,0.251972,169203.344933,0.063842,0.048274
9906215,9906215,,43,9,52,43,9,52,0.003968,0.006764,0,9001,1,0.000043,13,0.182093,0.204808,14234.54587,0.156486,0.016224
9907114,9907114,,11,33,44,11,33,44,0.00047,0.004928,0,8995,30,0.00003,14,0.20716,0.234311,125404.320605,0.125264,0.006212
9907183,9907183,,15,20,35,15,20,35,0.000812,0.003468,0,9000,52,0.000025,14,0.202414,0.230466,62295.425031,0.089076,0.007687
9908046,9908046,,18,9,27,18,9,27,0.000386,0.000229,0,8982,52,0.000031,13,0.170676,0.186056,7776.647335,0.18661,0.005687
9909025,9909025,,4,8,12,4,8,12,0.000076,0.007798,0,8962,13,0.000021,13,0.190201,0.216327,31216.834404,0.098485,0.001861
9509080,9509080,,92,5,97,92,5,97,0.008806,0.000434,0,1384,0,0.000277,6,0.248441,0.280126,42591.426203,0.082045,0.052769
9806131,9806131,,23,26,49,23,26,49,0.002685,0.002595,0,7644,0,0.000031,14,0.187359,0.213079,216559.386189,0.193452,0.010923
9312182,9312182,,23,8,31,23,8,31,0.000881,0.000159,0,254,41,0.000047,5,0.332143,0.391039,3293.253497,0.211828,0.008795
9608116,9608116,,71,9,80,71,9,80,0.004898,0.001873,0,3128,10,0.000117,11,0.19796,0.225965,11933.206106,0.059177,0.036176
9805006,9805006,,22,18,40,22,18,40,0.001427,0.002003,0,6345,52,0.000044,12,0.200872,0.234587,113632.097556,0.103846,0.015378
9901122,9901122,,38,26,64,38,26,64,0.003327,0.008696,0,7835,52,0.000038,11,0.217941,0.245567,246307.753296,0.104911,0.019388
9909072,9909072,,40,25,65,40,25,65,0.00169,0.002759,0,9011,3,0.00005,15,0.204607,0.236616,145469.639914,0.057933,0.019815
9206032,9206032,,16,0,16,16,0,16,0.000321,0,0,2916,9,0.000104,0,0,0,0,0.0625,0.004185
9603104,9603104,,15,10,25,15,10,25,0.001809,0.00149,0,4662,0,0.000021,12,0.198697,0.234883,4217.548414,0.181667,0.005538
9701061,9701061,,38,5,43,38,5,43,0.00231,0.000108,0,6646,52,0.000065,6,0.268509,0.308088,38177.659089,0.084718,0.012015
9708120,9708120,,27,3,30,27,3,30,0.000931,0.000195,0,8953,52,0.00004,13,0.181959,0.204099,2922.820531,0.121839,0.007105
9908034,9908034,,1,5,6,1,5,6,0.000001,0,0,8977,23,0.000012,10,0.181387,0.206576,53541.503561,0.166667,0.000294
9910079,9910079,,16,8,24,16,8,24,0.00075,0.000292,0,8961,52,0.000023,14,0.152403,0.1724,25720.055545,0.150362,0.004201
9404101,9404101,,13,2,15,13,2,15,0.000518,0.000032,0,1312,52,0.000125,3,0.555556,0.666667,1742.000954,0.07619,0.012439
1006,1006,,1,1,2,1,1,2,0.000056,0.000005,0,9058,6,0.000011,17,0.136077,0.146464,44664.424257,0,0.001192
9910243,9910243,,12,3,15,12,3,15,0.000419,0,0,9057,6,0.00004,16,0.157478,0.174249,65723.094818,0.033333,0.00297
9501063,9501063,,13,0,13,13,0,13,0.000008,0,0,8009,6,0.0001,0,0,0,0,0.153846,0.003293
9511002,9511002,,13,2,15,13,2,15,0.000018,0.000037,0,8010,6,0.000076,10,0.172414,0.203318,17399.697091,0.12381,0.003383
9805093,9805093,,5,19,24,5,19,24,0,0.000466,0,9056,6,0.00003,15,0.186518,0.215995,194271.411691,0.048913,0.001308
1007,1007,,0,4,4,0,4,4,0,0.000127,0,9078,1,0.00001,13,0.171136,0.185869,0,0.25,0
9405171,9405171,,51,0,51,51,0,51,0.006683,0,0,2874,1,0.000105,0,0,0,0,0.073333,0.027853
9807069,9807069,,69,2,71,69,2,71,0.000208,0.000002,0,9077,23,0.00021,1,1,1,1737.5696,0.060563,0.018044
9901148,9901148,,25,21,46,25,21,46,0.003725,0.009167,0,8174,1,0.000032,12,0.198848,0.22725,187691.777112,0.115942,0.013406
9911150,9911150,,6,16,22,6,16,22,0.000234,0.002002,0,9074,2,0.000015,12,0.193977,0.214542,16747.568634,0.108225,0.001415
9610193,9610193,,67,0,67,67,0,67,0.00009,0,0,9075,23,0.000478,0,0,0,0,0.056536,0.017606
9705176,9705176,,23,1,24,23,1,24,0.000076,0.000001,0,9076,23,0.000179,1,1,1,2547.621911,0.077899,0.006171
9310194,9310194,,51,4,55,51,4,55,0.009542,0.000589,0,5254,1,0.00011,1,1,1,4327.707295,0.083502,0.032897
9704005,9704005,,87,19,106,87,19,106,0.016715,0.005999,0,5253,1,0.000401,12,0.210942,0.247635,39363.189545,0.076999,0.086904
9711138,9711138,,121,47,168,121,47,168,0.026508,0.013042,0,5262,1,0.000532,15,0.189243,0.232375,298738.089597,0.060023,0.10943
9712251,9712251,,197,15,212,197,15,212,0.028203,0.009619,0,5334,1,0.000274,14,0.190369,0.220775,108939.718144,0.037401,0.085833
9802076,9802076,,57,8,65,57,8,65,0.009196,0.001317,0,6091,1,0.000077,15,0.166791,0.190001,49632.939059,0.090625,0.027291
9804085,9804085,,222,24,246,222,24,246,0.042803,0.019799,0,6095,1,0.000218,12,0.207463,0.238637,184682.081039,0.036502,0.097151
9805178,9805178,,12,6,18,12,6,18,0.00217,0.00099,0,6568,1,0.000025,15,0.160817,0.178549,48960.203872,0.228758,0.010858
9806026,9806026,,82,25,107,82,25,107,0.012194,0.003151,0,6632,1,0.000117,12,0.198063,0.22619,220314.38451,0.066302,0.035459
9806065,9806065,,12,8,20,12,8,20,0.001394,0.011592,0,7163,1,0.000029,13,0.184692,0.206408,8424.683961,0.223684,0.00426
9809021,9809021,,38,27,65,38,27,65,0.008066,0.022118,0,7164,1,0.00005,12,0.200352,0.231518,53729.532397,0.121875,0.021649
9810145,9810145,,5,15,20,5,15,20,0.000273,0.002935,0,8173,2,0.000017,12,0.193825,0.217705,132109.017014,0.076316,0.001422
9811162,9811162,,8,18,26,8,18,26,0.001129,0.018025,0,8151,1,0.000019,13,0.189166,0.214087,7530.530008,0.256923,0.002973
9812013,9812013,,68,5,73,68,5,73,0.005228,0.001936,0,8150,8,0.000088,13,0.171756,0.191216,17928.504489,0.052131,0.018971
9812056,9812056,,43,13,56,43,13,56,0.003531,0.002156,0,8163,8,0.000053,14,0.170995,0.193476,41730.321829,0.077273,0.013237
9901050,9901050,,22,91,113,22,91,113,0.00566,0.040468,0,8149,13,0.000026,12,0.221759,0.268711,114734.451994,0.073167,0.006776
9506187,9506187,,18,1,19,18,1,19,0.00076,0.000468,0,2871,2,0.000045,1,1,1,52.04394,0.131579,0.004856
9605159,9605159,,30,4,34,30,4,34,0.00215,0.000118,0,2875,2,0.000051,11,0.181928,0.203732,36558.109676,0.067736,0.008274
9702025,9702025,,14,1,15,14,1,15,0.000096,0.000004,0,8417,22,0.00005,1,1,1,82.526597,0.157143,0.003393
9710180,9710180,,30,7,37,30,7,37,0.001408,0.000315,0,5533,2,0.000043,12,0.181829,0.206585,14962.696009,0.092342,0.00808
9712130,9712130,,60,26,86,60,26,86,0.007245,0.009959,0,5534,2,0.000067,15,0.197929,0.233056,252037.590409,0.045964,0.021436
9806089,9806089,,9,8,17,9,8,17,0.0023,0.007,0,6633,1,0.000023,13,0.183541,0.205082,4545.502066,0.257353,0.010348
9905228,9905228,,7,14,21,7,14,21,0.000418,0.007815,0,9070,8,0.000015,12,0.179521,0.202717,10347.260448,0.111905,0.001642
9906165,9906165,,2,4,6,2,4,6,0.000086,0.000003,0,9073,22,0.000011,15,0.121836,0.137095,798.629777,0.233333,0.000499
9909112,9909112,,1,15,16,1,15,16,0.000024,0.020889,0,9071,1,0.000011,11,0.228765,0.259676,15747.037849,0.1875,0.000259
9911101,9911101,,3,13,16,3,13,16,0.000327,0.003056,0,9059,13,0.000015,12,0.195922,0.218511,4397.997779,0.1125,0.001244
1008,1008,,2,6,8,2,6,8,0,0.00003,0,9079,22,0.000013,3,0.6,0.688889,26.288925,0.107143,0.000452
9301008,9301008,,4,0,4,4,0,4,0.000017,0,0,2152,13,0.000027,0,0,0,0,0.083333,0.001004
9301014,9301014,,8,0,8,8,0,8,0.000007,0,0,5342,13,0.000048,0,0,0,0,0.053571,0.002051
9303112,9303112,,36,0,36,36,0,36,0.000786,0,0,4155,22,0.000186,0,0,0,0,0.073016,0.010169
9409139,9409139,,27,3,30,27,3,30,0.000013,0.00001,0,4158,22,0.000102,2,0.8,0.875,11498.636023,0.113793,0.007001
9507046,9507046,,23,2,25,23,2,25,0.000036,0.000009,0,4271,22,0.000058,3,0.555556,0.666667,110.436632,0.115,0.0059
9202013,9202013,,10,0,10,10,0,10,0.000001,0,0,2128,22,0.000161,0,0,0,0,0.044444,0.00322
9202057,9202057,,88,0,88,88,0,88,0.000311,0,0,617,22,0.000787,0,0,0,0,0.028866,0.02392
9212147,9212147,,3,0,3,3,0,3,0.000001,0,0,2127,22,0.000087,0,0,0,0,0.333333,0.001529
9303068,9303068,,5,0,5,5,0,5,0.000001,0,0,2126,22,0.000099,0,0,0,0,0.1,0.001941
9310104,9310104,,1,0,1,1,0,1,0,0,0,2125,22,0.000072,0,0,0,0,0,0.001044
9311011,9311011,,2,0,2,2,0,2,0,0,0,2124,22,0.000077,0,0,0,0,0,0.001296
9205074,9205074,,7,0,7,7,0,7,0.000068,0,0,4157,22,0.000059,0,0,0,0,0.095238,0.00183
9401036,9401036,,9,2,11,9,2,11,0.000001,0.000009,0,4156,22,0.000073,1,1,1,7767.793993,0.290909,0.002472
1009,1009,,1,1,2,1,1,2,0,0,0,9081,8,0.000016,1,1,1,0,0.5,0.000226
9610215,9610215,,4,0,4,4,0,4,0,0,0,9080,8,0.000038,0,0,0,0,0.166667,0.00089
1010,1010,,12,5,17,12,5,17,0.001074,0.000382,0,9082,4,0.000019,16,0.182847,0.203617,4209.445818,0.128676,0.003201
9608174,9608174,,28,3,31,28,3,31,0.002312,0.002054,0,4875,4,0.000057,13,0.166836,0.190347,5485.385159,0.058065,0.009645
9706225,9706225,,33,16,49,33,16,49,0.002507,0.002252,0,5149,4,0.000045,13,0.194127,0.225077,134666.98072,0.090136,0.01137
9808157,9808157,,29,25,54,29,25,54,0.006891,0.019226,0,7278,1,0.000031,12,0.204007,0.232936,28979.297669,0.136967,0.017229
9901128,9901128,,82,72,154,82,72,154,0.013377,0.028875,0,7387,1,0.000062,15,0.218128,0.256036,388721.612601,0.061794,0.033864
9505176,9505176,,2,0,2,2,0,2,0.000041,0,0,2548,23,0.000023,0,0,0,0,0,0.001497
9510023,9510023,,30,21,51,30,21,51,0.001777,0.007149,0,1856,4,0.000048,13,0.211913,0.274081,65831.986259,0.071765,0.011627
9601007,9601007,,65,15,80,65,15,80,0.00608,0.003457,0,1857,4,0.000113,11,0.21674,0.25551,66371.123421,0.081646,0.026235
9602073,9602073,,68,12,80,68,12,80,0.004216,0.003237,0,2831,4,0.000072,11,0.171611,0.212287,1749.33572,0.165348,0.027489
9501096,9501096,,52,6,58,52,6,58,0.003175,0.000462,0,585,4,0.000267,5,0.348921,0.400515,17660.176202,0.039927,0.032626
9506002,9506002,,17,12,29,17,12,29,0.001165,0.002341,0,3029,4,0.000027,7,0.258873,0.3,69863.474701,0.172414,0.005272
9606082,9606082,,20,15,35,20,15,35,0.000839,0.000262,0,2883,4,0.000042,10,0.203538,0.232774,108636.844977,0.051261,0.007463
9608169,9608169,,28,16,44,28,16,44,0.002061,0.001203,0,5131,4,0.000037,10,0.21854,0.256513,135897.82027,0.064482,0.008646
9611043,9611043,,9,0,9,9,0,9,0.00036,0,0,5148,0,0.00002,0,0,0,0,0.041667,0.002506
9612143,9612143,,33,39,72,33,39,72,0.001886,0.008311,0,5132,4,0.000053,10,0.242097,0.285258,130289.256427,0.059664,0.011972
9612182,9612182,,23,3,26,23,3,26,0.000385,0.000035,0,5130,10,0.000045,11,0.185572,0.203818,19199.177987,0.078462,0.006989
9702106,9702106,,17,19,36,17,19,36,0.000942,0.002489,0,5147,4,0.000023,12,0.194129,0.226272,75358.587219,0.195238,0.004503
9704167,9704167,,55,12,67,55,12,67,0.001958,0.002612,0,3706,10,0.000087,12,0.208205,0.242369,175219.844847,0.053596,0.017436
9705127,9705127,,24,7,31,24,7,31,0.000566,0.001877,0,5134,10,0.000038,13,0.183726,0.214911,13471.834658,0.078495,0.006418
9705138,9705138,,39,10,49,39,10,49,0.001355,0.001953,0,5133,10,0.000054,11,0.205997,0.233324,19678.677068,0.073129,0.012902
9602135,9602135,,187,15,202,187,15,202,0.040935,0.006333,0,1945,1,0.000876,10,0.224752,0.259302,135080.215996,0.049086,0.180062
9604166,9604166,,148,25,173,148,25,173,0.019273,0.006151,0,2082,13,0.00027,10,0.237776,0.279555,114485.380354,0.058341,0.08129
9612231,9612231,,36,14,50,36,14,50,0.003619,0.002561,0,3693,4,0.000053,13,0.178334,0.21102,43197.998345,0.123673,0.015222
9704029,9704029,,71,19,90,71,19,90,0.009859,0.008034,0,3582,2,0.000186,13,0.199261,0.230145,76269.823701,0.104744,0.045452
9704197,9704197,,37,25,62,37,25,62,0.004897,0.004182,0,3694,4,0.00009,14,0.190989,0.22336,120574.371349,0.095981,0.025248
9705190,9705190,,27,14,41,27,14,41,0.004161,0.004298,0,3891,2,0.000111,13,0.192385,0.221301,15266.25463,0.166463,0.03796
9708036,9708036,,32,17,49,32,17,49,0.003767,0.002749,0,4903,4,0.000037,13,0.172867,0.201346,16774.144222,0.132653,0.012039
9709072,9709072,,20,6,26,20,6,26,0.002551,0.000365,0,7276,4,0.000023,14,0.151069,0.170502,242.260004,0.24,0.007389
9710151,9710151,,37,16,53,37,16,53,0.007692,0.003475,0,5940,0,0.000054,13,0.193217,0.227314,60666.997229,0.13643,0.023086
9712239,9712239,,84,11,95,84,11,95,0.022029,0.008759,0,5372,1,0.00029,14,0.19163,0.219163,21974.925124,0.100896,0.077721
9804009,9804009,,44,28,72,44,28,72,0.004752,0.004177,0,7277,4,0.000034,17,0.169614,0.201185,32595.324592,0.122457,0.014836
9804058,9804058,,244,62,306,244,62,306,0.058927,0.029173,0,5934,1,0.000281,11,0.222683,0.259349,582451.213435,0.045644,0.114251
9807033,9807033,,101,39,140,101,39,140,0.022899,0.026442,0,6240,1,0.000108,12,0.215759,0.248267,235672.452263,0.073484,0.051827
9808119,9808119,,20,18,38,20,18,38,0.003329,0.003841,0,6670,2,0.00002,13,0.184575,0.210276,11552.413184,0.113798,0.007169
9601085,9601085,,63,13,76,63,13,76,0.002454,0.001077,0,2142,4,0.000212,11,0.208479,0.248465,65620.857237,0.087719,0.028558
9601097,9601097,,64,7,71,64,7,71,0.001969,0.000453,0,2143,4,0.000182,12,0.177075,0.203553,4347.383239,0.086318,0.026251
9605069,9605069,,9,12,21,9,12,21,0.000742,0.000792,0,3488,4,0.000019,12,0.18652,0.220066,6968.755027,0.214286,0.003433
9611075,9611075,,49,9,58,49,9,58,0.010848,0.00084,0,4897,1,0.000071,13,0.176454,0.202552,44314.926866,0.132486,0.025349
9612115,9612115,,327,5,332,327,5,332,0.028098,0.004907,0,2847,30,0.000549,11,0.185842,0.209459,23001.045214,0.023396,0.134606
9612127,9612127,,31,17,48,31,17,48,0.004097,0.005675,0,2846,2,0.000059,13,0.214047,0.248527,11941.327508,0.106826,0.017345
9701093,9701093,,144,25,169,144,25,169,0.018153,0.004946,0,4268,0,0.000191,12,0.20891,0.242919,186679.052797,0.04385,0.065681
9701125,9701125,,220,9,229,220,9,229,0.025524,0.003624,0,3325,2,0.000322,13,0.196893,0.227687,165465.554856,0.025818,0.097715
9703228,9703228,,37,11,48,37,11,48,0.003203,0.001394,0,3567,4,0.000068,12,0.194626,0.221766,81637.406054,0.090426,0.017322
9704011,9704011,,30,18,48,30,18,48,0.001354,0.000591,0,5783,4,0.00004,14,0.168256,0.194608,24645.352355,0.153369,0.012647
9704114,9704114,,45,63,108,45,63,108,0.00397,0.004705,0,4003,4,0.000065,13,0.195583,0.235229,389792.692355,0.063084,0.016258
9707079,9707079,,112,27,139,112,27,139,0.021513,0.010669,0,3898,2,0.000222,11,0.205176,0.239399,80319.88081,0.071942,0.091112
9707093,9707093,,118,31,149,118,31,149,0.022115,0.009444,0,4263,2,0.000213,11,0.214585,0.249341,525776.591599,0.055641,0.090452
9711107,9711107,,69,17,86,69,17,86,0.009069,0.007392,0,6161,2,0.000078,14,0.193266,0.228358,60197.791958,0.079343,0.024991
9802116,9802116,,80,3,83,80,3,83,0.020272,0.000863,0,5289,1,0.000327,13,0.197146,0.225328,123915.161901,0.102703,0.081937
9803117,9803117,,54,5,59,54,5,59,0.00453,0.000716,0,6220,30,0.000068,13,0.182821,0.202073,69796.605783,0.134424,0.018586
9803265,9803265,,82,18,100,82,18,100,0.009119,0.005692,0,6669,2,0.000083,15,0.196153,0.226231,233322.588105,0.067677,0.029752
9804035,9804035,,106,7,113,106,7,113,0.026138,0.015763,0,6100,1,0.000135,14,0.186341,0.208711,5616.435561,0.099716,0.055602
9804123,9804123,,31,39,70,31,39,70,0.005552,0.005301,0,6239,0,0.000026,13,0.212745,0.247768,132382.603839,0.086542,0.011386
9804199,9804199,,46,5,51,46,5,51,0.004211,0.000528,0,6719,30,0.000053,16,0.172088,0.191857,10198.824439,0.134902,0.015241
9805105,9805105,,68,10,78,68,10,78,0.018333,0.016689,0,6151,1,0.000097,12,0.193107,0.216575,8320.616002,0.149018,0.040499
9805145,9805145,,62,10,72,62,10,72,0.015724,0.017013,0,6153,1,0.000068,12,0.192988,0.216201,2212.19854,0.153756,0.033062
9805162,9805162,,42,10,52,42,10,52,0.011324,0.017441,0,6152,1,0.000063,12,0.194095,0.218417,2263.648157,0.213424,0.027836
9806004,9806004,,11,19,30,11,19,30,0.003573,0.020472,0,6566,1,0.000031,12,0.202988,0.229772,175489.405965,0.205747,0.013332
9806216,9806216,,56,16,72,56,16,72,0.013744,0.017878,0,6563,1,0.000063,12,0.194261,0.218553,21539.959349,0.152778,0.030044
9808041,9808041,,36,15,51,36,15,51,0.004561,0.001334,0,7386,1,0.000044,13,0.162324,0.183524,41091.807321,0.096471,0.01323
9808061,9808061,,57,19,76,57,19,76,0.007338,0.002087,0,6668,0,0.000066,15,0.184043,0.212496,40822.205209,0.072281,0.019078
9809130,9809130,,29,24,53,29,24,53,0.003223,0.005883,0,7380,2,0.000028,16,0.190862,0.223174,125388.896222,0.121916,0.009437
9810243,9810243,,41,22,63,41,22,63,0.007154,0.018925,0,7279,1,0.000033,13,0.208416,0.236925,37902.746464,0.111623,0.014292
9811047,9811047,,78,27,105,78,27,105,0.017593,0.022198,0,7329,1,0.00007,14,0.204815,0.235317,47374.727532,0.12674,0.036671
9811060,9811060,,10,48,58,10,48,58,0.002935,0.027526,0,7352,1,0.000016,15,0.207417,0.241066,42892.618313,0.132184,0.004962
9812038,9812038,,9,24,33,9,24,33,0.001272,0.014638,0,7280,2,0.000018,13,0.207348,0.237913,23212.687625,0.10322,0.004204
1011,1011,,4,20,24,4,20,24,0.000281,0.011434,0,9118,30,0.000012,13,0.203016,0.227591,1253.186581,0.182971,0.001231
9703038,9703038,,44,17,61,44,17,61,0.004717,0.006714,0,4716,2,0.000078,14,0.191285,0.225262,26066.70146,0.118579,0.018312
9703078,9703078,,43,10,53,43,10,53,0.006044,0.004866,0,5732,2,0.000064,14,0.18298,0.209486,37460.101908,0.106676,0.017758
9708039,9708039,,24,21,45,24,21,45,0.002647,0.007612,0,6167,2,0.000034,11,0.205899,0.234967,43037.434946,0.123737,0.009082
9710231,9710231,,132,121,253,132,121,253,0.019898,0.026438,0,5232,2,0.000237,14,0.220943,0.274711,972097.967275,0.050897,0.075883
9712072,9712072,,119,39,158,119,39,158,0.019013,0.014226,0,5225,2,0.000151,14,0.195575,0.231663,142393.595112,0.053052,0.059385
9804041,9804041,,2,18,20,2,18,20,0.000375,0.006341,0,6564,2,0.000012,15,0.187609,0.219707,25725.139913,0.105263,0.000684
9804163,9804163,,33,14,47,33,14,47,0.003424,0.0049,0,8499,30,0.000041,15,0.187147,0.221412,51324.685359,0.102683,0.013284
9805069,9805069,,55,17,72,55,17,72,0.008994,0.022132,0,6414,2,0.000088,14,0.197706,0.227835,57142.639375,0.088419,0.023784
9902004,9902004,,17,37,54,17,37,54,0.002133,0.007636,0,8500,30,0.00005,13,0.202764,0.233661,45409.58051,0.177848,0.017686
9907211,9907211,,48,19,67,48,19,67,0.0045,0.008911,0,9085,30,0.000096,12,0.192738,0.219541,35930.424968,0.069426,0.018293
9908019,9908019,,60,24,84,60,24,84,0.005364,0.005301,0,8506,30,0.000075,14,0.200477,0.231041,135757.553173,0.096099,0.035477
9909081,9909081,,61,2,63,61,2,63,0.005176,0.000838,0,9086,30,0.000091,13,0.186303,0.202117,1834.00764,0.086278,0.026347
9909176,9909176,,69,30,99,69,30,99,0.004998,0.007822,0,9117,30,0.000097,13,0.206318,0.231051,52428.631946,0.093486,0.029368
9508117,9508117,,40,6,46,40,6,46,0.002755,0.00248,0,1252,4,0.000334,6,0.280851,0.339899,3579.160108,0.110628,0.030153
9508156,9508156,,47,6,53,47,6,53,0.003223,0.002213,0,1251,4,0.000341,8,0.237989,0.284121,10440.963997,0.091437,0.032872
9509148,9509148,,54,19,73,54,19,73,0.005482,0.006794,0,1248,0,0.00056,12,0.211549,0.26331,46635.026353,0.096081,0.051688
9308139,9308139,,91,0,91,91,0,91,0.008216,0,0,337,5,0.001696,0,0,0,0,0.031258,0.060354
9405069,9405069,,32,0,32,32,0,32,0.004081,0,0,997,26,0.000228,0,0,0,0,0.049395,0.030527
9409089,9409089,,427,3,430,427,3,430,0.068686,0.000121,0,915,8,0.001098,4,0.375,0.434028,27443.965995,0.013097,0.208281
9512081,9512081,,63,11,74,63,11,74,0.007822,0.004722,0,2312,0,0.000237,11,0.209802,0.244758,17765.71424,0.072195,0.042342
9611202,9611202,,184,16,200,184,16,200,0.023531,0.007867,0,3267,2,0.000597,14,0.200791,0.235648,24587.313508,0.063216,0.12274
9611215,9611215,,77,15,92,77,15,92,0.008799,0.005423,0,3303,2,0.000217,12,0.215273,0.250729,55194.866756,0.119565,0.047345
9612087,9612087,,79,25,104,79,25,104,0.009933,0.010828,0,3306,2,0.000156,12,0.213443,0.251837,42101.999202,0.113984,0.043323
9612157,9612157,,181,9,190,181,9,190,0.020806,0.003709,0,3326,2,0.000338,12,0.18847,0.213965,16360.441404,0.042217,0.097949
9612222,9612222,,74,12,86,74,12,86,0.005752,0.003319,0,3330,30,0.000095,12,0.193809,0.218971,17820.775528,0.067852,0.03121
9612223,9612223,,60,29,89,60,29,89,0.006979,0.011591,0,3327,2,0.000128,12,0.209897,0.248239,19656.525118,0.134576,0.035012
9701151,9701151,,31,13,44,31,13,44,0.003385,0.005893,0,3332,2,0.000056,13,0.187198,0.213799,14090.524673,0.175476,0.013746
9701168,9701168,,19,7,26,19,7,26,0.00211,0.003424,0,3333,2,0.00004,14,0.171563,0.197806,1069.985604,0.230769,0.009151
9702101,9702101,,79,10,89,79,10,89,0.01143,0.005686,0,3569,2,0.000223,13,0.175441,0.204127,4329.863217,0.087334,0.049729
9702187,9702187,,223,15,238,223,15,238,0.029341,0.005892,0,3628,2,0.000447,13,0.18426,0.216719,73916.71514,0.041113,0.127801
9608042,9608042,,4,0,4,4,0,4,0.000221,0,0,3328,2,0.000025,0,0,0,0,0.25,0.001915
9611072,9611072,,57,18,75,57,18,75,0.005796,0.007174,0,3329,2,0.00013,13,0.214078,0.249262,80622.902515,0.063604,0.02542
9701144,9701144,,11,15,26,11,15,26,0.001018,0.002033,0,5731,2,0.000025,12,0.216509,0.248662,67068.313198,0.123077,0.003939
9611042,9611042,,265,22,287,265,22,287,0.030804,0.010713,0,3265,2,0.000885,13,0.210073,0.251295,153179.928447,0.039704,0.157167
9701025,9701025,,196,7,203,196,7,203,0.024804,0.003265,0,3311,2,0.000412,12,0.189923,0.219465,227838.842217,0.041018,0.098325
9703030,9703030,,347,23,370,347,23,370,0.042678,0.008697,0,3630,2,0.000477,14,0.198905,0.235157,400391.573354,0.025745,0.149889
9705120,9705120,,51,32,83,51,32,83,0.005591,0.010069,0,4717,2,0.000059,14,0.210078,0.246594,43354.742393,0.095504,0.022576
9705128,9705128,,71,13,84,71,13,84,0.006889,0.005557,0,5733,30,0.000082,14,0.178454,0.205097,13249.357896,0.080895,0.024783
9706130,9706130,,6,26,32,6,26,32,0.000324,0.01247,0,6166,2,0.000016,11,0.204069,0.236967,7828.640067,0.146169,0.001866
9707250,9707250,,61,32,93,61,32,93,0.010491,0.013219,0,4294,2,0.000097,11,0.221266,0.257254,152831.163786,0.093852,0.032121
9204083,9204083,,133,0,133,133,0,133,0.003274,0,0,26,4,0.001597,0,0,0,0,0.019196,0.041568
9511193,9511193,,14,4,18,14,4,18,0.002488,0.000935,0,2442,2,0.000025,8,0.22092,0.257117,1935.905356,0.098039,0.006726
9602071,9602071,,47,20,67,47,20,67,0.005854,0.009218,0,1696,2,0.000155,9,0.229762,0.265112,16930.135506,0.102216,0.034632
9602144,9602144,,11,16,27,11,16,27,0.001308,0.005238,0,1549,0,0.000043,10,0.216734,0.25151,26670.933308,0.225071,0.010013
9603009,9603009,,68,35,103,68,35,103,0.008749,0.01242,0,1698,0,0.000181,9,0.233018,0.276433,46515.55217,0.08281,0.044467
9603113,9603113,,30,27,57,30,27,57,0.00371,0.009174,0,1796,0,0.000068,9,0.235326,0.277413,21912.611409,0.157268,0.020452
9604042,9604042,,151,15,166,151,15,166,0.023249,0.006044,0,2081,13,0.000405,10,0.224813,0.259717,33230.099183,0.064367,0.102634
9604055,9604055,,119,30,149,119,30,149,0.015702,0.010975,0,1923,2,0.000258,9,0.238604,0.277201,92935.742581,0.054734,0.073148
9604133,9604133,,8,25,33,8,25,33,0.000702,0.007366,0,2333,0,0.000027,9,0.227549,0.266454,7743.8513,0.15625,0.005227
9604139,9604139,,70,20,90,70,20,90,0.006078,0.00891,0,1921,0,0.000102,9,0.229647,0.266467,16553.243454,0.101748,0.030126
9606185,9606185,,154,33,187,154,33,187,0.024888,0.007112,0,2136,13,0.000372,10,0.233984,0.277077,136804.668348,0.076016,0.114684
9607201,9607201,,247,68,315,247,68,315,0.026706,0.019564,0,2464,0,0.000371,11,0.231415,0.28705,204896.473653,0.028561,0.103933
9608096,9608096,,106,17,123,106,17,123,0.014024,0.006326,0,2094,2,0.000161,12,0.216278,0.255303,78769.756425,0.053445,0.054713
9608117,9608117,,123,65,188,123,65,188,0.014909,0.017923,0,2534,0,0.000192,12,0.245089,0.303254,331993.240812,0.043919,0.049934
9610082,9610082,,62,51,113,62,51,113,0.009434,0.018929,0,2753,2,0.000117,12,0.244259,0.292622,234623.610991,0.096002,0.036946
9610236,9610236,,99,7,106,99,7,106,0.013609,0.004372,0,3234,2,0.000289,12,0.208164,0.23804,22541.350413,0.069003,0.064825
9611164,9611164,,85,3,88,85,3,88,0.012533,0.002469,0,3266,2,0.00045,14,0.184268,0.212507,1517.637989,0.128265,0.07272
9612121,9612121,,190,61,251,190,61,251,0.023774,0.018919,0,3359,0,0.000282,11,0.238938,0.285733,546895.841127,0.032335,0.078313
9612162,9612162,,66,22,88,66,22,88,0.009159,0.009847,0,3307,2,0.000117,11,0.214048,0.24931,10725.501771,0.120037,0.032195
9612198,9612198,,31,6,37,31,6,37,0.004543,0.002987,0,3310,2,0.000115,12,0.191268,0.218127,26510.94793,0.162162,0.018179
9702006,9702006,,42,15,57,42,15,57,0.006846,0.006934,0,3625,2,0.000052,12,0.201773,0.230758,32073.668298,0.132519,0.020209
9702203,9702203,,75,12,87,75,12,87,0.011414,0.005991,0,3568,2,0.000131,12,0.196919,0.228491,6098.357137,0.092489,0.042775
9703052,9703052,,43,22,65,43,22,65,0.00694,0.006652,0,3715,2,0.00005,13,0.216816,0.250847,42523.349021,0.119952,0.021395
9703056,9703056,,44,9,53,44,9,53,0.006282,0.006129,0,4960,2,0.000055,14,0.185642,0.216385,26663.924158,0.096517,0.021596
9703102,9703102,,62,15,77,62,15,77,0.009201,0.005261,0,3631,2,0.000171,15,0.1869,0.219229,11382.205186,0.135509,0.040188
9703208,9703208,,17,19,36,17,19,36,0.002014,0.00386,0,3729,2,0.000039,13,0.201953,0.232816,10836.379524,0.160317,0.011125
9703218,9703218,,73,17,90,73,17,90,0.011292,0.005314,0,3716,2,0.000072,13,0.204628,0.235903,22083.397639,0.10412,0.031103
9704018,9704018,,90,37,127,90,37,127,0.015698,0.010897,0,3817,2,0.000119,14,0.204944,0.243204,171032.456647,0.07749,0.047665
9704041,9704041,,71,25,96,71,25,96,0.010309,0.012263,0,3717,2,0.000077,13,0.209879,0.245099,20266.535212,0.110965,0.031157
9704080,9704080,,301,13,314,301,13,314,0.039327,0.004494,0,3632,2,0.000673,14,0.187169,0.214148,106605.173034,0.032875,0.152563
9704123,9704123,,20,30,50,20,30,50,0.002596,0.009005,0,3733,2,0.000026,14,0.20291,0.237914,34108.678086,0.169796,0.009515
9704127,9704127,,39,41,80,39,41,80,0.005729,0.015415,0,4303,2,0.000073,13,0.22122,0.263932,68582.765761,0.127532,0.023245
9704158,9704158,,67,15,82,67,15,82,0.010034,0.005079,0,3728,2,0.000059,14,0.191445,0.221654,146286.012325,0.098314,0.028892
9705046,9705046,,125,17,142,125,17,142,0.014043,0.008018,0,3893,2,0.000184,15,0.176653,0.208245,23489.223663,0.055639,0.052446
9705055,9705055,,56,45,101,56,45,101,0.00802,0.013901,0,3818,2,0.000072,13,0.212832,0.253968,123774.001506,0.103465,0.02619
9705110,9705110,,16,25,41,16,25,41,0.002375,0.007966,0,4304,2,0.000036,14,0.207467,0.243714,10528.83997,0.184146,0.009297
9705132,9705132,,20,32,52,20,32,52,0.00263,0.008968,0,3880,2,0.00004,13,0.20947,0.244199,30809.041851,0.155732,0.012727
9705188,9705188,,25,43,68,25,43,68,0.002805,0.010967,0,4301,2,0.000047,11,0.211651,0.24827,44775.77924,0.136962,0.014758
9706039,9706039,,23,8,31,23,8,31,0.003249,0.006267,0,5062,2,0.000036,14,0.183354,0.213456,2981.735789,0.170968,0.011071
9706072,9706072,,136,17,153,136,17,153,0.020239,0.004062,0,4305,2,0.000292,12,0.202195,0.231577,107965.452757,0.078345,0.092022
9706177,9706177,,8,0,8,8,0,8,0.001501,0,0,5231,2,0.000016,0,0,0,0,0.071429,0.004161
9706194,9706194,,16,26,42,16,26,42,0.001509,0.007632,0,3889,2,0.00004,12,0.202862,0.239183,103772.941711,0.110337,0.00888
9706196,9706196,,25,26,51,25,26,51,0.003339,0.005354,0,4712,2,0.000026,12,0.207947,0.24078,14165.143916,0.191373,0.012669
9707099,9707099,,23,44,67,23,44,67,0.002831,0.017173,0,4958,2,0.000024,12,0.208597,0.248084,9542.043499,0.135007,0.008748
9707164,9707164,,10,53,63,10,53,63,0.001667,0.012782,0,4961,2,0.000016,12,0.21992,0.260458,96718.755039,0.141065,0.005198
9707217,9707217,,55,29,84,55,29,84,0.006943,0.009749,0,3895,2,0.000068,13,0.207138,0.244487,32264.90741,0.105278,0.025723
9707228,9707228,,58,36,94,58,36,94,0.00805,0.010838,0,5072,2,0.00006,13,0.210555,0.249435,85458.709855,0.082018,0.025725
9707259,9707259,,30,32,62,30,32,62,0.005773,0.007726,0,4335,2,0.000068,11,0.220388,0.253531,117202.346114,0.147012,0.018476
9708012,9708012,,34,8,42,34,8,42,0.005481,0.00355,0,5075,2,0.000045,13,0.186374,0.21186,23406.439041,0.116144,0.018601
9708022,9708022,,14,26,40,14,26,40,0.002476,0.006947,0,4707,2,0.000022,12,0.206847,0.245026,13908.167456,0.173077,0.009182
9708034,9708034,,16,24,40,16,24,40,0.002417,0.006086,0,4955,2,0.000046,13,0.207018,0.240538,30587.496954,0.101923,0.010783
9708037,9708037,,39,49,88,39,49,88,0.007093,0.014519,0,4306,2,0.000073,11,0.218872,0.257452,63823.883081,0.132445,0.021571
9708063,9708063,,13,14,27,13,14,27,0.002404,0.00391,0,5107,2,0.000025,12,0.200673,0.230023,9066.500296,0.242165,0.008667
9708119,9708119,,59,10,69,59,10,69,0.008948,0.004363,0,5227,2,0.000077,14,0.179617,0.208401,19506.902547,0.098039,0.027773
9709107,9709107,,49,46,95,49,46,95,0.009333,0.01447,0,5167,2,0.000068,11,0.221017,0.259666,229624.1607,0.087346,0.025129
9709220,9709220,,222,28,250,222,28,250,0.031841,0.007586,0,4956,2,0.000485,12,0.207451,0.238118,443303.055229,0.045478,0.144177
9710009,9710009,,264,19,283,264,19,283,0.038889,0.008403,0,4957,2,0.000552,14,0.197934,0.229492,198890.736143,0.038431,0.163949
9710014,9710014,,75,14,89,75,14,89,0.015062,0.004253,0,5168,1,0.00028,11,0.197985,0.225075,57037.711644,0.064862,0.091204
9710104,9710104,,21,22,43,21,22,43,0.002638,0.008465,0,5230,2,0.000027,13,0.191972,0.22224,32388.636737,0.153378,0.008342
9710174,9710174,,56,19,75,56,19,75,0.009019,0.006309,0,5059,2,0.00009,13,0.193864,0.223227,72822.287042,0.157297,0.030924
9710178,9710178,,66,22,88,66,22,88,0.011133,0.005815,0,5096,2,0.0001,14,0.192016,0.22458,424731.862702,0.100444,0.036326
9603053,9603053,,92,0,92,92,0,92,0.002639,0,0,2705,30,0.000401,0,0,0,0,0.035595,0.041726
9707179,9707179,,28,17,45,28,17,45,0.003006,0.006832,0,3641,2,0.000132,15,0.183451,0.21379,51728.698014,0.136869,0.021281
9709042,9709042,,11,7,18,11,7,18,0.00083,0.001695,0,5315,30,0.000106,14,0.171994,0.192254,35368.173067,0.127451,0.021698
9710153,9710153,,25,6,31,25,6,31,0.00087,0.002457,0,5496,30,0.000124,10,0.207954,0.231783,500721.529306,0.130108,0.024023
9711122,9711122,,4,7,11,4,7,11,0.000135,0.000149,0,5392,4,0.000081,13,0.189108,0.217516,94713.503442,0.154545,0.008249
9510134,9510134,,83,28,111,83,28,111,0.007936,0.002721,0,1411,13,0.000316,10,0.224353,0.279206,146942.163852,0.05602,0.067768
9603109,9603109,,159,20,179,159,20,179,0.022437,0.008051,0,1953,13,0.000403,10,0.231982,0.270655,70605.806544,0.063963,0.121232
9604089,9604089,,124,29,153,124,29,153,0.020997,0.009337,0,2079,13,0.000334,10,0.249368,0.288897,681374.206736,0.052116,0.098143
9607112,9607112,,82,19,101,82,19,101,0.006146,0.007252,0,2512,0,0.000215,9,0.229161,0.263492,48162.329428,0.085347,0.054974
9607149,9607149,,77,27,104,77,27,104,0.013277,0.006493,0,2204,13,0.000275,10,0.227045,0.266024,72635.337578,0.112771,0.078463
9608108,9608108,,64,18,82,64,18,82,0.009725,0.005231,0,2202,13,0.000261,10,0.221232,0.26075,17078.542838,0.15959,0.069518
9609026,9609026,,162,11,173,162,11,173,0.026248,0.002751,0,2205,13,0.000351,11,0.205078,0.235845,12391.042127,0.065399,0.112772
9610172,9610172,,113,39,152,113,39,152,0.018933,0.007516,0,2211,13,0.000252,10,0.224535,0.269031,128288.934818,0.090319,0.094519
9611125,9611125,,38,34,72,38,34,72,0.006636,0.009639,0,3570,13,0.000117,10,0.22984,0.274594,43465.037385,0.153169,0.039857
9612051,9612051,,50,32,82,50,32,82,0.010303,0.006296,0,3576,13,0.000163,10,0.230753,0.271782,47259.918598,0.156579,0.059281
9702015,9702015,,90,14,104,90,14,104,0.014332,0.00375,0,3571,13,0.000246,11,0.209956,0.242879,8970.648115,0.100168,0.076627
9703031,9703031,,100,29,129,100,29,129,0.019342,0.009682,0,3734,2,0.00026,13,0.209869,0.251947,226849.65721,0.056262,0.085875
9704112,9704112,,27,25,52,27,25,52,0.006991,0.005477,0,4636,13,0.000107,14,0.197296,0.230782,27744.339433,0.233786,0.043939
9705057,9705057,,79,13,92,79,13,92,0.012307,0.004019,0,3697,4,0.000145,12,0.180437,0.205522,137590.44345,0.072862,0.06299
9705192,9705192,,38,34,72,38,34,72,0.006184,0.005995,0,4993,13,0.000119,12,0.208377,0.244769,110307.092097,0.150039,0.038406
9705221,9705221,,208,30,238,208,30,238,0.032092,0.009924,0,3881,2,0.000377,13,0.205544,0.242138,443376.741557,0.043488,0.141349
9706100,9706100,,43,28,71,43,28,71,0.008237,0.005466,0,5004,13,0.000107,12,0.19265,0.225085,26706.516424,0.151308,0.039689
9707158,9707158,,49,36,85,49,36,85,0.006565,0.011508,0,4285,2,0.000105,11,0.209151,0.247997,346922.088134,0.064986,0.042353
9707188,9707188,,38,17,55,38,17,55,0.006861,0.003815,0,5304,1,0.000094,12,0.191203,0.220536,59230.294571,0.135354,0.035162
9708099,9708099,,24,26,50,24,26,50,0.004983,0.004387,0,5282,13,0.000086,13,0.202701,0.233432,348401.384882,0.167347,0.037656
9709091,9709091,,81,20,101,81,20,101,0.014136,0.009616,0,5010,2,0.000187,12,0.19535,0.228562,62630.5037,0.091386,0.06835
9709099,9709099,,50,32,82,50,32,82,0.008675,0.011441,0,4795,2,0.000152,14,0.195021,0.234195,157527.996224,0.091238,0.051134
9711002,9711002,,149,6,155,149,6,155,0.031397,0.000108,0,5300,1,0.000565,16,0.16344,0.193544,556099.003272,0.035819,0.131749
9711037,9711037,,70,9,79,70,9,79,0.010644,0.003331,0,5223,2,0.000143,14,0.181376,0.204248,100131.069177,0.102726,0.053896
9711053,9711053,,70,26,96,70,26,96,0.011264,0.004162,0,5170,13,0.000133,12,0.209632,0.244068,313162.881404,0.054057,0.055685
9711072,9711072,,14,10,24,14,10,24,0.004111,0.002363,0,5198,13,0.000077,13,0.189032,0.217575,10189.457896,0.273551,0.034014
9306069,9306069,,148,17,165,148,17,165,0.012651,0.000104,0,379,5,0.000716,2,0.947368,0.972222,154174.531163,0.021471,0.062003
9705091,9705091,,106,19,125,106,19,125,0.015478,0.008247,0,3890,2,0.000139,13,0.196358,0.227732,21911.5399,0.089226,0.048656
9709108,9709108,,64,13,77,64,13,77,0.010196,0.004488,0,5011,2,0.000109,13,0.17729,0.206749,13566.622556,0.101846,0.035913
9709114,9709114,,7,37,44,7,37,44,0.001371,0.009657,0,5224,2,0.000017,11,0.216396,0.254358,25964.168282,0.141649,0.003981
9710217,9710217,,60,27,87,60,27,87,0.008866,0.01051,0,5099,2,0.00008,14,0.195757,0.229876,55334.996074,0.103716,0.027838
9711063,9711063,,15,4,19,15,4,19,0.002414,0.000863,0,5220,2,0.000037,15,0.169904,0.190259,25122.12477,0.152047,0.008282
9411021,9411021,,50,7,57,50,7,57,0.002339,0.000189,0,2992,26,0.000135,7,0.253259,0.319975,34605.36244,0.052318,0.019013
9411100,9411100,,11,1,12,11,1,12,0.000165,0.000008,0,3913,26,0.000145,7,0.245455,0.289012,5572.006525,0.037879,0.005192
9507074,9507074,,41,4,45,41,4,45,0.00105,0.000086,0,5488,30,0.000147,9,0.238596,0.27194,41797.659212,0.1,0.015135
9706168,9706168,,32,43,75,32,43,75,0.003375,0.010859,0,3894,2,0.000053,12,0.211131,0.247738,62849.524564,0.087748,0.012666
9603089,9603089,,46,17,63,46,17,63,0.005597,0.006414,0,1927,2,0.000107,10,0.222794,0.262145,34435.418154,0.088582,0.029783
9603186,9603186,,30,4,34,30,4,34,0.003227,0.002749,0,3271,2,0.000062,10,0.20586,0.234086,1782.861072,0.127451,0.011746
9604013,9604013,,14,24,38,14,24,38,0.001538,0.0032,0,3278,13,0.000024,11,0.200456,0.243065,81251.140032,0.157895,0.004918
9607051,9607051,,20,38,58,20,38,58,0.001901,0.007697,0,3301,13,0.000034,13,0.219675,0.268232,182789.673121,0.106473,0.010107
9610024,9610024,,18,49,67,18,49,67,0.000567,0.006232,0,3419,13,0.000023,14,0.215394,0.273251,88104.782678,0.085482,0.004887
9610062,9610062,,5,20,25,5,20,25,0.00093,0.00246,0,3320,13,0.000017,14,0.203996,0.244178,21817.397366,0.203333,0.001757
9611060,9611060,,2,15,17,2,15,17,0.000112,0.001363,0,5740,13,0.000013,14,0.199483,0.236333,2389.624832,0.25,0.000793
9707002,9707002,,11,20,31,11,20,31,0.001819,0.006755,0,6183,2,0.00002,15,0.183547,0.220252,11622.610927,0.108602,0.004031
9805018,9805018,,62,23,85,62,23,85,0.009582,0.007379,0,6406,2,0.000059,14,0.190812,0.219382,76806.729379,0.102381,0.02488
9712201,9712201,,58,21,79,58,21,79,0.005599,0.005129,0,5613,30,0.000161,14,0.196231,0.227469,111769.553576,0.109218,0.03915
9801147,9801147,,66,15,81,66,15,81,0.006698,0.006778,0,6657,30,0.000195,15,0.189464,0.220887,23207.382555,0.107562,0.041606
9801170,9801170,,26,11,37,26,11,37,0.00203,0.008972,0,6658,30,0.000121,15,0.174161,0.200443,1589.774417,0.243243,0.026214
9803044,9803044,,58,22,80,58,22,80,0.005354,0.010218,0,6750,30,0.000159,14,0.193161,0.222005,10142.230863,0.14462,0.044557
9803166,9803166,,50,22,72,50,22,72,0.004,0.006278,0,6807,30,0.000122,14,0.193438,0.221313,33650.29232,0.144171,0.036576
9804120,9804120,,25,5,30,25,5,30,0.002247,0.001985,0,6843,30,0.000077,15,0.177725,0.199804,1627.31051,0.155172,0.020523
9805034,9805034,,95,16,111,95,16,111,0.006153,0.003753,0,6815,30,0.000144,14,0.195926,0.221835,33973.443414,0.080753,0.050087
9806099,9806099,,41,40,81,41,40,81,0.003293,0.005769,0,6864,30,0.00008,14,0.210054,0.244335,323439.124127,0.09784,0.028959
9807198,9807198,,59,17,76,59,17,76,0.004178,0.004954,0,6866,30,0.000131,13,0.200204,0.226263,64630.362015,0.13614,0.036997
9810099,9810099,,55,28,83,55,28,83,0.003751,0.0099,0,6934,30,0.0001,11,0.225015,0.257415,116443.068283,0.125037,0.033244
9810116,9810116,,68,26,94,68,26,94,0.005772,0.006276,0,6933,30,0.000127,12,0.214944,0.244064,121200.973907,0.107184,0.039401
9810185,9810185,,26,9,35,26,9,35,0.00221,0.001738,0,6935,30,0.000069,12,0.210612,0.236271,59814.332822,0.193277,0.02269
9810219,9810219,,56,22,78,56,22,78,0.004563,0.004839,0,6936,30,0.000096,12,0.213341,0.240941,121871.757894,0.139361,0.034413
9811159,9811159,,32,9,41,32,9,41,0.002977,0.00128,0,6937,30,0.000055,13,0.192837,0.216006,3754.741409,0.191463,0.023543
9811213,9811213,,26,25,51,26,25,51,0.002234,0.005966,0,6938,30,0.000049,13,0.196769,0.222316,19879.234767,0.172941,0.021348
9901008,9901008,,2,30,32,2,30,32,0.000217,0.00529,0,8498,30,0.000011,13,0.19764,0.224704,11167.923597,0.219758,0.000826
9901077,9901077,,28,9,37,28,9,37,0.001974,0.002636,0,6939,30,0.000049,12,0.210546,0.236199,52064.793716,0.184685,0.020182
9612205,9612205,,9,5,14,9,5,14,0.000614,0.000078,0,5518,30,0.000035,8,0.218922,0.252979,11539.703148,0.054945,0.005385
9712185,9712185,,62,36,98,62,36,98,0.010149,0.006725,0,5332,2,0.000054,13,0.203021,0.236523,33006.300166,0.107301,0.027659
9807060,9807060,,13,10,23,13,10,23,0.001649,0.003952,0,9083,2,0.000024,13,0.192823,0.220329,19744.677047,0.175889,0.004899
9812184,9812184,,5,10,15,5,10,15,0.000293,0.003606,0,9084,2,0.000018,13,0.19144,0.218843,1273.169435,0.214286,0.00194
9812239,9812239,,53,52,105,53,52,105,0.007499,0.013695,0,6688,2,0.000038,13,0.210822,0.246187,50352.630642,0.096978,0.020319
9903210,9903210,,59,49,108,59,49,108,0.006758,0.010785,0,7759,2,0.000054,15,0.216091,0.253526,172000.527356,0.05019,0.024431
9904095,9904095,,79,42,121,79,42,121,0.008958,0.028751,0,7765,2,0.000054,12,0.209113,0.243479,77231.604446,0.069835,0.027658
9711179,9711179,,27,36,63,27,36,63,0.00304,0.011062,0,5571,2,0.000028,15,0.205841,0.24408,27804.361385,0.131848,0.012769
9712047,9712047,,26,45,71,26,45,71,0.003142,0.011133,0,5574,2,0.00004,14,0.213179,0.252856,63156.476012,0.101006,0.011142
9712084,9712084,,38,36,74,38,36,74,0.004741,0.009375,0,5591,2,0.000055,15,0.201825,0.237599,116853.696125,0.102184,0.016026
9809039,9809039,,85,216,301,85,216,301,0.010249,0.039184,0,6932,2,0.000081,11,0.260836,0.31962,1589238.808482,0.035183,0.028669
9812139,9812139,,13,24,37,13,24,37,0.000956,0.005568,0,8188,0,0.000018,12,0.212198,0.243845,13130.139609,0.144895,0.004518
9906161,9906161,,98,38,136,98,38,136,0.006514,0.009203,0,8505,30,0.000113,13,0.205845,0.236075,212172.011873,0.067647,0.043916
9207011,9207011,,26,0,26,26,0,26,0.000756,0,0,404,5,0.000119,0,0,0,0,0.083077,0.018675
9309028,9309028,,16,3,19,16,3,19,0.000375,0.000012,0,691,5,0.000056,4,0.282828,0.345238,13433.364559,0.114035,0.014567
9403050,9403050,,21,6,27,21,6,27,0.000682,0.000199,0,747,26,0.000066,5,0.260563,0.373423,12696.15361,0.088319,0.017284
9608177,9608177,,105,4,109,105,4,109,0.004834,0.000901,0,2990,2,0.000202,10,0.20376,0.229007,25913.078274,0.060992,0.048147
9611065,9611065,,75,16,91,75,16,91,0.003554,0.002873,0,3354,2,0.000204,11,0.209555,0.24382,171647.837447,0.060928,0.04224
9611233,9611233,,47,10,57,47,10,57,0.003981,0.006093,0,3314,30,0.000076,12,0.210056,0.244479,45658.640479,0.067669,0.028791
9702008,9702008,,114,15,129,114,15,129,0.008757,0.002153,0,3403,2,0.000166,11,0.204427,0.23359,104916.587807,0.067163,0.05455
9702111,9702111,,43,6,49,43,6,49,0.00315,0.000624,0,3533,2,0.000062,11,0.19564,0.218305,8627.034316,0.106293,0.025235
9704037,9704037,,28,5,33,28,5,33,0.001517,0.001657,0,5313,30,0.000093,11,0.180148,0.199085,18850.081778,0.090909,0.021719
9707190,9707190,,32,9,41,32,9,41,0.001716,0.003039,0,5314,30,0.000094,13,0.18971,0.212844,36072.535962,0.071951,0.020655
9712117,9712117,,89,42,131,89,42,131,0.014741,0.016417,0,5601,2,0.000149,13,0.218607,0.254678,505220.293614,0.056371,0.061772
9712206,9712206,,18,20,38,18,20,38,0.00142,0.003148,0,6854,30,0.000041,15,0.189577,0.223465,273198.624796,0.118065,0.016783
9802068,9802068,,232,25,257,232,25,257,0.018168,0.007795,0,6661,30,0.000295,14,0.204922,0.238203,193427.128619,0.036235,0.106718
9804001,9804001,,52,14,66,52,14,66,0.002465,0.000762,0,7027,30,0.00015,16,0.173582,0.199292,460763.20644,0.121678,0.042809
9810147,9810147,,25,6,31,25,6,31,0.00261,0.001564,0,6940,30,0.000038,14,0.185372,0.207116,13256.156933,0.122581,0.017988
9812172,9812172,,16,39,55,16,39,55,0.002005,0.008577,0,6947,30,0.000033,12,0.212647,0.243361,164200.871557,0.105387,0.014283
9812180,9812180,,59,6,65,59,6,65,0.002518,0.000206,0,7007,30,0.000156,15,0.166646,0.187915,60416.56724,0.092308,0.040356
9903077,9903077,,114,17,131,114,17,131,0.004655,0.002109,0,7028,30,0.000214,13,0.191764,0.213691,58259.499278,0.09906,0.064747
9903107,9903107,,103,22,125,103,22,125,0.004747,0.004057,0,7005,30,0.000223,12,0.202415,0.228501,182467.167248,0.100194,0.063333
9903187,9903187,,104,12,116,104,12,116,0.004907,0.000975,0,7067,30,0.000238,12,0.186463,0.206634,198545.924771,0.116117,0.065588
9903239,9903239,,34,8,42,34,8,42,0.001561,0.000136,0,8529,30,0.00009,14,0.167726,0.184681,136183.218387,0.117305,0.029019
9904064,9904064,,10,19,29,10,19,29,0.001157,0.004689,0,8522,30,0.000034,15,0.192497,0.219736,153405.572712,0.190887,0.01445
9904132,9904132,,27,9,36,27,9,36,0.001097,0.000236,0,8515,30,0.000086,15,0.166777,0.188531,111223.139049,0.096032,0.025825
9906192,9906192,,142,12,154,142,12,154,0.011112,0.002921,0,8511,30,0.000147,14,0.198065,0.219512,161983.029365,0.049189,0.059251
9907008,9907008,,18,15,33,18,15,33,0.001336,0.003785,0,8507,30,0.000039,12,0.211802,0.238535,49277.617121,0.172348,0.015921
9907166,9907166,,144,9,153,144,9,153,0.020132,0.009606,0,6662,30,0.000187,14,0.189941,0.213491,36208.721498,0.061705,0.070039
9908052,9908052,,17,4,21,17,4,21,0.001158,0.000149,0,8482,30,0.00007,16,0.150861,0.169573,3448.02208,0.135714,0.022617
9908056,9908056,,190,8,198,190,8,198,0.012907,0.001722,0,7068,30,0.000302,13,0.181645,0.19929,27833.68997,0.046506,0.092461
9908105,9908105,,154,59,213,154,59,213,0.013233,0.020612,0,8481,2,0.000175,11,0.237466,0.27387,2215263.01499,0.03107,0.061926
9908134,9908134,,165,16,181,165,16,181,0.022199,0.019954,0,7184,30,0.000173,14,0.194262,0.22095,57111.139668,0.056814,0.076246
9801182,9801182,,131,126,257,131,126,257,0.017344,0.030475,0,5615,2,0.000128,13,0.225987,0.27596,631304.330019,0.048228,0.053747
9908141,9908141,,100,19,119,100,19,119,0.008123,0.020485,0,9116,30,0.000112,14,0.194492,0.221466,129581.260533,0.068722,0.043475
1012,1012,,37,10,47,37,10,47,0.00066,0.000068,0,9124,52,0.00004,17,0.152897,0.164787,15946.25504,0.095282,0.010059
9205059,9205059,,13,0,13,13,0,13,0.000091,0,0,1216,17,0.000065,0,0,0,0,0.070513,0.004296
9206053,9206053,,26,1,27,26,1,27,0.000314,0,0,2275,52,0.000089,1,1,1,394.520204,0.066952,0.007191
9302035,9302035,,23,0,23,23,0,23,0.000303,0,0,4222,52,0.000055,0,0,0,0,0.088933,0.006352
9403141,9403141,,55,8,63,55,8,63,0.00146,0.000012,0,2277,52,0.00012,3,0.666667,0.77381,85812.031221,0.044035,0.016589
9405136,9405136,,25,6,31,25,6,31,0.000174,0.000012,0,4224,52,0.000059,4,0.465116,0.579167,16980.613066,0.107527,0.006652
9506136,9506136,,85,0,85,85,0,85,0.002012,0,0,4228,52,0.000215,0,0,0,0,0.037675,0.025419
9507109,9507109,,21,5,26,21,5,26,0.000272,0.000051,0,4229,52,0.000049,5,0.369565,0.456863,3804.489326,0.135385,0.00642
9702190,9702190,,25,6,31,25,6,31,0.000048,0.000043,0,6752,6,0.000058,6,0.3,0.369259,6562.035525,0.111828,0.007033
9911110,9911110,,21,12,33,21,12,33,0.000843,0.000216,0,9123,52,0.000035,16,0.179653,0.197866,142997.512001,0.112689,0.005955
9204088,9204088,,10,0,10,10,0,10,0.000005,0,0,2274,52,0.000128,0,0,0,0,0.177778,0.00306
9206047,9206047,,35,0,35,35,0,35,0.0001,0,0,1184,6,0.000656,0,0,0,0,0.056303,0.010778
9208027,9208027,,180,0,180,180,0,180,0.006461,0,0,138,3,0.000586,0,0,0,0,0.043141,0.07019
9205034,9205034,,30,0,30,30,0,30,0.000397,0,0,1889,52,0.000207,0,0,0,0,0.087356,0.008615
9211016,9211016,,6,0,6,6,0,6,0.000231,0,0,2271,52,0.000061,0,0,0,0,0.133333,0.001871
9212004,9212004,,2,2,4,2,2,4,0.000001,0.000004,0,2276,52,0.000024,1,1,1,0,0.5,0.00087
9305023,9305023,,14,5,19,14,5,19,0.000018,0.000028,0,1959,52,0.000041,2,0.857143,0.916667,17135.96076,0.035088,0.003977
9305043,9305043,,29,1,30,29,1,30,0.000049,0.000005,0,2273,52,0.000098,1,1,1,48.918237,0.101149,0.007911
9311083,9311083,,3,1,4,3,1,4,0.000002,0.000003,0,2272,52,0.000025,1,1,1,1,0.25,0.001089
9208075,9208075,,7,0,7,7,0,7,0.000001,0,0,4223,52,0.000028,0,0,0,0,0.214286,0.001806
9401007,9401007,,13,7,20,13,7,20,0.000012,0.00003,0,2495,52,0.000048,3,0.625,0.722222,12691.352953,0.060526,0.00368
9403026,9403026,,25,2,27,25,2,27,0.000229,0.000005,0,2477,52,0.000054,1,1,1,1020.736739,0.108262,0.006461
9306044,9306044,,52,0,52,52,0,52,0.000006,0,0,2418,6,0.000218,0,0,0,0,0.081071,0.015052
9406125,9406125,,59,11,70,59,11,70,0.001324,0.000059,0,2067,3,0.000149,4,0.493506,0.594298,96672.820803,0.061491,0.029013
9604044,9604044,,39,7,46,39,7,46,0.000089,0.00002,0,5875,6,0.000113,5,0.34555,0.431818,14530.597433,0.07343,0.01037
9611238,9611238,,43,4,47,43,4,47,0.000031,0.000001,0,6751,6,0.000094,8,0.191244,0.258878,14642.308028,0.057354,0.011223
9811090,9811090,,6,8,14,6,8,14,0.000161,0.000052,0,9122,52,0.000019,7,0.217262,0.278898,21348.463223,0.126374,0.001776
9811203,9811203,,9,2,11,9,2,11,0.000336,0.000002,0,9119,52,0.000023,4,0.466667,0.583333,6536.065092,0.118182,0.002473
1013,1013,,16,11,27,16,11,27,0.000638,0.001445,0,9129,25,0.000021,12,0.191944,0.209792,4092.183676,0.156695,0.005619
9911234,9911234,,9,17,26,9,17,26,0.000549,0.001619,0,9128,25,0.000019,12,0.20178,0.222649,2119.584153,0.278462,0.003449
9912276,9912276,,4,2,6,4,2,6,0.000169,0.00112,0,9127,25,0.000014,12,0.189279,0.205306,79.114032,0.233333,0.001206
9805067,9805067,,14,0,14,14,0,14,0.000322,0,0,8114,0,0.000033,0,0,0,0,0.098901,0.003902
9909048,9909048,,26,7,33,26,7,33,0.001435,0.003763,0,8775,25,0.000032,12,0.193404,0.21356,1917.081362,0.15625,0.009042
9810123,9810123,,16,35,51,16,35,51,0.003073,0.013033,0,7401,13,0.000055,13,0.203427,0.238249,34732.175812,0.103529,0.006043
9808138,9808138,,26,7,33,26,7,33,0.001226,0.003295,0,7749,25,0.000087,15,0.168146,0.193826,23224.823063,0.092803,0.008972
9908018,9908018,,33,26,59,33,26,59,0.002831,0.005205,0,8786,25,0.000051,15,0.201706,0.231542,89552.311336,0.049971,0.010253
9909199,9909199,,54,28,82,54,28,82,0.003042,0.003016,0,8774,25,0.000084,12,0.214966,0.239678,163643.533473,0.098314,0.01988
9912018,9912018,,94,18,112,94,18,112,0.016467,0.019428,0,9126,25,0.000091,12,0.208761,0.23331,76106.727919,0.06427,0.032665
1014,1014,,3,8,11,3,8,11,0.000001,0.000001,0,9149,23,0.000015,17,0.139582,0.153938,699.549034,0.109091,0.000723
9502097,9502097,,6,0,6,6,0,6,0,0,0,9133,23,0.000041,0,0,0,0,0.166667,0.001471
9606100,9606100,,13,1,14,13,1,14,0.000007,0,0,9039,23,0.000162,3,0.444444,0.541667,772.346873,0.269231,0.003531
9803011,9803011,,22,4,26,22,4,26,0.000025,0.000001,0,9043,23,0.000065,4,0.454545,0.616667,7027.777825,0.141538,0.005453
9806244,9806244,,12,13,25,12,13,25,0.000013,0.000003,0,9148,23,0.000026,16,0.161645,0.182505,25816.65494,0.166667,0.002959
9807215,9807215,,5,1,6,5,1,6,0.000016,0,0,9138,23,0.00002,6,0.289474,0.381818,2.642857,0.333333,0.001235
9903055,9903055,,12,4,16,12,4,16,0.00001,0.000001,0,9135,23,0.000032,4,0.433333,0.570513,50.656385,0.2125,0.002882
9903266,9903266,,5,0,5,5,0,5,0,0,0,9130,23,0.000026,0,0,0,0,0.25,0.001219
9904136,9904136,,5,2,7,5,2,7,0.000001,0,0,9132,23,0.000019,3,0.444444,0.541667,319.689776,0.190476,0.001232
9511139,9511139,,9,1,10,9,1,10,0.000023,0,0,9038,23,0.00017,2,0.6,0.666667,392.233293,0.3,0.002468
9612091,9612091,,15,1,16,15,1,16,0.000007,0,0,9040,23,0.000127,4,0.357143,0.466667,832.276711,0.270833,0.004181
9702053,9702053,,18,2,20,18,2,20,0.00001,0.000001,0,9041,23,0.000085,5,0.347826,0.497917,490.436544,0.2,0.004667
9705216,9705216,,9,2,11,9,2,11,0.000022,0,0,9042,23,0.000039,5,0.346154,0.47963,1370.948345,0.254545,0.00247
9411080,9411080,,10,2,12,10,2,12,0.000035,0.000001,0,9037,23,0.000188,1,1,1,745.681196,0.128788,0.002697
9511176,9511176,,13,6,19,13,6,19,0.000024,0.000002,0,9146,23,0.000029,2,0.75,0.833333,12633.14571,0.146199,0.003353
9606105,9606105,,16,0,16,16,0,16,0.00001,0,0,9136,23,0.000058,0,0,0,0,0.158333,0.004066
9710093,9710093,,6,4,10,6,4,10,0.000026,0.000001,0,9144,23,0.000018,4,0.47619,0.625,3310.241803,0.155556,0.001564
9803030,9803030,,12,15,27,12,15,27,0.000054,0.001362,0,9147,23,0.000023,15,0.189448,0.220376,72634.712825,0.07265,0.00329
9803079,9803079,,5,6,11,5,6,11,0,0,0,9143,23,0.000021,9,0.183634,0.216359,8359.126651,0.181818,0.001198
9805022,9805022,,4,0,4,4,0,4,0,0,0,9139,23,0.000023,0,0,0,0,0,0.000959
9807078,9807078,,17,3,20,17,3,20,0.000024,0,0,9137,23,0.000073,5,0.37037,0.531667,12660.508188,0.128947,0.00416
9903011,9903011,,8,2,10,8,2,10,0.00001,0,0,9134,23,0.000025,5,0.352941,0.463889,11.680952,0.344444,0.001981
9710225,9710225,,6,2,8,6,2,8,0.000017,0.000003,0,9131,22,0.000029,2,0.6,0.666667,1898.896301,0.107143,0.001571
1015,1015,,0,1,1,0,1,1,0,0,0,9163,9,0.00001,13,0.124434,0.134455,0,0,0
9811016,9811016,,8,3,11,8,3,11,0,0,0,9162,9,0.000051,12,0.141971,0.158028,3874.719048,0.154545,0.001806
9709229,9709229,,7,9,16,7,9,16,0.000002,0.000011,0,9157,9,0.000045,6,0.329341,0.438485,10567.822898,0.095833,0.001763
9710069,9710069,,6,6,12,6,6,12,0.000008,0.000021,0,9160,9,0.000039,7,0.269565,0.356912,7326.602192,0.174242,0.001493
9810165,9810165,,6,4,10,6,4,10,0.000023,0.000002,0,9161,9,0.000036,11,0.163599,0.183424,8259.481075,0.211111,0.00142
1016,1016,,8,19,27,8,19,27,0.001621,0.01841,0,9188,1,0.000013,13,0.198575,0.221963,12064.814407,0.180912,0.001906
9607049,9607049,,84,2,86,84,2,86,0.004808,0.000063,0,2209,23,0.000315,1,1,1,13986.068852,0.030369,0.027139
9808057,9808057,,7,1,8,7,1,8,0.000478,0.000001,0,9184,23,0.000024,15,0.117402,0.124832,2125.183463,0.178571,0.0018
9906164,9906164,,6,12,18,6,12,18,0.000476,0.000927,0,9187,2,0.000014,15,0.17948,0.204097,10573.046712,0.160131,0.0015
9907158,9907158,,11,13,24,11,13,24,0.001804,0.008988,0,9185,1,0.000017,12,0.200829,0.223059,6416.157695,0.17029,0.002638
9911215,9911215,,5,17,22,5,17,22,0.000799,0.010069,0,9186,1,0.000013,13,0.197192,0.220913,3089.452687,0.183983,0.001249
9301068,9301068,,151,0,151,151,0,151,0.00534,0,0,131,26,0.000737,0,0,0,0,0.022561,0.056075
9404077,9404077,,9,0,9,9,0,9,0.000002,0,0,2208,23,0.000183,0,0,0,0,0.069444,0.002748
9505052,9505052,,45,79,124,45,79,124,0.001841,0.002593,0,1087,13,0.000181,7,0.320483,0.413523,783576.281209,0.042945,0.024156
9604040,9604040,,3,14,17,3,14,17,0.000002,0.000042,0,5299,5,0.000096,7,0.244671,0.282225,260384.907542,0.125,0.002909
9606104,9606104,,18,1,19,18,1,19,0.000292,0.001027,0,4766,23,0.000162,6,0.262295,0.292839,3453.695323,0.119883,0.007114
9705029,9705029,,20,10,30,20,10,30,0.002115,0.004016,0,5293,2,0.000147,15,0.17736,0.203903,44708.978636,0.114943,0.015641
9605009,9605009,,53,22,75,53,22,75,0.00665,0.001606,0,5008,1,0.000323,16,0.166894,0.213567,276155.581561,0.05027,0.048181
9308075,9308075,,70,4,74,70,4,74,0.009853,0.000121,0,351,1,0.000278,1,1,1,35769.234193,0.044983,0.052527
9712021,9712021,,18,14,32,18,14,32,0.003631,0.005437,0,5544,2,0.000122,15,0.185941,0.218206,75393.886994,0.136089,0.026351
9712073,9712073,,55,9,64,55,9,64,0.013232,0.00684,0,5371,1,0.000276,14,0.189078,0.214816,42994.574392,0.143849,0.060326
9802047,9802047,,69,31,100,69,31,100,0.0161,0.016929,0,5536,1,0.000214,13,0.208783,0.246422,257155.769571,0.086667,0.058157
9802126,9802126,,62,13,75,62,13,75,0.015282,0.009996,0,5386,1,0.000232,14,0.194649,0.222878,41355.540358,0.127928,0.063297
9302047,9302047,,70,0,70,70,0,70,0.00593,0,0,348,1,0.000238,0,0,0,0,0.046998,0.031426
9307010,9307010,,68,1,69,68,1,69,0.009537,0.000003,0,3246,1,0.000304,2,0.571429,0.625,35637.165213,0.050512,0.036102
9804083,9804083,,123,21,144,123,21,144,0.027861,0.01966,0,6101,1,0.000166,12,0.205082,0.234932,128307.535597,0.064394,0.055727
9303139,9303139,,39,0,39,39,0,39,0.002223,0,0,1203,4,0.000061,0,0,0,0,0.067476,0.01433
9702201,9702201,,79,26,105,79,26,105,0.011047,0.012138,0,3503,0,0.000074,11,0.241532,0.283398,162584.105133,0.06337,0.028663
9805028,9805028,,153,8,161,153,8,161,0.02718,0.015812,0,6137,41,0.000213,13,0.18984,0.212072,82105.40477,0.057803,0.069998
9804101,9804101,,12,6,18,12,6,18,0.000634,0.000591,0,6651,1,0.00003,13,0.157218,0.175057,16771.113074,0.153595,0.004121
9805143,9805143,,22,17,39,22,17,39,0.006113,0.02028,0,6111,1,0.000037,13,0.191736,0.219261,19549.786469,0.140351,0.017312
9806075,9806075,,17,22,39,17,22,39,0.003217,0.022436,0,6650,1,0.000031,13,0.205746,0.235109,141033.652074,0.131579,0.012732
9808045,9808045,,9,4,13,9,4,13,0.000044,0.000002,0,9183,23,0.000055,14,0.132978,0.144641,44884.905992,0.057692,0.002242
9806103,9806103,,31,28,59,31,28,59,0.007469,0.023289,0,6148,1,0.000054,12,0.212575,0.242947,65788.915779,0.104617,0.021918
9806106,9806106,,37,15,52,37,15,52,0.002033,0.002225,0,6920,13,0.000066,13,0.200088,0.227164,263564.786196,0.057315,0.012407
9610126,9610126,,7,1,8,7,1,8,0.000925,0.000002,0,5292,1,0.00003,8,0.198251,0.223206,196.760842,0.071429,0.003017
9803046,9803046,,11,8,19,11,8,19,0.000574,0.000104,0,7911,23,0.000018,12,0.179353,0.205768,18662.943391,0.239766,0.002996
9806199,9806199,,88,158,246,88,158,246,0.013354,0.048385,0,6887,2,0.000111,10,0.272702,0.33084,1398767.089184,0.044019,0.033906
9807223,9807223,,4,22,26,4,22,26,0.000708,0.016659,0,7909,1,0.000013,13,0.195961,0.221804,69734.330597,0.112308,0.001207
9805171,9805171,,155,21,176,155,21,176,0.035542,0.014131,0,6108,1,0.00014,12,0.199926,0.227634,64975.878481,0.035162,0.07018
9808017,9808017,,118,21,139,118,21,139,0.028195,0.015758,0,6282,1,0.000128,12,0.201883,0.228638,100081.093311,0.053227,0.058207
9901012,9901012,,34,19,53,34,19,53,0.007637,0.019353,0,7403,1,0.000049,13,0.201653,0.229292,33138.930558,0.105951,0.019751
9901079,9901079,,61,12,73,61,12,73,0.01392,0.014595,0,7390,1,0.00006,13,0.189757,0.213814,21924.176012,0.071918,0.031134
9901144,9901144,,27,36,63,27,36,63,0.006955,0.02212,0,7728,1,0.000044,12,0.206788,0.235565,41255.606378,0.141833,0.020116
9902073,9902073,,18,35,53,18,35,53,0.004636,0.023702,0,7434,1,0.000025,12,0.205861,0.237681,210510.668898,0.109216,0.01279
9902101,9902101,,17,34,51,17,34,51,0.004389,0.022957,0,7541,1,0.000024,11,0.208732,0.239143,56247.299328,0.110196,0.013578
9902121,9902121,,156,16,172,156,16,172,0.028912,0.017921,0,7862,1,0.000146,13,0.191926,0.215815,53211.492332,0.05406,0.066623
9903085,9903085,,39,12,51,39,12,51,0.01034,0.018321,0,8129,1,0.000036,13,0.193663,0.215663,5519.119492,0.148627,0.02083
9612128,9612128,,177,5,182,177,5,182,0.01109,0.002043,0,3996,25,0.000243,12,0.200487,0.226896,106273.789222,0.034212,0.059062
9706109,9706109,,205,38,243,205,38,243,0.021941,0.011163,0,4262,4,0.000245,14,0.220133,0.259534,898635.235143,0.040064,0.095807
9711116,9711116,,15,8,23,15,8,23,0.000739,0.001174,0,8703,25,0.000022,15,0.187649,0.213223,4530.300588,0.079051,0.004656
9803138,9803138,,43,36,79,43,36,79,0.008206,0.023898,0,5753,1,0.000069,13,0.211417,0.246122,193226.889055,0.092665,0.021161
9808182,9808182,,8,40,48,8,40,48,0.002686,0.019737,0,7655,1,0.000018,12,0.21494,0.247236,20163.689445,0.177748,0.010983
9811010,9811010,,8,46,54,8,46,54,0.002834,0.023732,0,7988,1,0.000018,12,0.218062,0.251285,40198.20167,0.150245,0.009831
9811048,9811048,,21,13,34,21,13,34,0.004396,0.010721,0,7989,1,0.000034,12,0.197074,0.222475,18510.661249,0.106952,0.015592
9901060,9901060,,25,16,41,25,16,41,0.00538,0.002376,0,8429,1,0.000024,11,0.201294,0.22766,66962.723103,0.108537,0.014258
9709014,9709014,,74,13,87,74,13,87,0.007645,0.002579,0,4896,2,0.000092,14,0.184896,0.215486,36503.184552,0.067629,0.032654
9804180,9804180,,47,20,67,47,20,67,0.00495,0.004528,0,6876,2,0.000052,14,0.199,0.229259,68586.357123,0.105156,0.01671
9807169,9807169,,12,1,13,12,1,13,0.000264,0,0,7226,2,0.000067,21,0.078991,0.084771,22573.198962,0.173077,0.003424
9810070,9810070,,37,45,82,37,45,82,0.001249,0.000786,0,7271,23,0.000087,22,0.1235,0.204904,237692.843504,0.03237,0.00924
9812094,9812094,,16,13,29,16,13,29,0.000711,0.002433,0,7242,2,0.00003,14,0.196513,0.224919,35024.869787,0.169951,0.005732
9901073,9901073,,17,11,28,17,11,28,0.00043,0.002035,0,7243,2,0.000037,14,0.18401,0.210687,21485.224755,0.202381,0.005689
9904065,9904065,,13,2,15,13,2,15,0.000254,0.000003,0,7227,2,0.000055,21,0.079051,0.085515,13052.083218,0.2,0.00346
9904186,9904186,,10,8,18,10,8,18,0.00014,0.000555,0,7249,2,0.000027,15,0.172916,0.192363,97688.788018,0.222222,0.002642
9905223,9905223,,19,6,25,19,6,25,0.00014,0.000035,0,7272,2,0.000064,16,0.157357,0.177542,139930.576581,0.111667,0.004845
9601143,9601143,,51,3,54,51,3,54,0.000965,0.000083,0,4777,28,0.000103,5,0.277419,0.328682,5034.659216,0.070231,0.0169
9906217,9906217,,22,44,66,22,44,66,0.003357,0.021851,0,9176,1,0.000032,11,0.229361,0.261756,96759.726359,0.129138,0.006746
9812187,9812187,,15,7,22,15,7,22,0.001569,0.008877,0,7948,1,0.000041,13,0.1861,0.208253,134586.277374,0.106061,0.004517
9909043,9909043,,12,16,28,12,16,28,0.00126,0.00177,0,9172,1,0.000021,14,0.182265,0.202715,68545.843098,0.095238,0.00413
9910099,9910099,,22,27,49,22,27,49,0.005267,0.023232,0,9171,1,0.000019,13,0.204848,0.231538,8899.925536,0.142432,0.006865
9908088,9908088,,69,23,92,69,23,92,0.005662,0.004027,0,9125,0,0.000055,13,0.194869,0.224222,65281.019895,0.075131,0.02739
1017,1017,,5,10,15,5,10,15,0.000151,0.000005,0,9206,23,0.000014,14,0.139314,0.153363,43960.371187,0.204762,0.001232
9609035,9609035,,28,1,29,28,1,29,0.000007,0,0,9195,23,0.000089,1,1,1,2075.925687,0.097291,0.00742
9808129,9808129,,42,6,48,42,6,48,0.000056,0.000007,0,9196,23,0.000095,17,0.115262,0.132484,10048.526108,0.097961,0.010706
9811053,9811053,,24,3,27,24,3,27,0.000009,0.000002,0,9199,23,0.000054,18,0.10346,0.11563,1586.693517,0.08547,0.005949
9811077,9811077,,31,9,40,31,9,40,0.000037,0.000025,0,9198,23,0.000056,13,0.153635,0.171514,63289.548145,0.103846,0.007651
9811171,9811171,,3,6,9,3,6,9,0.000003,0.000006,0,9205,23,0.000012,14,0.133256,0.14475,303.76636,0.333333,0.000718
9902140,9902140,,4,7,11,4,7,11,0.000003,0.000007,0,9204,23,0.000014,14,0.133369,0.145321,1499.869396,0.245455,0.000938
9903223,9903223,,17,5,22,17,5,22,0.000036,0.000004,0,9203,23,0.000035,15,0.119063,0.129932,18208.667044,0.147186,0.004342
9905215,9905215,,18,7,25,18,7,25,0.000003,0.000018,0,9197,23,0.000033,14,0.149624,0.171593,14156.072335,0.158333,0.004522
9406160,9406160,,15,0,15,15,0,15,0,0,0,4381,23,0.000192,0,0,0,0,0.02381,0.003674
9610113,9610113,,11,4,15,11,4,15,0.000004,0.000003,0,4968,23,0.000183,16,0.128844,0.147304,58161.467697,0.152381,0.003749
9702089,9702089,,36,3,39,36,3,39,0.000088,0.000003,0,4969,23,0.000214,17,0.115622,0.131548,32816.14513,0.064103,0.009431
9705151,9705151,,49,7,56,49,7,56,0.000198,0.000276,0,5319,23,0.000193,17,0.116228,0.136324,34551.731065,0.048377,0.012394
9707009,9707009,,19,29,48,19,29,48,0.001366,0.002739,0,5324,4,0.000079,12,0.180964,0.210931,251893.969445,0.058067,0.005563
9812090,9812090,,39,3,42,39,3,42,0.000192,0.000004,0,9190,23,0.000076,2,0.8,0.875,1969.412746,0.098142,0.010106
9506026,9506026,,18,0,18,18,0,18,0.000079,0,0,4000,23,0.00012,0,0,0,0,0.130719,0.005924
9611228,9611228,,4,1,5,4,1,5,0.000022,0.001027,0,7116,23,0.000031,6,0.262295,0.292839,647.392795,0.1,0.001447
9808127,9808127,,10,2,12,10,2,12,0.000001,0.000004,0,9189,23,0.000051,2,0.75,0.833333,0.60119,0.272727,0.002848
9901037,9901037,,3,11,14,3,11,14,0,0.000014,0,9202,23,0.000018,14,0.133693,0.147149,14861.263103,0.148352,0.000809
9610101,9610101,,27,3,30,27,3,30,0.000315,0.001028,0,4001,23,0.000114,6,0.265306,0.303718,23140.173328,0.088506,0.009173
9709109,9709109,,54,11,65,54,11,65,0.000675,0.001879,0,7118,23,0.000138,13,0.167525,0.197446,145348.601366,0.077885,0.015129
9805153,9805153,,33,9,42,33,9,42,0.000123,0.000031,0,9193,23,0.000064,14,0.149022,0.172761,14174.297917,0.122532,0.009079
9905127,9905127,,13,5,18,13,5,18,0.000058,0.000016,0,9194,23,0.000029,13,0.163267,0.185097,7626.977122,0.179739,0.003339
1018,1018,,10,18,28,10,18,28,0.000848,0.002531,0,9211,25,0.000019,11,0.204733,0.229257,12311.170181,0.152116,0.003912
9603087,9603087,,183,16,199,183,16,199,0.020491,0.005788,0,1834,13,0.000265,9,0.224495,0.25935,38074.039429,0.050556,0.091557
9604035,9604035,,224,38,262,224,38,262,0.026249,0.01398,0,1944,13,0.000306,9,0.247946,0.294831,75532.854321,0.045304,0.104437
9604179,9604179,,153,17,170,153,17,170,0.017392,0.005678,0,2101,13,0.000175,10,0.224437,0.263853,33760.725955,0.05315,0.067086
9609212,9609212,,71,24,95,71,24,95,0.009599,0.006674,0,2759,13,0.000099,11,0.218347,0.260829,30789.797155,0.081187,0.036495
9701042,9701042,,48,29,77,48,29,77,0.005802,0.011355,0,3361,13,0.000066,10,0.218934,0.257169,25899.935467,0.115687,0.021254
9801049,9801049,,21,41,62,21,41,62,0.003934,0.015291,0,5905,13,0.000022,13,0.212803,0.260916,26816.282013,0.140931,0.007835
9802163,9802163,,10,55,65,10,55,65,0.001633,0.007118,0,8253,13,0.000015,11,0.236467,0.278831,66069.016715,0.104087,0.003213
9906048,9906048,,17,22,39,17,22,39,0.002854,0.020975,0,8814,1,0.000019,12,0.201798,0.23051,5369.728332,0.118758,0.005849
9911218,9911218,,36,9,45,36,9,45,0.00312,0.001385,0,9208,25,0.000049,12,0.199256,0.219732,19029.770864,0.094949,0.014034
9912135,9912135,,47,11,58,47,11,58,0.004073,0.002341,0,9207,25,0.000052,11,0.19871,0.219705,10342.061404,0.119177,0.017436
9912175,9912175,,8,26,34,8,26,34,0.000334,0.003392,0,9210,25,0.000017,11,0.205906,0.230643,5018.267668,0.106061,0.003073
9508177,9508177,,77,9,86,77,9,86,0.00823,0.003952,0,1431,13,0.000132,11,0.194421,0.232994,4600.373994,0.064706,0.037852
9512089,9512089,,52,22,74,52,22,74,0.005068,0.003293,0,1680,13,0.00012,10,0.227951,0.271938,68486.706723,0.090337,0.028415
9512177,9512177,,20,40,60,20,40,60,0.002413,0.005336,0,1824,13,0.000052,10,0.223447,0.276143,15838.704111,0.090395,0.011269
9601077,9601077,,47,12,59,47,12,59,0.005738,0.007071,0,1541,0,0.00019,10,0.213701,0.250163,11808.407679,0.102279,0.034312
9508042,9508042,,88,5,93,88,5,93,0.008162,0.001349,0,1438,13,0.000253,6,0.286275,0.32481,2982.724146,0.062763,0.045181
9510229,9510229,,65,14,79,65,14,79,0.009978,0.008078,0,1386,13,0.000626,12,0.199676,0.242125,29411.715406,0.111003,0.086252
9601177,9601177,,119,41,160,119,41,160,0.015155,0.004065,0,1812,13,0.000217,10,0.248642,0.303296,149868.673361,0.056289,0.069287
9602043,9602043,,339,30,369,339,30,369,0.046451,0.009971,0,1821,13,0.000827,9,0.248713,0.295449,482278.516864,0.033537,0.19561
9603060,9603060,,143,17,160,143,17,160,0.016729,0.005889,0,1829,13,0.000319,11,0.225588,0.263278,13059.864208,0.059788,0.079325
9603061,9603061,,137,41,178,137,41,178,0.016924,0.011745,0,1828,13,0.000312,10,0.253766,0.304604,148824.19259,0.064369,0.078654
9603126,9603126,,131,37,168,131,37,168,0.016703,0.013938,0,1843,13,0.000304,9,0.251926,0.29872,223162.815713,0.059559,0.091362
9603183,9603183,,9,11,20,9,11,20,0.000483,0.0049,0,1943,0,0.000029,10,0.207368,0.239619,2757.00548,0.144737,0.004458
9302058,9302058,,4,2,6,4,2,6,0.000183,0.000043,0,503,13,0.000028,1,1,1,164.082092,0,0.002919
9511053,9511053,,70,44,114,70,44,114,0.006584,0.012054,0,1679,13,0.000154,9,0.254703,0.311851,69138.535055,0.060006,0.03844
9603123,9603123,,61,15,76,61,15,76,0.007483,0.005643,0,1928,2,0.000154,10,0.2221,0.25821,7419.407501,0.08807,0.044641
9511045,9511045,,5,12,17,5,12,17,0.000488,0.002439,0,1935,5,0.000036,9,0.216383,0.253812,30805.438296,0.0625,0.005535
9604068,9604068,,14,29,43,14,29,43,0.001165,0.00967,0,2080,13,0.00004,10,0.224285,0.266296,9225.472637,0.136766,0.008756
9604168,9604168,,62,33,95,62,33,95,0.007263,0.008951,0,2104,13,0.000072,10,0.233698,0.284925,30662.936829,0.082979,0.028545
9604189,9604189,,80,26,106,80,26,106,0.01089,0.00859,0,2100,13,0.000142,10,0.225898,0.264718,12250.966718,0.08814,0.045025
9606118,9606118,,43,17,60,43,17,60,0.004587,0.004502,0,2510,2,0.000143,10,0.225058,0.26079,22319.761457,0.108192,0.034036
9609095,9609095,,34,15,49,34,15,49,0.004704,0.007608,0,2755,13,0.000065,11,0.214968,0.250737,24723.235995,0.130527,0.025808
9604119,9604119,,102,14,116,102,14,116,0.011969,0.004966,0,1929,2,0.000222,10,0.221416,0.253917,8909.565936,0.062519,0.065423
9605077,9605077,,43,23,66,43,23,66,0.006506,0.003703,0,2117,13,0.000063,10,0.232255,0.269015,51852.223132,0.113054,0.023221
9609181,9609181,,32,25,57,32,25,57,0.003866,0.007342,0,2825,13,0.000042,9,0.230694,0.265798,10309.952662,0.136591,0.014783
9612095,9612095,,54,31,85,54,31,85,0.006363,0.009567,0,2829,13,0.000065,11,0.220958,0.261891,37197.533253,0.093557,0.022662
9612204,9612204,,60,28,88,60,28,88,0.006925,0.010779,0,3360,13,0.000051,10,0.224391,0.259531,22274.77567,0.073798,0.022043
9612236,9612236,,30,33,63,30,33,63,0.003097,0.008148,0,3342,13,0.000028,11,0.224989,0.271954,28036.538526,0.15745,0.010402
9305143,9305143,,10,1,11,10,1,11,0.002001,0.000006,0,4628,13,0.000016,1,1,1,126.050715,0.109091,0.004285
9702163,9702163,,75,56,131,75,56,131,0.01045,0.013926,0,3389,13,0.000095,12,0.230513,0.279574,379432.280841,0.070464,0.032623
9702164,9702164,,27,23,50,27,23,50,0.003038,0.005279,0,3523,13,0.000025,12,0.210918,0.24492,8838.969032,0.157551,0.008236
9705011,9705011,,59,63,122,59,63,122,0.009276,0.014088,0,4704,13,0.000053,11,0.228782,0.27412,158991.287825,0.071806,0.022705
9705078,9705078,,33,67,100,33,67,100,0.004586,0.017323,0,4642,13,0.000054,14,0.215352,0.262618,108810.162835,0.104444,0.014262
9710046,9710046,,72,359,431,72,359,431,0.012823,0.047956,0,5183,13,0.000056,17,0.264253,0.363339,1192001.940304,0.034101,0.030557
9711043,9711043,,31,22,53,31,22,53,0.003712,0.005484,0,5241,2,0.000041,13,0.199319,0.230785,20393.958549,0.119013,0.012372
9711205,9711205,,69,16,85,69,16,85,0.006486,0.002293,0,5242,2,0.000081,16,0.182286,0.213771,56249.86859,0.057843,0.024391
9712004,9712004,,116,49,165,116,49,165,0.015991,0.014127,0,5252,2,0.000089,15,0.204664,0.247972,155585.82241,0.041537,0.039006
9712170,9712170,,4,30,34,4,30,34,0.000764,0.010175,0,5185,13,0.000011,11,0.226466,0.269479,3542.456993,0.179144,0.001336
9504049,9504049,,7,7,14,7,7,14,0.000135,0.000126,0,6022,23,0.000028,7,0.234917,0.28375,20796.648335,0.159341,0.002137
9511115,9511115,,14,16,30,14,16,30,0.001738,0.004154,0,1677,13,0.000025,12,0.204872,0.255007,32273.924282,0.151724,0.006723
9604052,9604052,,73,33,106,73,33,106,0.009864,0.006162,0,2012,13,0.000119,10,0.238851,0.286696,183046.197638,0.067475,0.035838
9606033,9606033,,85,42,127,85,42,127,0.01074,0.007638,0,2123,13,0.000137,10,0.238656,0.284158,121574.282154,0.081052,0.038588
9608095,9608095,,13,29,42,13,29,42,0.001478,0.009229,0,3339,13,0.000016,10,0.232214,0.278028,719.188781,0.184669,0.004203
9609225,9609225,,12,30,42,12,30,42,0.001352,0.009237,0,3340,13,0.000017,10,0.236964,0.280492,29595.957491,0.181765,0.00433
9611026,9611026,,18,32,50,18,32,50,0.001814,0.010854,0,3341,13,0.000022,11,0.220834,0.26597,15867.110585,0.177551,0.006927
9611047,9611047,,94,36,130,94,36,130,0.01178,0.010082,0,2826,13,0.000114,12,0.233364,0.278143,98878.376567,0.057305,0.040959
9611111,9611111,,13,15,28,13,15,28,0.001937,0.003037,0,3388,13,0.000017,11,0.207403,0.242116,57864.91323,0.150794,0.005882
9612054,9612054,,3,2,5,3,2,5,0.000614,0.000341,0,3515,13,0.000011,12,0.189709,0.214708,1.521574,0.35,0.000984
9612089,9612089,,22,33,55,22,33,55,0.002148,0.012366,0,3520,13,0.000023,10,0.237766,0.28034,33532.825577,0.150842,0.007042
9701088,9701088,,74,36,110,74,36,110,0.011834,0.008574,0,3334,13,0.000052,11,0.231992,0.272302,67916.667638,0.053962,0.025193
9701092,9701092,,12,29,41,12,29,41,0.001154,0.007804,0,3521,13,0.000018,10,0.231114,0.274974,44022.406045,0.201829,0.004977
9702058,9702058,,5,12,17,5,12,17,0.000955,0.000788,0,5177,13,0.000012,11,0.207822,0.237045,342.96368,0.172794,0.002229
9702077,9702077,,18,32,50,18,32,50,0.001708,0.007486,0,4702,13,0.000026,10,0.221518,0.264639,10192.035201,0.177959,0.005432
9702079,9702079,,20,34,54,20,34,54,0.001863,0.007278,0,3522,13,0.000024,10,0.225564,0.267942,13035.900469,0.173305,0.006288
9702202,9702202,,97,21,118,97,21,118,0.009048,0.003726,0,3390,13,0.000123,13,0.206405,0.239679,76529.246366,0.048674,0.04203
9704120,9704120,,50,22,72,50,22,72,0.006573,0.004123,0,3392,13,0.00005,13,0.213105,0.249262,53057.554049,0.081768,0.018279
9704190,9704190,,11,18,29,11,18,29,0.001817,0.009057,0,5184,2,0.000013,11,0.206519,0.242205,1153.732472,0.169951,0.003268
9705036,9705036,,24,33,57,24,33,57,0.001776,0.008604,0,6132,13,0.000023,13,0.221856,0.2609,14146.876679,0.145677,0.006243
9705040,9705040,,95,28,123,95,28,123,0.007436,0.004066,0,3535,2,0.000109,11,0.213077,0.248764,101828.624892,0.045382,0.033071
9706096,9706096,,15,44,59,15,44,59,0.001893,0.007584,0,4876,13,0.000018,15,0.219821,0.2647,119299.346331,0.080947,0.005006
9710110,9710110,,3,32,35,3,32,35,0.000163,0.003196,0,8251,13,0.000011,12,0.214786,0.253029,26314.493162,0.217647,0.000864
9710155,9710155,,14,17,31,14,17,31,0.002478,0.002391,0,8252,13,0.000015,17,0.21427,0.255773,20882.810906,0.132258,0.004394
9711102,9711102,,16,86,102,16,86,102,0.001596,0.023264,0,6013,4,0.000014,15,0.226393,0.282821,69090.501107,0.079111,0.00519
9712221,9712221,,11,23,34,11,23,34,0.001784,0.002847,0,5176,13,0.000016,13,0.196599,0.23092,27063.268214,0.114973,0.004157
9801060,9801060,,20,73,93,20,73,93,0.0015,0.007158,0,5036,4,0.00002,12,0.215425,0.257502,51142.389273,0.152992,0.007635
9802051,9802051,,87,206,293,87,206,293,0.013112,0.045708,0,6227,0,0.000086,10,0.261503,0.326751,1186994.385169,0.044158,0.030947
9802067,9802067,,164,214,378,164,214,378,0.022699,0.034603,0,5830,4,0.000105,12,0.259396,0.325439,2435569.926676,0.037093,0.064861
9605234,9605234,,113,25,138,113,25,138,0.020663,0.007911,0,2134,13,0.00026,9,0.232331,0.269953,24646.178286,0.090765,0.077016
9705053,9705053,,43,26,69,43,26,69,0.008543,0.009346,0,4513,2,0.00004,14,0.199719,0.237778,7382.316324,0.112106,0.019872
9712213,9712213,,22,33,55,22,33,55,0.007163,0.009192,0,5188,13,0.00002,11,0.208612,0.246943,18497.12789,0.171044,0.016061
9804177,9804177,,81,1,82,81,1,82,0.007543,0.000264,0,7047,1,0.000145,15,0.166245,0.182399,34332.735337,0.051039,0.023761
9805156,9805156,,87,41,128,87,41,128,0.020265,0.028181,0,6157,1,0.000109,12,0.207063,0.241866,69820.754079,0.064222,0.041994
9809027,9809027,,62,23,85,62,23,85,0.01006,0.021406,0,7162,1,0.000062,12,0.206442,0.238439,83420.866708,0.081513,0.02601
9809032,9809032,,29,29,58,29,29,58,0.007104,0.02505,0,7428,1,0.000029,12,0.202757,0.23407,32712.063306,0.128554,0.01733
9812073,9812073,,89,26,115,89,26,115,0.013181,0.010615,0,7181,1,0.00008,12,0.207851,0.238891,166538.525828,0.035317,0.038045
9808079,9808079,,52,14,66,52,14,66,0.007746,0.017669,0,7548,1,0.000094,13,0.190416,0.215706,59475.742621,0.065035,0.024295
9806069,9806069,,38,29,67,38,29,67,0.003245,0.006334,0,6691,2,0.000038,13,0.203375,0.238556,76477.466024,0.094301,0.0133
9605051,9605051,,32,33,65,32,33,65,0.005543,0.006751,0,2118,13,0.000059,10,0.225181,0.2731,9756.501243,0.130529,0.017917
9801165,9801165,,31,15,46,31,15,46,0.003416,0.007384,0,5915,13,0.000048,14,0.194621,0.224229,25290.884267,0.074396,0.012809
9910021,9910021,,35,13,48,35,13,48,0.004324,0.008071,0,9209,25,0.000045,12,0.205955,0.231132,26495.749209,0.125443,0.015256
1019,1019,,6,8,14,6,8,14,0.000002,0.000003,0,9295,5,0.000017,16,0.124559,0.140031,7029.164693,0.159341,0.001394
9605022,9605022,,34,5,39,34,5,39,0.000024,0.000002,0,5650,5,0.000126,3,0.475,0.570175,22937.129074,0.084345,0.009867
9703097,9703097,,9,2,11,9,2,11,0.000006,0.000001,0,9230,5,0.000044,3,0.555556,0.666667,150.80927,0.145455,0.002486
9707253,9707253,,27,6,33,27,6,33,0.000002,0.000004,0,9231,5,0.000099,4,0.388889,0.497024,11937.036846,0.106061,0.007302
9908101,9908101,,12,7,19,12,7,19,0.000002,0.000001,0,9234,5,0.00003,11,0.137215,0.167913,434.785715,0.172515,0.003004
9908149,9908149,,8,34,42,8,34,42,0.000203,0.000011,0,9294,5,0.000023,13,0.15704,0.182661,99786.341745,0.060395,0.002078
9909210,9909210,,6,6,12,6,6,12,0,0,0,9253,5,0.000019,15,0.11842,0.128587,38290.339612,0.166667,0.001511
9912176,9912176,,10,7,17,10,7,17,0.000001,0.000001,0,9254,5,0.000022,16,0.107723,0.117867,8157.826588,0.1875,0.002425
9912223,9912223,,5,13,18,5,13,18,0,0.000004,0,9261,5,0.000018,16,0.107958,0.119862,30117.06775,0.124183,0.001251
2049,2049,,2,11,13,2,11,13,0,0.000006,0,9296,5,0.000012,17,0.119692,0.136202,1519.589842,0.230769,0.000485
9510221,9510221,,12,1,13,12,1,13,0.000001,0.000007,0,9229,5,0.000084,1,1,1,100.080567,0.102564,0.003132
9710101,9710101,,14,7,21,14,7,21,0.000001,0.000002,0,9233,5,0.000038,10,0.155282,0.187802,5892.001691,0.166667,0.003698
9812059,9812059,,18,9,27,18,9,27,0.000016,0.000002,0,9245,5,0.000034,10,0.157982,0.196101,6506.950583,0.14245,0.004558
9901011,9901011,,27,13,40,27,13,40,0.000264,0.000002,0,9243,5,0.000061,12,0.123552,0.163737,28751.449263,0.076282,0.006733
9901086,9901086,,11,7,18,11,7,18,0.000001,0.000004,0,9246,5,0.000026,11,0.138746,0.171342,465.18327,0.215686,0.002779
9907192,9907192,,12,14,26,12,14,26,0.000001,0.000003,0,9258,5,0.000025,10,0.159922,0.205154,9442.157583,0.136923,0.002956
9311060,9311060,,5,0,5,5,0,5,0,0,0,5649,20,0.000071,0,0,0,0,0.2,0.001485
9406048,9406048,,31,0,31,31,0,31,0.000017,0,0,5648,5,0.000346,0,0,0,0,0.115054,0.008861
9503023,9503023,,64,1,65,64,1,65,0.000134,0,0,5633,5,0.000219,2,0.666667,0.75,10985.223954,0.043269,0.016783
9506042,9506042,,13,3,16,13,3,16,0.000009,0.000001,0,5625,5,0.000099,3,0.583333,0.690476,579.190009,0.1,0.003603
9508082,9508082,,12,6,18,12,6,18,0.000001,0.000002,0,5635,5,0.000088,2,0.615385,0.6875,6652.457976,0.153595,0.003771
9508086,9508086,,10,1,11,10,1,11,0.000053,0.000001,0,2712,5,0.00005,2,0.666667,0.75,6220.244754,0.054545,0.002542
9703187,9703187,,8,1,9,8,1,9,0.000117,0,0,9228,5,0.000047,2,0.666667,0.75,2159.571308,0.097222,0.002051
9608070,9608070,,25,0,25,25,0,25,0.000002,0,0,9223,5,0.000139,0,0,0,0,0.083333,0.00659
9707122,9707122,,26,5,31,26,5,31,0.000018,0,0,9219,5,0.000094,5,0.310345,0.431481,15834.464113,0.127957,0.00736
9806193,9806193,,11,2,13,11,2,13,0.000002,0,0,9232,5,0.000036,5,0.29,0.352874,8.47809,0.211538,0.002993
9810062,9810062,,23,5,28,23,5,28,0.000019,0.000001,0,9220,5,0.00006,6,0.256881,0.38631,6353.596671,0.145503,0.006254
9811015,9811015,,43,7,50,43,7,50,0.00002,0.000002,0,9226,5,0.000088,4,0.43617,0.510163,41392.363819,0.069388,0.010657
9412055,9412055,,4,1,5,4,1,5,0.000026,0,0,9227,5,0.000056,1,1,1,232.483847,0.05,0.000989
9506061,9506061,,3,6,9,3,6,9,0,0.000032,0,7341,5,0.000015,2,0.875,0.928571,687.529322,0.083333,0.000747
9608071,9608071,,45,9,54,45,9,54,0.000098,0.000003,0,5651,5,0.000113,3,0.595238,0.673333,12983.662108,0.058001,0.011436
9609195,9609195,,12,2,14,12,2,14,0,0,0,9214,5,0.000096,2,0.75,0.833333,3254.286365,0.269231,0.003679
9701022,9701022,,2,2,4,2,2,4,0,0.000001,0,9293,6,0.000013,6,0.239617,0.282889,7716.544349,0,0.000501
9702007,9702007,,16,3,19,16,3,19,0.000015,0,0,9215,5,0.000078,2,0.8,0.875,3834.198079,0.195906,0.004478
9703089,9703089,,4,1,5,4,1,5,0.000117,0.000002,0,9289,5,0.000015,6,0.279412,0.335088,2465.67698,0.15,0.000953
9705101,9705101,,2,0,2,2,0,2,0,0,0,9288,26,0.000016,0,0,0,0,0,0.000515
9707073,9707073,,16,4,20,16,4,20,0.000001,0,0,9216,5,0.000077,2,0.833333,0.9,4070.026016,0.165789,0.004311
9707083,9707083,,27,14,41,27,14,41,0.000003,0.000006,0,5652,5,0.000061,9,0.178218,0.218725,203887.153548,0.072561,0.006744
9707168,9707168,,5,3,8,5,3,8,0,0.000001,0,9240,5,0.000039,4,0.382353,0.435897,4301.97241,0.089286,0.001222
9711159,9711159,,3,5,8,3,5,8,0.000001,0.000022,0,9287,5,0.000012,12,0.172395,0.18923,34669.852888,0.160714,0.000727
9801129,9801129,,8,4,12,8,4,12,0.000001,0.000003,0,9241,5,0.000051,5,0.348148,0.411348,4587.004516,0.113636,0.00209
9802149,9802149,,4,0,4,4,0,4,0,0,0,9280,5,0.000025,0,0,0,0,0.333333,0.000967
9807121,9807121,,6,1,7,6,1,7,0.000002,0,0,9279,5,0.000022,6,0.262295,0.294444,14.068838,0.238095,0.001418
9811054,9811054,,2,6,8,2,6,8,0,0.000001,0,9244,5,0.000014,5,0.322222,0.453448,63.787345,0.267857,0.00062
9811174,9811174,,2,5,7,2,5,7,0,0.000001,0,9235,5,0.000015,6,0.261261,0.39023,6.645435,0.47619,0.000681
9811219,9811219,,2,2,4,2,2,4,0.000058,0.000001,0,9278,5,0.000012,5,0.295918,0.361494,69.370947,0.25,0.000508
9812060,9812060,,16,8,24,16,8,24,0.000015,0.000001,0,9277,5,0.000035,10,0.169371,0.208278,34425.440293,0.101449,0.003882
9905204,9905204,,5,4,9,5,4,9,0.000064,0.000001,0,9264,5,0.000014,10,0.155247,0.183225,32208.995883,0.166667,0.001425
9906228,9906228,,12,16,28,12,16,28,0.00002,0.000006,0,9262,5,0.000024,10,0.156994,0.202669,4968.954527,0.132275,0.002928
9607186,9607186,,7,1,8,7,1,8,0,0,0,9212,5,0.000101,1,1,1,5.444444,0.160714,0.001973
9810065,9810065,,6,4,10,6,4,10,0,0.000001,0,9252,23,0.000024,14,0.130774,0.140355,64289.679022,0.144444,0.001471
9601019,9601019,,3,1,4,3,1,4,0.000001,0,0,9260,5,0.000014,2,0.666667,0.75,1,0.166667,0.000699
9711168,9711168,,17,5,22,17,5,22,0.000002,0.000001,0,9242,5,0.000038,11,0.135402,0.160621,4339.770245,0.114719,0.004416
9809199,9809199,,16,5,21,16,5,21,0.000033,0.000001,0,9236,5,0.000039,4,0.372549,0.449561,15313.805613,0.133333,0.004478
9906043,9906043,,1,0,1,1,0,1,0,0,0,9259,5,0.000011,0,0,0,0,0,0.000254
9910097,9910097,,2,6,8,2,6,8,0,0.000001,0,9255,5,0.000012,11,0.137694,0.167451,20.369689,0.25,0.000492
1020,1020,,0,1,1,0,1,1,0,0.000014,0,9297,8,0.00001,1,1,1,0,0,0
9805177,9805177,,12,0,12,12,0,12,0.001181,0,0,7413,8,0.000028,0,0,0,0,0.022727,0.00335
1021,1021,,2,15,17,2,15,17,0.00001,0.002243,0,9322,13,0.000012,14,0.164806,0.199981,11138.738973,0.128676,0.000478
9406206,9406206,,82,11,93,82,11,93,0.003034,0.000253,0,512,13,0.000148,6,0.321962,0.387748,25548.504871,0.076905,0.028174
9505186,9505186,,78,5,83,78,5,83,0.003863,0.002694,0,917,4,0.000168,6,0.306854,0.35643,9062.795355,0.041287,0.028003
9604136,9604136,,22,3,25,22,3,25,0.000934,0.000034,0,3269,13,0.000045,10,0.172547,0.204841,2404.272365,0.151667,0.006522
9606187,9606187,,22,4,26,22,4,26,0.000972,0.000131,0,3270,13,0.00003,10,0.18306,0.229204,3189.458997,0.158462,0.006194
9609198,9609198,,5,10,15,5,10,15,0.000055,0.000241,0,5844,13,0.000013,9,0.206561,0.258258,43.468808,0.252381,0.00124
9701178,9701178,,3,17,20,3,17,20,0.000048,0.00078,0,9321,13,0.000012,9,0.238529,0.293959,860.44169,0.139474,0.000697
9704157,9704157,,18,7,25,18,7,25,0.000686,0.000701,0,5737,13,0.000033,10,0.182932,0.238688,1748.828061,0.173333,0.004861
9705105,9705105,,13,2,15,13,2,15,0.000659,0.000019,0,5738,13,0.00002,11,0.155027,0.185567,0.25,0.257143,0.003477
9705193,9705193,,28,21,49,28,21,49,0.001304,0.002536,0,5739,13,0.000031,12,0.201407,0.248842,45021.160945,0.074405,0.008206
9801102,9801102,,2,14,16,2,14,16,0.000051,0.001077,0,9315,4,0.000012,12,0.19817,0.232023,5831.133095,0.1375,0.000478
9806068,9806068,,15,21,36,15,21,36,0.000569,0.000259,0,8147,13,0.000017,16,0.15446,0.184841,11672.92496,0.183333,0.003543
9906007,9906007,,3,3,6,3,3,6,0.000029,0.000002,0,9312,13,0.000013,13,0.152778,0.189861,2986.561494,0.1,0.000684
9912105,9912105,,2,10,12,2,10,12,0.000034,0.000084,0,9299,13,0.000011,17,0.140593,0.166348,17.808333,0.318182,0.000465
9303016,9303016,,63,3,66,63,3,66,0.001546,0.000014,0,237,13,0.000163,1,1,1,2146.155344,0.039394,0.023385
9308112,9308112,,48,3,51,48,3,51,0.001061,0.000103,0,272,13,0.000164,1,1,1,270.157286,0.134902,0.017837
9308154,9308154,,69,3,72,69,3,72,0.002064,0.000057,0,273,13,0.000144,2,0.714286,0.8,690.684662,0.116002,0.023491
9309039,9309039,,87,2,89,87,2,89,0.005241,0.000139,0,271,13,0.000189,4,0.315789,0.35,3094.406861,0.055797,0.035794
9401147,9401147,,3,6,9,3,6,9,0.000026,0.000384,0,511,13,0.000026,3,0.5,0.566667,1980.890768,0.069444,0.001698
9403155,9403155,,79,3,82,79,3,82,0.002666,0.000052,0,261,13,0.000176,3,0.439252,0.475177,12451.332698,0.074676,0.025959
9403191,9403191,,28,12,40,28,12,40,0.001496,0.000661,0,256,41,0.000076,5,0.379032,0.443499,18204.716632,0.182692,0.012963
9406082,9406082,,23,11,34,23,11,34,0.001498,0.000233,0,509,13,0.000057,6,0.31828,0.390541,26464.48644,0.192513,0.008884
9411102,9411102,,121,6,127,121,6,127,0.004975,0.002463,0,639,4,0.00034,6,0.271984,0.322306,7144.139296,0.042307,0.037319
9504108,9504108,,35,4,39,35,4,39,0.003049,0.000301,0,902,2,0.000541,5,0.272109,0.320417,5704.276894,0.082996,0.029271
9204024,9204024,,14,0,14,14,0,14,0.000096,0,0,71,13,0.000214,0,0,0,0,0.142857,0.0048
9601091,9601091,,24,7,31,24,7,31,0.000933,0.000208,0,2816,13,0.000051,9,0.205128,0.25207,6234.949795,0.168817,0.00707
9410237,9410237,,91,18,109,91,18,109,0.006604,0.001184,0,853,13,0.00028,6,0.392019,0.464671,161870.33625,0.053857,0.037388
9401006,9401006,,65,5,70,65,5,70,0.002028,0.000001,0,851,13,0.000165,1,1,1,63997.614111,0.073706,0.02116
9407044,9407044,,11,4,15,11,4,15,0.000109,0.000025,0,2220,13,0.000059,2,0.666667,0.75,20570.371,0.104762,0.003924
9503045,9503045,,38,15,53,38,15,53,0.000539,0.000834,0,2225,13,0.000055,8,0.240651,0.304034,17729.045167,0.179245,0.011785
9308124,9308124,,64,9,73,64,9,73,0.003145,0.000123,0,496,13,0.000139,3,0.684211,0.820513,12102.402355,0.022831,0.021236
9311117,9311117,,2,0,2,2,0,2,0.000009,0,0,9320,41,0.000017,0,0,0,0,0,0.000492
9408060,9408060,,14,8,22,14,8,22,0.000427,0.000523,0,581,13,0.00013,5,0.342029,0.415537,42257.366843,0.140693,0.008047
9410104,9410104,,59,9,68,59,9,68,0.002984,0.000342,0,499,13,0.000141,6,0.298246,0.389076,65907.337111,0.045215,0.024989
9502065,9502065,,41,22,63,41,22,63,0.002204,0.001377,0,1133,13,0.000091,6,0.302416,0.369631,51127.90193,0.075781,0.015953
9504070,9504070,,7,8,15,7,8,15,0.00004,0.000066,0,9319,28,0.000016,8,0.212903,0.270109,4781.723688,0.180952,0.001619
9504148,9504148,,35,20,55,35,20,55,0.001313,0.001198,0,1241,13,0.000058,8,0.254015,0.312988,84222.567553,0.088552,0.011986
9507112,9507112,,35,14,49,35,14,49,0.002496,0.000699,0,1390,13,0.000052,9,0.235853,0.294561,49662.09407,0.079082,0.011693
9510028,9510028,,12,12,24,12,12,24,0.001016,0.00075,0,1823,13,0.000023,9,0.242619,0.29527,6606.619642,0.137681,0.004542
9510034,9510034,,14,20,34,14,20,34,0.000823,0.000822,0,1392,13,0.000022,9,0.230287,0.293346,17975.538327,0.142602,0.004268
9610032,9610032,,1,12,13,1,12,13,0.000009,0.000573,0,9316,3,0.00001,7,0.324561,0.386755,301.442511,0.160256,0.000239
9311012,9311012,,24,14,38,24,14,38,0.0007,0.000328,0,252,41,0.000054,4,0.447236,0.514045,8245.753432,0.121622,0.01213
9401025,9401025,,42,3,45,42,3,45,0.001996,0.000061,0,277,13,0.000198,1,1,1,1114.67219,0.090404,0.021654
9402016,9402016,,46,17,63,46,17,63,0.001154,0.000374,0,572,13,0.000129,2,0.688889,0.774194,24518.151492,0.048387,0.015881
9406067,9406067,,47,28,75,47,28,75,0.002775,0.000724,0,284,13,0.00015,5,0.424242,0.499451,164419.741351,0.063243,0.027952
9409060,9409060,,17,13,30,17,13,30,0.000572,0.00048,0,516,13,0.000096,5,0.332795,0.383819,5230.430402,0.137931,0.012176
9507022,9507022,,77,16,93,77,16,93,0.007918,0.002948,0,1139,13,0.000173,9,0.239951,0.284779,12789.794737,0.066386,0.037163
9610131,9610131,,21,2,23,21,2,23,0.000512,0.000015,0,4539,0,0.000032,3,0.426667,0.463542,903.501934,0.134387,0.007539
9611039,9611039,,58,14,72,58,14,72,0.001745,0.000226,0,4542,0,0.000071,12,0.170973,0.203281,16163.861224,0.148279,0.019929
9410162,9410162,,11,8,19,11,8,19,0.000064,0.000007,0,2574,23,0.000027,5,0.432,0.50679,6035.24694,0.108187,0.003122
9412228,9412228,,110,53,163,110,53,163,0.000491,0.000331,0,2600,23,0.000245,6,0.483696,0.598221,562545.314286,0.015868,0.028302
9508153,9508153,,18,3,21,18,3,21,0.000169,0.001917,0,2908,4,0.000068,6,0.265306,0.303718,441.022774,0.128571,0.00455
9606109,9606109,,14,11,25,14,11,25,0.000204,0.002013,0,7219,4,0.000027,12,0.190575,0.218503,24164.274152,0.063333,0.003408
9612196,9612196,,13,1,14,13,1,14,0.000089,0.000002,0,7186,4,0.000033,7,0.21095,0.232007,0,0.175824,0.003141
9703081,9703081,,9,7,16,9,7,16,0.000067,0.000013,0,7187,4,0.000021,12,0.189537,0.217203,21495.213378,0.145833,0.00227
9706218,9706218,,7,7,14,7,7,14,0.000049,0.00005,0,6956,28,0.000018,11,0.165755,0.181773,9920.36736,0.131868,0.001735
9710166,9710166,,6,7,13,6,7,13,0.000052,0.00004,0,9313,4,0.000016,13,0.185386,0.212341,2811.991652,0.217949,0.001443
9712137,9712137,,4,8,12,4,8,12,0.000014,0.001085,0,9314,4,0.000014,13,0.183591,0.207185,1049.769967,0.212121,0.000924
9208026,9208026,,32,0,32,32,0,32,0.000475,0,0,3000,17,0.000097,0,0,0,0,0.069556,0.008736
9502122,9502122,,66,19,85,66,19,85,0.001379,0.000441,0,2224,13,0.000098,7,0.276371,0.342197,38814.774846,0.114986,0.019115
9503226,9503226,,25,12,37,25,12,37,0.001221,0.000713,0,2228,13,0.000035,9,0.209181,0.271475,2569.547655,0.228979,0.0084
9506132,9506132,,4,1,5,4,1,5,0.000031,0.000031,0,2811,13,0.000013,4,0.309677,0.329861,9.26632,0.25,0.001141
9509095,9509095,,33,19,52,33,19,52,0.000335,0.000781,0,2229,13,0.000043,8,0.252052,0.320169,6702.945238,0.159879,0.009646
9509123,9509123,,29,26,55,29,26,55,0.000979,0.000835,0,2262,13,0.000037,8,0.259349,0.325916,99144.154841,0.164983,0.00872
9512025,9512025,,26,10,36,26,10,36,0.000271,0.000141,0,3282,13,0.000032,8,0.225453,0.261718,3380.29852,0.220635,0.007816
9512040,9512040,,34,25,59,34,25,59,0.000402,0.000904,0,3286,13,0.000037,13,0.191628,0.253256,19788.260059,0.194623,0.009575
9602179,9602179,,15,35,50,15,35,50,0.000526,0.000541,0,3287,13,0.000024,14,0.195522,0.269131,72123.890153,0.138776,0.004495
9704137,9704137,,10,27,37,10,27,37,0.000102,0.000834,0,5845,13,0.000015,14,0.169734,0.226301,23901.659072,0.204955,0.002654
9803019,9803019,,16,21,37,16,21,37,0.000425,0.00026,0,5847,13,0.000026,15,0.167281,0.197214,218227.489445,0.174925,0.004632
9307101,9307101,,5,3,8,5,3,8,0.000006,0.000011,0,313,13,0.000038,1,1,1,21876.00789,0.053571,0.001638
9508141,9508141,,3,6,9,3,6,9,0.000001,0.000065,0,9311,6,0.000017,4,0.446809,0.563492,187.921348,0.083333,0.000704
9805185,9805185,,27,38,65,27,38,65,0.000146,0.000012,0,9309,6,0.000047,12,0.178149,0.247313,44548.081949,0.060817,0.006563
9708110,9708110,,6,8,14,6,8,14,0.000507,0.000072,0,9298,13,0.000014,13,0.168972,0.197584,129.35831,0.296703,0.001368
1022,1022,,1,3,4,1,3,4,0.00018,0.000021,0,9327,22,0.00001,14,0.131665,0.142351,51.362745,0.333333,0.000219
9311055,9311055,,40,2,42,40,2,42,0.001118,0.00013,0,3691,4,0.000142,1,1,1,12641.302494,0.058072,0.012054
9802096,9802096,,9,3,12,9,3,12,0.000232,0.000014,0,7233,22,0.000039,6,0.344086,0.423437,15028.46385,0.083333,0.002066
9902115,9902115,,40,17,57,40,17,57,0.000475,0.000018,0,9326,23,0.00006,13,0.151019,0.167842,151418.585359,0.027569,0.010283
9202038,9202038,,1,0,1,1,0,1,0.000002,0,0,3690,4,0.000074,0,0,0,0,0,0.000523
9508049,9508049,,3,3,6,3,3,6,0,0.000001,0,7232,21,0.000024,2,0.666667,0.75,7437.151758,0.3,0.000717
9702118,9702118,,6,7,13,6,7,13,0.000054,0.000015,0,7230,22,0.000035,5,0.436364,0.570833,13617.35756,0.038462,0.001422
9211035,9211035,,23,0,23,23,0,23,0.000046,0,0,1771,22,0.000085,0,0,0,0,0.043478,0.006261
9306027,9306027,,19,1,20,19,1,20,0.000004,0.000001,0,4141,22,0.000089,1,1,1,118.137239,0.126316,0.005185
9403056,9403056,,17,0,17,17,0,17,0.00002,0,0,1769,22,0.000081,0,0,0,0,0.055147,0.004374
9403116,9403116,,12,1,13,12,1,13,0.000053,0.000001,0,4136,22,0.00003,1,1,1,44.335738,0.096154,0.003662
9406034,9406034,,18,4,22,18,4,22,0.000092,0.000001,0,4135,22,0.000054,2,0.833333,0.9,11230.842947,0.106061,0.005119
9408091,9408091,,13,2,15,13,2,15,0.000003,0,0,4143,22,0.00004,2,0.625,0.7,1105.5838,0.204762,0.003652
9411062,9411062,,13,5,18,13,5,18,0.000003,0.000001,0,4145,22,0.000038,2,0.727273,0.8125,20124.57793,0.176471,0.003695
9612194,9612194,,50,5,55,50,5,55,0.000063,0.000001,0,6743,23,0.000158,6,0.256757,0.344298,32427.134158,0.106061,0.013723
9701027,9701027,,11,2,13,11,2,13,0.000001,0,0,9324,22,0.000041,2,0.75,0.833333,5338.377124,0.089744,0.002789
9705052,9705052,,46,4,50,46,4,50,0.000041,0.000002,0,6744,23,0.000111,6,0.277174,0.346405,5077.438761,0.117551,0.012177
9705124,9705124,,38,4,42,38,4,42,0.00004,0.000002,0,6745,23,0.00008,6,0.263959,0.325962,1343.291012,0.146341,0.010092
9706102,9706102,,4,7,11,4,7,11,0.00002,0.000003,0,9325,22,0.000016,5,0.434783,0.589167,4689.804958,0.081818,0.001254
9709035,9709035,,23,3,26,23,3,26,0.000004,0.000002,0,9177,23,0.000055,6,0.254902,0.318376,949.897438,0.153846,0.006225
9712066,9712066,,34,11,45,34,11,45,0.000024,0.000104,0,9179,23,0.000083,12,0.175667,0.196243,328764.915347,0.106566,0.008726
9712144,9712144,,21,12,33,21,12,33,0.000033,0.000008,0,9248,23,0.000046,13,0.150193,0.164664,59622.124389,0.175189,0.005401
9807017,9807017,,3,2,5,3,2,5,0,0.000272,0,9323,22,0.000018,4,0.347826,0.399306,4767.438719,0,0.000944
1023,1023,,9,6,15,9,6,15,0.000467,0.000015,0,9383,15,0.000018,14,0.171515,0.184824,26382.987314,0.114286,0.002429
9512044,9512044,,1,2,3,1,2,3,0,0.000808,0,9382,17,0.000013,5,0.307018,0.355714,155.551954,0,0.000284
9612084,9612084,,32,14,46,32,14,46,0.000892,0.000035,0,6203,15,0.000077,16,0.181391,0.209143,162784.766162,0.063768,0.010902
9706031,9706031,,13,8,21,13,8,21,0.000189,0.000116,0,6187,15,0.000031,14,0.178153,0.199055,36174.891007,0.052381,0.003363
9908073,9908073,,2,6,8,2,6,8,0.000003,0.000028,0,9381,15,0.000014,17,0.154591,0.172824,453.941553,0.178571,0.000537
9910131,9910131,,3,10,13,3,10,13,0,0.000035,0,9380,15,0.000024,14,0.168265,0.185818,28144.117429,0.057692,0.000806
9912113,9912113,,10,16,26,10,16,26,0.000215,0.000107,0,9376,15,0.000033,13,0.2024,0.22225,47270.84314,0.090769,0.002492
9501049,9501049,,25,3,28,25,3,28,0.000055,0.000009,0,7031,17,0.000066,2,0.6,0.666667,1688.624549,0.088624,0.006342
9306009,9306009,,25,0,25,25,0,25,0.000097,0,0,6198,15,0.000105,0,0,0,0,0.073333,0.006204
9309034,9309034,,26,3,29,26,3,29,0.000069,0.000102,0,1004,15,0.000114,4,0.308411,0.373737,7298.03335,0.1133,0.007092
9311147,9311147,,39,1,40,39,1,40,0.000219,0,0,3802,15,0.000156,1,1,1,10938.092728,0.073077,0.010805
9405067,9405067,,13,5,18,13,5,18,0.000036,0.000007,0,3803,15,0.000077,5,0.293413,0.387755,29868.103038,0.22549,0.003947
9412167,9412167,,39,3,42,39,3,42,0.000571,0.000004,0,3804,15,0.000099,5,0.274725,0.335,40391.376741,0.08072,0.011215
9510144,9510144,,11,6,17,11,6,17,0.000041,0.000012,0,5492,15,0.000039,5,0.292818,0.38522,5220.891702,0.242647,0.003143
9602085,9602085,,16,9,25,16,9,25,0.000078,0.000015,0,5494,15,0.00006,5,0.3125,0.433333,65632.963762,0.15,0.004605
9602119,9602119,,10,7,17,10,7,17,0.000079,0.000017,0,5495,15,0.00005,14,0.150837,0.172683,39013.160657,0.235294,0.003266
9603115,9603115,,5,7,12,5,7,12,0.000001,0.000013,0,6201,15,0.000024,15,0.131926,0.149614,100.514272,0.356061,0.001506
9604045,9604045,,17,9,26,17,9,26,0.000313,0.000018,0,6202,15,0.00003,14,0.15104,0.173993,1079.375341,0.129231,0.004294
9609139,9609139,,2,6,8,2,6,8,0.000005,0.000004,0,6200,20,0.000016,2,0.875,0.928571,14113.136168,0.232143,0.000696
9610153,9610153,,3,3,6,3,3,6,0.000001,0.000002,0,6199,15,0.000018,1,1,1,18768.268576,0.066667,0.00095
9610230,9610230,,3,6,9,3,6,9,0.000045,0.000008,0,6195,15,0.000017,5,0.285714,0.387681,32681.214768,0.083333,0.00096
9611040,9611040,,20,26,46,20,26,46,0.00146,0.003298,0,5160,9,0.00003,15,0.21767,0.261321,148052.210446,0.122222,0.006766
9207103,9207103,,42,0,42,42,0,42,0.001428,0,0,420,9,0.000111,0,0,0,0,0.098142,0.012494
9301067,9301067,,25,3,28,25,3,28,0.000467,0.000041,0,999,15,0.000128,3,0.380282,0.432099,3718.367085,0.042328,0.006501
9305116,9305116,,17,3,20,17,3,20,0.001034,0.000027,0,2745,9,0.000034,1,1,1,934.758103,0.2,0.005714
9312153,9312153,,40,1,41,40,1,41,0.000198,0.000004,0,6186,15,0.000095,1,1,1,597.127813,0.080488,0.010751
9405107,9405107,,55,2,57,55,2,57,0.000245,0,0,6185,15,0.000146,1,1,1,15909.999546,0.04386,0.013899
9412059,9412059,,16,2,18,16,2,18,0.00012,0.000004,0,5440,15,0.000054,2,0.75,0.833333,23052.671065,0.042484,0.00453
9305163,9305163,,18,4,22,18,4,22,0.000039,0.00001,0,1003,15,0.000072,4,0.303922,0.38172,20996.293143,0.071429,0.004587
9202074,9202074,,21,0,21,21,0,21,0.000114,0,0,2517,15,0.000127,0,0,0,0,0.061905,0.005074
9205090,9205090,,19,0,19,19,0,19,0.000077,0,0,761,15,0.000085,0,0,0,0,0.049708,0.004624
9301062,9301062,,7,0,7,7,0,7,0.000021,0,0,5468,15,0.000036,0,0,0,0,0.071429,0.001678
9304164,9304164,,5,2,7,5,2,7,0.000028,0.000013,0,764,15,0.000036,2,0.75,0.833333,12615.129532,0.142857,0.001262
9409167,9409167,,5,2,7,5,2,7,0.000004,0,0,9363,15,0.000022,3,0.533333,0.604167,12254.370163,0.071429,0.00126
9505027,9505027,,23,4,27,23,4,27,0.000033,0.000014,0,6024,23,0.000064,8,0.185956,0.224276,18259.040379,0.082621,0.006211
9801022,9801022,,8,21,29,8,21,29,0.000837,0.005881,0,6902,41,0.000015,16,0.17328,0.199693,41503.650737,0.110837,0.002129
9804185,9804185,,9,1,10,9,1,10,0.00061,0,0,9367,15,0.000024,3,0.5,0.583333,1067.725699,0.077778,0.002302
9808192,9808192,,5,44,49,5,44,49,0.00079,0.026858,0,9368,41,0.000016,13,0.201823,0.233601,60171.463404,0.047619,0.001396
9907154,9907154,,9,8,17,9,8,17,0.000475,0.000032,0,9379,15,0.000021,14,0.168564,0.186093,14861.13342,0.099265,0.002178
9301019,9301019,,19,1,20,19,1,20,0.000717,0,0,6189,15,0.00005,1,1,1,1575.578018,0.089474,0.004842
9305020,9305020,,18,3,21,18,3,21,0.000456,0.000084,0,2251,15,0.000092,1,1,1,26847.697053,0.045238,0.004594
9505128,9505128,,13,0,13,13,0,13,0.000466,0,0,6204,15,0.000039,0,0,0,0,0.128205,0.003325
9602016,9602016,,30,3,33,30,3,33,0.001163,0.000009,0,5560,15,0.000063,1,1,1,20576.951192,0.072917,0.007613
9603117,9603117,,14,6,20,14,6,20,0.000586,0.000609,0,6992,15,0.00003,6,0.28535,0.32567,11043.69289,0.105263,0.003468
9702027,9702027,,19,6,25,19,6,25,0.000047,0.000014,0,9375,23,0.000059,5,0.353293,0.423729,5535.823235,0.055,0.004901
9707023,9707023,,3,9,12,3,9,12,0.000086,0.006638,0,9353,0,0.000015,11,0.216039,0.246074,5401.674654,0.174242,0.000776
9809102,9809102,,10,35,45,10,35,45,0.00007,0.010632,0,9371,15,0.000025,12,0.223219,0.254542,57268.38859,0.033333,0.002504
9809182,9809182,,7,6,13,7,6,13,0.000222,0.000056,0,9374,15,0.000018,13,0.20395,0.229868,19633.050588,0.089744,0.001718
9812189,9812189,,3,5,8,3,5,8,0.000008,0.000023,0,9372,15,0.000013,13,0.186008,0.203402,9722.085739,0.214286,0.000828
9906248,9906248,,29,13,42,29,13,42,0.00224,0.001878,0,9330,2,0.000036,15,0.201067,0.223675,47996.085008,0.091754,0.008306
9908115,9908115,,9,19,28,9,19,28,0.000961,0.000531,0,9373,15,0.000017,15,0.196473,0.219707,83111.646907,0.068783,0.002614
9908157,9908157,,7,4,11,7,4,11,0.00007,0.000156,0,9343,15,0.000029,12,0.192727,0.210443,59023.05988,0.072727,0.001696
9909022,9909022,,13,26,39,13,26,39,0.001202,0.011884,0,9331,2,0.00002,13,0.210141,0.235058,36497.707919,0.101889,0.004217
9911080,9911080,,14,28,42,14,28,42,0.000849,0.013828,0,9328,13,0.000021,13,0.210163,0.245721,29216.981311,0.103368,0.003876
1024,1024,,27,20,47,27,20,47,0.001198,0.000729,0,9444,2,0.000025,12,0.194159,0.218012,52375.234088,0.080018,0.007251
9301050,9301050,,7,0,7,7,0,7,0.000878,0,0,9443,1,0.000032,0,0,0,0,0.142857,0.001989
9512153,9512153,,38,13,51,38,13,51,0.00312,0.001413,0,1826,13,0.000075,10,0.211251,0.249394,7470.62858,0.113725,0.017975
9606139,9606139,,223,26,249,223,26,249,0.019111,0.009836,0,2757,0,0.000209,10,0.223713,0.262526,73593.906109,0.041667,0.103254
9704057,9704057,,24,12,36,24,12,36,0.000845,0.000983,0,4684,0,0.000032,14,0.200361,0.227914,29422.091535,0.180952,0.007124
9710129,9710129,,47,11,58,47,11,58,0.002383,0.001141,0,4980,13,0.000045,13,0.181954,0.209692,20655.701726,0.065336,0.014262
9811022,9811022,,33,19,52,33,19,52,0.001719,0.001825,0,8861,2,0.000031,14,0.194533,0.225039,20022.050566,0.106712,0.009178
9812074,9812074,,7,21,28,7,21,28,0.00022,0.001873,0,8862,2,0.000014,14,0.194571,0.225285,2407.641911,0.150794,0.002245
9904109,9904109,,32,22,54,32,22,54,0.002185,0.001505,0,8869,2,0.000032,12,0.193706,0.223143,90163.25102,0.089797,0.009187
9905196,9905196,,60,1,61,60,1,61,0.002818,0.000015,0,9405,25,0.000078,17,0.149425,0.164295,23287.578726,0.092623,0.01845
9905217,9905217,,48,10,58,48,10,58,0.001799,0.000492,0,9425,25,0.000064,15,0.181938,0.209284,60470.286925,0.111615,0.014651
9907066,9907066,,32,3,35,32,3,35,0.00152,0.000123,0,9433,25,0.000037,16,0.158416,0.177309,2393.199242,0.177311,0.009305
9909007,9909007,,4,13,17,4,13,17,0.000111,0.001351,0,9442,0,0.000012,14,0.196229,0.227081,8392.495583,0.150735,0.001131
9909015,9909015,,43,26,69,43,26,69,0.001597,0.002492,0,9426,25,0.00005,12,0.211233,0.240884,193708.443319,0.076726,0.012317
9909098,9909098,,25,20,45,25,20,45,0.000673,0.002761,0,9439,13,0.000025,15,0.193429,0.22497,39208.958775,0.072727,0.007288
9910095,9910095,,24,18,42,24,18,42,0.000626,0.00247,0,9435,25,0.000028,13,0.182182,0.203564,44945.091367,0.1777,0.007145
9912081,9912081,,28,13,41,28,13,41,0.001194,0.000369,0,9438,25,0.000029,12,0.182463,0.202349,19459.679745,0.186585,0.007633
9912226,9912226,,9,8,17,9,8,17,0.000294,0.00038,0,9398,2,0.00002,15,0.168915,0.187332,5915.539692,0.143382,0.002638
9212029,9212029,,16,1,17,16,1,17,0.000599,0.000005,0,280,13,0.000152,1,1,1,360.277796,0.113971,0.012048
9301035,9301035,,9,3,12,9,3,12,0.000378,0.000085,0,296,13,0.000116,1,1,1,60.248066,0.189394,0.008451
9506106,9506106,,65,30,95,65,30,95,0.006384,0.001528,0,1125,13,0.000205,8,0.278579,0.33622,145077.076523,0.072228,0.038577
9507160,9507160,,73,27,100,73,27,100,0.00829,0.005899,0,1140,13,0.000171,9,0.238392,0.28941,23259.100834,0.074444,0.042035
9508058,9508058,,41,35,76,41,35,76,0.00461,0.006831,0,1141,13,0.000125,9,0.236873,0.301581,97534.002607,0.091579,0.029413
9511162,9511162,,39,15,54,39,15,54,0.005327,0.004727,0,1439,13,0.000085,11,0.212101,0.25238,7000.609199,0.065688,0.020083
9512012,9512012,,90,13,103,90,13,103,0.009161,0.002378,0,1632,13,0.000179,11,0.211962,0.254704,19397.927068,0.062345,0.045784
9307050,9307050,,13,2,15,13,2,15,0.001291,0.000023,0,361,0,0.000078,1,1,1,383.121614,0.119048,0.011635
9605049,9605049,,99,9,108,99,9,108,0.008556,0.004278,0,2309,0,0.00014,10,0.212844,0.242648,4740.032674,0.130149,0.052981
9607007,9607007,,21,9,30,21,9,30,0.000218,0.001065,0,3989,26,0.000121,8,0.233581,0.273323,127031.389228,0.078161,0.008602
9205115,9205115,,19,0,19,19,0,19,0.000313,0,0,1763,22,0.00009,0,0,0,0,0.076023,0.006659
9501069,9501069,,14,2,16,14,2,16,0.000386,0.000003,0,1249,28,0.000123,3,0.571429,0.708333,8697.817643,0.083333,0.005962
9607185,9607185,,57,7,64,57,7,64,0.003914,0.001187,0,2513,0,0.000086,10,0.212044,0.240068,8178.033933,0.140129,0.021711
9608017,9608017,,37,19,56,37,19,56,0.002208,0.002116,0,2890,0,0.000073,10,0.226553,0.260951,347287.449606,0.084416,0.015613
9612008,9612008,,24,40,64,24,40,64,0.00082,0.004898,0,3232,0,0.000037,11,0.237316,0.27739,325764.554894,0.106151,0.008268
9612119,9612119,,18,21,39,18,21,39,0.000593,0.007496,0,4643,0,0.000034,11,0.212304,0.24785,3080.843256,0.206478,0.006209
9703060,9703060,,38,24,62,38,24,62,0.002694,0.002708,0,4644,0,0.000053,11,0.223876,0.259542,38311.675011,0.147277,0.013143
9703123,9703123,,28,12,40,28,12,40,0.001742,0.002178,0,4646,0,0.000045,12,0.192776,0.22081,20606.47317,0.219872,0.010206
9703214,9703214,,31,15,46,31,15,46,0.00219,0.001752,0,4683,0,0.000033,13,0.214855,0.247359,23539.922194,0.137198,0.008933
9704009,9704009,,4,15,19,4,15,19,0.000119,0.004229,0,4680,0,0.000014,13,0.206664,0.239681,52050.12633,0.137427,0.001183
9307066,9307066,,13,0,13,13,0,13,0.000195,0,0,1236,28,0.000047,0,0,0,0,0.025641,0.003769
9406015,9406015,,10,2,12,10,2,12,0.000096,0.000024,0,1235,28,0.000087,2,0.75,0.833333,1313.344349,0.075758,0.002851
9708074,9708074,,20,9,29,20,9,29,0.001579,0.001321,0,4701,13,0.000027,11,0.196362,0.223852,2013.94617,0.152709,0.00653
9709065,9709065,,9,42,51,9,42,51,0.000634,0.010435,0,4706,2,0.000018,12,0.207024,0.245136,59045.512036,0.131765,0.003906
9206026,9206026,,56,0,56,56,0,56,0.002495,0,0,1608,2,0.000224,0,0,0,0,0.043831,0.023965
9405113,9405113,,32,4,36,32,4,36,0.001799,0.000112,0,2944,2,0.00004,5,0.431818,0.536842,1150.047046,0.133333,0.010048
9501113,9501113,,77,17,94,77,17,94,0.003979,0.000271,0,2950,2,0.000114,5,0.561404,0.725,77378.447013,0.07504,0.025858
9609086,9609086,,45,11,56,45,11,56,0.00337,0.001177,0,2959,2,0.000067,10,0.208607,0.237299,15765.272053,0.069481,0.017439
9701011,9701011,,12,14,26,12,14,26,0.000282,0.001401,0,8859,0,0.00002,11,0.213495,0.241753,18582.343264,0.14,0.003482
9705160,9705160,,49,9,58,49,9,58,0.003945,0.003636,0,4649,2,0.000049,13,0.191912,0.221695,1704.185009,0.063823,0.015864
9708003,9708003,,55,22,77,55,22,77,0.003889,0.003151,0,4954,2,0.000063,11,0.211946,0.247802,68772.610091,0.064422,0.019602
9709002,9709002,,46,22,68,46,22,68,0.004071,0.005828,0,5251,2,0.000044,14,0.18346,0.217212,57256.322276,0.078797,0.014772
9710007,9710007,,38,21,59,38,21,59,0.003077,0.006192,0,5268,2,0.000035,11,0.210229,0.241593,16830.665751,0.09585,0.012974
9711128,9711128,,22,7,29,22,7,29,0.001698,0.000191,0,8164,0,0.000026,15,0.174533,0.197826,948.377206,0.158867,0.006891
9712017,9712017,,15,23,38,15,23,38,0.000298,0.001786,0,8860,0,0.000029,13,0.21638,0.250387,24469.697803,0.109531,0.004157
9804011,9804011,,29,21,50,29,21,50,0.0018,0.008118,0,6707,2,0.000033,14,0.202251,0.23134,56634.851473,0.097551,0.009222
9201020,9201020,,41,0,41,41,0,41,0.002319,0,0,1346,2,0.000321,0,0,0,0,0.083537,0.014178
9409117,9409117,,4,0,4,4,0,4,0.000041,0,0,8868,2,0.000013,0,0,0,0,0.416667,0.001141
9609107,9609107,,7,8,15,7,8,15,0.000466,0.00012,0,7884,2,0.000021,5,0.393064,0.46299,57628.438968,0.12381,0.002332
9611024,9611024,,60,0,60,60,0,60,0.00562,0,0,6223,1,0.00012,0,0,0,0,0.049153,0.017492
9611193,9611193,,9,1,10,9,1,10,0.00041,0.000002,0,8867,1,0.00002,1,1,1,5875.449891,0.155556,0.002644
9703010,9703010,,14,1,15,14,1,15,0.00026,0,0,8865,1,0.000079,1,1,1,6507,0.166667,0.003914
9811101,9811101,,19,50,69,19,50,69,0.001826,0.012819,0,8863,2,0.000027,18,0.184105,0.229011,31183.709691,0.078431,0.005844
9812161,9812161,,22,22,44,22,22,44,0.001267,0.016795,0,8857,0,0.000027,12,0.201565,0.230341,42609.847149,0.159091,0.006316
9811084,9811084,,17,15,32,17,15,32,0.001289,0.000432,0,9404,25,0.000095,16,0.175634,0.201847,28595.265625,0.134073,0.004838
9710120,9710120,,6,6,12,6,6,12,0.000722,0.001229,0,4509,4,0.000018,15,0.185703,0.209701,880.600761,0.272727,0.003778
9711083,9711083,,12,43,55,12,43,55,0.001518,0.008238,0,4881,4,0.00002,15,0.21731,0.261404,69621.114357,0.158586,0.005941
9711099,9711099,,13,9,22,13,9,22,0.000438,0.005098,0,5774,2,0.000037,15,0.195796,0.224424,19423.731791,0.112554,0.004696
9801166,9801166,,5,27,32,5,27,32,0.00038,0.003144,0,9407,4,0.000018,13,0.206636,0.242453,16512.441425,0.175403,0.002155
9807140,9807140,,14,29,43,14,29,43,0.000496,0.018692,0,9417,25,0.000025,13,0.203083,0.23143,28463.160373,0.112403,0.004481
9812116,9812116,,10,5,15,10,5,15,0.000406,0.000215,0,9406,25,0.000026,17,0.145246,0.161069,1351.293021,0.22381,0.003263
9901032,9901032,,30,42,72,30,42,72,0.002063,0.004899,0,9424,25,0.00004,14,0.198257,0.232375,142977.185091,0.098005,0.010591
9711130,9711130,,67,13,80,67,13,80,0.005879,0.003084,0,5777,0,0.000092,16,0.179643,0.21071,29560.8156,0.102532,0.026476
9701117,9701117,,5,46,51,5,46,51,0.000166,0.015518,0,4681,0,0.000015,11,0.221158,0.264164,13726.988131,0.128627,0.001443
9711127,9711127,,13,30,43,13,30,43,0.000825,0.002165,0,5382,0,0.000045,14,0.198348,0.233893,283921.11447,0.162237,0.005604
9805148,9805148,,3,11,14,3,11,14,0.000058,0.001013,0,9441,0,0.000012,16,0.186997,0.217548,3381.969286,0.296703,0.000714
9606136,9606136,,37,29,66,37,29,66,0.003067,0.010923,0,2200,0,0.000067,10,0.240969,0.280602,155802.956806,0.079487,0.016762
9607058,9607058,,14,13,27,14,13,27,0.001693,0.003818,0,3495,4,0.000034,11,0.210646,0.245197,27775.420187,0.115385,0.008955
9706089,9706089,,82,9,91,82,9,91,0.004653,0.001341,0,4004,25,0.000136,14,0.1708,0.196414,157830.007718,0.078632,0.030001
9706141,9706141,,69,6,75,69,6,75,0.002392,0.000566,0,4314,25,0.000135,15,0.184198,0.206193,70946.437103,0.085045,0.022564
9707192,9707192,,37,52,89,37,52,89,0.002747,0.007498,0,4321,4,0.000035,14,0.217509,0.258284,151817.585508,0.106231,0.014406
9710222,9710222,,4,9,13,4,9,13,0.000089,0.002364,0,9389,4,0.000016,12,0.178844,0.202467,951.433687,0.160256,0.001386
9802033,9802033,,41,24,65,41,24,65,0.004186,0.005993,0,5935,0,0.000038,17,0.179696,0.212834,16093.508535,0.131731,0.016095
9803142,9803142,,44,45,89,44,45,89,0.003359,0.005105,0,6353,0,0.000037,15,0.205692,0.246129,318521.122094,0.100102,0.01625
9806056,9806056,,16,19,35,16,19,35,0.001328,0.003676,0,9390,4,0.000023,15,0.187983,0.218396,37013.69654,0.107563,0.004895
9807166,9807166,,8,13,21,8,13,21,0.000301,0.000813,0,9415,25,0.000017,15,0.185445,0.210051,811.900701,0.285714,0.00298
9902134,9902134,,10,25,35,10,25,35,0.000751,0.002317,0,9392,4,0.000017,13,0.180706,0.210072,27510.424215,0.092437,0.003216
9906243,9906243,,15,17,32,15,17,32,0.000931,0.002592,0,9401,4,0.00002,15,0.194008,0.224358,16087.68539,0.1875,0.004191
9907206,9907206,,12,20,32,12,20,32,0.002191,0.01206,0,9399,1,0.00002,11,0.23382,0.268106,80929.704041,0.127016,0.006042
9803163,9803163,,44,33,77,44,33,77,0.002675,0.005409,0,7682,13,0.000048,14,0.194584,0.22921,40860.379509,0.08527,0.01452
9803216,9803216,,50,26,76,50,26,76,0.003658,0.003748,0,7683,13,0.000046,13,0.199492,0.234171,29901.101457,0.086842,0.016014
9803260,9803260,,23,11,34,23,11,34,0.00135,0.001121,0,7684,13,0.000028,14,0.185412,0.213989,4701.844752,0.152406,0.00722
9805073,9805073,,12,14,26,12,14,26,0.000967,0.001176,0,7685,13,0.000019,14,0.188225,0.217214,2063.093297,0.218462,0.003671
9811021,9811021,,36,28,64,36,28,64,0.002745,0.006343,0,8259,2,0.00003,11,0.224117,0.259217,74622.222697,0.073661,0.010541
9812224,9812224,,23,36,59,23,36,59,0.001361,0.007823,0,8260,2,0.000023,12,0.224085,0.260705,67428.476737,0.087084,0.006629
9408155,9408155,,107,1,108,107,1,108,0.004867,0.000145,0,1,4,0.000532,1,1,1,57.115833,0.045085,0.052203
9706217,9706217,,41,9,50,41,9,50,0.002134,0.001658,0,4315,25,0.000045,15,0.185016,0.208504,4266.038009,0.18,0.012902
9811195,9811195,,28,21,49,28,21,49,0.000975,0.003679,0,9408,25,0.000026,14,0.185567,0.213333,9803.099524,0.125,0.008221
9905165,9905165,,26,14,40,26,14,40,0.001205,0.000369,0,9431,25,0.000023,15,0.168793,0.190444,21868.695594,0.203846,0.007201
9908090,9908090,,19,7,26,19,7,26,0.000761,0.000243,0,9434,25,0.000025,16,0.156283,0.174607,996.31827,0.233846,0.005083
9910050,9910050,,15,34,49,15,34,49,0.000615,0.019353,0,9432,25,0.00002,13,0.192358,0.221,17192.359227,0.12415,0.004092
9910057,9910057,,2,4,6,2,4,6,0.000034,0.000101,0,9427,25,0.000012,13,0.174939,0.190872,0,0.433333,0.00071
9308052,9308052,,13,6,19,13,6,19,0.001218,0.000124,0,477,13,0.000039,4,0.473684,0.601852,39075.782272,0.134503,0.00793
9801090,9801090,,8,42,50,8,42,50,0.001712,0.013415,0,6464,2,0.000013,15,0.204454,0.245993,161316.257527,0.09102,0.003006
9806146,9806146,,124,42,166,124,42,166,0.016809,0.02163,0,7050,8,0.000108,13,0.208994,0.246208,246830.935831,0.048485,0.055247
9807127,9807127,,50,29,79,50,29,79,0.00712,0.014147,0,7052,8,0.000061,11,0.222988,0.256521,148502.936099,0.057124,0.025699
9808069,9808069,,34,26,60,34,26,60,0.005032,0.017478,0,7699,8,0.000032,12,0.205462,0.234702,43460.211665,0.081073,0.01862
9801142,9801142,,21,10,31,21,10,31,0.00101,0.000544,0,7979,25,0.000035,14,0.181912,0.205556,42359.010313,0.250538,0.008966
9912015,9912015,,15,13,28,15,13,28,0.00076,0.000317,0,9437,25,0.00002,13,0.178004,0.194506,11040.334003,0.227513,0.004033
9710033,9710033,,38,11,49,38,11,49,0.003936,0.003116,0,4914,2,0.000044,15,0.171537,0.202315,5546.796367,0.083333,0.014037
9904097,9904097,,6,12,18,6,12,18,0.000491,0.000819,0,8879,2,0.000015,14,0.18173,0.205499,4735.25996,0.222222,0.002041
9907170,9907170,,11,18,29,11,18,29,0.000857,0.001102,0,9397,2,0.000017,14,0.189728,0.211176,14424.761303,0.153941,0.002846
1025,1025,,17,39,56,17,39,56,0.000805,0.00331,0,9501,0,0.000018,15,0.186866,0.221311,13745.242982,0.098377,0.005777
9203079,9203079,,32,1,33,32,1,33,0.001026,0.000004,0,763,15,0.000108,1,1,1,5692.069839,0.02178,0.008392
9308005,9308005,,22,6,28,22,6,28,0.000683,0.000074,0,591,0,0.000049,1,1,1,5245.037878,0.060847,0.007832
9612181,9612181,,22,21,43,22,21,43,0.001162,0.004356,0,4296,0,0.000032,11,0.222936,0.260505,7282.37995,0.101329,0.010555
9804131,9804131,,48,12,60,48,12,60,0.002484,0.003132,0,7319,52,0.000049,15,0.17875,0.20768,36207.816942,0.081356,0.020277
9807056,9807056,,29,22,51,29,22,51,0.002251,0.006317,0,7611,13,0.00003,14,0.192106,0.235571,7742.72015,0.102745,0.009218
9907013,9907013,,35,4,39,35,4,39,0.001691,0.000107,0,9493,52,0.000035,13,0.165281,0.183529,60540.293889,0.109987,0.015183
9908135,9908135,,45,18,63,45,18,63,0.002467,0.002932,0,9494,52,0.000034,15,0.199003,0.22821,45883.175688,0.109063,0.019562
9910170,9910170,,57,32,89,57,32,89,0.00307,0.007019,0,9500,52,0.000044,14,0.202282,0.234432,71255.86285,0.089122,0.020872
9912279,9912279,,55,17,72,55,17,72,0.003538,0.002207,0,9479,3,0.000051,15,0.175111,0.202244,87740.664409,0.0759,0.018743
9202054,9202054,,8,0,8,8,0,8,0.000326,0,0,762,15,0.000125,0,0,0,0,0.071429,0.002069
9201014,9201014,,26,0,26,26,0,26,0.000424,0,0,590,0,0.000074,0,0,0,0,0.092308,0.008151
9202039,9202039,,12,0,12,12,0,12,0.000064,0,0,589,0,0.000063,0,0,0,0,0.090909,0.003705
9203071,9203071,,71,0,71,71,0,71,0.003184,0,0,177,0,0.000288,0,0,0,0,0.078471,0.036233
9206084,9206084,,143,1,144,143,1,144,0.003951,0.000007,0,158,3,0.00059,1,1,1,13630.456287,0.016754,0.055164
9207004,9207004,,47,0,47,47,0,47,0.000039,0,0,176,9,0.000193,0,0,0,0,0.047641,0.014375
9207094,9207094,,126,0,126,126,0,126,0.005965,0,0,175,4,0.000196,0,0,0,0,0.043937,0.050956
9208035,9208035,,37,1,38,37,1,38,0.000986,0.000017,0,174,2,0.000222,1,1,1,4044.861378,0.08037,0.016251
9209085,9209085,,16,1,17,16,1,17,0.000526,0.000001,0,172,4,0.000077,1,1,1,1835.346571,0.029412,0.009471
9211040,9211040,,82,4,86,82,4,86,0.000365,0.000003,0,171,9,0.000231,1,1,1,40707.771036,0.026813,0.027727
9212149,9212149,,124,0,124,124,0,124,0.004368,0,0,133,26,0.000537,0,0,0,0,0.02498,0.048084
9302048,9302048,,38,1,39,38,1,39,0.000204,0.000001,0,165,4,0.000151,2,0.666667,0.75,7401.808167,0.027665,0.013346
9303046,9303046,,126,0,126,126,0,126,0.004321,0,0,130,26,0.000612,0,0,0,0,0.024063,0.048633
9304087,9304087,,22,0,22,22,0,22,0.000555,0,0,162,5,0.000139,0,0,0,0,0.034632,0.008528
9305079,9305079,,20,1,21,20,1,21,0.000359,0.000017,0,161,4,0.000098,1,1,1,5226.892378,0.097619,0.012053
9306122,9306122,,15,4,19,15,4,19,0.000445,0.000105,0,159,0,0.00008,2,0.833333,0.9,3553.63411,0.02924,0.008128
9211119,9211119,,17,1,18,17,1,18,0.00138,0.000006,0,650,52,0.00014,1,1,1,4033.14647,0.065359,0.008258
9304034,9304034,,7,2,9,7,2,9,0.000235,0.000029,0,317,0,0.000044,1,1,1,855.121115,0.180556,0.003829
9307151,9307151,,5,3,8,5,3,8,0.000653,0.000051,0,205,0,0.000128,1,1,1,1552.106569,0.107143,0.004263
9205051,9205051,,41,0,41,41,0,41,0.002373,0,0,6,13,0.001746,0,0,0,0,0.081707,0.038801
9206016,9206016,,45,0,45,45,0,45,0.002169,0,0,18,13,0.001223,0,0,0,0,0.061616,0.036314
9302109,9302109,,50,1,51,50,1,51,0.001809,0.00013,0,17,13,0.000888,1,1,1,81.321172,0.071373,0.039816
9412158,9412158,,48,3,51,48,3,51,0.002331,0.001868,0,206,4,0.000321,6,0.267748,0.307955,7059.91976,0.096471,0.037679
9305083,9305083,,50,7,57,50,7,57,0.00245,0.00013,0,221,13,0.000453,3,0.409524,0.48062,29025.227619,0.04104,0.031573
9503030,9503030,,108,14,122,108,14,122,0.005581,0.003025,0,1150,0,0.000454,6,0.318991,0.377287,56367.106885,0.063745,0.051994
9407025,9407025,,40,4,44,40,4,44,0.001456,0.000356,0,309,10,0.000103,2,0.75,0.833333,2075.482066,0.085624,0.014685
9311049,9311049,,4,3,7,4,3,7,0.000379,0.000058,0,2214,0,0.000027,1,1,1,384.665391,0.02381,0.003836
9407190,9407190,,124,27,151,124,27,151,0.00477,0.000688,0,1352,28,0.000333,5,0.439716,0.538844,323533.942272,0.032362,0.048135
9604041,9604041,,64,24,88,64,24,88,0.008006,0.011159,0,1931,0,0.000173,9,0.23137,0.274208,55392.542665,0.056557,0.0521
9211072,9211072,,43,1,44,43,1,44,0.000701,0.000021,0,331,9,0.000236,1,1,1,168.512888,0.040169,0.015645
9310026,9310026,,18,9,27,18,9,27,0.002411,0.000166,0,480,0,0.000108,5,0.409836,0.576,38628.811052,0.04416,0.008521
9404025,9404025,,7,3,10,7,3,10,0.000501,0.000053,0,481,0,0.000075,6,0.325123,0.37803,36600.749033,0.166667,0.004864
9512046,9512046,,23,37,60,23,37,60,0.001684,0.00688,0,1851,0,0.000044,13,0.223615,0.283218,25876.657195,0.127401,0.009958
9607026,9607026,,60,33,93,60,33,93,0.006017,0.009538,0,2093,13,0.000121,9,0.245299,0.290709,125411.677157,0.069308,0.029368
9607078,9607078,,21,26,47,21,26,47,0.001841,0.003838,0,2332,0,0.000023,10,0.223323,0.262585,8982.955536,0.191027,0.0079
9608014,9608014,,7,3,10,7,3,10,0.000143,0.000015,0,2722,13,0.000026,16,0.160309,0.189618,10650.604228,0.133333,0.002606
9608145,9608145,,20,14,34,20,14,34,0.002371,0.000872,0,2490,0,0.000021,10,0.20984,0.244322,3664.320835,0.147059,0.00844
9608154,9608154,,32,57,89,32,57,89,0.003828,0.009917,0,2336,0,0.000026,10,0.233773,0.285351,73925.802991,0.131639,0.01379
9310003,9310003,,5,0,5,5,0,5,0.000066,0,0,5161,9,0.000044,0,0,0,0,0.05,0.002232
9510016,9510016,,3,8,11,3,8,11,0.000388,0.000632,0,4650,2,0.000014,9,0.210839,0.24359,675.459216,0.118182,0.001539
9612214,9612214,,2,1,3,2,1,3,0.000065,0,0,5159,20,0.000015,2,0.666667,0.75,21866.121677,0,0.001493
9702173,9702173,,18,21,39,18,21,39,0.00211,0.003422,0,3554,0,0.000032,12,0.217002,0.2532,127746.088426,0.094467,0.009637
9702184,9702184,,45,14,59,45,14,59,0.001068,0.000542,0,3413,2,0.000075,12,0.186401,0.21324,81961.614714,0.062537,0.014646
9707174,9707174,,20,22,42,20,22,42,0.000867,0.002473,0,5152,4,0.000037,12,0.20076,0.233489,135148.03231,0.056911,0.007585
9710063,9710063,,18,6,24,18,6,24,0.00096,0.000907,0,5128,2,0.000031,13,0.186446,0.211814,24563.405853,0.150362,0.006885
9511173,9511173,,94,17,111,94,17,111,0.009864,0.007339,0,1416,2,0.000502,10,0.222481,0.26247,86109.529686,0.07027,0.083551
9611023,9611023,,1,8,9,1,8,9,0.000145,0.000087,0,5523,28,0.000013,5,0.32,0.404427,35399.000709,0.208333,0.001532
9701137,9701137,,109,19,128,109,19,128,0.012299,0.008524,0,4128,3,0.000209,11,0.223094,0.261126,50586.789772,0.063054,0.059763
9702093,9702093,,60,44,104,60,44,104,0.007116,0.010926,0,4669,0,0.00006,11,0.230569,0.272768,172018.556017,0.089152,0.026747
9705130,9705130,,67,27,94,67,27,94,0.007463,0.010724,0,4129,2,0.000071,13,0.206294,0.2428,202638.875437,0.081446,0.028739
9706186,9706186,,29,19,48,29,19,48,0.002857,0.008027,0,5506,2,0.000053,12,0.211872,0.249306,15580.88351,0.109929,0.018086
9710049,9710049,,10,17,27,10,17,27,0.00056,0.004991,0,5507,2,0.000026,13,0.191774,0.226275,5822.325869,0.198006,0.00408
9710246,9710246,,10,34,44,10,34,44,0.001308,0.013778,0,5505,0,0.00002,11,0.226843,0.274083,105554.890309,0.098837,0.00457
9711112,9711112,,39,15,54,39,15,54,0.002819,0.007124,0,5502,30,0.000068,15,0.185826,0.219343,24901.120232,0.078966,0.019524
9804066,9804066,,4,9,13,4,9,13,0.000088,0.000353,0,7318,0,0.000016,15,0.175758,0.200852,21497.778861,0.134615,0.001396
9602014,9602014,,58,18,76,58,18,76,0.007005,0.00381,0,1825,13,0.000115,10,0.218551,0.261435,21503.935124,0.09614,0.030632
9701163,9701163,,4,30,34,4,30,34,0.000388,0.00441,0,6371,13,0.000014,10,0.221507,0.261287,2780.785416,0.170232,0.001719
9707087,9707087,,32,43,75,32,43,75,0.003977,0.009987,0,4627,13,0.000036,13,0.207503,0.256875,62701.414259,0.117477,0.012211
9707203,9707203,,4,70,74,4,70,74,0.000549,0.015145,0,7610,13,0.000012,11,0.237725,0.293439,3054.096976,0.100518,0.00157
9608015,9608015,,18,50,68,18,50,68,0.002931,0.011632,0,2439,13,0.000031,11,0.242409,0.289638,26002.335992,0.113477,0.009003
9610105,9610105,,67,47,114,67,47,114,0.007403,0.009526,0,2468,13,0.000063,10,0.239222,0.289259,59349.053591,0.093774,0.027411
9610155,9610155,,48,18,66,48,18,66,0.006351,0.002968,0,3528,13,0.000117,12,0.212659,0.24779,20077.477558,0.075991,0.029206
9612076,9612076,,27,16,43,27,16,43,0.003814,0.002799,0,4567,13,0.000037,10,0.219693,0.255877,8258.287579,0.173865,0.013272
9701054,9701054,,17,28,45,17,28,45,0.001669,0.005951,0,4566,13,0.000022,11,0.22005,0.261059,31468.546254,0.10404,0.006604
9702168,9702168,,14,20,34,14,20,34,0.001949,0.003979,0,4621,13,0.000021,11,0.225281,0.264139,62114.662762,0.165775,0.006206
9703156,9703156,,17,39,56,17,39,56,0.002206,0.007768,0,5283,13,0.000019,11,0.218741,0.264366,6777.169188,0.161364,0.005886
9704095,9704095,,13,48,61,13,48,61,0.001889,0.006706,0,4622,13,0.000017,11,0.22766,0.276392,42144.788495,0.13224,0.005088
9706097,9706097,,36,25,61,36,25,61,0.005129,0.006083,0,5285,13,0.000029,13,0.20505,0.245991,31462.967374,0.090164,0.012316
9708025,9708025,,22,11,33,22,11,33,0.002919,0.001785,0,6145,13,0.000023,13,0.185544,0.215147,50603.64396,0.108902,0.007039
9708065,9708065,,25,25,50,25,25,50,0.00328,0.003675,0,4877,13,0.000021,16,0.204339,0.241279,38137.336049,0.150204,0.009023
9708103,9708103,,29,33,62,29,33,62,0.003833,0.004327,0,5174,13,0.000031,17,0.197631,0.239073,16901.67633,0.128239,0.010431
9709113,9709113,,3,49,52,3,49,52,0.00051,0.007839,0,7616,13,0.000011,12,0.218933,0.264428,2224.226627,0.139894,0.001125
9711067,9711067,,40,24,64,40,24,64,0.005924,0.00638,0,5173,13,0.00004,13,0.194672,0.229531,72014.893101,0.073661,0.015339
9712189,9712189,,18,11,29,18,11,29,0.001373,0.000462,0,5702,2,0.000033,14,0.184005,0.210254,40377.457789,0.081281,0.006097
9712215,9712215,,11,32,43,11,32,43,0.00188,0.008265,0,5186,13,0.000014,13,0.202957,0.240255,6758.256036,0.173311,0.00421
9801081,9801081,,17,32,49,17,32,49,0.00258,0.004089,0,6104,13,0.000025,13,0.204973,0.245005,52867.259653,0.146684,0.006421
9802147,9802147,,8,35,43,8,35,43,0.002553,0.011115,0,6147,13,0.000016,14,0.203796,0.242348,52057.400497,0.105759,0.010071
9803072,9803072,,16,123,139,16,123,139,0.001701,0.02101,0,6235,0,0.000019,11,0.24001,0.292044,300690.415851,0.092274,0.006992
9806030,9806030,,6,16,22,6,16,22,0.000515,0.002491,0,7614,0,0.000013,16,0.184377,0.214925,6137.751842,0.166667,0.002829
9202085,9202085,,14,0,14,14,0,14,0.000589,0,0,1414,3,0.000107,0,0,0,0,0.076923,0.006054
9311092,9311092,,16,0,16,16,0,16,0.000361,0,0,983,3,0.000128,0,0,0,0,0.1,0.008335
9402113,9402113,,72,0,72,72,0,72,0.002515,0,0,982,3,0.000224,0,0,0,0,0.101526,0.04697
9503014,9503014,,10,6,16,10,6,16,0.000565,0.000065,0,1415,3,0.00006,2,0.75,0.833333,37926.932274,0.129167,0.007411
9510008,9510008,,15,6,21,15,6,21,0.00023,0.000009,0,4083,6,0.000026,8,0.249042,0.299096,84247.980891,0.07619,0.005044
9704151,9704151,,136,20,156,136,20,156,0.016467,0.005052,0,4297,52,0.000138,14,0.202314,0.236043,70912.568438,0.056741,0.068472
9808080,9808080,,42,19,61,42,19,61,0.002905,0.003815,0,8627,52,0.000039,14,0.201539,0.229022,43753.121927,0.118033,0.020082
9902105,9902105,,193,18,211,193,18,211,0.008595,0.003287,0,8047,3,0.000193,13,0.199032,0.226908,169633.565848,0.062063,0.091173
9902120,9902120,,28,35,63,28,35,63,0.001656,0.003829,0,8756,52,0.00003,13,0.212766,0.247691,134483.707247,0.084485,0.012789
9611165,9611165,,39,29,68,39,29,68,0.005483,0.009391,0,3429,13,0.000048,10,0.226384,0.268038,33589.568078,0.110843,0.019599
9712223,9712223,,22,27,49,22,27,49,0.004622,0.006387,0,5525,2,0.000025,15,0.201965,0.236301,112080.27202,0.082483,0.011961
9810254,9810254,,26,23,49,26,23,49,0.004555,0.003778,0,7993,4,0.000027,14,0.205669,0.235694,41415.280199,0.088435,0.010884
9710006,9710006,,6,1,7,6,1,7,0.000001,0,0,9492,28,0.000045,1,1,1,6017,0.095238,0.001668
9712048,9712048,,12,11,23,12,11,23,0.000847,0.004173,0,6158,0,0.000035,12,0.190571,0.217971,5392.029823,0.077075,0.006721
9809072,9809072,,1,4,5,1,4,5,0.000001,0.000006,0,9490,23,0.000018,14,0.132228,0.142198,42125.705907,0.25,0.000547
9807076,9807076,,49,11,60,49,11,60,0.005102,0.017587,0,7070,0,0.000075,14,0.19104,0.214751,21360.413908,0.076836,0.019421
9812031,9812031,,146,38,184,146,38,184,0.010298,0.006419,0,7985,3,0.000162,11,0.219705,0.251004,199167.790811,0.070444,0.077571
9907026,9907026,,57,44,101,57,44,101,0.00203,0.005529,0,9488,10,0.000052,13,0.208216,0.244389,205552.044524,0.044851,0.020557
9707214,9707214,,24,12,36,24,12,36,0.002469,0.004135,0,5071,52,0.000037,15,0.183513,0.213834,109584.940154,0.138889,0.010415
9711090,9711090,,24,12,36,24,12,36,0.001776,0.002207,0,6949,52,0.00003,15,0.189965,0.220828,3992.160595,0.178571,0.009218
9711124,9711124,,39,20,59,39,20,59,0.003865,0.004988,0,6950,52,0.00004,14,0.189339,0.225189,19320.902862,0.117183,0.015556
9901146,9901146,,38,40,78,38,40,78,0.00347,0.006615,0,7001,30,0.000068,12,0.208742,0.240471,201810.93396,0.05378,0.019152
9906242,9906242,,82,53,135,82,53,135,0.005144,0.009994,0,9499,52,0.000052,16,0.203731,0.242201,126723.659372,0.065395,0.030512
9907131,9907131,,41,22,63,41,22,63,0.001855,0.003373,0,9495,52,0.000032,15,0.195197,0.225002,36295.207428,0.134153,0.01617
9609122,9609122,,116,8,124,116,8,124,0.007293,0.002175,0,2984,0,0.000162,11,0.211554,0.240771,30760.19504,0.043076,0.049374
9806016,9806016,,11,8,19,11,8,19,0.000805,0.000528,0,8917,2,0.000031,15,0.17198,0.196099,9450.434329,0.160819,0.004037
9908107,9908107,,15,3,18,15,3,18,0.000675,0.000144,0,9478,2,0.00003,14,0.157456,0.173153,9623.990151,0.150327,0.004312
9912086,9912086,,26,30,56,26,30,56,0.001338,0.002185,0,9476,2,0.000035,14,0.182399,0.209361,140791.164904,0.084091,0.008903
1026,1026,,0,6,6,0,6,6,0,0.000035,0,9507,5,0.00001,11,0.207748,0.291054,0,0.233333,0
9310144,9310144,,35,3,38,35,3,38,0.000315,0.000039,0,154,26,0.000098,1,1,1,19718.282068,0.037696,0.010882
9312059,9312059,,42,13,55,42,13,55,0.000454,0.000051,0,2240,5,0.000111,2,0.809524,0.882353,40750.598368,0.056566,0.010914
9405110,9405110,,61,2,63,61,2,63,0.000869,0.000005,0,2242,5,0.000108,3,0.475,0.517544,30766.737848,0.056068,0.016006
9411163,9411163,,29,8,37,29,8,37,0.000572,0.000066,0,2259,5,0.000051,5,0.38843,0.482979,24401.822575,0.090841,0.008006
9910178,9910178,,4,7,11,4,7,11,0.000281,0.000031,0,9506,5,0.000013,10,0.224726,0.299933,13638.464164,0.109091,0.001041
9201036,9201036,,13,0,13,13,0,13,0.000047,0,0,153,9,0.00006,0,0,0,0,0.012821,0.003395
9206063,9206063,,22,0,22,22,0,22,0.000024,0,0,152,9,0.000149,0,0,0,0,0.062771,0.006579
9201021,9201021,,53,0,53,53,0,53,0.0008,0,0,230,5,0.000297,0,0,0,0,0.029028,0.017528
9203056,9203056,,68,0,68,68,0,68,0.000514,0,0,234,5,0.000667,0,0,0,0,0.038191,0.020516
9203077,9203077,,13,0,13,13,0,13,0.000002,0,0,622,9,0.000148,0,0,0,0,0.115385,0.00378
9205030,9205030,,7,0,7,7,0,7,0.000404,0,0,2239,5,0.000023,0,0,0,0,0.02381,0.001892
9205071,9205071,,22,0,22,22,0,22,0.000323,0,0,2235,5,0.000103,0,0,0,0,0.106061,0.006058
9207001,9207001,,14,0,14,14,0,14,0.000022,0,0,2234,5,0.000086,0,0,0,0,0.087912,0.003963
9209118,9209118,,20,3,23,20,3,23,0.000458,0.000025,0,426,5,0.000048,1,1,1,1169.364812,0.088933,0.005911
9210010,9210010,,157,0,157,157,0,157,0.000834,0,0,439,9,0.000694,0,0,0,0,0.009554,0.041603
9210017,9210017,,29,2,31,29,2,31,0.000347,0.000019,0,376,5,0.000097,1,1,1,461.664501,0.062366,0.009513
9211054,9211054,,25,2,27,25,2,27,0.000314,0.000004,0,2236,5,0.000071,1,1,1,2769.54937,0.138177,0.006985
9301021,9301021,,10,0,10,10,0,10,0.000041,0,0,418,5,0.000044,0,0,0,0,0.111111,0.003068
9304012,9304012,,21,1,22,21,1,22,0.000286,0.000009,0,2238,5,0.000038,1,1,1,311.945257,0.11039,0.005452
9307025,9307025,,2,3,5,2,3,5,0.000001,0.000008,0,2237,5,0.000021,1,1,1,1.166667,0.35,0.000776
9212003,9212003,,19,0,19,19,0,19,0.000001,0,0,2241,23,0.000279,0,0,0,0,0.143275,0.005306
9302026,9302026,,32,2,34,32,2,34,0.000277,0.000009,0,239,5,0.000116,1,1,1,6677.787507,0.06328,0.009265
9308002,9308002,,19,1,20,19,1,20,0.000041,0.000001,0,2256,26,0.000107,1,1,1,823.498612,0.047368,0.005043
9312003,9312003,,18,1,19,18,1,19,0.000058,0.000006,0,2248,5,0.000078,1,1,1,365.676268,0.099415,0.005767
9403121,9403121,,22,15,37,22,15,37,0.00048,0.000068,0,2258,5,0.000057,4,0.545455,0.7,107570.683144,0.085586,0.006498
9201017,9201017,,20,0,20,20,0,20,0.000941,0,0,731,17,0.000083,0,0,0,0,0.018421,0.010058
9201041,9201041,,8,0,8,8,0,8,0.000135,0,0,799,3,0.000024,0,0,0,0,0.178571,0.00308
9202021,9202021,,30,0,30,30,0,30,0.000368,0,0,142,23,0.000226,0,0,0,0,0.032184,0.011403
9204044,9204044,,30,0,30,30,0,30,0.000084,0,0,2599,23,0.000114,0,0,0,0,0.044828,0.00861
9204065,9204065,,19,0,19,19,0,19,0.000032,0,0,2184,23,0.000092,0,0,0,0,0.096491,0.006192
9205018,9205018,,28,0,28,28,0,28,0.000015,0,0,140,23,0.000256,0,0,0,0,0.09127,0.008589
9205088,9205088,,65,0,65,65,0,65,0.000393,0,0,332,23,0.000175,0,0,0,0,0.040144,0.019177
9206061,9206061,,7,0,7,7,0,7,0.00001,0,0,2587,23,0.000025,0,0,0,0,0.190476,0.00242
9206097,9206097,,15,0,15,15,0,15,0.000054,0,0,821,23,0.000149,0,0,0,0,0.1,0.005026
9207067,9207067,,32,0,32,32,0,32,0.000014,0,0,169,9,0.000119,0,0,0,0,0.070565,0.009399
9208047,9208047,,46,0,46,46,0,46,0.000069,0,0,2567,23,0.000151,0,0,0,0,0.037681,0.012361
9209007,9209007,,13,1,14,13,1,14,0.000008,0,0,2598,23,0.000049,1,1,1,55.642435,0.17033,0.004471
9209037,9209037,,22,1,23,22,1,23,0.000034,0,0,455,9,0.000065,1,1,1,9445.031909,0.057312,0.006473
9210026,9210026,,4,0,4,4,0,4,0.000004,0,0,2593,23,0.000035,0,0,0,0,0.083333,0.001691
9210115,9210115,,37,0,37,37,0,37,0.000287,0,0,471,23,0.000108,0,0,0,0,0.051051,0.010724
9211096,9211096,,36,2,38,36,2,38,0.000018,0,0,470,23,0.000142,1,1,1,5995.444476,0.103129,0.010672
9211107,9211107,,9,0,9,9,0,9,0.000006,0,0,1054,9,0.000029,0,0,0,0,0.055556,0.00313
9212072,9212072,,19,0,19,19,0,19,0.000224,0,0,330,9,0.000077,0,0,0,0,0.067251,0.006241
9301103,9301103,,30,3,33,30,3,33,0.000036,0.000005,0,823,23,0.000177,1,1,1,19339.172187,0.064394,0.009396
9301122,9301122,,19,1,20,19,1,20,0.000031,0,0,2178,23,0.000092,1,1,1,3270.92589,0.121053,0.006639
9302020,9302020,,3,9,12,3,9,12,0.000072,0.00011,0,146,26,0.000025,1,1,1,24842.73933,0.045455,0.001784
9303027,9303027,,6,0,6,6,0,6,0.000013,0,0,2181,23,0.000023,0,0,0,0,0.133333,0.002404
9303136,9303136,,37,1,38,37,1,38,0.000051,0,0,818,23,0.000141,1,1,1,3491.646336,0.070413,0.011616
9303167,9303167,,2,0,2,2,0,2,0.000004,0,0,2597,23,0.000019,0,0,0,0,0,0.001472
9304057,9304057,,90,4,94,90,4,94,0.000353,0.000127,0,819,23,0.000269,2,0.75,0.833333,10522.356401,0.059254,0.027127
9304061,9304061,,8,3,11,8,3,11,0.000373,0.00007,0,2596,30,0.000024,2,0.8,0.875,112.877636,0.172727,0.002902
9305026,9305026,,22,13,35,22,13,35,0.000274,0.000243,0,523,3,0.000078,3,0.689655,0.808333,24373.132411,0.043697,0.009013
9305087,9305087,,7,5,12,7,5,12,0.000008,0.000086,0,2180,23,0.000024,3,0.555556,0.644444,190.493528,0.227273,0.002546
9306101,9306101,,11,1,12,11,1,12,0.00001,0.000001,0,817,23,0.000141,1,1,1,531.169265,0.204545,0.005243
9306147,9306147,,28,7,35,28,7,35,0.00006,0.000011,0,2179,23,0.000099,2,0.769231,0.85,33963.207936,0.063025,0.008212
9307088,9307088,,33,19,52,33,19,52,0.000384,0.000364,0,800,3,0.000082,3,0.742857,0.852564,48763.744218,0.070136,0.012119
9308001,9308001,,3,6,9,3,6,9,0.000024,0.000194,0,2595,3,0.000017,3,0.54,0.598765,688.450175,0.222222,0.001455
9308076,9308076,,2,1,3,2,1,3,0.000004,0,0,2594,23,0.000017,1,1,1,133.617019,0.166667,0.001222
9309011,9309011,,22,1,23,22,1,23,0.000012,0,0,2583,23,0.000053,2,0.6,0.666667,0,0.195652,0.006722
9309027,9309027,,11,7,18,11,7,18,0.000022,0.000158,0,801,23,0.00004,3,0.55102,0.617284,999.912629,0.160131,0.00394
9309085,9309085,,4,6,10,4,6,10,0.000005,0.000037,0,827,23,0.000048,2,0.75,0.833333,13977.891441,0.066667,0.002021
9310080,9310080,,16,1,17,16,1,17,0.000113,0,0,815,23,0.000145,1,1,1,5105.593786,0.154412,0.007082
9310126,9310126,,5,4,9,5,4,9,0.000156,0.000117,0,2592,2,0.000019,2,0.833333,0.9,1985.440811,0.055556,0.002133
9310166,9310166,,4,2,6,4,2,6,0.00004,0,0,2187,23,0.000023,2,0.6,0.666667,4311.411569,0.1,0.001715
9311157,9311157,,12,4,16,12,4,16,0.000031,0.00002,0,1331,9,0.000044,5,0.364964,0.421333,68272.750927,0.2,0.004022
9312185,9312185,,6,13,19,6,13,19,0.000006,0.000015,0,1035,9,0.000019,2,0.782609,0.861111,17531.623201,0.102339,0.002233
9312206,9312206,,38,4,42,38,4,42,0.000087,0.000007,0,820,23,0.000154,3,0.55,0.651515,17976.911581,0.102207,0.012348
9401148,9401148,,4,3,7,4,3,7,0.000005,0.000003,0,2591,23,0.000016,3,0.571429,0.666667,48393.094928,0.142857,0.001687
9401161,9401161,,9,4,13,9,4,13,0.000054,0.000003,0,2586,23,0.000025,3,0.518519,0.607143,2816.616868,0.217949,0.002892
9403143,9403143,,26,16,42,26,16,42,0.00003,0.000056,0,2185,23,0.000056,3,0.616667,0.707207,30507.663479,0.073171,0.0072
9404170,9404170,,5,5,10,5,5,10,0.000028,0.000022,0,2585,23,0.000026,3,0.463768,0.526042,5817.672122,0.122222,0.001921
9405109,9405109,,100,9,109,100,9,109,0.000385,0.000007,0,2558,23,0.000263,4,0.465753,0.571078,60802.190565,0.04069,0.028255
9405112,9405112,,12,12,24,12,12,24,0.00001,0.000086,0,2584,23,0.000029,3,0.473684,0.592593,16963.297195,0.192029,0.003981
9502010,9502010,,29,3,32,29,3,32,0.000338,0.000054,0,4447,5,0.000049,2,0.8,0.875,1221.981305,0.064516,0.00786
9710176,9710176,,8,8,16,8,8,16,0.000017,0.000006,0,9504,22,0.000019,9,0.170442,0.233163,2328.264406,0.2,0.002034
9807155,9807155,,7,11,18,7,11,18,0.000056,0.000009,0,9505,22,0.000017,9,0.176042,0.248756,4222.575599,0.22549,0.001746
1027,1027,,55,19,74,55,19,74,0.004212,0.003072,0,9533,30,0.000054,13,0.200575,0.220755,41748.142361,0.137357,0.024796
9802085,9802085,,56,23,79,56,23,79,0.004725,0.004944,0,6931,30,0.00007,15,0.191358,0.21985,51612.51772,0.107108,0.020369
9908038,9908038,,48,59,107,48,59,107,0.004329,0.023486,0,9115,30,0.000059,13,0.214785,0.248141,260544.200356,0.08182,0.016462
9910004,9910004,,150,24,174,150,24,174,0.010376,0.021251,0,9508,30,0.000169,13,0.205836,0.229709,197771.817357,0.066939,0.067115
9910091,9910091,,49,16,65,49,16,65,0.003769,0.003461,0,9515,30,0.000065,13,0.197197,0.217396,55356.464573,0.120192,0.025253
9911041,9911041,,79,25,104,79,25,104,0.006086,0.006077,0,9516,30,0.000087,13,0.204536,0.227722,58000.920546,0.113237,0.037156
9911098,9911098,,90,14,104,90,14,104,0.004333,0.002722,0,9517,30,0.000132,13,0.196005,0.216032,32994.383072,0.128361,0.045623
9912072,9912072,,341,17,358,341,17,358,0.016722,0.002633,0,9528,30,0.000361,13,0.198013,0.217797,359496.764291,0.034975,0.126936
9912075,9912075,,82,14,96,82,14,96,0.003355,0.002372,0,9531,30,0.000093,13,0.196061,0.215769,73153.315219,0.107237,0.033092
9912094,9912094,,107,13,120,107,13,120,0.004524,0.003018,0,9530,30,0.000126,12,0.206647,0.226235,50392.934556,0.080392,0.042382
9912167,9912167,,114,22,136,114,22,136,0.004019,0.006103,0,9532,30,0.000145,12,0.209054,0.23027,82808.038182,0.089379,0.046891
9604171,9604171,,20,9,29,20,9,29,0.001861,0.002231,0,2083,2,0.000123,10,0.214502,0.241959,21075.20518,0.119458,0.013364
9610041,9610041,,34,30,64,34,30,64,0.006248,0.013873,0,2720,2,0.000059,12,0.231184,0.277258,62726.899933,0.114831,0.019173
9712168,9712168,,7,29,36,7,29,36,0.001086,0.00744,0,6659,2,0.000057,14,0.208333,0.240363,28273.480337,0.230952,0.008097
9611103,9611103,,37,8,45,37,8,45,0.003731,0.003742,0,3235,2,0.000106,13,0.194371,0.224316,8464.862431,0.105556,0.02072
9704017,9704017,,15,3,18,15,3,18,0.001418,0.001922,0,5730,2,0.00003,15,0.164005,0.186489,55.93434,0.287582,0.006595
9704098,9704098,,87,18,105,87,18,105,0.008204,0.009228,0,3892,2,0.000135,14,0.194312,0.229095,34382.21746,0.070879,0.034333
9708123,9708123,,19,29,48,19,29,48,0.001451,0.010653,0,6211,2,0.000024,12,0.192683,0.22462,9172.144056,0.152482,0.006304
9709098,9709098,,8,26,34,8,26,34,0.001216,0.005644,0,6208,2,0.000019,13,0.20904,0.239701,16036.774868,0.165775,0.003967
9711073,9711073,,25,23,48,25,23,48,0.001566,0.003027,0,6219,2,0.000043,12,0.203129,0.230285,120188.696849,0.136968,0.008426
9712179,9712179,,6,56,62,6,56,62,0.001238,0.011512,0,6436,2,0.000015,14,0.213146,0.253839,48890.15429,0.130354,0.002876
9801084,9801084,,17,49,66,17,49,66,0.001316,0.012367,0,6930,2,0.000023,12,0.211011,0.246634,48804.82268,0.128671,0.005747
9801085,9801085,,6,11,17,6,11,17,0.000478,0.004587,0,6929,30,0.000016,16,0.169935,0.194927,11510.339055,0.238971,0.002292
9510083,9510083,,48,0,48,48,0,48,0.000728,0,0,5485,30,0.000119,0,0,0,0,0.124113,0.015947
9602115,9602115,,37,5,42,37,5,42,0.002483,0.000052,0,5614,30,0.000086,10,0.203176,0.231943,69841.577692,0.093496,0.01441
9902037,9902037,,12,5,17,12,5,17,0.000171,0.000049,0,7008,30,0.000042,16,0.145896,0.16141,22315.602319,0.095588,0.004709
9810179,9810179,,45,18,63,45,18,63,0.004959,0.005597,0,7003,30,0.000103,13,0.191917,0.215344,8888.416683,0.111367,0.023197
9901080,9901080,,78,22,100,78,22,100,0.005189,0.004013,0,7004,30,0.000163,13,0.195718,0.220172,55930.281165,0.068586,0.037852
9902051,9902051,,14,71,85,14,71,85,0.002257,0.0335,0,6747,2,0.000024,13,0.213466,0.254978,121208.445417,0.09916,0.00573
9410223,9410223,,14,1,15,14,1,15,0.000015,0.000001,0,4354,22,0.000056,1,1,1,860.655966,0.057143,0.004742
9411030,9411030,,4,2,6,4,2,6,0.000012,0.000002,0,4353,22,0.000035,3,0.545455,0.638889,9491.784459,0.066667,0.00222
9502025,9502025,,25,1,26,25,1,26,0.000038,0.000001,0,5555,20,0.00009,1,1,1,7436.224113,0.049231,0.007721
9601092,9601092,,28,1,29,28,1,29,0.00011,0,0,5552,20,0.000115,1,1,1,6763.603726,0.046798,0.008269
9712095,9712095,,11,24,35,11,24,35,0.000184,0.000072,0,7066,30,0.000037,11,0.165077,0.187416,88022.304403,0.104202,0.003908
9812208,9812208,,7,3,10,7,3,10,0.00058,0.000002,0,7063,20,0.000037,3,0.529412,0.62963,28606.014781,0.133333,0.002898
9902022,9902022,,21,25,46,21,25,46,0.006501,0.017617,0,7058,1,0.000039,13,0.195358,0.224605,54743.006814,0.084058,0.014385
9701139,9701139,,70,17,87,70,17,87,0.007759,0.007096,0,3579,2,0.000124,10,0.215978,0.246609,28570.703588,0.087677,0.030229
9706187,9706187,,6,15,21,6,15,21,0.000835,0.003785,0,6218,2,0.000015,15,0.192409,0.221422,10273.889337,0.233333,0.002228
9707162,9707162,,18,9,27,18,9,27,0.002651,0.004103,0,6216,30,0.000023,16,0.180384,0.2124,68518.423896,0.159544,0.006841
9708029,9708029,,8,4,12,8,4,12,0.000898,0.00247,0,6209,30,0.000016,11,0.193848,0.214892,7884.711933,0.280303,0.003274
9801051,9801051,,12,8,20,12,8,20,0.000922,0.002162,0,6928,30,0.000019,15,0.180085,0.203265,8053.392798,0.2,0.004056
9801184,9801184,,8,0,8,8,0,8,0.000737,0,0,8044,30,0.000021,0,0,0,0,0.071429,0.002505
9802082,9802082,,14,9,23,14,9,23,0.000839,0.00314,0,9093,30,0.000028,13,0.178006,0.199698,40687.236822,0.162055,0.00605
9802164,9802164,,8,13,21,8,13,21,0.001155,0.002644,0,9109,2,0.000014,16,0.180712,0.208801,3169.422016,0.180952,0.00289
9803088,9803088,,10,25,35,10,25,35,0.001782,0.004977,0,6925,2,0.000015,14,0.189721,0.218164,5505.147591,0.178992,0.004348
9805212,9805212,,6,12,18,6,12,18,0.000929,0.001974,0,6921,4,0.000013,16,0.172276,0.197107,38932.04408,0.183007,0.002964
9806096,9806096,,8,20,28,8,20,28,0.00078,0.00884,0,7346,30,0.000014,13,0.220202,0.253481,121198.783039,0.140212,0.002655
9810004,9810004,,6,10,16,6,10,16,0.001192,0.005151,0,9097,30,0.000024,10,0.214534,0.244035,9318.256426,0.254167,0.004299
9810035,9810035,,28,14,42,28,14,42,0.001519,0.005946,0,7787,4,0.000039,15,0.183607,0.209299,180321.584133,0.074332,0.011867
9810237,9810237,,7,26,33,7,26,33,0.000773,0.008982,0,9104,2,0.000014,13,0.195338,0.22509,28958.671343,0.186553,0.002181
9811220,9811220,,35,6,41,35,6,41,0.001485,0.002062,0,9094,30,0.000038,15,0.167632,0.18612,1791.401319,0.194512,0.010307
9812008,9812008,,3,41,44,3,41,44,0.00076,0.014112,0,9113,2,0.000011,15,0.19775,0.234522,11532.119025,0.144292,0.001251
9812177,9812177,,7,16,23,7,16,23,0.000562,0.004685,0,9110,2,0.000013,14,0.181786,0.20878,23152.643883,0.205534,0.002133
9902087,9902087,,5,24,29,5,24,29,0.000716,0.004425,0,8794,2,0.000014,12,0.199872,0.227178,22121.073423,0.12931,0.00183
9902113,9902113,,21,11,32,21,11,32,0.001345,0.001153,0,9095,30,0.000023,16,0.190082,0.212811,11161.153892,0.260081,0.006837
9902200,9902200,,9,53,62,9,53,62,0.002779,0.027412,0,8426,2,0.000015,12,0.217503,0.249809,316054.886387,0.111317,0.009206
9903037,9903037,,9,20,29,9,20,29,0.001172,0.004769,0,9098,30,0.000016,17,0.189671,0.218141,6164.009399,0.195813,0.003433
9903050,9903050,,5,45,50,5,45,50,0.000907,0.023886,0,9096,2,0.000012,13,0.216521,0.254307,66093.680912,0.10449,0.001861
9903165,9903165,,31,33,64,31,33,64,0.005754,0.026196,0,7794,2,0.000027,18,0.199357,0.23185,151210.393623,0.105407,0.017064
9903217,9903217,,17,54,71,17,54,71,0.001671,0.008373,0,9114,30,0.00003,14,0.211585,0.244168,115037.49995,0.104628,0.00726
9904122,9904122,,12,24,36,12,24,36,0.001318,0.009138,0,9091,2,0.000017,13,0.190942,0.217763,70155.354785,0.115873,0.003973
9209003,9209003,,58,0,58,58,0,58,0.000548,0,0,699,22,0.000254,0,0,0,0,0.030248,0.018142
9307087,9307087,,11,2,13,11,2,13,0.000268,0.000009,0,2765,22,0.00004,1,1,1,1052.050547,0.115385,0.004192
9508111,9508111,,4,5,9,4,5,9,0.000176,0.000003,0,9514,30,0.000015,4,0.457143,0.578125,32567.755391,0.013889,0.001603
9610248,9610248,,4,3,7,4,3,7,0.000205,0.000011,0,6997,15,0.000016,4,0.419355,0.532051,6133.749405,0.02381,0.001748
9908152,9908152,,31,7,38,31,7,38,0.002286,0.004046,0,9509,30,0.000047,13,0.190756,0.207893,777.314262,0.16643,0.014525
9911137,9911137,,20,25,45,20,25,45,0.00258,0.019839,0,9527,30,0.000037,12,0.216676,0.241303,193005.464489,0.139394,0.010076
9912036,9912036,,15,19,34,15,19,34,0.000614,0.002118,0,9518,30,0.00005,13,0.194589,0.215462,140023.022941,0.175579,0.012258
9812063,9812063,,7,7,14,7,7,14,0.000245,0.000021,0,8991,15,0.000021,15,0.15204,0.166772,42905.708421,0.065934,0.002879
9909215,9909215,,79,36,115,79,36,115,0.011497,0.014381,0,9526,30,0.000062,11,0.240871,0.273026,371837.028671,0.078947,0.030307
9910138,9910138,,38,20,58,38,20,58,0.002267,0.005619,0,9529,30,0.000065,13,0.197195,0.218087,11118.174919,0.125227,0.016629
1028,1028,,1,6,7,1,6,7,0.000001,0.000201,0,9549,28,0.000011,12,0.187418,0.207179,159.149516,0.285714,0.000246
9706175,9706175,,97,10,107,97,10,107,0.007925,0.002848,0,4924,0,0.000124,14,0.186422,0.217498,38936.194333,0.05149,0.03611
9712195,9712195,,11,24,35,11,24,35,0.001825,0.005735,0,6419,0,0.000024,13,0.201193,0.239365,29797.700662,0.130252,0.004324
9802162,9802162,,44,13,57,44,13,57,0.002829,0.000187,0,5768,28,0.000104,14,0.175568,0.198519,244972.814823,0.059524,0.014761
9809070,9809070,,18,25,43,18,25,43,0.002562,0.006805,0,6687,2,0.000025,13,0.198953,0.231212,42485.756205,0.146733,0.007002
9812136,9812136,,13,5,18,13,5,18,0.000828,0.000236,0,9548,28,0.000028,14,0.175507,0.197242,36412.469818,0.143791,0.003409
9910055,9910055,,20,17,37,20,17,37,0.00118,0.002697,0,9547,0,0.000036,11,0.218791,0.247768,56168.716689,0.09009,0.006993
9611205,9611205,,30,18,48,30,18,48,0.002936,0.005573,0,3538,0,0.000038,11,0.219125,0.257032,11503.307134,0.112145,0.011971
9704087,9704087,,19,30,49,19,30,49,0.002516,0.012877,0,4266,2,0.000058,13,0.196684,0.233729,35089.591227,0.153061,0.012278
9704145,9704145,,86,16,102,86,16,102,0.010213,0.007657,0,4269,0,0.000121,14,0.190946,0.226295,36051.831966,0.073384,0.035739
9705056,9705056,,30,12,42,30,12,42,0.001847,0.003771,0,4923,2,0.000064,12,0.196262,0.226311,31897.174615,0.135889,0.011329
9706025,9706025,,24,69,93,24,69,93,0.002027,0.017121,0,4505,0,0.000032,14,0.22374,0.27798,150898.937566,0.079126,0.012058
9707018,9707018,,59,16,75,59,16,75,0.006101,0.005765,0,4925,0,0.000055,15,0.186104,0.222613,8523.80713,0.107027,0.021435
9707126,9707126,,58,72,130,58,72,130,0.005993,0.012451,0,4943,0,0.000048,11,0.226523,0.274957,259381.68032,0.066726,0.021999
9707134,9707134,,54,13,67,54,13,67,0.004967,0.005932,0,4945,0,0.000072,13,0.19615,0.229457,38627.213078,0.078924,0.019951
9707222,9707222,,28,17,45,28,17,45,0.003086,0.005286,0,4944,0,0.000033,12,0.202091,0.237752,57061.859306,0.166162,0.010557
9709058,9709058,,34,64,98,34,64,98,0.004192,0.009394,0,5939,0,0.000028,12,0.217802,0.266757,84900.656173,0.083947,0.012487
9709116,9709116,,23,13,36,23,13,36,0.001907,0.001364,0,5169,0,0.00004,13,0.188216,0.215196,43058.453259,0.162698,0.009733
9710023,9710023,,30,14,44,30,14,44,0.004513,0.003174,0,5589,0,0.000034,13,0.186526,0.214807,4229.165003,0.162262,0.010523
9307001,9307001,,42,0,42,42,0,42,0.000529,0,0,1364,28,0.000599,0,0,0,0,0.117305,0.013021
9311026,9311026,,3,2,5,3,2,5,0.00021,0.000007,0,5767,28,0.000019,1,1,1,605.232658,0.3,0.001146
9408014,9408014,,34,2,36,34,2,36,0.000459,0.000007,0,3933,28,0.000089,1,1,1,1130.055088,0.138889,0.009933
9502156,9502156,,18,3,21,18,3,21,0.000124,0.000096,0,4776,28,0.000079,4,0.362832,0.416667,5873.119697,0.140476,0.006356
9508135,9508135,,9,6,15,9,6,15,0.000033,0.00006,0,5766,28,0.000025,4,0.397436,0.489247,31455.952335,0.204762,0.002638
9512084,9512084,,12,3,15,12,3,15,0.000234,0.000012,0,5756,28,0.000046,1,1,1,662.154596,0.27619,0.003468
9606067,9606067,,4,1,5,4,1,5,0.000009,0.000003,0,5759,28,0.000019,2,0.571429,0.625,0,0.45,0.001259
9607141,9607141,,20,3,23,20,3,23,0.000216,0.000016,0,4780,28,0.000038,5,0.306533,0.358743,5015.607466,0.22332,0.007332
9611045,9611045,,1,6,7,1,6,7,0.000002,0.000006,0,5758,28,0.000017,11,0.168797,0.204219,71755.954038,0.238095,0.000569
9611127,9611127,,11,14,25,11,14,25,0.000221,0.000931,0,5757,28,0.000025,10,0.209242,0.238925,48260.085791,0.106667,0.003224
9509158,9509158,,28,3,31,28,3,31,0.000405,0.000013,0,2110,28,0.000103,1,1,1,15478.264512,0.112903,0.007662
9709063,9709063,,29,9,38,29,9,38,0.003657,0.004614,0,5110,2,0.000037,15,0.182816,0.21323,9523.491827,0.170697,0.012452
9709199,9709199,,32,12,44,32,12,44,0.003673,0.00392,0,5111,2,0.000035,13,0.188489,0.214387,5568.492905,0.186575,0.012928
9801110,9801110,,24,28,52,24,28,52,0.001898,0.00575,0,5704,2,0.000049,15,0.202013,0.244461,86261.945662,0.113499,0.016167
9801183,9801183,,24,31,55,24,31,55,0.003308,0.008991,0,6402,2,0.000025,16,0.192057,0.229654,30881.278743,0.12963,0.008578
9801189,9801189,,20,15,35,20,15,35,0.002155,0.004704,0,6403,2,0.000027,13,0.193785,0.222804,12176.584344,0.248739,0.007578
9802088,9802088,,57,26,83,57,26,83,0.005105,0.005387,0,5709,2,0.000059,13,0.203748,0.236067,181812.498548,0.077432,0.025436
9805091,9805091,,25,25,50,25,25,50,0.002468,0.007255,0,6686,2,0.000031,14,0.203318,0.236869,32060.238571,0.126122,0.013023
9806081,9806081,,17,12,29,17,12,29,0.002269,0.002947,0,6665,2,0.000019,15,0.185224,0.214293,3783.308363,0.213054,0.00622
9806082,9806082,,14,12,26,14,12,26,0.001835,0.00586,0,6663,2,0.000018,14,0.175594,0.201897,2465.683267,0.216923,0.004817
9808188,9808188,,30,24,54,30,24,54,0.004824,0.003008,0,6684,2,0.000027,13,0.193137,0.218449,22671.875115,0.133823,0.010637
9712164,9712164,,14,16,30,14,16,30,0.002256,0.00269,0,6236,0,0.000018,14,0.179218,0.209955,2142.412312,0.211494,0.004512
9804023,9804023,,25,12,37,25,12,37,0.003743,0.000805,0,6396,0,0.000026,15,0.173383,0.19784,11554.451045,0.171171,0.007937
9809163,9809163,,3,4,7,3,4,7,0.000037,0.000048,0,9546,28,0.000014,15,0.149402,0.162818,451.83685,0.285714,0.000928
9905050,9905050,,16,2,18,16,2,18,0.001031,0.0003,0,9545,0,0.000028,16,0.161424,0.180443,622.48716,0.205882,0.004174
9907155,9907155,,16,16,32,16,16,32,0.000691,0.007577,0,9544,0,0.00002,12,0.198956,0.225464,30431.140705,0.094758,0.004491
1029,1029,,7,33,40,7,33,40,0.000971,0.007425,0,9562,0,0.000012,12,0.206437,0.23448,9652.298065,0.104487,0.002205
9209101,9209101,,4,0,4,4,0,4,0.000104,0,0,634,0,0.000028,0,0,0,0,0.25,0.001653
9611007,9611007,,23,14,37,23,14,37,0.002009,0.004918,0,4025,0,0.000031,12,0.21031,0.242151,3228.358697,0.105856,0.00862
9712035,9712035,,5,25,30,5,25,30,0.000182,0.005406,0,7324,0,0.000013,12,0.178355,0.213402,1366.663138,0.166667,0.001395
9811194,9811194,,31,14,45,31,14,45,0.002026,0.003168,0,8334,0,0.000045,12,0.214337,0.243687,136204.461935,0.074747,0.01121
9812028,9812028,,22,31,53,22,31,53,0.001032,0.006703,0,9552,0,0.000021,13,0.192408,0.222949,8390.45374,0.152758,0.006827
9812209,9812209,,22,28,50,22,28,50,0.001402,0.002579,0,9558,0,0.00002,12,0.211213,0.241833,34752.369139,0.106531,0.00602
9907134,9907134,,11,38,49,11,38,49,0.000498,0.004572,0,9560,0,0.000016,13,0.196555,0.22737,13654.410367,0.177296,0.003782
9907164,9907164,,16,18,34,16,18,34,0.000812,0.002238,0,9561,0,0.000017,13,0.192767,0.216875,27034.39485,0.165775,0.005756
9509070,9509070,,18,30,48,18,30,48,0.003653,0.008616,0,1165,13,0.00019,10,0.224085,0.278273,55429.913116,0.104167,0.014588
9201054,9201054,,26,0,26,26,0,26,0.001983,0,0,893,2,0.001842,0,0,0,0,0.061538,0.027405
9401070,9401070,,149,2,151,149,2,151,0.010504,0.000178,0,391,5,0.000545,3,0.512195,0.539683,22033.033841,0.027461,0.070216
9510200,9510200,,81,12,93,81,12,93,0.008856,0.005806,0,1388,2,0.000426,14,0.202336,0.254931,19460.638602,0.076438,0.068288
9511159,9511159,,8,24,32,8,24,32,0.000882,0.009972,0,1432,0,0.000054,11,0.235186,0.284279,21527.861386,0.149194,0.00879
9512121,9512121,,26,16,42,26,16,42,0.002438,0.007917,0,1688,0,0.00012,11,0.209946,0.247859,8965.154336,0.113821,0.022393
9512191,9512191,,1,4,5,1,4,5,0.000186,0.002194,0,1694,0,0.000036,12,0.190409,0.215954,840.32953,0.3,0.00527
9512203,9512203,,19,36,55,19,36,55,0.002659,0.013763,0,1540,0,0.000137,9,0.245216,0.291803,35879.899704,0.117172,0.021001
9601057,9601057,,70,30,100,70,30,100,0.008931,0.011482,0,1607,2,0.000344,10,0.24609,0.293165,48414.208083,0.089495,0.062211
9601098,9601098,,18,8,26,18,8,26,0.002233,0.003084,0,1687,2,0.000085,10,0.216793,0.248716,465.170856,0.201538,0.018206
9604070,9604070,,48,18,66,48,18,66,0.00489,0.006285,0,1907,0,0.000096,10,0.226638,0.264624,39944.159703,0.07972,0.030498
9608061,9608061,,38,28,66,38,28,66,0.00431,0.009039,0,2960,0,0.000058,11,0.230827,0.270621,26068.66881,0.134033,0.01584
9705074,9705074,,69,9,78,69,9,78,0.011003,0.0058,0,3540,2,0.000072,11,0.207746,0.23723,3783.826772,0.071429,0.036751
9705084,9705084,,71,15,86,71,15,86,0.010578,0.005238,0,4093,2,0.000072,13,0.207153,0.24031,34583.353309,0.070315,0.037473
9706142,9706142,,21,7,28,21,7,28,0.002005,0.001251,0,4308,2,0.000024,14,0.184387,0.20962,1664.465947,0.214286,0.00824
9710218,9710218,,18,39,57,18,39,57,0.001883,0.008427,0,5013,2,0.000022,13,0.210225,0.247302,65797.164049,0.125627,0.007331
9710247,9710247,,11,17,28,11,17,28,0.00139,0.007241,0,5658,2,0.000019,12,0.199179,0.232232,198220.983983,0.207672,0.004542
9704129,9704129,,15,21,36,15,21,36,0.000894,0.005402,0,4287,0,0.000019,14,0.200956,0.240137,5686.857571,0.205556,0.004786
9708137,9708137,,19,15,34,19,15,34,0.001553,0.004866,0,4515,2,0.000022,12,0.198135,0.226734,7231.799514,0.183601,0.00732
9303017,9303017,,60,4,64,60,4,64,0.002292,0.00013,0,33,0,0.000296,1,1,1,10389.845163,0.089534,0.023419
9312159,9312159,,11,0,11,11,0,11,0.000533,0,0,3131,0,0.000022,0,0,0,0,0.136364,0.00307
9608005,9608005,,42,13,55,42,13,55,0.0052,0.004816,0,3153,0,0.000043,9,0.228337,0.259741,6950.340035,0.123232,0.018972
9708130,9708130,,22,42,64,22,42,64,0.005102,0.016785,0,5828,0,0.000019,12,0.231642,0.278834,87547.84392,0.106895,0.013947
9709004,9709004,,12,16,28,12,16,28,0.000727,0.001556,0,5955,0,0.000014,12,0.192495,0.225798,17812.613373,0.17328,0.003671
9709123,9709123,,8,52,60,8,52,60,0.001758,0.013116,0,5270,2,0.000013,14,0.20461,0.248491,34250.061283,0.14548,0.002951
9710016,9710016,,8,9,17,8,9,17,0.000775,0.001157,0,7320,0,0.000013,13,0.205735,0.239268,630.422629,0.161765,0.002258
9801205,9801205,,53,29,82,53,29,82,0.005515,0.006286,0,5806,0,0.000047,16,0.195436,0.230307,67352.005907,0.113821,0.022295
9804014,9804014,,7,30,37,7,30,37,0.000335,0.002998,0,7322,0,0.000013,13,0.220161,0.261769,13134.227836,0.13964,0.002263
9601151,9601151,,22,13,35,22,13,35,0.001804,0.001431,0,2443,0,0.000056,14,0.206401,0.2539,23574.713998,0.060504,0.009594
9712166,9712166,,25,15,40,25,15,40,0.001919,0.005623,0,5604,0,0.000074,15,0.187215,0.219341,16706.94539,0.053846,0.014873
9807111,9807111,,17,13,30,17,13,30,0.000825,0.002386,0,7288,0,0.000032,15,0.171059,0.198573,11169.557318,0.056322,0.00501
9501053,9501053,,19,2,21,19,2,21,0.000773,0.000036,0,1182,0,0.000057,4,0.385965,0.439394,2189.78509,0.080952,0.007024
9604103,9604103,,49,31,80,49,31,80,0.004299,0.009959,0,2326,2,0.000188,9,0.242612,0.286707,49138.618578,0.081171,0.033853
9709030,9709030,,22,24,46,22,24,46,0.001063,0.003087,0,6129,0,0.000029,12,0.209522,0.245316,105008.692214,0.159903,0.009251
9806230,9806230,,42,17,59,42,17,59,0.001498,0.000262,0,8109,0,0.000064,14,0.176271,0.202717,74733.051108,0.118936,0.01461
9608186,9608186,,30,17,47,30,17,47,0.002445,0.004677,0,3154,0,0.000038,9,0.233314,0.266262,8194.395229,0.142461,0.013713
9705031,9705031,,39,6,45,39,6,45,0.003488,0.002306,0,4049,4,0.000041,12,0.182427,0.209366,1153.256804,0.166667,0.021688
9709013,9709013,,67,20,87,67,20,87,0.005629,0.004896,0,4489,0,0.000078,14,0.192317,0.226693,145454.876105,0.103849,0.026818
9710116,9710116,,65,31,96,65,31,96,0.005356,0.007953,0,4506,0,0.000055,13,0.209338,0.245249,99400.315098,0.078728,0.026022
9801067,9801067,,17,37,54,17,37,54,0.001912,0.003884,0,5805,0,0.000022,16,0.205977,0.247351,131145.134638,0.149895,0.008714
9802168,9802168,,46,42,88,46,42,88,0.003034,0.008962,0,6504,0,0.000042,16,0.196674,0.237646,121657.196765,0.078109,0.014592
9802189,9802189,,20,8,28,20,8,28,0.001482,0.002475,0,5936,0,0.00003,16,0.171636,0.196062,6528.258011,0.198413,0.010389
9804210,9804210,,34,36,70,34,36,70,0.002442,0.005757,0,6470,0,0.000024,12,0.207096,0.239948,14009.752314,0.140994,0.009495
9805076,9805076,,9,34,43,9,34,43,0.000735,0.004735,0,6495,0,0.000016,13,0.198992,0.230524,27674.429915,0.217608,0.003784
9805220,9805220,,28,26,54,28,26,54,0.001806,0.005274,0,6505,0,0.000024,13,0.199702,0.228293,28170.784298,0.133823,0.008945
9807117,9807117,,8,23,31,8,23,31,0.000986,0.003025,0,8238,0,0.000013,12,0.200556,0.228561,4239.082845,0.229032,0.002306
9809026,9809026,,18,22,40,18,22,40,0.001293,0.001528,0,9551,0,0.00002,13,0.191187,0.221424,6871.713963,0.166026,0.005954
9406175,9406175,,16,3,19,16,3,19,0.000367,0.000051,0,335,13,0.000247,2,0.636364,0.714286,27763.351273,0.093567,0.015562
9411188,9411188,,8,3,11,8,3,11,0.00083,0.000052,0,1318,13,0.000029,5,0.324324,0.395139,10516.096296,0.118182,0.004589
9705237,9705237,,20,23,43,20,23,43,0.00125,0.003459,0,4499,0,0.000021,12,0.219057,0.257229,9638.155358,0.157807,0.006628
9805131,9805131,,70,52,122,70,52,122,0.015459,0.02732,0,6559,1,0.000078,12,0.223133,0.256384,206488.919971,0.095922,0.044407
9811228,9811228,,21,37,58,21,37,58,0.001704,0.004915,0,7748,0,0.000019,13,0.214808,0.248951,167243.346903,0.098306,0.006186
9709010,9709010,,15,28,43,15,28,43,0.001351,0.005617,0,4491,4,0.000017,15,0.201841,0.243716,10158.146782,0.177187,0.006964
9902179,9902179,,9,25,34,9,25,34,0.00048,0.001923,0,9559,0,0.000014,13,0.192434,0.219741,4924.227454,0.2041,0.003407
9903215,9903215,,13,36,49,13,36,49,0.000511,0.00429,0,9557,0,0.000017,12,0.197349,0.228479,34332.218503,0.114796,0.003327
9811064,9811064,,7,21,28,7,21,28,0.000904,0.004144,0,8239,0,0.000012,12,0.202898,0.228503,17525.491775,0.181217,0.001961
1030,1030,,0,4,4,0,4,4,0,0.000001,0,9566,5,0.00001,8,0.205272,0.235015,0,0,0
9406173,9406173,,2,2,4,2,2,4,0,0,0,8533,15,0.000019,2,0.75,0.833333,21.899246,0.166667,0.000452
9612009,9612009,,5,5,10,5,5,10,0.000001,0.000046,0,8535,5,0.000017,7,0.245527,0.278918,16753.530123,0.044444,0.001137
9704150,9704150,,4,1,5,4,1,5,0.000001,0,0,9565,5,0.000016,9,0.169107,0.184371,386.829027,0.05,0.000909
9902165,9902165,,5,5,10,5,5,10,0.000073,0.000004,0,9564,15,0.000015,2,0.631579,0.708333,45.748016,0.177778,0.001142
9402138,9402138,,4,1,5,4,1,5,0,0,0,4806,15,0.000044,1,1,1,27.490227,0.15,0.000923
9405108,9405108,,2,1,3,2,1,3,0.000001,0,0,4807,15,0.000019,2,0.666667,0.75,10074.211426,0.166667,0.000459
9204048,9204048,,5,0,5,5,0,5,0.000001,0,0,2839,23,0.000063,0,0,0,0,0.05,0.00122
9410137,9410137,,2,2,4,2,2,4,0.000023,0,0,8534,15,0.000015,2,0.666667,0.75,7289.178046,0.083333,0.000478
9506079,9506079,,14,2,16,14,2,16,0.000011,0.000002,0,2630,5,0.000074,8,0.202643,0.227308,15845.063486,0.075,0.00334
9210032,9210032,,17,1,18,17,1,18,0.000045,0.000001,0,2518,15,0.000072,1,1,1,5792.701999,0.058824,0.004084
9305080,9305080,,11,6,17,11,6,17,0.000083,0.000112,0,4811,15,0.000031,1,1,1,7182.695364,0.084559,0.002642
9306012,9306012,,3,4,7,3,4,7,0.000001,0.000003,0,9563,15,0.000016,1,1,1,37.081349,0.047619,0.000704
1031,1031,,5,3,8,5,3,8,0.000439,0.000879,0,9576,1,0.000013,13,0.188788,0.205119,1147.530936,0.214286,0.001411
9806236,9806236,,25,16,41,25,16,41,0.002881,0.017138,0,9350,1,0.000038,13,0.199172,0.225006,60716.915689,0.098171,0.007196
9910096,9910096,,54,24,78,54,24,78,0.005126,0.019819,0,9575,1,0.000074,13,0.201767,0.225319,104802.835355,0.081419,0.015251
9208074,9208074,,30,1,31,30,1,31,0.001909,0.000002,0,904,0,0.000119,1,1,1,3111.582454,0.025806,0.008559
9712043,9712043,,14,26,40,14,26,40,0.000239,0.0001,0,6969,28,0.000034,15,0.165315,0.192577,106192.027528,0.08141,0.003591
9712246,9712246,,2,2,4,2,2,4,0.000207,0.000008,0,9349,1,0.000012,2,0.666667,0.75,11920.212876,0.083333,0.00063
9802023,9802023,,8,17,25,8,17,25,0.00054,0.000887,0,6996,15,0.000019,15,0.188171,0.217734,159696.878456,0.043333,0.002365
9804172,9804172,,21,15,36,21,15,36,0.005572,0.018732,0,6097,1,0.000033,12,0.193268,0.220269,18887.670166,0.143651,0.017784
9805125,9805125,,26,5,31,26,5,31,0.002756,0.015155,0,7055,1,0.00006,14,0.18538,0.208256,14583.971523,0.109677,0.008066
9511063,9511063,,4,3,7,4,3,7,0.000646,0.000012,0,9574,1,0.000015,1,1,1,777.077222,0.047619,0.001597
9606027,9606027,,6,8,14,6,8,14,0.000234,0.000003,0,6966,28,0.00004,8,0.208494,0.283355,37529.042119,0.142857,0.001893
9609034,9609034,,6,0,6,6,0,6,0.000651,0,0,9345,1,0.000024,0,0,0,0,0.1,0.001925
9808004,9808004,,26,11,37,26,11,37,0.002701,0.005462,0,7607,1,0.00006,13,0.180566,0.203735,28638.814838,0.107357,0.0093
9903020,9903020,,16,7,23,16,7,23,0.001886,0.005986,0,9351,1,0.000027,13,0.198433,0.219646,9418.598056,0.164032,0.004993
9906149,9906149,,4,7,11,4,7,11,0.00085,0.01554,0,9572,1,0.000016,14,0.185027,0.2079,1.277873,0.409091,0.001413
9906167,9906167,,22,5,27,22,5,27,0.002454,0.000197,0,9571,1,0.000034,13,0.156373,0.170728,8184.985264,0.10114,0.006417
9907020,9907020,,3,10,13,3,10,13,0.000667,0.015611,0,9573,1,0.000014,14,0.183106,0.207556,13.507799,0.339744,0.001167
1032,1032,,36,6,42,36,6,42,0.001294,0.00101,0,9587,30,0.000068,13,0.187379,0.203754,2716.825851,0.11266,0.012638
9912070,9912070,,29,11,40,29,11,40,0.002464,0.002485,0,9586,30,0.000056,12,0.210757,0.232346,50965.336317,0.10641,0.013547
9802129,9802129,,6,2,8,6,2,8,0.000499,0.001226,0,6865,30,0.000021,16,0.161642,0.179488,246.285588,0.25,0.002957
9911018,9911018,,12,8,20,12,8,20,0.000563,0.002133,0,9585,30,0.000023,13,0.190282,0.207987,6541.545814,0.184211,0.003365
9911026,9911026,,4,15,19,4,15,19,0.000382,0.003149,0,9582,30,0.000016,13,0.190068,0.209472,17508.857641,0.274854,0.002589
9912038,9912038,,13,30,43,13,30,43,0.000936,0.027614,0,9578,30,0.000022,13,0.204375,0.230009,17941.196194,0.129568,0.005241
1033,1033,,110,62,172,110,62,172,0.007185,0.00509,0,9706,25,0.000153,11,0.213022,0.239513,444602.625577,0.057528,0.038979
9910132,9910132,,88,7,95,88,7,95,0.003659,0.001581,0,8943,25,0.000156,12,0.198494,0.217812,59021.129911,0.073684,0.03111
9910174,9910174,,56,43,99,56,43,99,0.004806,0.013436,0,8818,25,0.000048,11,0.229516,0.261457,126739.431983,0.069161,0.01964
9911083,9911083,,20,21,41,20,21,41,0.001653,0.003159,0,9436,25,0.000027,12,0.203788,0.226156,46236.428653,0.141463,0.007946
9911104,9911104,,20,19,39,20,19,39,0.001548,0.00232,0,9664,25,0.000027,12,0.20013,0.221569,49423.080054,0.156545,0.007908
9911165,9911165,,61,10,71,61,10,71,0.005148,0.004502,0,8770,25,0.000061,12,0.198399,0.21909,9174.817161,0.092555,0.023621
9911181,9911181,,37,11,48,37,11,48,0.002814,0.00309,0,8769,25,0.000048,12,0.19834,0.219592,11388.748571,0.112145,0.015341
9911237,9911237,,16,20,36,16,20,36,0.001704,0.001755,0,9675,25,0.000024,11,0.206009,0.227213,47753.590607,0.151587,0.00714
9912060,9912060,,40,22,62,40,22,62,0.002597,0.00308,0,9705,25,0.000057,11,0.205683,0.22826,42700.771626,0.115547,0.015513
9912125,9912125,,21,53,74,21,53,74,0.001407,0.023375,0,9688,25,0.000029,11,0.223708,0.253394,126605.214645,0.094965,0.007736
9912166,9912166,,1,6,7,1,6,7,0.00006,0.001198,0,9704,25,0.000012,12,0.192599,0.211965,704.378379,0.214286,0.001134
9912182,9912182,,9,19,28,9,19,28,0.000479,0.001642,0,9703,25,0.000019,11,0.20346,0.224346,2825.199563,0.251323,0.003622
9912186,9912186,,29,8,37,29,8,37,0.00161,0.001688,0,9702,25,0.000046,12,0.197407,0.215751,13072.727547,0.10961,0.009737
9912193,9912193,,6,18,24,6,18,24,0.000308,0.002046,0,9701,25,0.000015,12,0.195454,0.215129,3748.534227,0.210145,0.002551
9912230,9912230,,10,28,38,10,28,38,0.000935,0.003721,0,9700,25,0.000017,11,0.217356,0.242368,132296.20608,0.137269,0.004368
9912232,9912232,,54,20,74,54,20,74,0.002389,0.019364,0,9658,25,0.000056,11,0.203294,0.226215,20830.13309,0.070344,0.016754
9912233,9912233,,61,15,76,61,15,76,0.003892,0.00372,0,9588,25,0.000067,11,0.19872,0.220159,14331.801229,0.110175,0.021447
9912287,9912287,,99,16,115,99,16,115,0.009142,0.009964,0,9656,25,0.000082,11,0.227719,0.258099,160290.719797,0.089016,0.035395
1071,1071,,95,20,115,95,20,115,0.010882,0.003076,0,9711,25,0.000114,11,0.205571,0.22983,76729.025093,0.07376,0.033952
9912027,9912027,,33,20,53,33,20,53,0.003573,0.022321,0,9710,25,0.000036,11,0.231202,0.26371,44627.696401,0.12881,0.011656
9912053,9912053,,8,17,25,8,17,25,0.001554,0.002415,0,9708,13,0.000019,12,0.201404,0.225547,6626.706837,0.211667,0.00362
9811045,9811045,,8,14,22,8,14,22,0.00057,0.017731,0,8707,13,0.00002,12,0.195718,0.222223,7609.011792,0.090909,0.002359
9802195,9802195,,45,14,59,45,14,59,0.013675,0.014965,0,5608,1,0.000085,14,0.197101,0.227171,5800.986569,0.217709,0.043384
9803109,9803109,,50,49,99,50,49,99,0.012891,0.026318,0,5815,1,0.000067,13,0.217013,0.253184,176373.906013,0.119975,0.038496
9804093,9804093,,15,17,32,15,17,32,0.004331,0.018451,0,6558,1,0.000028,12,0.2036,0.227625,3385.556354,0.290323,0.015606
9903003,9903003,,4,16,20,4,16,20,0.000799,0.019115,0,8752,1,0.000015,12,0.195411,0.222211,2524.530869,0.181579,0.002379
9804096,9804096,,28,35,63,28,35,63,0.001382,0.002286,0,7662,0,0.000048,12,0.200744,0.234452,63643.749532,0.113415,0.012439
9809195,9809195,,35,9,44,35,9,44,0.002118,0.002029,0,8716,25,0.000051,13,0.188235,0.211657,14029.594024,0.13055,0.014428
9808124,9808124,,31,74,105,31,74,105,0.001926,0.010579,0,7718,2,0.000033,11,0.244998,0.283578,784098.032427,0.077289,0.012578
9903164,9903164,,2,28,30,2,28,30,0.000224,0.020561,0,8777,2,0.000011,13,0.201832,0.231963,13699.831084,0.13908,0.000801
9810028,9810028,,1,0,1,1,0,1,0.000011,0,0,8740,25,0.000088,0,0,0,0,0,0.001442
9908146,9908146,,13,24,37,13,24,37,0.001391,0.005679,0,8942,0,0.000043,13,0.219485,0.25533,67188.691082,0.063814,0.005483
9209032,9209032,,95,0,95,95,0,95,0.008002,0,0,401,2,0.000348,0,0,0,0,0.027324,0.050764
9404092,9404092,,38,19,57,38,19,57,0.000752,0.000869,0,495,0,0.000116,5,0.339286,0.469123,44233.394062,0.06109,0.015602
9709023,9709023,,10,14,24,10,14,24,0.000733,0.002145,0,7663,0,0.000018,17,0.165803,0.203746,2239.70544,0.222826,0.003413
9807225,9807225,,27,16,43,27,16,43,0.007389,0.017977,0,6469,1,0.00004,13,0.20579,0.23463,40156.10318,0.138427,0.02034
9902055,9902055,,32,27,59,32,27,59,0.002063,0.006883,0,8606,0,0.000029,11,0.221016,0.253898,107999.711733,0.076856,0.010939
9905037,9905037,,10,40,50,10,40,50,0.003153,0.020267,0,8246,2,0.000018,13,0.211697,0.24324,71710.575301,0.117143,0.010476
9906206,9906206,,33,50,83,33,50,83,0.003261,0.027762,0,8817,25,0.000037,12,0.229788,0.264976,126667.392942,0.063033,0.009631
9512170,9512170,,1,7,8,1,7,8,0.000027,0.001741,0,8946,13,0.000012,8,0.253661,0.293391,1413.867884,0.107143,0.000256
9911015,9911015,,67,7,74,67,7,74,0.002508,0.001392,0,8944,25,0.0001,12,0.197621,0.216236,16048.108083,0.092188,0.021082
9711038,9711038,,10,11,21,10,11,21,0.000069,0.000155,0,9663,0,0.000019,12,0.181726,0.204931,42163.166058,0.278571,0.002766
9706012,9706012,,8,1,9,8,1,9,0.000026,0.00002,0,9674,22,0.000027,2,0.538462,0.571429,231.569464,0.097222,0.002008
9910202,9910202,,24,22,46,24,22,46,0.001891,0.002463,0,9673,0,0.000028,15,0.181919,0.209553,53930.326064,0.100483,0.007106
9809057,9809057,,133,10,143,133,10,143,0.02689,0.017689,0,7036,1,0.000137,14,0.192852,0.217844,318029.437478,0.043682,0.056627
9903226,9903226,,35,11,46,35,11,46,0.004771,0.002863,0,8637,1,0.000048,13,0.197656,0.222541,32232.851494,0.083575,0.013825
9905115,9905115,,19,71,90,19,71,90,0.001692,0.006823,0,8824,0,0.000027,14,0.197855,0.242627,141673.483976,0.087266,0.008765
9910245,9910245,,25,5,30,25,5,30,0.004372,0.01572,0,8771,1,0.000034,13,0.179174,0.201464,1492.369296,0.113793,0.008746
9911164,9911164,,17,45,62,17,45,62,0.001325,0.004796,0,9687,0,0.00003,12,0.219655,0.252841,120665.724174,0.062665,0.006818
9901103,9901103,,6,20,26,6,20,26,0.000103,0.003652,0,8587,0,0.000015,16,0.173494,0.206482,14121.132605,0.116923,0.001555
9303160,9303160,,117,0,117,117,0,117,0.004728,0,0,2269,9,0.00024,0,0,0,0,0.110669,0.040244
9509166,9509166,,68,12,80,68,12,80,0.002575,0.000059,0,2738,9,0.000088,5,0.352313,0.431481,134244.765396,0.129589,0.023574
9511134,9511134,,80,3,83,80,3,83,0.003882,0.000094,0,3755,9,0.000086,2,0.8,0.875,2165.637755,0.154129,0.02661
9512210,9512210,,58,9,67,58,9,67,0.002451,0.00017,0,2748,9,0.000067,6,0.294964,0.366396,67610.709589,0.183175,0.020726
9606102,9606102,,56,17,73,56,17,73,0.003985,0.001196,0,3793,9,0.000045,10,0.220328,0.251173,85931.384377,0.129376,0.017693
9609238,9609238,,26,34,60,26,34,60,0.002142,0.003541,0,3809,9,0.000025,14,0.228706,0.273978,245141.56626,0.10791,0.00818
9610168,9610168,,44,19,63,44,19,63,0.001587,0.000291,0,7098,9,0.000035,11,0.207995,0.241938,64682.387472,0.18894,0.013455
9703028,9703028,,27,10,37,27,10,37,0.002082,0.000147,0,7096,9,0.000024,15,0.124418,0.150506,34938.633399,0.165916,0.008577
9711163,9711163,,19,18,37,19,18,37,0.00203,0.002776,0,7146,9,0.000021,13,0.209605,0.247816,116649.598201,0.098348,0.006179
9804084,9804084,,9,39,48,9,39,48,0.00039,0.023286,0,9609,9,0.000014,13,0.230931,0.268279,45515.464976,0.08156,0.00244
9908139,9908139,,5,16,21,5,16,21,0.000294,0.000416,0,9699,9,0.000012,12,0.20365,0.227255,10305.014228,0.230952,0.001733
9909068,9909068,,11,17,28,11,17,28,0.000698,0.002049,0,9697,9,0.000014,13,0.204892,0.229047,22533.813034,0.181217,0.003254
9704045,9704045,,6,7,13,6,7,13,0.000512,0.001111,0,3393,13,0.000019,10,0.202333,0.228655,13842.769242,0.083333,0.003199
9907082,9907082,,17,4,21,17,4,21,0.000837,0.001569,0,9657,0,0.000033,16,0.164749,0.187655,3622.897246,0.17381,0.005043
9911230,9911230,,17,15,32,17,15,32,0.00206,0.00917,0,9655,1,0.00003,11,0.226994,0.256259,113463.510063,0.142137,0.006131
1034,1034,,0,4,4,0,4,4,0,0,0,9712,5,0.00001,3,0.615385,0.729167,0,0.166667,0
9510091,9510091,,6,1,7,6,1,7,0,0,0,9213,5,0.000101,1,1,1,3.5,0.190476,0.001659
1035,1035,,53,9,62,53,9,62,0.003234,0.00059,0,9714,2,0.000133,14,0.167525,0.185128,89396.644148,0.084611,0.015088
9404162,9404162,,62,11,73,62,11,73,0.002478,0.000088,0,1351,2,0.000145,5,0.369942,0.463802,19806.523338,0.063546,0.022318
9604123,9604123,,27,16,43,27,16,43,0.000765,0.000317,0,2932,2,0.000081,10,0.207735,0.248098,93925.518921,0.086932,0.009101
9902099,9902099,,10,6,16,10,6,16,0.000175,0.000161,0,8579,2,0.00003,11,0.175565,0.205248,385.968505,0.254167,0.003102
9910205,9910205,,14,5,19,14,5,19,0.00146,0.000323,0,9713,2,0.000036,15,0.165906,0.184656,11095.476794,0.157895,0.004046
9201004,9201004,,44,0,44,44,0,44,0.001427,0,0,173,2,0.000657,0,0,0,0,0.10148,0.016116
9207050,9207050,,36,1,37,36,1,37,0.000545,0.000014,0,1345,2,0.000171,1,1,1,4462.085771,0.089339,0.014037
9211025,9211025,,12,1,13,12,1,13,0.000089,0.000017,0,462,2,0.000245,1,1,1,181.690184,0.115385,0.0052
9302049,9302049,,19,2,21,19,2,21,0.000337,0.000005,0,465,9,0.000161,1,1,1,1237.078639,0.069048,0.008564
9303025,9303025,,8,1,9,8,1,9,0.000133,0.000001,0,1350,2,0.00004,2,0.666667,0.75,500.46347,0.138889,0.003227
9303122,9303122,,18,2,20,18,2,20,0.000346,0.000018,0,464,2,0.000151,1,1,1,4490.430992,0.060526,0.00842
9303172,9303172,,18,2,20,18,2,20,0.000436,0.000001,0,1349,10,0.000122,3,0.538462,0.619048,37031.374737,0.071053,0.007217
9308129,9308129,,45,3,48,45,3,48,0.001577,0.000029,0,463,2,0.000176,1,1,1,2675.000266,0.088652,0.017484
9310170,9310170,,85,10,95,85,10,95,0.001441,0.000052,0,468,9,0.000394,4,0.5,0.5875,118067.948495,0.038522,0.028715
9312187,9312187,,24,5,29,24,5,29,0.000189,0.000021,0,1337,9,0.000075,5,0.377622,0.435802,25759.953615,0.140394,0.009042
9402007,9402007,,28,4,32,28,4,32,0.000617,0.000118,0,1243,0,0.000075,1,1,1,428.628398,0.081653,0.009465
9409043,9409043,,14,0,14,14,0,14,0.000272,0,0,2287,28,0.000064,0,0,0,0,0.10989,0.004017
9508139,9508139,,14,2,16,14,2,16,0.000112,0.000003,0,2289,28,0.000051,6,0.225641,0.274621,63553.329708,0.108333,0.004033
9309030,9309030,,28,2,30,28,2,30,0.000253,0.000005,0,2925,10,0.000111,3,0.533333,0.604167,1088.766602,0.057471,0.006863
9503099,9503099,,75,3,78,75,3,78,0.002684,0.000092,0,1603,3,0.000148,6,0.328084,0.365333,14306.94287,0.101066,0.037664
9505143,9505143,,5,4,9,5,4,9,0.000028,0.00001,0,2931,10,0.00002,4,0.409091,0.509259,53521.245829,0.194444,0.001423
9504140,9504140,,32,1,33,32,1,33,0.002135,0.000029,0,1920,2,0.000096,1,1,1,272.599451,0.116477,0.013104
9512082,9512082,,11,5,16,11,5,16,0.000504,0.003766,0,2958,2,0.000054,10,0.193172,0.230501,2056.82989,0.1,0.004655
9804076,9804076,,23,13,36,23,13,36,0.002696,0.003417,0,6136,3,0.000054,13,0.201033,0.228296,63331.292208,0.106349,0.011775
9503205,9503205,,56,11,67,56,11,67,0.006099,0.000157,0,568,1,0.00011,6,0.324053,0.374628,187773.219328,0.08028,0.03017
9511187,9511187,,22,14,36,22,14,36,0.003405,0.000275,0,3166,1,0.000041,7,0.27563,0.331107,81569.642527,0.107143,0.017777
9608078,9608078,,19,20,39,19,20,39,0.000525,0.000283,0,2936,2,0.000035,11,0.206531,0.240366,170194.134867,0.05668,0.00608
9712258,9712258,,43,1,44,43,1,44,0.004162,0.000024,0,7041,1,0.000053,1,1,1,809.545175,0.142706,0.018413
9805217,9805217,,76,7,83,76,7,83,0.01295,0.015776,0,6677,41,0.000121,14,0.182505,0.204425,46068.700274,0.11196,0.034604
9808020,9808020,,77,10,87,77,10,87,0.0154,0.016064,0,6733,41,0.000093,13,0.1855,0.208655,41728.314603,0.117348,0.03828
9808038,9808038,,86,10,96,86,10,96,0.01721,0.016036,0,6734,41,0.000095,13,0.183358,0.207432,9643.577216,0.116338,0.040852
9809145,9809145,,45,16,61,45,16,61,0.00875,0.017285,0,7331,41,0.000061,12,0.193008,0.218408,25798.150556,0.15847,0.026636
9809164,9809164,,43,19,62,43,19,62,0.008078,0.012847,0,7332,41,0.00006,12,0.1998,0.229307,54764.559394,0.140931,0.025695
9812062,9812062,,35,22,57,35,22,57,0.006589,0.007999,0,7456,41,0.000051,12,0.197688,0.224484,167559.836541,0.149749,0.022328
9812216,9812216,,20,17,37,20,17,37,0.004556,0.016837,0,7704,1,0.000023,14,0.195805,0.222698,169842.461722,0.198949,0.013365
9812252,9812252,,12,13,25,12,13,25,0.002485,0.0077,0,7700,1,0.000027,14,0.199777,0.22814,25163.6574,0.17,0.013358
9902046,9902046,,25,16,41,25,16,41,0.00633,0.017459,0,7537,41,0.000033,14,0.190813,0.215619,13236.058782,0.22439,0.015885
9502162,9502162,,9,0,9,9,0,9,0.000025,0,0,3825,23,0.000068,0,0,0,0,0.069444,0.002267
9607161,9607161,,39,1,40,39,1,40,0.000699,0,0,7527,23,0.000082,1,1,1,1423.036736,0.025,0.009817
9902180,9902180,,19,17,36,19,17,36,0.00343,0.014018,0,7799,41,0.000038,12,0.199391,0.226676,89483.716663,0.140476,0.01201
9906013,9906013,,18,28,46,18,28,46,0.002478,0.017673,0,8578,41,0.000032,12,0.204463,0.230565,93955.980407,0.186957,0.007448
9804166,9804166,,47,13,60,47,13,60,0.009303,0.016534,0,6107,1,0.000061,12,0.199912,0.225928,32964.580776,0.098588,0.026781
1036,1036,,11,16,27,11,16,27,0.000481,0.003496,0,9715,4,0.000015,12,0.165569,0.194741,270.0371,0.250712,0.002728
9411047,9411047,,23,6,29,23,6,29,0.000481,0.000069,0,2542,3,0.000048,5,0.361582,0.43125,6042.210157,0.103448,0.006443
9603002,9603002,,60,20,80,60,20,80,0.006156,0.004165,0,3020,4,0.000068,15,0.168545,0.212562,65872.584198,0.119462,0.028502
9608129,9608129,,26,11,37,26,11,37,0.00164,0.002088,0,3545,4,0.00003,11,0.181593,0.207952,10516.792523,0.137387,0.011306
9707005,9707005,,15,0,15,15,0,15,0.000807,0,0,5793,4,0.000021,0,0,0,0,0.066667,0.004117
9210090,9210090,,14,1,15,14,1,15,0.000034,0.000013,0,474,3,0.000061,1,1,1,102.157426,0.17619,0.004317
9304053,9304053,,21,7,28,21,7,28,0.000176,0.000127,0,476,3,0.000067,3,0.592593,0.697917,19230.87367,0.101852,0.00687
9311009,9311009,,27,27,54,27,27,54,0.000265,0.000629,0,802,3,0.00014,4,0.529412,0.665344,55160.07135,0.060797,0.008117
9407106,9407106,,72,1,73,72,1,73,0.002621,0.000145,0,194,4,0.000305,1,1,1,4.45444,0.066971,0.034907
9408013,9408013,,64,5,69,64,5,69,0.003381,0.001296,0,193,4,0.000537,6,0.269474,0.319531,4609.197017,0.06607,0.043999
9502013,9502013,,19,11,30,19,11,30,0.001004,0.003811,0,202,4,0.000076,6,0.276773,0.335092,406.288198,0.198851,0.010537
9503086,9503086,,89,6,95,89,6,95,0.003362,0.002421,0,198,4,0.00029,7,0.244694,0.286358,981.66998,0.116573,0.050886
9505004,9505004,,94,8,102,94,8,102,0.004797,0.002543,0,208,4,0.000255,7,0.250905,0.299485,1423.403478,0.109785,0.053179
9504080,9504080,,27,9,36,27,9,36,0.002459,0.002303,0,662,4,0.000087,7,0.251208,0.301889,204.35639,0.22619,0.016325
9504113,9504113,,30,16,46,30,16,46,0.001475,0.00563,0,663,4,0.000132,8,0.229633,0.276336,48640.178377,0.178744,0.020956
9507144,9507144,,48,11,59,48,11,59,0.002382,0.003137,0,1847,4,0.000063,10,0.194436,0.234189,589.875814,0.195792,0.021698
9509075,9509075,,6,3,9,6,3,9,0.000089,0,0,1916,5,0.000032,3,0.625,0.766667,49832.600401,0.208333,0.002649
9607125,9607125,,11,24,35,11,24,35,0.00088,0.005324,0,3116,4,0.000018,10,0.215974,0.252453,7151.840107,0.218487,0.004384
1037,1037,,32,22,54,32,22,54,0.001472,0.002162,0,9723,52,0.000026,15,0.18806,0.216509,16532.245744,0.175751,0.012306
9910172,9910172,,52,24,76,52,24,76,0.002262,0.003109,0,9720,52,0.000036,15,0.193151,0.221411,26596.779191,0.128596,0.019022
9912147,9912147,,42,18,60,42,18,60,0.001555,0.00157,0,9721,52,0.000031,15,0.192386,0.221827,11299.691029,0.183333,0.016345
9912151,9912151,,55,22,77,55,22,77,0.00245,0.002958,0,9719,52,0.000042,16,0.185144,0.214151,17658.466531,0.092789,0.023604
9912188,9912188,,44,27,71,44,27,71,0.002029,0.002748,0,9722,52,0.000031,15,0.191789,0.22185,19176.88407,0.150101,0.016145
9606169,9606169,,121,15,136,121,15,136,0.010792,0.004008,0,2313,0,0.000147,9,0.219526,0.250149,5823.346199,0.106046,0.059889
9509160,9509160,,40,32,72,40,32,72,0.00296,0.009212,0,1418,0,0.000087,10,0.237516,0.28608,49284.548971,0.111307,0.018514
9610232,9610232,,19,13,32,19,13,32,0.001865,0.00257,0,3527,13,0.000027,11,0.222974,0.262061,4395.42468,0.240927,0.008166
9704147,9704147,,31,24,55,31,24,55,0.003819,0.002594,0,4576,13,0.000028,11,0.213305,0.25211,9679.477126,0.142088,0.011085
9801191,9801191,,1,10,11,1,10,11,0.000045,0.000264,0,8755,52,0.000011,12,0.179891,0.199435,716.616425,0.2,0.000489
9803096,9803096,,14,21,35,14,21,35,0.001166,0.003038,0,6372,13,0.000034,13,0.20236,0.235829,50793.702468,0.112605,0.011308
9902100,9902100,,10,22,32,10,22,32,0.00113,0.008365,0,8577,13,0.000016,13,0.203972,0.236409,111713.802786,0.104839,0.003821
9301088,9301088,,17,2,19,17,2,19,0.000203,0.000008,0,1262,4,0.000039,1,1,1,474.581014,0.02924,0.004747
9307038,9307038,,22,1,23,22,1,23,0.00032,0,0,315,0,0.000093,1,1,1,458.431812,0.134387,0.007245
9312189,9312189,,29,9,38,29,9,38,0.000292,0.000325,0,932,4,0.000063,4,0.362319,0.47,34568.735377,0.073257,0.01001
9506064,9506064,,27,23,50,27,23,50,0.000513,0.000119,0,4082,6,0.000041,7,0.320225,0.415121,119557.44188,0.058776,0.009315
9703194,9703194,,10,14,24,10,14,24,0.000748,0.003625,0,4951,0,0.000019,13,0.20566,0.23977,2366.729862,0.152174,0.004626
9912123,9912123,,47,16,63,47,16,63,0.001914,0.000965,0,9718,4,0.000051,15,0.190876,0.216655,37091.766077,0.1298,0.019104
1038,1038,,1,2,3,1,2,3,0.000014,0,0,9727,5,0.00001,2,0.75,0.833333,803.5,0.333333,0.000232
9511055,9511055,,2,1,3,2,1,3,0,0,0,9725,5,0.000021,1,1,1,0.5,0.333333,0.000458
9704160,9704160,,2,2,4,2,2,4,0.000014,0,0,9726,5,0.000015,1,1,1,2411,0.25,0.000458
9402123,9402123,,2,0,2,2,0,2,0,0,0,9724,5,0.000035,0,0,0,0,0.5,0.000465
1039,1039,,5,2,7,5,2,7,0.000011,0,0,9753,5,0.000024,17,0.122117,0.135216,3649.65297,0.119048,0.001135
9906169,9906169,,6,8,14,6,8,14,0,0.000005,0,9752,5,0.000048,16,0.138911,0.159137,13402.931949,0.148352,0.001393
9308048,9308048,,13,0,13,13,0,13,0.000045,0,0,2005,5,0.000315,0,0,0,0,0.032051,0.003374
9504029,9504029,,8,0,8,8,0,8,0.000014,0,0,5624,5,0.000082,0,0,0,0,0.178571,0.002594
9505157,9505157,,30,3,33,30,3,33,0.00001,0,0,5623,5,0.000138,2,0.8,0.875,8702.642284,0.063447,0.007968
9603021,9603021,,19,0,19,19,0,19,0.000002,0,0,9221,5,0.000135,0,0,0,0,0.122807,0.004882
9610017,9610017,,6,1,7,6,1,7,0.000001,0.000008,0,9735,5,0.000023,9,0.200929,0.223793,1038.831566,0.166667,0.001449
9701018,9701018,,24,3,27,24,3,27,0.000071,0,0,9730,5,0.000095,4,0.319588,0.384409,16718.484806,0.11396,0.005986
9704016,9704016,,11,18,29,11,18,29,0.000034,0.000038,0,9739,5,0.000051,15,0.158949,0.189455,68461.230499,0.064039,0.00268
9706129,9706129,,14,2,16,14,2,16,0.000069,0.000003,0,9731,5,0.000048,4,0.362637,0.409091,977.389188,0.183333,0.003548
9708163,9708163,,12,4,16,12,4,16,0.000069,0.000002,0,9740,5,0.000041,16,0.137419,0.155679,23187.731938,0.1625,0.00288
9710048,9710048,,16,6,22,16,6,22,0.00007,0.000003,0,9741,5,0.000049,16,0.137574,0.156783,27505.956003,0.136364,0.003742
9806168,9806168,,11,11,22,11,11,22,0.00007,0.000012,0,9751,5,0.000022,17,0.126295,0.146704,13190.049506,0.149351,0.002539
1040,1040,,1,1,2,1,1,2,0,0,0,9755,25,0.000019,1,1,1,1,0,0.000219
9912054,9912054,,3,0,3,3,0,3,0,0,0,9754,25,0.000037,0,0,0,0,0,0.000664
1041,1041,,31,47,78,31,47,78,0.005819,0.019991,0,9843,1,0.000025,12,0.20979,0.238303,163303.215627,0.083417,0.009416
9208059,9208059,,39,0,39,39,0,39,0.0007,0,0,349,28,0.000354,0,0,0,0,0.079622,0.011978
9410191,9410191,,3,5,8,3,5,8,0.000239,0.000084,0,3651,5,0.000012,4,0.483871,0.605556,699.800447,0.178571,0.000927
9411068,9411068,,12,3,15,12,3,15,0.001348,0.000081,0,6530,1,0.00003,2,0.8,0.875,890.410564,0.142857,0.003614
9704108,9704108,,12,7,19,12,7,19,0.000764,0.000274,0,5329,1,0.000022,12,0.155471,0.174837,25076.210437,0.081871,0.003477
9803051,9803051,,86,34,120,86,34,120,0.022474,0.026588,0,5746,1,0.000132,13,0.211149,0.245506,65776.082838,0.117437,0.062319
9803053,9803053,,75,8,83,75,8,83,0.020064,0.010398,0,5603,1,0.000103,13,0.191308,0.214184,37272.604241,0.116956,0.052632
9803068,9803068,,62,19,81,62,19,81,0.015599,0.02095,0,5770,1,0.000096,13,0.199936,0.228773,36641.594404,0.125154,0.043565
9803077,9803077,,55,28,83,55,28,83,0.015403,0.023921,0,5747,1,0.000072,13,0.205462,0.237761,10182.962773,0.16221,0.039996
9808060,9808060,,29,19,48,29,19,48,0.004396,0.018359,0,8144,1,0.000027,11,0.202949,0.232365,17012.152947,0.093085,0.009105
9810256,9810256,,6,12,18,6,12,18,0.000482,0.000217,0,9569,5,0.000019,15,0.165731,0.185001,34790.778303,0.098039,0.001778
9812218,9812218,,12,37,49,12,37,49,0.003623,0.026115,0,7402,2,0.000018,12,0.22035,0.256335,147993.927112,0.11267,0.010708
9901021,9901021,,19,8,27,19,8,27,0.004498,0.013376,0,8142,1,0.000035,13,0.18029,0.200651,5232.236132,0.159544,0.013749
9901121,9901121,,28,36,64,28,36,64,0.007214,0.021111,0,7602,1,0.000026,15,0.197424,0.226712,23611.970952,0.181052,0.01692
9902153,9902153,,22,32,54,22,32,54,0.006082,0.023545,0,8143,1,0.000025,12,0.208928,0.238876,14717.142909,0.153389,0.014547
9903161,9903161,,9,15,24,9,15,24,0.003332,0.017032,0,8410,1,0.000016,15,0.191521,0.21671,4725.125557,0.266304,0.009654
9905005,9905005,,16,8,24,16,8,24,0.000827,0.000609,0,9570,1,0.000031,14,0.154464,0.17174,14586.081506,0.157609,0.004374
9905163,9905163,,8,7,15,8,7,15,0.000919,0.001656,0,9477,1,0.000025,14,0.176225,0.197627,11374.983094,0.171429,0.002322
9907047,9907047,,19,19,38,19,19,38,0.004176,0.020691,0,9814,1,0.000018,11,0.229637,0.260928,13143.570995,0.223329,0.006381
9908014,9908014,,19,11,30,19,11,30,0.00122,0.000929,0,9842,1,0.000028,13,0.177886,0.199731,26726.688742,0.122989,0.005257
9909094,9909094,,26,24,50,26,24,50,0.001707,0.003157,0,9465,2,0.000026,13,0.193216,0.22239,152377.581919,0.099592,0.007565
9909179,9909179,,15,18,33,15,18,33,0.003625,0.018792,0,9821,1,0.000016,11,0.228178,0.258519,50896.074253,0.242424,0.005007
9910192,9910192,,7,13,20,7,13,20,0.001402,0.018132,0,9834,1,0.000013,11,0.226641,0.256422,9682.549971,0.231579,0.002072
9910267,9910267,,37,8,45,37,8,45,0.008123,0.007421,0,9590,1,0.000033,11,0.226918,0.256209,55993.633944,0.118687,0.012679
9911109,9911109,,2,19,21,2,19,21,0.000531,0.001874,0,9825,2,0.000011,14,0.181797,0.209957,14253.975454,0.15,0.000795
9911129,9911129,,13,6,19,13,6,19,0.001469,0.00025,0,9841,1,0.000023,12,0.186535,0.202881,47635.960727,0.105263,0.003942
9911135,9911135,,16,50,66,16,50,66,0.003467,0.025165,0,9835,1,0.000016,12,0.233725,0.268969,37281.30373,0.116317,0.004756
9911238,9911238,,35,30,65,35,30,65,0.005228,0.020359,0,9823,1,0.000032,12,0.229822,0.261761,147505.300895,0.111538,0.011667
9303044,9303044,,15,3,18,15,3,18,0.000286,0.000017,0,3245,22,0.000358,1,1,1,24887.894531,0.081699,0.004527
9205015,9205015,,40,0,40,40,0,40,0.000508,0,0,350,5,0.000287,0,0,0,0,0.037821,0.011935
9212140,9212140,,8,0,8,8,0,8,0.000004,0,0,3644,5,0.000046,0,0,0,0,0.232143,0.00206
9404020,9404020,,5,8,13,5,8,13,0.000021,0.000099,0,3645,5,0.000021,3,0.684211,0.794872,13720.572924,0.083333,0.001479
9401031,9401031,,20,1,21,20,1,21,0.000223,0.000021,0,2550,5,0.00007,1,1,1,73.719268,0.1,0.005428
9304159,9304159,,40,0,40,40,0,40,0.005175,0,0,287,13,0.000269,0,0,0,0,0.05641,0.027129
9512095,9512095,,1,9,10,1,9,10,0.00011,0,0,2078,6,0.00002,7,0.248804,0.324374,564581.691302,0.122222,0.001909
9601152,9601152,,85,23,108,85,23,108,0.011946,0.006288,0,1805,13,0.000392,10,0.23055,0.273483,23639.62768,0.090775,0.069595
9603078,9603078,,95,14,109,95,14,109,0.014503,0.004965,0,1835,13,0.000214,10,0.229421,0.264643,4543.519753,0.092593,0.062184
9204004,9204004,,14,0,14,14,0,14,0.001135,0,0,3244,22,0.000163,0,0,0,0,0.115385,0.007261
9404187,9404187,,17,5,22,17,5,22,0.000284,0.000092,0,4522,1,0.000084,1,1,1,3403.740915,0.051948,0.0065
9410093,9410093,,23,5,28,23,5,28,0.002374,0.000131,0,3250,41,0.000067,3,0.555556,0.7,35561.466452,0.080688,0.009087
9412061,9412061,,8,7,15,8,7,15,0.000434,0.000007,0,3649,5,0.000031,4,0.5,0.615079,61077.559667,0.12381,0.002875
9505051,9505051,,53,9,62,53,9,62,0.00154,0.002861,0,886,4,0.000115,9,0.19596,0.234813,1971.097466,0.162877,0.024339
9506148,9506148,,73,16,89,73,16,89,0.003583,0.003319,0,1360,4,0.000116,9,0.201037,0.250035,5938.051811,0.12168,0.031725
9509140,9509140,,44,1,45,44,1,45,0.007392,0.000112,0,3451,1,0.000116,3,0.416667,0.5,6444.550965,0.15404,0.023116
9510205,9510205,,5,2,7,5,2,7,0.000189,0.000005,0,5007,1,0.000029,2,0.583333,0.642857,1633.289927,0.190476,0.002411
9511065,9511065,,29,15,44,29,15,44,0.000406,0.000984,0,3240,4,0.000101,9,0.197591,0.242415,25662.001016,0.113636,0.010954
9206021,9206021,,13,0,13,13,0,13,0.000271,0,0,2633,3,0.000063,0,0,0,0,0.019231,0.004771
9509084,9509084,,10,0,10,10,0,10,0.000035,0,0,1546,23,0.000118,0,0,0,0,0.233333,0.004057
9609211,9609211,,17,6,23,17,6,23,0.000909,0.00192,0,2985,0,0.000054,12,0.19923,0.22696,4380.353706,0.241107,0.00788
9510053,9510053,,38,6,44,38,6,44,0.004447,0.003716,0,1506,2,0.000186,8,0.224801,0.259145,1465.873275,0.077696,0.032367
9603194,9603194,,85,34,119,85,34,119,0.008525,0.011526,0,1934,2,0.000136,9,0.237722,0.281001,40558.930188,0.054266,0.043118
9604065,9604065,,69,38,107,69,38,107,0.007797,0.014005,0,2133,2,0.000174,9,0.243539,0.288901,22887.085757,0.08182,0.04553
9604127,9604127,,11,31,42,11,31,42,0.001324,0.005861,0,2098,13,0.000071,9,0.244852,0.285515,51188.922556,0.150987,0.010941
9608126,9608126,,34,8,42,34,8,42,0.004403,0.002666,0,2193,13,0.000114,10,0.208113,0.23697,3369.063344,0.196283,0.02478
9608127,9608127,,22,26,48,22,26,48,0.002292,0.008118,0,2729,2,0.000046,12,0.227128,0.269062,11202.282547,0.121454,0.011572
9609052,9609052,,67,12,79,67,12,79,0.008405,0.003324,0,2206,13,0.000167,11,0.206903,0.237505,6357.389323,0.12074,0.040746
9609076,9609076,,56,17,73,56,17,73,0.008446,0.004468,0,2207,13,0.000152,11,0.217365,0.255084,4519.768114,0.164574,0.041519
9701149,9701149,,162,25,187,162,25,187,0.013946,0.006383,0,3402,2,0.000268,11,0.216389,0.251462,125525.062778,0.047208,0.070829
9701166,9701166,,146,48,194,146,48,194,0.012398,0.010654,0,3398,2,0.000218,10,0.234871,0.276828,224509.295447,0.045163,0.062508
9701187,9701187,,43,46,89,43,46,89,0.005967,0.009168,0,3577,13,0.000079,12,0.22681,0.273239,24373.430917,0.146578,0.022411
9702045,9702045,,27,26,53,27,26,53,0.003772,0.005315,0,3810,13,0.000065,12,0.223383,0.261394,227861.541646,0.190493,0.018155
9702109,9702109,,28,22,50,28,22,50,0.00331,0.003527,0,3811,13,0.000063,13,0.207906,0.241906,60157.530317,0.229388,0.017701
9607110,9607110,,12,0,12,12,0,12,0.000516,0,0,2541,23,0.000029,0,0,0,0,0.045455,0.002975
9609138,9609138,,7,6,13,7,6,13,0.000181,0.000392,0,5328,1,0.000023,11,0.175142,0.19631,10689.040918,0.166667,0.002095
9603147,9603147,,44,25,69,44,25,69,0.005511,0.005401,0,2090,13,0.000102,10,0.229805,0.275866,41851.115833,0.142157,0.026108
9605016,9605016,,70,24,94,70,24,94,0.010141,0.008524,0,2092,13,0.000177,10,0.230227,0.266463,38810.883826,0.097575,0.042275
9610077,9610077,,12,29,41,12,29,41,0.001598,0.009783,0,5005,13,0.000031,12,0.224027,0.270194,20733.129262,0.127439,0.00577
9703146,9703146,,18,51,69,18,51,69,0.003898,0.01104,0,3814,13,0.000037,14,0.204828,0.248117,17014.239133,0.166027,0.010647
9703216,9703216,,48,32,80,48,32,80,0.010484,0.006437,0,4635,13,0.00006,13,0.213952,0.255306,12436.292485,0.149051,0.029694
9704156,9704156,,33,25,58,33,25,58,0.007057,0.005195,0,4634,13,0.000048,14,0.201348,0.237629,33378.039752,0.19873,0.023844
9704195,9704195,,57,29,86,57,29,86,0.011166,0.006465,0,4637,13,0.000069,14,0.206762,0.241371,39239.39863,0.126813,0.032278
9706071,9706071,,35,29,64,35,29,64,0.006008,0.005116,0,4994,13,0.000049,12,0.20807,0.244685,10774.295501,0.157242,0.016071
9706204,9706204,,13,37,50,13,37,50,0.002347,0.006944,0,5003,13,0.00003,11,0.212273,0.246529,24785.330401,0.197551,0.007134
9611133,9611133,,11,7,18,11,7,18,0.00111,0.000295,0,5931,1,0.000054,17,0.145634,0.175118,69635.889719,0.071895,0.007815
9703196,9703196,,14,2,16,14,2,16,0.000226,0.00019,0,5924,1,0.000056,17,0.143176,0.168743,20592.396255,0.145833,0.00555
9712074,9712074,,36,1,37,36,1,37,0.008401,0.000235,0,5598,1,0.00006,13,0.173845,0.193312,185.537187,0.097598,0.023606
9802198,9802198,,53,22,75,53,22,75,0.012733,0.018589,0,5715,1,0.000077,13,0.200516,0.23611,48350.004617,0.116036,0.03809
9803013,9803013,,31,8,39,31,8,39,0.008568,0.01205,0,5714,1,0.000061,15,0.185759,0.212528,1524.708987,0.262483,0.024564
9803028,9803028,,50,37,87,50,37,87,0.01377,0.025867,0,5745,1,0.000111,14,0.210837,0.245363,313844.224761,0.136194,0.043026
9803039,9803039,,68,28,96,68,28,96,0.016537,0.019762,0,5710,1,0.0001,13,0.212029,0.248966,227061.647171,0.095504,0.046974
9711020,9711020,,4,5,9,4,5,9,0.000289,0.001753,0,5602,2,0.000033,14,0.168347,0.193466,6439.653683,0.180556,0.002468
9709087,9709087,,62,70,132,62,70,132,0.010148,0.015464,0,4794,2,0.000069,13,0.213933,0.260622,549024.530049,0.085647,0.030292
9803082,9803082,,23,32,55,23,32,55,0.005951,0.024809,0,5816,1,0.000049,13,0.205959,0.239147,6145.986856,0.20404,0.017308
9210099,9210099,,23,0,23,23,0,23,0.002647,0,0,2311,0,0.00005,0,0,0,0,0.096838,0.010627
9212146,9212146,,7,2,9,7,2,9,0.000377,0.000079,0,5361,23,0.000026,1,1,1,61.884344,0.083333,0.002751
9403186,9403186,,37,7,44,37,7,44,0.004223,0.000829,0,260,13,0.000102,4,0.392045,0.445652,46758.182572,0.069239,0.021097
9803085,9803085,,34,29,63,34,29,63,0.009664,0.024355,0,5809,1,0.000063,13,0.202061,0.23452,85079.884915,0.156426,0.031644
9804037,9804037,,3,17,20,3,17,20,0.000846,0.012905,0,5938,1,0.000024,13,0.207085,0.235859,7567.546658,0.255263,0.002982
9805041,9805041,,54,16,70,54,16,70,0.011379,0.016911,0,6156,1,0.000117,13,0.196645,0.224037,72790.762296,0.079089,0.03546
9506109,9506109,,96,11,107,96,11,107,0.003242,0.000781,0,3347,2,0.000167,9,0.197111,0.233988,35315.12804,0.057045,0.034239
9701008,9701008,,43,3,46,43,3,46,0.003008,0.000268,0,3397,2,0.000067,12,0.173719,0.192343,641.893262,0.097585,0.018663
9701037,9701037,,114,32,146,114,32,146,0.007467,0.007528,0,3396,2,0.000136,11,0.218494,0.255426,104400.605674,0.059991,0.04323
9703127,9703127,,51,28,79,51,28,79,0.003855,0.00194,0,3534,2,0.000056,11,0.203407,0.236076,35439.036013,0.102726,0.02095
9805065,9805065,,15,22,37,15,22,37,0.000883,0.0015,0,6892,2,0.000023,14,0.192885,0.220966,28136.180249,0.119369,0.004988
9807205,9807205,,24,12,36,24,12,36,0.006364,0.019073,0,6099,1,0.000034,13,0.202894,0.229156,12226.836305,0.129365,0.017342
9412147,9412147,,42,0,42,42,0,42,0.006746,0,0,3684,1,0.000043,0,0,0,0,0.122532,0.014241
9611074,9611074,,35,4,39,35,4,39,0.006505,0.000308,0,4942,1,0.000049,15,0.152275,0.178199,3107.711094,0.178812,0.016901
9309035,9309035,,9,0,9,9,0,9,0.000028,0,0,6528,5,0.000053,0,0,0,0,0.180556,0.00219
9504097,9504097,,28,1,29,28,1,29,0.000436,0.000008,0,1633,28,0.000096,1,1,1,675.530238,0.107143,0.007793
9509073,9509073,,13,3,16,13,3,16,0.000411,0.00186,0,6529,5,0.000053,6,0.265306,0.303718,6385.479642,0.1125,0.003461
9510140,9510140,,11,0,11,11,0,11,0.000006,0,0,4519,5,0.000086,0,0,0,0,0.036364,0.00272
9609014,9609014,,3,2,5,3,2,5,0.000003,0.000005,0,9568,5,0.000015,7,0.21129,0.235823,5.451569,0.3,0.000703
9702003,9702003,,4,3,7,4,3,7,0.000005,0.000075,0,9567,5,0.000017,7,0.21256,0.241613,52.508573,0.238095,0.000928
9712064,9712064,,12,12,24,12,12,24,0.000696,0.000488,0,5663,23,0.000019,14,0.191227,0.220812,63387.37944,0.126812,0.00432
9801056,9801056,,3,6,9,3,6,9,0.000008,0.000135,0,7858,5,0.000014,18,0.148152,0.178921,4806.137708,0.236111,0.000793
9409009,9409009,,10,14,24,10,14,24,0.000366,0.00002,0,3016,17,0.000025,7,0.268156,0.381647,171444.288712,0.092391,0.002854
9802026,9802026,,23,26,49,23,26,49,0.006896,0.012734,0,5772,2,0.000024,14,0.207674,0.24183,15321.463712,0.143707,0.015415
9805070,9805070,,18,13,31,18,13,31,0.002574,0.005063,0,6412,2,0.000023,14,0.182152,0.207768,12839.884433,0.166667,0.006679
9805136,9805136,,18,41,59,18,41,59,0.003876,0.026122,0,6671,2,0.000018,13,0.207951,0.243712,14365.017798,0.138808,0.005955
9806240,9806240,,33,61,94,33,61,94,0.005394,0.031607,0,6421,2,0.000045,13,0.222503,0.262829,317786.267226,0.088081,0.013941
9807229,9807229,,8,16,24,8,16,24,0.001369,0.003575,0,6718,2,0.000015,13,0.192515,0.21885,41636.977719,0.139493,0.003076
9810146,9810146,,29,11,40,29,11,40,0.005183,0.018067,0,7392,2,0.000027,14,0.182752,0.206349,2685.197466,0.124359,0.00929
9809188,9809188,,47,14,61,47,14,61,0.010994,0.019867,0,7691,1,0.000049,12,0.193824,0.218454,11958.131083,0.134426,0.021361
9808184,9808184,,23,18,41,23,18,41,0.005266,0.013282,0,7168,1,0.000031,12,0.18721,0.209123,20526.128617,0.253049,0.008751
9809132,9809132,,16,21,37,16,21,37,0.00479,0.017982,0,7550,1,0.00002,12,0.193263,0.218344,13810.331513,0.231231,0.012331
9810151,9810151,,23,21,44,23,21,44,0.006185,0.019466,0,7543,1,0.000027,12,0.194736,0.218671,6910.535916,0.241015,0.015721
9811106,9811106,,26,25,51,26,25,51,0.006233,0.01947,0,7552,1,0.000032,12,0.197703,0.222832,15971.84708,0.200784,0.017921
9811146,9811146,,6,10,16,6,10,16,0.001363,0.016041,0,7601,1,0.000014,13,0.183009,0.204947,23239.605208,0.3125,0.002422
9811152,9811152,,41,26,67,41,26,67,0.010452,0.020027,0,7558,1,0.000043,16,0.197871,0.225265,39029.19114,0.189281,0.023669
9811257,9811257,,37,20,57,37,20,57,0.009501,0.01862,0,7596,1,0.000044,14,0.194875,0.218894,454675.649102,0.188596,0.022511
9710065,9710065,,53,21,74,53,21,74,0.005699,0.006772,0,4419,0,0.000044,12,0.205832,0.237646,126635.264216,0.054424,0.019295
9705139,9705139,,30,35,65,30,35,65,0.00236,0.012623,0,3539,2,0.000045,14,0.209342,0.253495,30244.457909,0.087019,0.01049
9711055,9711055,,41,27,68,41,27,68,0.00297,0.00167,0,5248,2,0.000046,14,0.193765,0.226012,92869.085132,0.098332,0.014124
9407023,9407023,,13,2,15,13,2,15,0.000038,0.000001,0,828,23,0.000061,4,0.411765,0.468254,33877.355086,0.095238,0.004252
9903196,9903196,,63,32,95,63,32,95,0.015255,0.019633,0,7729,1,0.000054,15,0.208117,0.237888,324666.910794,0.129675,0.02988
9902131,9902131,,46,50,96,46,50,96,0.012029,0.031066,0,8241,1,0.000036,12,0.225032,0.262201,135203.079135,0.065132,0.018836
9509169,9509169,,6,2,8,6,2,8,0.000241,0.000011,0,7606,5,0.000024,2,0.75,0.833333,632.83237,0.142857,0.002137
9405194,9405194,,69,6,75,69,6,75,0.000293,0.000012,0,2559,23,0.000172,5,0.371134,0.47037,7202.40884,0.077297,0.019517
9506035,9506035,,103,1,104,103,1,104,0.004639,0.000027,0,1168,2,0.000362,9,0.219937,0.253098,15508.627964,0.038462,0.039097
9511145,9511145,,27,6,33,27,6,33,0.000143,0.000016,0,4094,23,0.000067,11,0.183925,0.22204,15513.067303,0.157197,0.008109
9606181,9606181,,35,12,47,35,12,47,0.000223,0.000023,0,4104,23,0.000072,11,0.187897,0.237345,135576.046564,0.104533,0.010353
9706119,9706119,,35,8,43,35,8,43,0.000235,0.000025,0,9451,23,0.000046,11,0.186974,0.214214,9592.21509,0.137874,0.009392
9710147,9710147,,24,5,29,24,5,29,0.000172,0.000005,0,6919,23,0.000085,12,0.15799,0.181086,195968.648501,0.091133,0.006353
9712067,9712067,,8,3,11,8,3,11,0.000213,0.000109,0,5700,2,0.000025,12,0.176613,0.195952,713.593333,0.263636,0.002353
9806062,9806062,,10,22,32,10,22,32,0.000236,0.001157,0,9464,2,0.000014,15,0.186556,0.21858,12565.568151,0.116935,0.002484
9812140,9812140,,11,12,23,11,12,23,0.0002,0.000222,0,9463,23,0.000017,16,0.158823,0.179309,73391.307703,0.144269,0.003196
9905018,9905018,,11,32,43,11,32,43,0.000567,0.006493,0,9449,2,0.000017,12,0.203966,0.234702,75259.619877,0.066999,0.003156
9906151,9906151,,24,43,67,24,43,67,0.005613,0.025065,0,8478,1,0.000027,11,0.236742,0.269397,114061.458508,0.157395,0.011712
9907085,9907085,,29,40,69,29,40,69,0.005704,0.020256,0,9818,1,0.000025,12,0.206112,0.230944,29543.892135,0.177323,0.010733
9907108,9907108,,16,26,42,16,26,42,0.003568,0.014245,0,9819,1,0.000019,11,0.22788,0.257899,18295.959363,0.247967,0.006112
9908160,9908160,,55,21,76,55,21,76,0.011913,0.020016,0,9820,1,0.000035,11,0.229232,0.259434,51599.779456,0.183158,0.019753
9908165,9908165,,2,33,35,2,33,35,0.000567,0.025882,0,9759,1,0.000011,11,0.216283,0.245229,3290.921662,0.168908,0.000559
9810148,9810148,,8,10,18,8,10,18,0.002412,0.016768,0,8243,1,0.000016,12,0.194694,0.220381,686.904162,0.29085,0.008571
9904010,9904010,,23,20,43,23,20,43,0.005207,0.020482,0,8244,1,0.000024,13,0.204278,0.232644,13532.853462,0.149502,0.008278
9904085,9904085,,12,9,21,12,9,21,0.001161,0.000889,0,8850,2,0.000026,16,0.18689,0.210105,46291.718297,0.059524,0.003355
9910134,9910134,,5,2,7,5,2,7,0.000962,0.000589,0,9833,1,0.000014,14,0.169643,0.185012,186.218821,0.261905,0.00178
9903033,9903033,,31,22,53,31,22,53,0.007644,0.014269,0,8234,1,0.000034,14,0.192248,0.219893,462744.264608,0.132801,0.017118
9904179,9904179,,30,23,53,30,23,53,0.007846,0.020698,0,8309,1,0.000027,13,0.208517,0.237829,20507.823854,0.150581,0.016352
9910023,9910023,,23,6,29,23,6,29,0.003348,0.015663,0,9589,1,0.000032,14,0.181234,0.203102,5027.153599,0.139163,0.00669
9503182,9503182,,62,2,64,62,2,64,0.001823,0.000176,0,3346,2,0.000112,3,0.447368,0.5,2114.006207,0.09127,0.022224
9906103,9906103,,8,15,23,8,15,23,0.000126,0.006853,0,9824,2,0.000015,15,0.169693,0.202017,2810.092016,0.150198,0.002085
9904074,9904074,,10,3,13,10,3,13,0.000017,0.000155,0,9836,1,0.000027,17,0.143435,0.16989,836.654938,0.160256,0.002607
9904162,9904162,,13,9,22,13,9,22,0.000389,0.000284,0,9840,1,0.000029,12,0.166146,0.188026,31014.537396,0.097403,0.003258
9611100,9611100,,94,11,105,94,11,105,0.007199,0.000615,0,3358,2,0.000135,12,0.187169,0.212741,68673.275967,0.061172,0.037242
9803108,9803108,,11,54,65,11,54,65,0.00191,0.01913,0,6399,2,0.000018,14,0.214163,0.253456,38360.860117,0.096394,0.004066
9807186,9807186,,14,9,23,14,9,23,0.001583,0.000767,0,7388,1,0.00002,15,0.169884,0.193716,2962.157415,0.100791,0.004088
9808025,9808025,,10,14,24,10,14,24,0.001212,0.000858,0,8852,2,0.000014,15,0.168927,0.193882,14768.156886,0.175725,0.002954
9903230,9903230,,21,20,41,21,20,41,0.002942,0.016345,0,7389,1,0.000023,15,0.193036,0.219706,22976.548966,0.113415,0.007263
9910199,9910199,,4,9,13,4,9,13,0.000619,0.00053,0,9832,1,0.000012,12,0.1963,0.216774,4129.692706,0.179487,0.001222
9711181,9711181,,42,9,51,42,9,51,0.005529,0.001262,0,5908,1,0.000061,6,0.291717,0.338203,5353.55464,0.070196,0.015909
9909099,9909099,,29,11,40,29,11,40,0.001923,0.000826,0,9822,13,0.000044,13,0.181891,0.206766,11943.183069,0.067949,0.008225
9909203,9909203,,22,12,34,22,12,34,0.003458,0.016297,0,8937,1,0.000027,12,0.19978,0.222769,10460.271876,0.18984,0.007976
9910116,9910116,,9,20,29,9,20,29,0.000715,0.001678,0,9758,1,0.000018,14,0.192512,0.22148,62076.497302,0.110837,0.002574
9911180,9911180,,20,6,26,20,6,26,0.002852,0.015173,0,9756,1,0.000027,15,0.168167,0.189189,576.483081,0.173846,0.007877
1042,1042,,2,12,14,2,12,14,0,0.000415,0,9860,26,0.000012,14,0.176375,0.193566,26598.985377,0.21978,0.000452
9401153,9401153,,86,3,89,86,3,89,0.000725,0.000001,0,1781,26,0.000406,1,1,1,41281.78936,0.023749,0.02271
9402015,9402015,,27,0,27,27,0,27,0.00005,0,0,3904,26,0.000125,0,0,0,0,0.066952,0.006891
9407056,9407056,,21,3,24,21,3,24,0.000298,0.00001,0,3905,26,0.00008,2,0.714286,0.8,5287.691342,0.110507,0.005664
9707028,9707028,,15,2,17,15,2,17,0.000007,0.000009,0,9845,26,0.00006,3,0.424242,0.488095,716.188523,0.110294,0.003553
9707057,9707057,,5,0,5,5,0,5,0.000005,0,0,9847,26,0.000017,0,0,0,0,0.4,0.001209
9710175,9710175,,6,7,13,6,7,13,0.000046,0.00001,0,9846,26,0.000021,4,0.533333,0.677083,786.510606,0.179487,0.001435
9710233,9710233,,12,9,21,12,9,21,0.000006,0.000011,0,7589,26,0.000025,7,0.243902,0.340262,8621.448071,0.133333,0.002762
9712188,9712188,,10,8,18,10,8,18,0.000007,0.00001,0,9848,26,0.000024,2,0.642857,0.722222,109.987179,0.205882,0.002358
9804136,9804136,,6,6,12,6,6,12,0.000006,0.000013,0,9855,26,0.00002,3,0.542857,0.631579,67.467216,0.310606,0.001447
9904029,9904029,,3,11,14,3,11,14,0.000005,0.000014,0,9859,26,0.000013,8,0.214425,0.317251,31.143841,0.214286,0.000671
9908161,9908161,,1,11,12,1,11,12,0.000005,0.000031,0,9858,26,0.000011,14,0.157759,0.172391,133.921064,0.280303,0.000232
9210147,9210147,,6,0,6,6,0,6,0.000001,0,0,1780,26,0.000143,0,0,0,0,0.166667,0.002119
9302107,9302107,,2,0,2,2,0,2,0,0,0,1779,26,0.00015,0,0,0,0,0,0.001061
9302119,9302119,,19,0,19,19,0,19,0.000044,0,0,1778,26,0.000303,0,0,0,0,0.096491,0.005709
9706212,9706212,,2,3,5,2,3,5,0,0.000009,0,9844,26,0.000038,2,0.565217,0.615385,247.312566,0.35,0.000552
9411037,9411037,,2,3,5,2,3,5,0,0.00001,0,6256,26,0.000029,2,0.714286,0.8,0,0.4,0.000675
9605231,9605231,,28,7,35,28,7,35,0.000004,0.000013,0,6259,26,0.000126,2,0.818182,0.888889,29830.325198,0.114286,0.007187
9612163,9612163,,9,3,12,9,3,12,0.000002,0.000012,0,6269,26,0.000037,2,0.588235,0.65,126.584608,0.189394,0.002321
9608035,9608035,,12,7,19,12,7,19,0.000001,0.000027,0,6266,26,0.000037,6,0.272425,0.365854,22127.306946,0.108187,0.002919
9610020,9610020,,11,5,16,11,5,16,0.000007,0.000013,0,7587,26,0.000045,2,0.631579,0.708333,3381.54407,0.125,0.00271
9702162,9702162,,9,3,12,9,3,12,0.000001,0.000001,0,6263,26,0.000044,3,0.52381,0.606061,2896.522783,0.189394,0.002334
9703106,9703106,,8,1,9,8,1,9,0.000001,0,0,7586,26,0.000024,3,0.47619,0.516667,0,0.25,0.00197
9705021,9705021,,11,6,17,11,6,17,0.000001,0.000009,0,6267,26,0.000029,7,0.237245,0.322862,3801.691963,0.220588,0.002645
9708054,9708054,,5,10,15,5,10,15,0.000569,0.000004,0,7588,26,0.000015,7,0.243243,0.343699,53126.849278,0.157143,0.001389
9806197,9806197,,23,26,49,23,26,49,0.005967,0.02327,0,6149,1,0.00004,13,0.211221,0.242631,22647.211122,0.121173,0.018683
9807230,9807230,,7,33,40,7,33,40,0.002606,0.021198,0,6561,1,0.000026,12,0.212039,0.242812,82878.54988,0.133333,0.011256
9808035,9808035,,16,55,71,16,55,71,0.003208,0.026853,0,6468,2,0.000028,13,0.22355,0.261106,339830.549636,0.099799,0.014071
9806097,9806097,,6,1,7,6,1,7,0.000001,0.000009,0,9854,26,0.000019,2,0.571429,0.625,3,0.190476,0.001401
9812080,9812080,,4,7,11,4,7,11,0.000001,0.000012,0,9856,26,0.000015,3,0.547619,0.630435,19.305556,0.281818,0.000936
9904081,9904081,,2,11,13,2,11,13,0.000001,0.000004,0,9853,26,0.000013,7,0.260369,0.365718,378.48991,0.198718,0.000478
9908124,9908124,,5,10,15,5,10,15,0.000001,0.000031,0,9857,26,0.00002,14,0.157737,0.172258,26808.397997,0.2,0.001135
1044,1044,,3,16,19,3,16,19,0.000121,0.001579,0,9878,3,0.000011,13,0.196357,0.218954,4354.908151,0.201754,0.000827
9901159,9901159,,94,16,110,94,16,110,0.005929,0.003897,0,8040,3,0.000111,12,0.194746,0.220245,44418.81509,0.097665,0.051502
9905159,9905159,,49,5,54,49,5,54,0.004029,0.001443,0,9676,0,0.000034,15,0.179511,0.200274,3135.802844,0.095737,0.01743
9911116,9911116,,198,22,220,198,22,220,0.009043,0.00277,0,9873,3,0.000216,12,0.202653,0.22507,155009.286276,0.068078,0.09493
9912249,9912249,,200,20,220,200,20,220,0.008838,0.001556,0,9877,3,0.000217,13,0.190222,0.212011,108142.64621,0.077252,0.097927
9912275,9912275,,54,33,87,54,33,87,0.004498,0.007986,0,9870,3,0.000037,15,0.201962,0.237235,72606.102201,0.075114,0.018206
9707012,9707012,,15,16,31,15,16,31,0.001387,0.002369,0,6948,52,0.000022,15,0.197136,0.229832,32733.492993,0.134409,0.005794
9707019,9707019,,13,49,62,13,49,62,0.001281,0.011495,0,4298,2,0.000024,11,0.210706,0.250093,9973.095455,0.104707,0.006926
9711131,9711131,,20,12,32,20,12,32,0.002154,0.002408,0,6951,52,0.000025,15,0.175141,0.205768,875.461271,0.179435,0.008273
9803076,9803076,,123,24,147,123,24,147,0.024259,0.022955,0,5769,1,0.000165,14,0.200043,0.230882,139902.718232,0.076088,0.075115
9803249,9803249,,65,5,70,65,5,70,0.011739,0.001736,0,5871,1,0.000101,13,0.193293,0.213879,68679.109026,0.087578,0.041606
9806052,9806052,,6,16,22,6,16,22,0.000495,0.003611,0,6953,52,0.000019,16,0.174984,0.206236,4762.998929,0.207792,0.002597
9707160,9707160,,53,25,78,53,25,78,0.005524,0.004289,0,4445,0,0.000073,13,0.199538,0.236702,111939.902523,0.07326,0.024193
9708016,9708016,,5,13,18,5,13,18,0.000393,0.004317,0,4446,0,0.000024,14,0.183462,0.215523,13054.571843,0.173203,0.004157
9708075,9708075,,16,10,26,16,10,26,0.000836,0.003866,0,6373,0,0.000059,13,0.185115,0.217083,6575.77997,0.115385,0.016
9709081,9709081,,7,16,23,7,16,23,0.000348,0.003072,0,4863,4,0.000025,15,0.192592,0.219257,41636.764106,0.211462,0.006707
9710123,9710123,,28,13,41,28,13,41,0.001401,0.00171,0,6012,25,0.000049,15,0.186117,0.210917,59881.588941,0.187805,0.010876
9801128,9801128,,15,11,26,15,11,26,0.001588,0.0024,0,7711,2,0.000038,14,0.186625,0.215377,3699.866085,0.14,0.008264
9712077,9712077,,37,28,65,37,28,65,0.007098,0.012842,0,5306,2,0.000055,13,0.204392,0.23627,71374.501421,0.142548,0.02895
9812226,9812226,,24,42,66,24,42,66,0.001655,0.023191,0,8039,3,0.000031,11,0.221081,0.257953,162758.190908,0.102098,0.01268
9812003,9812003,,3,21,24,3,21,24,0.000251,0.010135,0,7984,3,0.000026,15,0.202202,0.229622,9982.474166,0.201087,0.006577
9812175,9812175,,7,20,27,7,20,27,0.000341,0.002837,0,8046,4,0.000024,11,0.224207,0.257102,94136.838947,0.122507,0.003492
9901014,9901014,,51,22,73,51,22,73,0.004328,0.005321,0,8041,3,0.000052,12,0.2035,0.229506,11484.048027,0.133562,0.024026
9404008,9404008,,58,3,61,58,3,61,0.001807,0.000034,0,985,3,0.000125,1,1,1,7542.17542,0.119399,0.038329
9804160,9804160,,47,34,81,47,34,81,0.005882,0.007949,0,6356,0,0.000051,12,0.216905,0.251052,208601.535409,0.126852,0.027136
9807161,9807161,,17,7,24,17,7,24,0.000894,0.001834,0,8628,3,0.000031,12,0.200721,0.231181,9428.52173,0.105072,0.010937
9808073,9808073,,3,13,16,3,13,16,0.000443,0.002201,0,8038,4,0.000014,12,0.18738,0.210425,7052.094422,0.225,0.003478
9902102,9902102,,24,35,59,24,35,59,0.001529,0.007341,0,8619,3,0.000024,12,0.218677,0.252567,89724.706285,0.109877,0.011
9902116,9902116,,26,19,45,26,19,45,0.001407,0.001664,0,8618,3,0.000028,12,0.20073,0.228649,30901.804398,0.113636,0.01145
9902158,9902158,,15,31,46,15,31,46,0.001026,0.005844,0,8483,3,0.000018,13,0.20373,0.231493,65518.816495,0.122705,0.007192
9902181,9902181,,15,17,32,15,17,32,0.001249,0.001819,0,8626,3,0.000028,12,0.197207,0.222032,5486.395949,0.21875,0.010193
9903129,9903129,,4,24,28,4,24,28,0.00048,0.0038,0,8622,3,0.000014,12,0.201029,0.226682,23102.95712,0.202381,0.003797
9904153,9904153,,9,36,45,9,36,45,0.000639,0.00716,0,8625,3,0.00002,13,0.209736,0.240039,73486.814033,0.168687,0.006088
9707148,9707148,,43,9,52,43,9,52,0.003998,0.001544,0,4420,0,0.000063,12,0.196507,0.224575,17550.387472,0.0954,0.018299
9803048,9803048,,10,27,37,10,27,37,0.002356,0.007663,0,6369,2,0.000016,13,0.201737,0.235267,9401.054071,0.146396,0.004266
9807213,9807213,,37,13,50,37,13,50,0.003144,0.016657,0,8068,0,0.000051,15,0.188546,0.217552,8825.582025,0.10449,0.014484
9906055,9906055,,64,34,98,64,34,98,0.005144,0.01073,0,8645,3,0.00006,15,0.211449,0.24649,100845.418925,0.079634,0.022358
9906109,9906109,,17,37,54,17,37,54,0.001277,0.00713,0,8657,3,0.000024,15,0.198717,0.233274,7612.670611,0.166317,0.007829
9906234,9906234,,27,38,65,27,38,65,0.003626,0.00372,0,8656,0,0.000022,12,0.207233,0.235037,89912.064712,0.126683,0.011005
9908060,9908060,,35,34,69,35,34,69,0.002496,0.017884,0,8632,3,0.000027,15,0.203067,0.236999,40037.160393,0.119352,0.01167
9409015,9409015,,12,4,16,12,4,16,0.00031,0.000056,0,2544,3,0.000049,4,0.445783,0.504505,16923.312114,0.075,0.00857
9705241,9705241,,43,14,57,43,14,57,0.001667,0.00112,0,4487,3,0.000071,12,0.203293,0.232803,289729.811297,0.062657,0.022112
9909062,9909062,,107,30,137,107,30,137,0.006094,0.007214,0,9872,3,0.000121,12,0.204458,0.228658,107592.548011,0.085713,0.054517
9202015,9202015,,20,0,20,20,0,20,0.000632,0,0,157,3,0.000576,0,0,0,0,0.139474,0.011784
9412106,9412106,,3,6,9,3,6,9,0.000025,0.000067,0,9876,3,0.000022,5,0.365385,0.428947,2459.049941,0.208333,0.002768
9605088,9605088,,30,2,32,30,2,32,0.000568,0.000001,0,9875,3,0.000157,2,0.625,0.7,8779.287792,0.09375,0.016565
9705038,9705038,,39,9,48,39,9,48,0.002116,0.000719,0,4449,3,0.000069,12,0.184987,0.208398,44577.864397,0.08555,0.021609
9807171,9807171,,20,167,187,20,167,187,0.002477,0.037113,0,8066,2,0.000024,12,0.24664,0.302994,125077.396144,0.052786,0.007098
9904112,9904112,,16,9,25,16,9,25,0.001316,0.009062,0,8255,30,0.000022,14,0.188843,0.214239,9381.09946,0.125,0.006644
9904129,9904129,,29,17,46,29,17,46,0.004213,0.010185,0,8261,30,0.000025,12,0.19945,0.227734,41389.807024,0.091787,0.015825
9905014,9905014,,19,18,37,19,18,37,0.003045,0.008928,0,8262,30,0.000023,13,0.198958,0.226096,66693.475573,0.119369,0.013911
9905056,9905056,,9,20,29,9,20,29,0.000614,0.003213,0,9861,13,0.000015,13,0.190393,0.216495,4065.43578,0.146552,0.003218
9906214,9906214,,37,19,56,37,19,56,0.003323,0.005258,0,9862,2,0.000029,13,0.194947,0.220755,22637.265339,0.087662,0.012392
9909027,9909027,,7,25,32,7,25,32,0.000371,0.002417,0,9865,2,0.000018,14,0.193772,0.22159,20435.766717,0.09375,0.002423
9909095,9909095,,9,30,39,9,30,39,0.000463,0.004865,0,9869,2,0.000021,13,0.196678,0.225541,23797.867333,0.08502,0.003052
9912161,9912161,,57,10,67,57,10,67,0.004432,0.004325,0,9863,3,0.000035,14,0.190804,0.221788,26075.858689,0.06626,0.018319
1045,1045,,0,3,3,0,3,3,0,0.000002,0,9881,5,0.00001,15,0.119648,0.128551,0,0.5,0
9912102,9912102,,2,2,4,2,2,4,0,0.000001,0,9879,5,0.000017,3,0.571429,0.708333,155.584456,0.25,0.000459
9912291,9912291,,3,3,6,3,3,6,0.000129,0.000002,0,9880,5,0.000014,14,0.13583,0.149495,16296.821762,0.133333,0.000722
1046,1046,,6,7,13,6,7,13,0,0,0,9893,26,0.000018,14,0.158744,0.172788,21836.907364,0.224359,0.001387
9505078,9505078,,1,0,1,1,0,1,0,0,0,9892,26,0.000012,0,0,0,0,0,0.000259
9512070,9512070,,17,0,17,17,0,17,0,0,0,8006,26,0.000053,0,0,0,0,0.216912,0.004261
9705156,9705156,,9,10,19,9,10,19,0,0.000015,0,8016,26,0.000025,13,0.162222,0.179875,51763.970418,0.140351,0.002225
9807052,9807052,,6,13,19,6,13,19,0.000001,0.000002,0,9888,26,0.000018,14,0.141182,0.155372,2087.915243,0.172515,0.001528
9904202,9904202,,9,5,14,9,5,14,0,0.000001,0,9885,26,0.000023,15,0.124364,0.134105,51.576193,0.241758,0.002158
9906080,9906080,,1,3,4,1,3,4,0,0.000343,0,9891,2,0.000012,13,0.180265,0.199823,24716.597584,0.083333,0.000259
9907081,9907081,,8,13,21,8,13,21,0,0.000002,0,9890,26,0.000021,14,0.140965,0.154789,1508.459394,0.221429,0.001886
9402023,9402023,,11,0,11,11,0,11,0,0,0,8003,26,0.000065,0,0,0,0,0.245455,0.002876
9512118,9512118,,4,5,9,4,5,9,0,0.000007,0,8008,9,0.000028,7,0.227711,0.271277,7598.642186,0.166667,0.001161
9602083,9602083,,14,5,19,14,5,19,0.000013,0.000001,0,8015,26,0.000054,11,0.160674,0.185953,30986.633465,0.099415,0.003571
9606078,9606078,,11,0,11,11,0,11,0.000012,0,0,8005,26,0.000039,0,0,0,0,0.290909,0.002972
9606079,9606079,,9,1,10,9,1,10,0.000012,0,0,8004,26,0.000029,1,1,1,19.277778,0.333333,0.002376
9702114,9702114,,6,4,10,6,4,10,0,0,0,8007,26,0.000021,1,1,1,0.111111,0.411111,0.001563
9702204,9702204,,17,2,19,17,2,19,0.000028,0.000003,0,8002,26,0.000067,2,0.6,0.666667,11931.995767,0.090643,0.004503
9703150,9703150,,43,13,56,43,13,56,0.001166,0.00023,0,4556,0,0.000066,12,0.184448,0.209599,63611.245137,0.165909,0.01523
9704210,9704210,,9,0,9,9,0,9,0.000003,0,0,6479,41,0.000059,0,0,0,0,0.180556,0.002334
9302117,9302117,,4,0,4,4,0,4,0,0,0,9887,22,0.000033,0,0,0,0,0,0.000925
9408019,9408019,,18,8,26,18,8,26,0.000001,0.000005,0,6963,9,0.00012,2,0.833333,0.9,36010.271105,0.056923,0.004446
9703046,9703046,,2,2,4,2,2,4,0,0,0,9886,9,0.000014,6,0.274882,0.328161,768.26155,0.083333,0.000506
9705154,9705154,,4,5,9,4,5,9,0,0,0,8018,26,0.000016,1,1,1,0.111111,0.402778,0.001035
9705155,9705155,,14,7,21,14,7,21,0,0.000001,0,8017,26,0.00004,12,0.146115,0.173453,26997.122883,0.157143,0.003509
9707072,9707072,,5,8,13,5,8,13,0.000113,0,0,8019,26,0.000015,14,0.139744,0.151442,102799.838459,0.320513,0.001308
9803128,9803128,,10,0,10,10,0,10,0,0,0,9882,26,0.000028,0,0,0,0,0.277778,0.002483
9809024,9809024,,7,5,12,7,5,12,0.000045,0,0,9884,26,0.000021,14,0.140142,0.152,24440.421115,0.227273,0.001699
9705059,9705059,,4,10,14,4,10,14,0.000331,0.001703,0,6942,4,0.000016,13,0.175839,0.20105,10978.300491,0.115385,0.001334
9711097,9711097,,53,26,79,53,26,79,0.006329,0.007625,0,5776,2,0.000086,12,0.205888,0.237658,95037.065968,0.084388,0.026894
9208009,9208009,,6,0,6,6,0,6,0,0,0,9889,26,0.000051,0,0,0,0,0,0.001434
9807054,9807054,,4,12,16,4,12,16,0,0.000002,0,9883,26,0.000017,14,0.141364,0.156055,6255.35365,0.225,0.000998
1047,1047,,3,9,12,3,9,12,0.000144,0.007858,0,9894,30,0.000013,15,0.178041,0.199792,2643.643464,0.106061,0.000822
9301069,9301069,,6,0,6,6,0,6,0.000529,0,0,3249,41,0.000029,0,0,0,0,0.1,0.001949
9411025,9411025,,31,3,34,31,3,34,0.000862,0.000036,0,2994,26,0.000073,7,0.249548,0.302053,15084.057046,0.105169,0.008522
9903030,9903030,,3,9,12,3,9,12,0.000196,0.003855,0,8795,2,0.000012,13,0.181949,0.205077,3538.492777,0.212121,0.000881
9904191,9904191,,67,16,83,67,16,83,0.013566,0.020022,0,8297,1,0.000058,12,0.194372,0.219324,32306.841506,0.09139,0.025868
9306077,9306077,,21,0,21,21,0,21,0.000216,0,0,675,4,0.000068,0,0,0,0,0.057143,0.006273
9404004,9404004,,36,7,43,36,7,43,0.000842,0.000233,0,686,26,0.000074,3,0.6,0.685185,22636.287796,0.118494,0.011257
9409098,9409098,,31,21,52,31,21,52,0.000717,0.000292,0,700,26,0.000243,6,0.322892,0.437189,144925.105065,0.059201,0.010846
9410054,9410054,,32,8,40,32,8,40,0.000287,0.000188,0,677,26,0.000056,2,0.653846,0.735294,10358.469842,0.091667,0.008839
9407124,9407124,,3,0,3,3,0,3,0.000001,0,0,2993,6,0.000036,0,0,0,0,0,0.000881
9607052,9607052,,24,4,28,24,4,28,0.002085,0.003745,0,4931,2,0.000057,10,0.201732,0.227835,6447.925893,0.103175,0.007498
9801023,9801023,,15,31,46,15,31,46,0.002403,0.005969,0,6383,2,0.00002,14,0.201368,0.235696,29451.774701,0.133816,0.004733
9803058,9803058,,10,34,44,10,34,44,0.000737,0.011429,0,6427,2,0.000017,13,0.206064,0.240328,11802.33449,0.132664,0.0027
9805126,9805126,,13,30,43,13,30,43,0.001247,0.006982,0,6441,2,0.00002,13,0.205629,0.2383,126740.033811,0.091916,0.003938
9810170,9810170,,11,12,23,11,12,23,0.001028,0.005238,0,7766,2,0.000017,13,0.198781,0.227532,8830.554735,0.175889,0.003121
9812037,9812037,,12,34,46,12,34,46,0.002248,0.030828,0,8240,0,0.000018,12,0.221828,0.257443,54474.524454,0.118357,0.004636
9901057,9901057,,26,14,40,26,14,40,0.007054,0.010129,0,8235,1,0.00003,14,0.189378,0.215686,21431.072181,0.198718,0.015641
9903042,9903042,,34,17,51,34,17,51,0.00804,0.018436,0,8295,1,0.000035,14,0.186073,0.210687,8972.360395,0.160392,0.018124
9904147,9904147,,12,16,28,12,16,28,0.004177,0.019558,0,8296,1,0.000021,14,0.184368,0.209477,676.836346,0.332011,0.010987
1048,1048,,2,4,6,2,4,6,0,0,0,9899,30,0.000014,6,0.27027,0.3975,6.166667,0.333333,0.000445
9703083,9703083,,3,0,3,3,0,3,0,0,0,9896,30,0.000038,0,0,0,0,0.5,0.000697
9705006,9705006,,4,1,5,4,1,5,0,0,0,9897,30,0.000025,1,1,1,1.5,0.4,0.000916
9707128,9707128,,3,1,4,3,1,4,0,0,0,9895,30,0.000024,5,0.296296,0.347917,64,0.25,0.000697
9809019,9809019,,3,2,5,3,2,5,0,0,0,9898,30,0.000017,6,0.256757,0.339474,5.666667,0.4,0.000677
9605006,9605006,,2,2,4,2,2,4,0.000005,0.000031,0,3677,30,0.000032,4,0.394737,0.466667,8681.779921,0.083333,0.000522
1049,1049,,11,27,38,11,27,38,0.000969,0.003705,0,9905,3,0.000013,13,0.205574,0.234109,9122.354225,0.197013,0.00312
9709062,9709062,,57,82,139,57,82,139,0.00886,0.021545,0,5829,0,0.000049,12,0.246981,0.306389,284906.607034,0.058075,0.020032
9904201,9904201,,5,7,12,5,7,12,0.000274,0.001665,0,9904,4,0.000012,15,0.168044,0.186186,5922.822916,0.068182,0.001274
9910109,9910109,,39,36,75,39,36,75,0.002526,0.006063,0,9902,3,0.000024,12,0.212149,0.240986,25850.800994,0.12955,0.012237
9912079,9912079,,10,29,39,10,29,39,0.000239,0.008292,0,9901,52,0.000021,12,0.2148,0.242929,43053.37478,0.080297,0.002972
3022,3022,,5,26,31,5,26,31,0.000267,0.002845,0,9912,3,0.000011,13,0.200301,0.228401,4879.726307,0.208602,0.001497
1143,1143,,32,22,54,32,22,54,0.002487,0.003956,0,9911,3,0.000054,13,0.191115,0.21337,76660.373855,0.11181,0.017769
9211118,9211118,,9,0,9,9,0,9,0.000312,0,0,282,13,0.000261,0,0,0,0,0.138889,0.01994
9305066,9305066,,20,8,28,20,8,28,0.00114,0.000118,0,283,13,0.000146,2,0.833333,0.9,6049.601604,0.083333,0.016987
9508068,9508068,,63,19,82,63,19,82,0.003524,0.000422,0,1398,3,0.000102,8,0.274112,0.324094,142420.178808,0.085065,0.028638
9509067,9509067,,11,1,12,11,1,12,0.000936,0.000066,0,1401,0,0.000053,7,0.242697,0.265862,45.922139,0.113636,0.00746
9510041,9510041,,23,25,48,23,25,48,0.001394,0.000643,0,1400,3,0.000068,9,0.25707,0.3101,90321.705631,0.10594,0.013517
9205070,9205070,,26,0,26,26,0,26,0.001639,0,0,1355,0,0.000078,0,0,0,0,0.047692,0.010183
9607235,9607235,,164,75,239,164,75,239,0.026734,0.019391,0,2728,13,0.000183,9,0.253791,0.311771,262067.176468,0.044267,0.075191
9410052,9410052,,41,2,43,41,2,43,0.006128,0.00021,0,922,2,0.000285,1,1,1,11943.781839,0.05814,0.039743
9411028,9411028,,63,47,110,63,47,110,0.007604,0.004601,0,1590,5,0.000082,5,0.393607,0.462877,993620.759217,0.025855,0.027718
9511064,9511064,,106,13,119,106,13,119,0.011591,0.003672,0,1690,13,0.000448,10,0.217955,0.259009,27138.786023,0.107819,0.091766
9601167,9601167,,40,16,56,40,16,56,0.004128,0.008411,0,1601,2,0.000114,10,0.222561,0.262657,7367.37785,0.106818,0.027317
9601037,9601037,,31,23,54,31,23,54,0.001666,0.000941,0,1724,0,0.000049,15,0.194583,0.254907,33322.555725,0.144654,0.012899
9612064,9612064,,9,29,38,9,29,38,0.000886,0.01142,0,4126,2,0.000033,10,0.239858,0.277213,41178.228633,0.175676,0.003127
9701143,9701143,,17,17,34,17,17,34,0.001077,0.007503,0,4124,2,0.000039,12,0.218206,0.252451,16152.149965,0.15508,0.007417
9611174,9611174,,79,31,110,79,31,110,0.009918,0.009047,0,3302,13,0.000087,11,0.233004,0.277084,102727.303535,0.055546,0.033077
9706024,9706024,,5,8,13,5,8,13,0.000241,0.003216,0,5499,2,0.000019,14,0.174822,0.198955,22192.72732,0.160256,0.00277
9212006,9212006,,6,3,9,6,3,9,0.00153,0.000105,0,2727,13,0.000014,1,1,1,202.246323,0.083333,0.003436
9212045,9212045,,58,3,61,58,3,61,0.003506,0.000129,0,155,0,0.000199,1,1,1,1242.363196,0.096721,0.025365
9410212,9410212,,31,6,37,31,6,37,0.001715,0.000198,0,625,0,0.000051,6,0.280453,0.361448,11186.617444,0.141892,0.01518
9501020,9501020,,67,17,84,67,17,84,0.004822,0.001773,0,1321,0,0.000105,8,0.305147,0.368356,65443.772352,0.090361,0.02776
9501144,9501144,,45,32,77,45,32,77,0.000983,0.000226,0,565,52,0.000101,5,0.348011,0.434082,401916.768953,0.037081,0.013893
9507051,9507051,,14,34,48,14,34,48,0.001108,0.001061,0,1707,0,0.000023,9,0.276209,0.348083,44074.888524,0.113475,0.007161
9602045,9602045,,61,54,115,61,54,115,0.004317,0.001055,0,1743,0,0.000137,11,0.237351,0.296981,406593.922348,0.04958,0.029249
9605028,9605028,,43,38,81,43,38,81,0.004349,0.008428,0,2459,0,0.000044,10,0.246079,0.292942,30234.69624,0.083642,0.017243
9606087,9606087,,24,20,44,24,20,44,0.001423,0.000854,0,2434,0,0.000032,11,0.218018,0.258425,24491.505967,0.153277,0.009239
9607050,9607050,,76,35,111,76,35,111,0.008388,0.013734,0,2465,0,0.00012,9,0.259671,0.311598,352899.063656,0.049959,0.035804
9608012,9608012,,36,28,64,36,28,64,0.003502,0.006171,0,2460,0,0.000046,12,0.232656,0.276402,21574.44285,0.121776,0.014935
9608034,9608034,,44,47,91,44,47,91,0.003305,0.00463,0,2492,0,0.000032,10,0.230603,0.278235,47240.748878,0.094017,0.014686
9610237,9610237,,43,34,77,43,34,77,0.004806,0.008418,0,2834,0,0.000047,10,0.236239,0.280423,43641.051514,0.083219,0.018841
9611184,9611184,,21,97,118,21,97,118,0.00249,0.010235,0,3619,0,0.000017,11,0.246937,0.309053,122706.601984,0.092713,0.007392
9701019,9701019,,37,43,80,37,43,80,0.006312,0.018215,0,3623,2,0.000046,10,0.244893,0.289164,133783.642452,0.102848,0.01491
9701069,9701069,,77,6,83,77,6,83,0.007657,0.00237,0,3815,4,0.000091,12,0.201144,0.232962,139541.35881,0.039524,0.026008
9703062,9703062,,24,16,40,24,16,40,0.001951,0.003323,0,3532,2,0.000032,11,0.210405,0.241441,15276.806712,0.116026,0.009261
9708062,9708062,,38,49,87,38,49,87,0.004103,0.008488,0,4946,0,0.000029,12,0.209046,0.251648,77651.824381,0.096899,0.012825
9607113,9607113,,6,18,24,6,18,24,0.000154,0.006134,0,5707,2,0.000018,10,0.217559,0.254767,8480.647639,0.081522,0.002029
9608167,9608167,,36,9,45,36,9,45,0.001849,0.004689,0,5617,0,0.000049,13,0.215054,0.251474,5502.664837,0.102525,0.016399
9704109,9704109,,9,24,33,9,24,33,0.00029,0.006976,0,4926,2,0.000024,13,0.203567,0.238417,86379.395262,0.091856,0.003009
9710121,9710121,,35,24,59,35,24,59,0.002241,0.006564,0,5698,0,0.000029,12,0.214265,0.247503,30256.128591,0.075102,0.012596
9711087,9711087,,8,18,26,8,18,26,0.000076,0.001812,0,5708,3,0.000021,14,0.177973,0.205617,67176.435624,0.086154,0.002637
9801135,9801135,,13,30,43,13,30,43,0.000502,0.002143,0,5699,2,0.000018,12,0.208658,0.240966,48352.125755,0.11794,0.003832
9504120,9504120,,23,3,26,23,3,26,0.001585,0.001867,0,1197,4,0.000071,6,0.265306,0.303718,1653.346991,0.175385,0.013609
9605101,9605101,,51,15,66,51,15,66,0.003608,0.002778,0,3152,4,0.000049,10,0.211719,0.239154,22059.521718,0.108625,0.018919
9702050,9702050,,17,22,39,17,22,39,0.003213,0.00806,0,3506,13,0.000022,12,0.205387,0.244974,18169.78735,0.148448,0.007728
9705239,9705239,,5,22,27,5,22,27,0.001246,0.003833,0,5103,13,0.000014,13,0.199252,0.237019,7534.237917,0.210826,0.003154
9708002,9708002,,29,28,57,29,28,57,0.002605,0.007137,0,4894,2,0.000057,15,0.2047,0.239617,76993.303064,0.069549,0.013756
9711094,9711094,,66,13,79,66,13,79,0.005546,0.003942,0,5239,0,0.000097,15,0.189982,0.221571,73541.839052,0.108082,0.028755
9711202,9711202,,37,10,47,37,10,47,0.002914,0.002497,0,5780,0,0.00006,16,0.178774,0.207756,35734.155635,0.172525,0.017391
9712050,9712050,,37,13,50,37,13,50,0.003308,0.0016,0,5782,0,0.000057,15,0.183668,0.212957,33502.742315,0.184898,0.017942
9712070,9712070,,32,14,46,32,14,46,0.003231,0.001795,0,5788,0,0.000042,16,0.184179,0.213703,18103.962633,0.202899,0.015198
9712148,9712148,,16,5,21,16,5,21,0.001594,0.000521,0,5790,41,0.000026,16,0.166515,0.190335,7978.304635,0.142857,0.00592
9712180,9712180,,16,16,32,16,16,32,0.001196,0.002562,0,5789,0,0.000027,16,0.184435,0.21539,3450.55528,0.185484,0.008167
9712211,9712211,,75,16,91,75,16,91,0.00787,0.003686,0,5787,0,0.000076,16,0.178904,0.211821,66465.628075,0.101587,0.037338
9801141,9801141,,13,16,29,13,16,29,0.001736,0.002205,0,6354,0,0.000017,15,0.19453,0.224518,5772.777023,0.23399,0.005042
9803097,9803097,,24,10,34,24,10,34,0.002422,0.001705,0,5807,0,0.000029,16,0.176618,0.201727,2663.909342,0.202317,0.010075
9803127,9803127,,46,19,65,46,19,65,0.003789,0.003225,0,6346,0,0.000048,15,0.183123,0.211408,15521.103683,0.155048,0.023337
9803232,9803232,,57,64,121,57,64,121,0.007958,0.018938,0,6370,4,0.000053,11,0.227755,0.268751,189351.388719,0.067837,0.024769
9703039,9703039,,30,20,50,30,20,50,0.004201,0.008613,0,3526,2,0.000068,14,0.204253,0.247423,20066.263744,0.156735,0.018074
9706073,9706073,,9,27,36,9,27,36,0.000709,0.009192,0,4514,2,0.000019,11,0.215097,0.248379,11966.301591,0.12381,0.003538
9707102,9707102,,13,19,32,13,19,32,0.002519,0.004484,0,4713,2,0.000016,11,0.208027,0.242753,4961.805951,0.205645,0.00578
9710136,9710136,,45,7,52,45,7,52,0.007125,0.005624,0,5503,2,0.000039,12,0.184334,0.21134,3059.763755,0.060709,0.016002
9503157,9503157,,48,8,56,48,8,56,0.001677,0.000058,0,1865,4,0.00009,2,0.833333,0.9,47065.039932,0.049026,0.016799
9810013,9810013,,6,4,10,6,4,10,0.000308,0.0011,0,9903,4,0.000014,11,0.2056,0.231172,6224.693599,0.088889,0.00145
9810015,9810015,,6,3,9,6,3,9,0.000271,0.00002,0,8272,4,0.000016,15,0.117996,0.130232,31276.550981,0.125,0.00173
9903125,9903125,,5,10,15,5,10,15,0.000484,0.00137,0,8623,3,0.000012,12,0.204788,0.228176,5100.997371,0.142857,0.002221
9808056,9808056,,30,15,45,30,15,45,0.003478,0.012493,0,8069,0,0.000069,13,0.194256,0.221874,36323.059377,0.110606,0.013429
9808095,9808095,,13,12,25,13,12,25,0.001413,0.000912,0,8070,0,0.000045,13,0.184697,0.2084,14215.456028,0.163333,0.006006
9810129,9810129,,24,8,32,24,8,32,0.002264,0.015851,0,8610,0,0.000053,14,0.184397,0.207122,11875.882565,0.125,0.009622
9904092,9904092,,29,35,64,29,35,64,0.002828,0.003252,0,8612,0,0.000022,12,0.206758,0.234734,15897.683427,0.159474,0.010861
9908023,9908023,,84,39,123,84,39,123,0.006369,0.005657,0,8614,0,0.000052,12,0.214108,0.243383,62095.534663,0.082167,0.03201
9612188,9612188,,32,13,45,32,13,45,0.001813,0.002053,0,4198,0,0.000031,13,0.209137,0.241571,14859.58807,0.087374,0.011396
9910263,9910263,,28,14,42,28,14,42,0.001492,0.005393,0,9900,30,0.000028,13,0.194434,0.215641,4183.712516,0.106852,0.009595
1050,1050,,6,2,8,6,2,8,0.000001,0.000006,0,9913,23,0.000018,13,0.169344,0.197873,2198.682652,0.071429,0.001479
9705007,9705007,,23,16,39,23,16,39,0.000086,0.000027,0,5563,23,0.000042,12,0.202349,0.253145,164503.592754,0.078273,0.005822
9307022,9307022,,3,1,4,3,1,4,0.000002,0,0,2557,23,0.000041,1,1,1,459.646438,0.166667,0.001569
9310025,9310025,,23,3,26,23,3,26,0.000055,0.000009,0,2556,5,0.000156,3,0.583333,0.690476,5922.640869,0.033846,0.006669
9402068,9402068,,1,2,3,1,2,3,0,0.000001,0,2555,23,0.000036,3,0.481481,0.538462,2019.33399,0.166667,0.000955
9307155,9307155,,22,0,22,22,0,22,0.000112,0,0,4119,23,0.000043,0,0,0,0,0.112554,0.006255
9404003,9404003,,2,0,2,2,0,2,0,0,0,5548,23,0.000015,0,0,0,0,0.5,0.000758
9406030,9406030,,4,0,4,4,0,4,0.000023,0,0,4107,23,0.000022,0,0,0,0,0.333333,0.001342
9406031,9406031,,4,1,5,4,1,5,0.000023,0.000004,0,4106,23,0.000022,1,1,1,282.935887,0.2,0.001342
9412092,9412092,,18,5,23,18,5,23,0.000195,0.000836,0,4105,23,0.000055,7,0.22735,0.27526,3766.418298,0.142292,0.005131
9501057,9501057,,20,11,31,20,11,31,0.000265,0.001868,0,4109,23,0.000073,6,0.278,0.345204,17938.324302,0.102151,0.005491
9504065,9504065,,11,2,13,11,2,13,0.000121,0.000004,0,4110,23,0.000047,7,0.220472,0.253997,3289.466136,0.147436,0.003512
9507045,9507045,,22,7,29,22,7,29,0.000063,0.000043,0,4111,23,0.000079,7,0.272799,0.321257,51312.127802,0.08867,0.005751
9605158,9605158,,13,5,18,13,5,18,0.000029,0.000008,0,5547,23,0.000038,7,0.233801,0.261789,9748.891692,0.111111,0.00382
9605213,9605213,,11,6,17,11,6,17,0.000004,0.000077,0,5562,2,0.000029,10,0.210444,0.273457,74572.625261,0.099265,0.002755
9606172,9606172,,23,10,33,23,10,33,0.000382,0.000014,0,5549,23,0.000033,7,0.243226,0.280213,8036.594282,0.079545,0.005866
9612118,9612118,,8,8,16,8,8,16,0.000001,0.000012,0,5557,23,0.000022,12,0.197999,0.250762,56439.032734,0.15,0.001985
1051,1051,,2,24,26,2,24,26,0.000055,0.005572,0,9915,0,0.000011,12,0.187246,0.21698,139.984657,0.161538,0.000445
9908082,9908082,,4,19,23,4,19,23,0.000121,0.009876,0,9914,0,0.000013,11,0.203516,0.231589,4839.801841,0.13834,0.000903
9503127,9503127,,19,22,41,19,22,41,0.001283,0.004731,0,1112,13,0.000165,7,0.270669,0.335663,59357.011623,0.107317,0.01511
9204085,9204085,,11,0,11,11,0,11,0.00018,0,0,167,9,0.000191,0,0,0,0,0.145455,0.006417
9401030,9401030,,31,7,38,31,7,38,0.000249,0.000026,0,927,4,0.00007,3,0.625,0.722222,39393.544047,0.081792,0.010629
9608105,9608105,,31,12,43,31,12,43,0.002265,0.001447,0,3377,4,0.000073,11,0.206367,0.233968,63822.15253,0.104651,0.017476
9610016,9610016,,8,13,21,8,13,21,0.000561,0.007171,0,3374,4,0.000026,11,0.214981,0.250973,14868.177736,0.12619,0.003871
9609116,9609116,,39,30,69,39,30,69,0.002736,0.00404,0,3486,4,0.000024,11,0.198349,0.23215,5879.128,0.192029,0.014286
9609145,9609145,,65,33,98,65,33,98,0.004938,0.0041,0,3441,4,0.000037,11,0.198106,0.235962,16460.623663,0.160004,0.025146
9609157,9609157,,25,9,34,25,9,34,0.001574,0.002227,0,3438,4,0.00002,12,0.171487,0.199166,1115.881283,0.247772,0.009212
9610099,9610099,,4,4,8,4,4,8,0.000139,0.00001,0,4288,28,0.000014,3,0.666667,0.805556,4669.184496,0.071429,0.002042
9702012,9702012,,17,24,41,17,24,41,0.000951,0.005069,0,3941,4,0.000025,12,0.211498,0.253347,45130.824332,0.139024,0.009241
9703145,9703145,,10,19,29,10,19,29,0.000711,0.0031,0,4022,4,0.00002,13,0.200776,0.237437,35709.547782,0.190887,0.006926
9703176,9703176,,26,54,80,26,54,80,0.001949,0.0051,0,4010,4,0.000018,13,0.194247,0.231796,117813.9615,0.188449,0.009535
9703186,9703186,,18,23,41,18,23,41,0.001056,0.003146,0,4011,4,0.000016,12,0.201526,0.237107,5916.168393,0.241463,0.005961
9704174,9704174,,24,63,87,24,63,87,0.001845,0.005361,0,4024,4,0.000017,13,0.198707,0.239141,154240.698639,0.171345,0.008321
9705199,9705199,,89,43,132,89,43,132,0.008558,0.011448,0,4092,4,0.000061,11,0.228837,0.272358,368564.333469,0.112885,0.039234
9707051,9707051,,12,5,17,12,5,17,0.001368,0.000703,0,4488,3,0.000027,12,0.188074,0.209811,166353.590815,0.147059,0.007057
9304121,9304121,,25,0,25,25,0,25,0.000464,0,0,924,4,0.000064,0,0,0,0,0.095,0.007945
9609101,9609101,,17,4,21,17,4,21,0.000945,0.001956,0,3442,4,0.000023,11,0.176525,0.193489,199.622754,0.202381,0.005991
9610053,9610053,,19,37,56,19,37,56,0.001602,0.008709,0,3490,4,0.000022,12,0.214046,0.257566,17033.290767,0.134416,0.00786
9612086,9612086,,11,14,25,11,14,25,0.000476,0.001041,0,5791,4,0.000014,12,0.195212,0.223191,2016.531409,0.156667,0.003112
9703072,9703072,,45,45,90,45,45,90,0.002321,0.00506,0,3975,4,0.000037,12,0.215228,0.254473,379104.558386,0.114232,0.014839
9706145,9706145,,34,16,50,34,16,50,0.002266,0.002517,0,4497,4,0.000029,11,0.191764,0.219417,49944.885537,0.120408,0.009694
9708017,9708017,,19,29,48,19,29,48,0.000816,0.00332,0,5792,4,0.000016,12,0.210276,0.249426,12150.614072,0.203457,0.005365
9712018,9712018,,14,42,56,14,42,56,0.000683,0.003777,0,5973,4,0.000014,13,0.194178,0.228138,18711.218066,0.183442,0.004703
9803014,9803014,,10,22,32,10,22,32,0.000766,0.0031,0,9555,4,0.000012,13,0.194994,0.23244,9323.033964,0.22379,0.002786
9806011,9806011,,15,30,45,15,30,45,0.001838,0.005628,0,6496,0,0.000017,13,0.202475,0.232048,22237.165049,0.157071,0.004969
9808022,9808022,,2,22,24,2,22,24,0.000094,0.004598,0,9556,4,0.000011,12,0.205849,0.239821,6377.640858,0.300725,0.000536
9812227,9812227,,4,27,31,4,27,31,0.000726,0.003781,0,9550,0,0.000011,12,0.196399,0.222811,4409.059009,0.204301,0.001155
9805096,9805096,,75,29,104,75,29,104,0.017045,0.022864,0,5937,1,0.000061,12,0.214046,0.246319,170482.830019,0.078883,0.040157
9805139,9805139,,64,35,99,64,35,99,0.008981,0.021723,0,7038,1,0.000062,13,0.221547,0.255089,120049.016772,0.101938,0.036227
9806238,9806238,,23,16,39,23,16,39,0.002255,0.003265,0,7916,4,0.00002,12,0.204491,0.232122,21634.301366,0.120108,0.006916
9903242,9903242,,15,45,60,15,45,60,0.00111,0.006895,0,8633,4,0.000016,12,0.210444,0.245373,12778.354552,0.105085,0.004321
1052,1052,,0,2,2,0,2,2,0,0,0,9921,23,0.00001,3,0.5,0.583333,0,0,0
9805040,9805040,,6,1,7,6,1,7,0.000001,0,0,9920,23,0.000027,1,1,1,7,0.02381,0.001328
9807083,9807083,,7,3,10,7,3,10,0.000003,0.000011,0,9919,0,0.000037,2,0.714286,0.8,3277.039719,0.022222,0.001554
9303040,9303040,,46,1,47,46,1,47,0.000964,0.000018,0,29,0,0.000355,1,1,1,154.097051,0.047179,0.017054
9305099,9305099,,2,0,2,2,0,2,0,0,0,9918,23,0.000025,0,0,0,0,0,0.000484
9807058,9807058,,3,2,5,3,2,5,0.000001,0.000012,0,9917,0,0.000025,2,0.75,0.833333,35.039719,0.2,0.000703
1053,1053,,109,18,127,109,18,127,0.011496,0.001902,0,9926,1,0.00008,12,0.201766,0.225155,117809.414393,0.054556,0.038793
9211075,9211075,,11,0,11,11,0,11,0.00076,0,0,6635,1,0.000025,0,0,0,0,0.190909,0.004573
9712256,9712256,,62,5,67,62,5,67,0.005725,0.000054,0,7042,1,0.000064,6,0.260479,0.322797,33042.007585,0.106739,0.024058
9806024,9806024,,57,14,71,57,14,71,0.008607,0.018725,0,6636,1,0.000061,13,0.192531,0.220336,39906.256869,0.100402,0.028622
9907087,9907087,,23,20,43,23,20,43,0.002743,0.016916,0,9689,1,0.000026,13,0.186145,0.212879,4615.515661,0.215393,0.007821
9909110,9909110,,67,27,94,67,27,94,0.005498,0.005306,0,9923,1,0.000047,11,0.230649,0.264049,138181.571212,0.078701,0.021025
9909149,9909149,,13,10,23,13,10,23,0.001148,0.006517,0,9925,1,0.000021,13,0.179437,0.203497,6270.264306,0.294466,0.004866
9911039,9911039,,46,29,75,46,29,75,0.003764,0.003898,0,9924,1,0.000037,12,0.219372,0.250629,72152.596183,0.086486,0.015123
9206107,9206107,,20,1,21,20,1,21,0.000636,0.00001,0,224,5,0.000056,1,1,1,401.805969,0.052381,0.007129
9207118,9207118,,10,1,11,10,1,11,0.00004,0.000007,0,42,13,0.000086,1,1,1,114.593561,0.081818,0.004087
9301015,9301015,,39,3,42,39,3,42,0.000545,0.000029,0,51,13,0.000185,1,1,1,11646.41546,0.045296,0.013715
9301047,9301047,,43,6,49,43,6,49,0.000374,0.000066,0,49,13,0.000227,3,0.642857,0.796296,5841.220347,0.076531,0.015604
9404114,9404114,,42,20,62,42,20,62,0.001993,0.000334,0,504,41,0.00008,5,0.379747,0.451204,39709.96545,0.096774,0.015817
9405156,9405156,,8,4,12,8,4,12,0.000028,0.000012,0,566,13,0.000029,5,0.425532,0.5325,2026.924453,0.128788,0.002887
9411078,9411078,,4,12,16,4,12,16,0.000062,0.00021,0,567,13,0.000023,5,0.350734,0.408372,2979.035179,0.175,0.002183
9402073,9402073,,50,13,63,50,13,63,0.002419,0.000244,0,490,13,0.000127,3,0.527778,0.631579,45638.127723,0.042755,0.017501
9410008,9410008,,4,20,24,4,20,24,0.000074,0.000735,0,1157,13,0.000022,4,0.405405,0.502381,19934.806337,0.030797,0.001503
9502038,9502038,,38,18,56,38,18,56,0.001995,0.001181,0,1151,3,0.000046,6,0.303915,0.360265,19176.364649,0.081494,0.014207
9201080,9201080,,30,0,30,30,0,30,0.000639,0,0,4231,9,0.000077,0,0,0,0,0.112644,0.008952
9506180,9506180,,14,5,19,14,5,19,0.000214,0.000035,0,6324,9,0.000042,6,0.292308,0.35848,5808.654918,0.245614,0.004552
9705208,9705208,,34,10,44,34,10,44,0.005012,0.000989,0,5260,1,0.000048,11,0.208271,0.244907,50297.508614,0.114165,0.01884
9406063,9406063,,20,1,21,20,1,21,0.000539,0.000013,0,577,28,0.00007,1,1,1,240.125735,0.083333,0.007709
9504012,9504012,,5,5,10,5,5,10,0.000617,0.000695,0,5303,1,0.000031,4,0.335,0.389303,13204.100018,0.211111,0.005432
9801019,9801019,,60,16,76,60,16,76,0.009527,0.011342,0,5353,1,0.000089,14,0.18689,0.21732,124088.617278,0.090351,0.026701
9804111,9804111,,54,44,98,54,44,98,0.01275,0.026556,0,6094,1,0.000078,12,0.211715,0.248268,146438.29792,0.089207,0.035068
9804159,9804159,,26,21,47,26,21,47,0.00673,0.019385,0,6105,1,0.000041,12,0.207778,0.238787,56268.605344,0.141073,0.019584
9805165,9805165,,30,24,54,30,24,54,0.005861,0.019955,0,6591,1,0.00005,12,0.202155,0.231373,51518.551627,0.136268,0.019496
9806104,9806104,,103,99,202,103,99,202,0.020264,0.030443,0,6648,1,0.000098,12,0.226231,0.271162,553436.123464,0.050638,0.044977
9304011,9304011,,121,11,132,121,11,132,0.00581,0.000094,0,732,4,0.000287,3,0.433735,0.550926,102171.447972,0.012376,0.047267
9811005,9811005,,28,17,45,28,17,45,0.005137,0.018394,0,7535,1,0.000054,13,0.195797,0.223307,22332.425804,0.157071,0.018281
9812027,9812027,,46,27,73,46,27,73,0.008893,0.015847,0,7534,1,0.000047,12,0.210897,0.24322,76101.023767,0.101788,0.024444
9512154,9512154,,72,18,90,72,18,90,0.004952,0.005761,0,2499,3,0.000112,10,0.200464,0.246917,58401.011818,0.074782,0.032362
9707021,9707021,,9,11,20,9,11,20,0.000649,0.002678,0,7179,13,0.000021,14,0.194044,0.226016,4626.830824,0.152632,0.003846
9708091,9708091,,6,18,24,6,18,24,0.000391,0.002506,0,7180,13,0.000017,13,0.203732,0.239288,4621.470188,0.11413,0.002478
9712118,9712118,,10,24,34,10,24,34,0.002232,0.002759,0,5219,13,0.000018,13,0.195632,0.226543,14066.844395,0.220143,0.004771
9803231,9803231,,58,83,141,58,83,141,0.011721,0.03572,0,5916,1,0.000087,11,0.225719,0.266907,354235.053513,0.079787,0.035781
9805146,9805146,,26,25,51,26,25,51,0.005729,0.012171,0,6593,13,0.000034,12,0.196503,0.228181,9436.408547,0.135686,0.016831
9807173,9807173,,23,63,86,23,63,86,0.00497,0.016405,0,7049,1,0.000028,11,0.223416,0.261964,166732.725484,0.067031,0.014504
9810135,9810135,,10,40,50,10,40,50,0.002144,0.019902,0,7178,1,0.000016,13,0.206011,0.245576,32171.412597,0.14,0.003588
9601026,9601026,,4,7,11,4,7,11,0.0003,0.000059,0,7508,9,0.000015,6,0.298246,0.426961,13920.389035,0.072727,0.001881
9607129,9607129,,19,11,30,19,11,30,0.000405,0.000118,0,6330,9,0.00003,7,0.255589,0.293642,49744.196811,0.127586,0.005828
9811245,9811245,,30,4,34,30,4,34,0.005479,0.000535,0,7458,1,0.000037,12,0.187346,0.210094,6161.81633,0.15508,0.017856
9607145,9607145,,23,4,27,23,4,27,0.003,0.001632,0,3233,2,0.000115,11,0.182166,0.204826,4586.053665,0.119658,0.016507
9708086,9708086,,44,11,55,44,11,55,0.007011,0.001209,0,3566,13,0.000056,14,0.178407,0.206623,20183.922425,0.049495,0.023769
9709228,9709228,,16,23,39,16,23,39,0.001963,0.004435,0,4328,4,0.000025,11,0.211081,0.244838,99673.556713,0.131579,0.008022
9710005,9710005,,31,48,79,31,48,79,0.004526,0.010626,0,4416,2,0.000038,11,0.219898,0.258552,51745.141707,0.098994,0.014072
9810210,9810210,,46,42,88,46,42,88,0.008772,0.016535,0,7742,1,0.000038,12,0.212506,0.249608,129436.738447,0.081113,0.022097
9903086,9903086,,12,29,41,12,29,41,0.003204,0.018938,0,7841,41,0.00002,11,0.20667,0.233829,43676.649873,0.196951,0.011043
9407167,9407167,,23,12,35,23,12,35,0.001393,0.000059,0,4243,17,0.000043,4,0.414815,0.508929,21863.54301,0.084874,0.007808
9409064,9409064,,26,14,40,26,14,40,0.002503,0.000057,0,4245,17,0.000039,4,0.370968,0.4843,67969.716695,0.076282,0.008751
9806159,9806159,,92,47,139,92,47,139,0.018694,0.025886,0,6560,1,0.000077,11,0.220162,0.255725,216702.808138,0.059066,0.042451
9808014,9808014,,60,23,83,60,23,83,0.011002,0.020145,0,7420,1,0.000073,11,0.210518,0.239295,54710.722038,0.083162,0.033332
9808075,9808075,,78,33,111,78,33,111,0.018162,0.026994,0,7421,1,0.000065,11,0.215536,0.246651,27413.395008,0.102948,0.044076
9810201,9810201,,117,68,185,117,68,185,0.021567,0.017677,0,7680,1,0.000102,12,0.217655,0.254083,205184.692662,0.054877,0.058257
9811004,9811004,,66,38,104,66,38,104,0.011397,0.021777,0,7919,1,0.000052,13,0.213428,0.249902,162460.295461,0.099328,0.035203
9811139,9811139,,57,25,82,57,25,82,0.010323,0.012188,0,7973,1,0.000042,13,0.209819,0.242585,34109.24325,0.107347,0.030556
9901018,9901018,,28,48,76,28,48,76,0.008384,0.039743,0,7444,1,0.00003,13,0.209703,0.245285,23882.333677,0.111754,0.018444
9903203,9903203,,37,19,56,37,19,56,0.007328,0.018885,0,7863,1,0.000042,14,0.203233,0.229884,43021.378722,0.096429,0.01483
9904187,9904187,,18,14,32,18,14,32,0.005658,0.016223,0,8308,1,0.000024,14,0.190215,0.21568,43408.14148,0.1875,0.014995
9905049,9905049,,29,17,46,29,17,46,0.00753,0.017875,0,8190,1,0.000027,16,0.195445,0.22212,9751.676252,0.205797,0.017241
9810132,9810132,,13,18,31,13,18,31,0.00301,0.019258,0,8290,1,0.000018,13,0.199329,0.225962,15077.978646,0.136559,0.011304
9812237,9812237,,22,30,52,22,30,52,0.004207,0.024263,0,7182,2,0.000032,12,0.208318,0.240516,28508.509643,0.11991,0.015347
9904142,9904142,,33,13,46,33,13,46,0.005804,0.017747,0,7183,1,0.000046,13,0.194217,0.221113,8979.321422,0.127053,0.020454
9907210,9907210,,9,27,36,9,27,36,0.000904,0.010707,0,8531,2,0.000016,14,0.19941,0.23113,5076.957295,0.146825,0.003498
9909017,9909017,,12,20,32,12,20,32,0.000651,0.010264,0,9922,2,0.000017,12,0.210025,0.237001,19454.492019,0.09375,0.003819
9310046,9310046,,9,11,20,9,11,20,0.0004,0.000154,0,943,5,0.000015,4,0.390533,0.487374,13795.572832,0.086842,0.002437
9510222,9510222,,76,20,96,76,20,96,0.004153,0.002609,0,1594,4,0.000128,9,0.198859,0.249652,20703.214765,0.090132,0.035403
9903201,9903201,,11,10,21,11,10,21,0.001965,0.000777,0,7901,1,0.000017,12,0.181906,0.204048,2897.733148,0.138095,0.005053
1054,1054,,8,45,53,8,45,53,0.001146,0.028065,0,9931,4,0.000013,11,0.239199,0.277688,12711.147796,0.113208,0.00226
9705131,9705131,,72,126,198,72,126,198,0.008083,0.016437,0,4039,0,0.000039,12,0.240595,0.30439,406120.74569,0.055556,0.026278
9906070,9906070,,114,23,137,114,23,137,0.008322,0.002794,0,8542,0,0.000076,13,0.199758,0.228194,87101.828917,0.051632,0.042625
9910182,9910182,,18,19,37,18,19,37,0.001945,0.003471,0,9930,4,0.000018,12,0.200529,0.225077,29829.926388,0.123123,0.00763
9203033,9203033,,36,0,36,36,0,36,0.001131,0,0,274,0,0.000185,0,0,0,0,0.124603,0.017518
9205037,9205037,,45,0,45,45,0,45,0.000558,0,0,41,13,0.001166,0,0,0,0,0.082828,0.016996
9206006,9206006,,67,1,68,67,1,68,0.000395,0.000007,0,46,13,0.000564,1,1,1,252.527764,0.053556,0.024613
9208001,9208001,,24,3,27,24,3,27,0.000121,0.000027,0,55,13,0.00008,1,1,1,560.216013,0.098291,0.007847
9201064,9201064,,9,0,9,9,0,9,0.000219,0,0,949,9,0.000037,0,0,0,0,0.041667,0.003137
9201072,9201072,,14,0,14,14,0,14,0.000217,0,0,163,5,0.000247,0,0,0,0,0.038462,0.004487
9410034,9410034,,10,8,18,10,8,18,0.000068,0.000027,0,961,4,0.000027,5,0.374372,0.41745,269198.705222,0.111111,0.002993
9503012,9503012,,17,1,18,17,1,18,0.000605,0.001027,0,1196,4,0.000137,6,0.262295,0.292839,97.977188,0.133987,0.009339
9505190,9505190,,21,2,23,21,2,23,0.000912,0.00186,0,1195,4,0.000068,6,0.263804,0.29832,6.711556,0.171937,0.011458
9506181,9506181,,38,6,44,38,6,44,0.001917,0.00129,0,1845,4,0.000057,10,0.193064,0.2261,4385.14417,0.158034,0.017441
9511126,9511126,,94,29,123,94,29,123,0.005767,0.004593,0,1885,4,0.000072,13,0.2086,0.263527,105400.352048,0.112688,0.037112
9512161,9512161,,97,28,125,97,28,125,0.006041,0.004983,0,1900,4,0.000076,13,0.215157,0.268268,167282.477184,0.128581,0.038882
9602082,9602082,,67,8,75,67,8,75,0.004559,0.002108,0,1858,4,0.000075,12,0.182109,0.209724,12290.156868,0.08955,0.027115
9501062,9501062,,5,3,8,5,3,8,0.000551,0,0,1842,6,0.000033,1,1,1,42346.3379,0.053571,0.004978
9601053,9601053,,5,2,7,5,2,7,0.000293,0,0,1838,23,0.00009,1,1,1,28338.340022,0.095238,0.004165
9603116,9603116,,82,29,111,82,29,111,0.004512,0.010301,0,1803,0,0.000158,9,0.236824,0.277277,143649.363309,0.058804,0.034708
9507135,9507135,,40,3,43,40,3,43,0.002692,0.001896,0,2486,4,0.00013,10,0.178914,0.217955,2018.496337,0.148948,0.017213
9508163,9508163,,10,8,18,10,8,18,0.000785,0.002873,0,3485,4,0.000013,10,0.193973,0.231022,8.287399,0.333333,0.003995
9510079,9510079,,6,29,35,6,29,35,0.00116,0.007871,0,1434,0,0.000017,10,0.241653,0.292418,5586.005206,0.236975,0.00385
9510129,9510129,,85,20,105,85,20,105,0.005227,0.003826,0,1846,4,0.000084,13,0.195051,0.242781,9390.409722,0.12619,0.037233
9510183,9510183,,116,31,147,116,31,147,0.006738,0.009227,0,1848,4,0.000099,13,0.219708,0.279909,81443.55337,0.104231,0.046802
9510204,9510204,,101,19,120,101,19,120,0.006495,0.003586,0,1872,4,0.000077,14,0.200254,0.254042,64506.408192,0.122829,0.04017
9510207,9510207,,10,12,22,10,12,22,0.001566,0.00654,0,1854,0,0.00002,9,0.21393,0.252948,2688.686279,0.188312,0.00468
9512138,9512138,,16,27,43,16,27,43,0.001936,0.003689,0,1627,0,0.000023,13,0.226269,0.279681,109811.668687,0.17608,0.008738
9512140,9512140,,6,12,18,6,12,18,0.000607,0.002823,0,3501,4,0.000013,10,0.182867,0.232886,312.608837,0.346405,0.002796
9601059,9601059,,27,17,44,27,17,44,0.00149,0.003799,0,3061,4,0.000031,14,0.187491,0.231828,6175.99588,0.145877,0.009689
9601168,9601168,,45,22,67,45,22,67,0.002603,0.00354,0,2436,4,0.000044,13,0.212688,0.261331,12230.401992,0.18114,0.019143
9602061,9602061,,4,27,31,4,27,31,0.000416,0.01149,0,1783,2,0.000019,9,0.237827,0.279414,60850.635643,0.13871,0.00266
9602174,9602174,,51,43,94,51,43,94,0.002085,0.005234,0,3062,4,0.000065,12,0.215336,0.269938,33122.214079,0.120339,0.018772
9603073,9603073,,29,34,63,29,34,63,0.001759,0.0052,0,3066,4,0.000034,14,0.199971,0.250591,6429.365236,0.204813,0.012354
9604004,9604004,,67,35,102,67,35,102,0.003506,0.005399,0,2171,4,0.000072,11,0.224842,0.274987,65668.948382,0.086488,0.022353
9604043,9604043,,4,30,34,4,30,34,0.000494,0.011114,0,3476,0,0.000011,9,0.235994,0.278494,816.211108,0.180036,0.002026
9604051,9604051,,39,10,49,39,10,49,0.002358,0.002498,0,2437,4,0.000043,13,0.191197,0.227049,13863.409287,0.220663,0.017044
9604057,9604057,,3,29,32,3,29,32,0.000468,0.008154,0,3477,0,0.000011,10,0.231833,0.274482,782.881489,0.24496,0.001639
9604059,9604059,,34,10,44,34,10,44,0.002067,0.0025,0,3065,4,0.000038,14,0.186504,0.2223,1536.623302,0.268499,0.01573
9604077,9604077,,15,19,34,15,19,34,0.001724,0.00148,0,2267,0,0.000016,14,0.201122,0.247664,23374.053578,0.121212,0.006213
9604199,9604199,,58,25,83,58,25,83,0.003456,0.003997,0,3105,4,0.00006,14,0.19358,0.241226,84800.572298,0.151043,0.02232
9605090,9605090,,45,13,58,45,13,58,0.002334,0.002427,0,3073,4,0.000045,12,0.202135,0.236878,15235.538218,0.16092,0.018519
9605096,9605096,,51,9,60,51,9,60,0.003254,0.002482,0,3059,4,0.000056,13,0.170955,0.200851,11943.192077,0.116949,0.020068
9605135,9605135,,11,28,39,11,28,39,0.001289,0.005395,0,3500,4,0.000015,10,0.228799,0.270269,46425.458331,0.190283,0.004998
9605215,9605215,,59,8,67,59,8,67,0.003702,0.00234,0,3060,4,0.000067,13,0.169921,0.198699,1762.208907,0.155133,0.023138
9606111,9606111,,6,9,15,6,9,15,0.000513,0.002354,0,3456,4,0.000013,10,0.210772,0.235709,529.502496,0.32381,0.003095
9606168,9606168,,8,26,34,8,26,34,0.000627,0.004856,0,3496,4,0.000016,12,0.208617,0.256345,1556.618306,0.213904,0.003641
9606191,9606191,,45,31,76,45,31,76,0.002263,0.005164,0,3444,4,0.000043,11,0.200442,0.239381,19718.08416,0.122281,0.015138
9606199,9606199,,58,9,67,58,9,67,0.00405,0.001619,0,3063,4,0.000051,12,0.192687,0.224972,3854.157527,0.163275,0.023587
9607066,9607066,,52,7,59,52,7,59,0.003984,0.002094,0,3067,4,0.000043,13,0.175541,0.204877,2051.469272,0.145237,0.01899
9607109,9607109,,81,7,88,81,7,88,0.005731,0.001823,0,3111,4,0.000053,12,0.184653,0.214267,3178.869806,0.121996,0.027587
9607159,9607159,,14,17,31,14,17,31,0.001115,0.002981,0,3467,4,0.000016,10,0.215606,0.248334,12566.793669,0.316129,0.00623
9607190,9607190,,3,22,25,3,22,25,0.000448,0.002301,0,3408,0,0.000012,11,0.221678,0.254986,36564.269987,0.131667,0.001464
9608060,9608060,,43,27,70,43,27,70,0.002589,0.003966,0,3072,4,0.000037,13,0.189063,0.230931,42608.454704,0.201035,0.017411
9608104,9608104,,9,51,60,9,51,60,0.001152,0.012698,0,3478,4,0.000013,9,0.237368,0.286955,9363.211378,0.166102,0.004189
9608121,9608121,,7,4,11,7,4,11,0.000734,0.001951,0,3460,4,0.000014,14,0.152315,0.175338,69.113415,0.3,0.00329
9608161,9608161,,5,0,5,5,0,5,0.000677,0,0,3493,4,0.000012,0,0,0,0,0.2,0.002976
9609041,9609041,,76,39,115,76,39,115,0.005202,0.005136,0,3110,4,0.000047,10,0.227127,0.270586,97000.020197,0.152937,0.028902
9609062,9609062,,22,36,58,22,36,58,0.002175,0.005081,0,3475,4,0.000017,11,0.219159,0.258344,5675.147723,0.267998,0.0083
9609065,9609065,,20,17,37,20,17,37,0.001515,0.003421,0,3440,4,0.000017,11,0.190175,0.22008,278.282356,0.277027,0.00788
9609066,9609066,,17,18,35,17,18,35,0.001255,0.0034,0,3439,4,0.000018,14,0.170347,0.207179,271.019238,0.246218,0.007057
9609130,9609130,,9,14,23,9,14,23,0.000697,0.002501,0,3463,4,0.000014,11,0.185801,0.212333,6099.953523,0.249012,0.003779
9610049,9610049,,13,32,45,13,32,45,0.001576,0.004092,0,3492,4,0.000013,11,0.195402,0.231166,1547.640478,0.301515,0.004491
9610142,9610142,,11,21,32,11,21,32,0.00056,0.002797,0,3489,4,0.000017,10,0.213169,0.243731,16643.565104,0.177419,0.004094
9610204,9610204,,27,19,46,27,19,46,0.001549,0.001843,0,3487,4,0.000023,13,0.180797,0.213606,22819.246316,0.149758,0.008934
9610242,9610242,,18,43,61,18,43,61,0.001456,0.005823,0,3469,4,0.00002,12,0.21057,0.255981,75359.99822,0.184973,0.009045
9611016,9611016,,33,17,50,33,17,50,0.002987,0.002688,0,3459,4,0.000037,13,0.181203,0.214039,44959.750526,0.147755,0.011828
9611104,9611104,,6,12,18,6,12,18,0.000854,0.005822,0,3465,0,0.000025,10,0.209921,0.24115,631.45542,0.179739,0.004129
9611123,9611123,,22,23,45,22,23,45,0.001128,0.003231,0,3464,4,0.000027,13,0.181469,0.215599,23300.806989,0.15101,0.007515
9603176,9603176,,28,5,33,28,5,33,0.000838,0.000383,0,3381,4,0.000079,12,0.17719,0.202821,1778.23725,0.145833,0.012641
9605054,9605054,,24,4,28,24,4,28,0.000549,0.000085,0,3378,4,0.000082,12,0.174563,0.198155,4047.523598,0.140212,0.011728
9605182,9605182,,26,8,34,26,8,34,0.0005,0.000402,0,3379,4,0.000071,12,0.177817,0.205993,12250.353891,0.139037,0.01161
9608163,9608163,,88,17,105,88,17,105,0.008938,0.007146,0,3386,2,0.000135,9,0.217755,0.252889,42028.182116,0.051007,0.043593
9510001,9510001,,9,11,20,9,11,20,0.000613,0.000011,0,1504,9,0.00005,7,0.249337,0.313792,714293.175112,0.113158,0.007879
9605224,9605224,,27,20,47,27,20,47,0.003317,0.006368,0,2137,13,0.000035,11,0.213232,0.255716,2008.230305,0.168825,0.010899
9606113,9606113,,20,21,41,20,21,41,0.002472,0.006644,0,2138,13,0.000027,10,0.220093,0.26057,2177.801891,0.192073,0.007894
9703163,9703163,,19,33,52,19,33,52,0.004856,0.01209,0,3816,13,0.000022,14,0.214705,0.255126,66525.445447,0.176471,0.014175
9703211,9703211,,22,37,59,22,37,59,0.003592,0.009364,0,3737,2,0.00003,13,0.212179,0.254347,36302.798922,0.133255,0.011078
9702108,9702108,,46,24,70,46,24,70,0.006407,0.008569,0,3580,2,0.000108,14,0.191112,0.227436,5541.009205,0.142857,0.028521
9703016,9703016,,15,31,46,15,31,46,0.001763,0.010633,0,3627,2,0.000061,13,0.213869,0.256012,115279.073734,0.151691,0.012726
9703201,9703201,,21,32,53,21,32,53,0.002735,0.010464,0,3581,2,0.000068,12,0.209537,0.244649,94534.578865,0.173077,0.01398
9209018,9209018,,2,0,2,2,0,2,0.000242,0,0,4038,52,0.000011,0,0,0,0,0,0.001205
9212062,9212062,,5,0,5,5,0,5,0.000225,0,0,191,4,0.000239,0,0,0,0,0.1,0.006047
9311128,9311128,,5,1,6,5,1,6,0.000238,0.000002,0,1625,0,0.000016,1,1,1,2819.164978,0,0.001904
9402147,9402147,,45,0,45,45,0,45,0.001718,0,0,737,4,0.000137,0,0,0,0,0.05303,0.016368
9406008,9406008,,7,22,29,7,22,29,0.000412,0.000768,0,785,0,0.000021,3,0.692308,0.796296,8411.672013,0.125616,0.00342
9407192,9407192,,6,0,6,6,0,6,0.00047,0,0,3462,0,0.000013,0,0,0,0,0.1,0.002773
9508089,9508089,,43,5,48,43,5,48,0.003563,0.002518,0,1433,4,0.000103,6,0.270604,0.312267,4491.402155,0.052305,0.015719
9602147,9602147,,3,11,14,3,11,14,0.000319,0.001128,0,3130,0,0.000012,13,0.198343,0.241333,2033.807496,0.252747,0.001699
9607239,9607239,,46,12,58,46,12,58,0.002607,0.00214,0,3455,4,0.000061,14,0.1708,0.206286,25218.186233,0.083182,0.015852
9607121,9607121,,17,34,51,17,34,51,0.00166,0.00815,0,2522,0,0.000031,9,0.233561,0.275526,153062.256198,0.151373,0.009721
9404071,9404071,,62,3,65,62,3,65,0.007704,0.000178,0,1952,25,0.000102,3,0.380282,0.432099,11038.705542,0.067548,0.032587
9504147,9504147,,145,25,170,145,25,170,0.014854,0.005109,0,1106,13,0.000496,8,0.276827,0.335173,202094.683967,0.052698,0.091261
9704096,9704096,,5,23,28,5,23,28,0.0002,0.003516,0,5363,13,0.000028,14,0.18754,0.226135,89450.385739,0.101852,0.004523
9708085,9708085,,25,49,74,25,49,74,0.003241,0.013039,0,4336,2,0.000052,11,0.219613,0.259958,60049.885557,0.104036,0.014879
9710226,9710226,,41,14,55,41,14,55,0.00578,0.004283,0,5063,2,0.000061,14,0.188307,0.215918,22696.276419,0.139394,0.019848
9711003,9711003,,27,25,52,27,25,52,0.003841,0.005395,0,5106,2,0.000046,15,0.190146,0.225418,51094.31188,0.115762,0.014358
9712063,9712063,,34,19,53,34,19,53,0.004194,0.005995,0,5109,2,0.000047,14,0.190829,0.221292,15564.093109,0.12881,0.014743
9712236,9712236,,23,13,36,23,13,36,0.00357,0.003315,0,5126,2,0.000033,14,0.190884,0.217702,22080.02697,0.219841,0.011396
9801048,9801048,,12,22,34,12,22,34,0.001771,0.011178,0,5354,13,0.000026,14,0.192846,0.226055,10046.076599,0.184492,0.006825
9801070,9801070,,27,48,75,27,48,75,0.004271,0.010041,0,5333,2,0.000034,13,0.209439,0.248293,86912.526197,0.112252,0.0113
9509130,9509130,,20,18,38,20,18,38,0.002122,0.003683,0,1593,4,0.00003,10,0.180874,0.234388,363.215049,0.228307,0.008941
9603051,9603051,,31,23,54,31,23,54,0.002363,0.003931,0,3481,4,0.000025,14,0.180332,0.223543,4002.649483,0.180643,0.012074
9608090,9608090,,17,5,22,17,5,22,0.001658,0.000493,0,3415,4,0.000035,12,0.187066,0.21246,2340.263489,0.08658,0.005997
9610205,9610205,,20,36,56,20,36,56,0.002574,0.007431,0,3558,0,0.000031,11,0.228931,0.269051,53123.831703,0.100974,0.011383
9611152,9611152,,4,17,21,4,17,21,0.001388,0.002981,0,4014,4,0.000011,15,0.166262,0.203874,17173.142421,0.288095,0.002579
9611186,9611186,,24,28,52,24,28,52,0.004046,0.008088,0,3560,0,0.000035,12,0.217614,0.253463,14935.845376,0.156109,0.015195
9611222,9611222,,45,34,79,45,34,79,0.007554,0.010889,0,3562,0,0.000066,12,0.221692,0.260641,79065.911713,0.091853,0.025879
9612062,9612062,,50,10,60,50,10,60,0.009242,0.002871,0,3563,4,0.00004,12,0.200989,0.229582,10665.516845,0.093785,0.027826
9612104,9612104,,2,21,23,2,21,23,0.000442,0.005289,0,3556,0,0.000014,12,0.214251,0.250212,20052.209405,0.193676,0.002583
9703051,9703051,,67,11,78,67,11,78,0.006072,0.001639,0,3660,4,0.000066,11,0.207471,0.236819,35416.175632,0.156344,0.034931
9703172,9703172,,10,16,26,10,16,26,0.001148,0.003004,0,4043,4,0.000021,12,0.20584,0.238332,20603.919413,0.207692,0.006565
9703215,9703215,,7,16,23,7,16,23,0.001068,0.002012,0,4044,4,0.000018,12,0.192368,0.22165,884.937479,0.254941,0.005794
9704198,9704198,,37,30,67,37,30,67,0.003921,0.006212,0,4054,4,0.000036,11,0.20901,0.247016,59285.354567,0.223881,0.020199
9705003,9705003,,16,44,60,16,44,60,0.000942,0.002144,0,4061,4,0.000021,12,0.198714,0.233669,105371.674192,0.157345,0.006153
9705022,9705022,,41,17,58,41,17,58,0.004826,0.003347,0,4050,4,0.00004,11,0.21654,0.247563,11802.454978,0.174531,0.022221
9705106,9705106,,26,31,57,26,31,57,0.00234,0.002953,0,4062,4,0.000025,12,0.20761,0.242476,17929.889078,0.257206,0.013848
9705148,9705148,,14,15,29,14,15,29,0.001509,0.004704,0,4068,4,0.000017,12,0.186799,0.21683,1148.891338,0.198276,0.007473
9705232,9705232,,64,30,94,64,30,94,0.005849,0.006255,0,4067,4,0.000047,12,0.223158,0.264141,76876.290598,0.15111,0.028529
9706047,9706047,,45,43,88,45,43,88,0.005052,0.008755,0,4130,4,0.000035,13,0.21473,0.25375,62974.170327,0.139237,0.021647
9706082,9706082,,101,37,138,101,37,138,0.010976,0.007297,0,4206,4,0.000079,14,0.204437,0.245449,110276.702754,0.101238,0.050524
9706087,9706087,,33,29,62,33,29,62,0.003979,0.008393,0,4312,4,0.000027,11,0.22813,0.267831,29309.899967,0.139873,0.014487
9706121,9706121,,4,13,17,4,13,17,0.000672,0.004544,0,5035,4,0.000011,13,0.18447,0.213641,55.696102,0.242647,0.002627
9706127,9706127,,58,29,87,58,29,87,0.004978,0.004176,0,4311,4,0.000043,14,0.20673,0.245673,33211.149335,0.160118,0.024107
9706131,9706131,,7,28,35,7,28,35,0.000779,0.005511,0,4310,4,0.000012,15,0.212137,0.251819,11667.989259,0.253782,0.003956
9707027,9707027,,24,46,70,24,46,70,0.002122,0.004597,0,4313,4,0.000021,13,0.217556,0.2555,21243.560706,0.217805,0.011105
9707244,9707244,,71,51,122,71,51,122,0.007543,0.011506,0,4854,4,0.000055,14,0.217879,0.259347,91471.628789,0.101274,0.025175
9707247,9707247,,27,24,51,27,24,51,0.002166,0.006122,0,4852,4,0.000022,15,0.209529,0.244221,198827.311881,0.242353,0.011672
9707251,9707251,,39,11,50,39,11,50,0.003569,0.003632,0,4490,4,0.000031,12,0.199237,0.224826,9201.415134,0.14,0.01539
9707258,9707258,,28,15,43,28,15,43,0.002463,0.00501,0,4815,4,0.000024,15,0.188492,0.215055,1375.672512,0.230897,0.011981
9708015,9708015,,27,32,59,27,32,59,0.002245,0.005273,0,4855,4,0.000022,14,0.212448,0.248504,6453.189542,0.271771,0.011807
9708041,9708041,,17,34,51,17,34,51,0.002619,0.007843,0,4882,4,0.000016,14,0.210714,0.247197,5725.329981,0.162745,0.006854
9708044,9708044,,34,59,93,34,59,93,0.002667,0.008387,0,4857,4,0.00004,14,0.215947,0.257684,83528.921593,0.152641,0.015923
9708068,9708068,,35,14,49,35,14,49,0.003435,0.005632,0,4498,4,0.000027,10,0.209291,0.238089,42962.007246,0.122449,0.013338
9708082,9708082,,27,36,63,27,36,63,0.002466,0.005927,0,4858,4,0.000021,14,0.213927,0.251179,7849.40244,0.25704,0.011477
9708122,9708122,,21,48,69,21,48,69,0.002178,0.005885,0,4868,4,0.000022,14,0.211252,0.249117,109439.757402,0.179668,0.008597
9708127,9708127,,22,48,70,22,48,70,0.001979,0.005189,0,4865,4,0.000018,14,0.214483,0.252642,16382.798541,0.234369,0.009323
9708134,9708134,,43,33,76,43,33,76,0.003931,0.005438,0,4862,4,0.00004,14,0.215002,0.252543,87026.563361,0.138772,0.019083
9708168,9708168,,20,67,87,20,67,87,0.001821,0.008555,0,4872,4,0.000018,14,0.220897,0.26306,36266.271839,0.170543,0.008431
9709096,9709096,,19,51,70,19,51,70,0.00158,0.005302,0,4873,4,0.000017,14,0.212941,0.250383,13505.219044,0.243478,0.008326
9710020,9710020,,9,30,39,9,30,39,0.001311,0.004776,0,4916,4,0.000014,11,0.218725,0.25304,14033.124386,0.237517,0.004457
9710029,9710029,,3,14,17,3,14,17,0.000524,0.004642,0,5827,4,0.000012,11,0.204573,0.232117,771.138465,0.220588,0.002133
9710097,9710097,,36,9,45,36,9,45,0.004878,0.002296,0,5237,2,0.000075,16,0.189905,0.221004,32813.028147,0.126768,0.01933
9710181,9710181,,29,7,36,29,7,36,0.003386,0.000558,0,5238,2,0.000054,16,0.173168,0.194684,22144.776892,0.133333,0.016995
9711030,9711030,,13,30,43,13,30,43,0.001245,0.003011,0,4883,4,0.000016,15,0.20359,0.238148,52570.43564,0.176633,0.005572
9711117,9711117,,17,16,33,17,16,33,0.001454,0.004103,0,5014,2,0.00002,14,0.196583,0.22307,7702.029958,0.160985,0.00647
9711143,9711143,,38,62,100,38,62,100,0.004046,0.007835,0,4912,4,0.000028,16,0.208968,0.254107,265025.394222,0.097879,0.013401
9711177,9711177,,10,11,21,10,11,21,0.000869,0.002196,0,5661,2,0.000016,14,0.190963,0.215334,1658.733772,0.235714,0.004653
9712005,9712005,,17,74,91,17,74,91,0.001564,0.008274,0,4917,4,0.000016,14,0.21409,0.256295,32122.289797,0.182418,0.00766
9712029,9712029,,11,25,36,11,25,36,0.00094,0.007566,0,5015,4,0.000014,15,0.189645,0.218866,5028.917086,0.192857,0.00455
9712071,9712071,,46,49,95,46,49,95,0.009853,0.011241,0,5600,2,0.000044,15,0.211553,0.252397,193320.891157,0.092833,0.02789
9712143,9712143,,30,34,64,30,34,64,0.004807,0.006109,0,4979,4,0.000034,12,0.213724,0.249498,40297.160901,0.125992,0.013726
9712145,9712145,,28,34,62,28,34,62,0.003934,0.007224,0,4977,4,0.000024,16,0.196253,0.234383,47224.383461,0.131148,0.01252
9712149,9712149,,13,64,77,13,64,77,0.001301,0.005047,0,5016,4,0.000014,12,0.215043,0.254583,23172.183955,0.197539,0.006097
9712172,9712172,,13,39,52,13,39,52,0.001356,0.005569,0,5017,4,0.000015,13,0.197075,0.230447,17714.457358,0.20362,0.0061
9712187,9712187,,17,8,25,17,8,25,0.001882,0.001046,0,5662,2,0.000017,14,0.182098,0.20546,1027.100612,0.143333,0.006283
9712193,9712193,,28,35,63,28,35,63,0.002971,0.004827,0,4918,4,0.000035,15,0.206207,0.24596,160237.468472,0.16257,0.015472
9801002,9801002,,23,29,52,23,29,52,0.002127,0.006663,0,5018,4,0.000023,13,0.203381,0.236929,9461.166016,0.206637,0.010448
9801017,9801017,,29,26,55,29,26,55,0.003463,0.002724,0,5034,4,0.000026,13,0.199683,0.234311,74862.098889,0.128283,0.012877
9801020,9801020,,32,31,63,32,31,63,0.003176,0.004398,0,5019,4,0.000034,13,0.198152,0.233142,28153.34601,0.142089,0.014226
9801108,9801108,,16,12,28,16,12,28,0.001403,0.003018,0,5825,4,0.000017,16,0.186231,0.217346,11998.589075,0.154762,0.006039
9801134,9801134,,60,29,89,60,29,89,0.00651,0.002439,0,5037,4,0.000051,13,0.198198,0.230763,81300.593872,0.08593,0.027025
9708090,9708090,,5,33,38,5,33,38,0.000754,0.007034,0,5175,13,0.000018,12,0.201444,0.238531,3612.145288,0.187767,0.003166
9712200,9712200,,14,9,23,14,9,23,0.001063,0.001366,0,5606,13,0.000057,13,0.188078,0.217788,60703.860922,0.06917,0.009137
9707131,9707131,,7,18,25,7,18,25,0.000775,0.007314,0,4417,0,0.000015,12,0.197366,0.233528,5407.830062,0.128333,0.00235
9804149,9804149,,32,19,51,32,19,51,0.007542,0.013865,0,6138,1,0.000045,12,0.203087,0.232166,29239.512007,0.118431,0.015756
9805207,9805207,,23,15,38,23,15,38,0.004925,0.019179,0,6277,1,0.000027,12,0.200033,0.22688,95992.15127,0.105263,0.016302
9301003,9301003,,38,0,38,38,0,38,0.001307,0,0,132,26,0.000117,0,0,0,0,0.0633,0.017618
9305097,9305097,,21,1,22,21,1,22,0.001553,0,0,149,26,0.000058,1,1,1,14832.162966,0.123377,0.01322
9307085,9307085,,15,0,15,15,0,15,0.001473,0,0,179,26,0.000042,0,0,0,0,0.147619,0.011315
9402107,9402107,,48,16,64,48,16,64,0.003324,0.00028,0,189,26,0.000302,4,0.465278,0.558458,230500.010731,0.049107,0.027044
9505032,9505032,,15,3,18,15,3,18,0.002038,0.000058,0,1026,13,0.000034,2,0.8,0.875,24212.670542,0.065359,0.011515
9611203,9611203,,92,84,176,92,84,176,0.013394,0.024055,0,3019,0,0.000082,11,0.256773,0.310708,415962.596204,0.050357,0.039392
9711011,9711011,,5,4,9,5,4,9,0.001158,0.000001,0,8476,28,0.000016,5,0.308642,0.420667,77809.361879,0.236111,0.007584
9712253,9712253,,65,200,265,65,200,265,0.014119,0.038951,0,5288,13,0.000153,12,0.245355,0.309584,926076.881165,0.054774,0.030962
9803061,9803061,,61,39,100,61,39,100,0.01434,0.026358,0,5749,1,0.00009,14,0.204962,0.241603,103303.364044,0.091818,0.044319
9803103,9803103,,45,22,67,45,22,67,0.008812,0.01102,0,5906,13,0.000042,13,0.223664,0.260044,89248.382006,0.104025,0.022712
9803111,9803111,,33,33,66,33,33,66,0.009417,0.022635,0,5810,1,0.000063,13,0.205477,0.23707,41435.929546,0.189044,0.031727
9803119,9803119,,31,33,64,31,33,64,0.00947,0.023151,0,5773,1,0.000051,13,0.207328,0.240834,14212.778804,0.201885,0.029631
9803135,9803135,,94,33,127,94,33,127,0.024048,0.025409,0,5819,1,0.000121,13,0.206613,0.239063,71255.083449,0.086864,0.055588
9803167,9803167,,57,47,104,57,47,104,0.015487,0.028923,0,5820,1,0.000069,13,0.215411,0.25097,73843.874724,0.137976,0.038639
9803214,9803214,,69,67,136,69,67,136,0.013967,0.030901,0,5848,1,0.000084,12,0.230106,0.268645,653824.037576,0.094499,0.041044
9803263,9803263,,77,44,121,77,44,121,0.019303,0.021286,0,5918,1,0.000084,13,0.213304,0.246319,91612.43522,0.087672,0.040571
9804060,9804060,,14,58,72,14,58,72,0.004684,0.027832,0,6557,1,0.000025,11,0.222122,0.256486,64636.0246,0.211854,0.013263
9804062,9804062,,16,50,66,16,50,66,0.004301,0.023986,0,6586,1,0.000024,13,0.205889,0.244579,138399.029099,0.113986,0.01331
9804139,9804139,,35,9,44,35,9,44,0.003022,0.000615,0,6347,0,0.000036,15,0.171966,0.194729,4555.4508,0.179704,0.018408
9804164,9804164,,37,40,77,37,40,77,0.003333,0.004808,0,6494,0,0.000035,12,0.205917,0.237816,154702.60359,0.113978,0.017906
9804174,9804174,,48,23,71,48,23,71,0.003672,0.002301,0,6477,4,0.000048,13,0.192035,0.220808,204380.073158,0.105433,0.020858
9804184,9804184,,43,31,74,43,31,74,0.009593,0.022332,0,5872,0,0.000049,13,0.214691,0.246224,112761.176036,0.152166,0.028359
9804209,9804209,,5,14,19,5,14,19,0.002055,0.019375,0,7407,1,0.000016,13,0.196421,0.224275,3278.594433,0.216374,0.008545
9805047,9805047,,9,51,60,9,51,60,0.003492,0.028113,0,6642,2,0.000014,11,0.214044,0.250967,50357.704092,0.120904,0.00987
9805050,9805050,,15,32,47,15,32,47,0.003674,0.020031,0,6629,1,0.000022,12,0.206218,0.237532,559181.761985,0.145236,0.012512
9805097,9805097,,45,44,89,45,44,89,0.008799,0.022943,0,6592,13,0.000047,12,0.214392,0.256513,76307.065021,0.102911,0.022968
9805154,9805154,,3,27,30,3,27,30,0.001751,0.011471,0,8451,2,0.000012,15,0.195065,0.230999,17768.867268,0.114943,0.007284
9805218,9805218,,17,22,39,17,22,39,0.003218,0.009062,0,7918,1,0.000024,13,0.209913,0.239362,81786.939773,0.109987,0.013787
9806039,9806039,,93,3,96,93,3,96,0.011228,0.006367,0,8103,8,0.000194,15,0.165445,0.183668,6184.642835,0.09068,0.043168
9806041,9806041,,12,40,52,12,40,52,0.003874,0.024977,0,7647,1,0.000018,12,0.217127,0.248984,10893.750601,0.201735,0.012115
9806042,9806042,,56,28,84,56,28,84,0.010672,0.024059,0,6673,1,0.000056,12,0.215049,0.245756,54015.7334,0.092083,0.026964
9806072,9806072,,10,5,15,10,5,15,0.003212,0.001132,0,7696,1,0.000017,14,0.18173,0.203991,2650.850343,0.2,0.009556
9806091,9806091,,28,38,66,28,38,66,0.00455,0.023091,0,7627,0,0.000036,13,0.215387,0.246581,81204.057742,0.158508,0.016817
9806095,9806095,,65,30,95,65,30,95,0.012147,0.021753,0,6679,41,0.000081,13,0.205983,0.239032,105145.666093,0.08757,0.032642
9806113,9806113,,10,31,41,10,31,41,0.002853,0.024458,0,7161,1,0.000017,12,0.202121,0.232814,14738.52407,0.159146,0.009635
9806122,9806122,,11,17,28,11,17,28,0.003263,0.010034,0,7157,1,0.000016,13,0.189327,0.214822,41319.094282,0.201058,0.009658
9806125,9806125,,50,25,75,50,25,75,0.013462,0.023061,0,6728,1,0.000066,12,0.204521,0.233287,43022.109981,0.121982,0.029067
9806128,9806128,,29,4,33,29,4,33,0.008137,0.010821,0,7406,1,0.000045,13,0.181716,0.20166,108.781027,0.188447,0.018571
9806132,9806132,,12,36,48,12,36,48,0.003443,0.022468,0,8057,1,0.000016,12,0.205243,0.237137,24370.969292,0.183954,0.009827
9806136,9806136,,15,28,43,15,28,43,0.004637,0.015677,0,6417,2,0.000018,12,0.22073,0.25679,56634.219081,0.210963,0.012495
9806158,9806158,,22,18,40,22,18,40,0.00625,0.020742,0,7174,1,0.000024,13,0.200572,0.22697,5557.454426,0.223718,0.014026
9806178,9806178,,8,35,43,8,35,43,0.00296,0.022436,0,7791,2,0.000015,13,0.207462,0.239193,21924.828607,0.173865,0.009914
9806180,9806180,,27,13,40,27,13,40,0.007065,0.01837,0,7039,1,0.000037,12,0.200573,0.226086,3548.22295,0.182051,0.021507
9806188,9806188,,6,8,14,6,8,14,0.002684,0.014918,0,7790,2,0.000016,14,0.186935,0.211892,11388.38749,0.302198,0.009419
9806235,9806235,,31,15,46,31,15,46,0.007128,0.015146,0,6729,1,0.00004,13,0.190967,0.215785,8067.01293,0.204831,0.017967
9807019,9807019,,17,11,28,17,11,28,0.004063,0.01271,0,7044,1,0.000033,13,0.190482,0.213763,25137.834431,0.191799,0.013631
9807055,9807055,,10,22,32,10,22,32,0.00336,0.012292,0,6869,2,0.000016,14,0.192367,0.221885,19045.271092,0.118952,0.010423
9807093,9807093,,9,15,24,9,15,24,0.002639,0.020215,0,7426,1,0.000018,13,0.194882,0.220181,961.73581,0.259058,0.009313
9807109,9807109,,25,7,32,25,7,32,0.004921,0.017454,0,7075,1,0.000037,13,0.192102,0.215965,33324.708396,0.127016,0.01515
9807149,9807149,,9,10,19,9,10,19,0.00258,0.016022,0,7419,1,0.000021,12,0.196362,0.220649,26346.816667,0.192982,0.010743
9807150,9807150,,32,33,65,32,33,65,0.007788,0.021065,0,7056,1,0.000039,11,0.20535,0.236533,39946.375468,0.138462,0.019781
9807179,9807179,,35,14,49,35,14,49,0.007432,0.014481,0,7833,1,0.00003,13,0.198553,0.223962,10166.642789,0.130952,0.017485
9807185,9807185,,5,80,85,5,80,85,0.001765,0.031891,0,8058,13,0.000013,12,0.226042,0.272347,91784.762041,0.127451,0.007854
9807196,9807196,,20,14,34,20,14,34,0.005801,0.019172,0,6730,1,0.000044,13,0.190909,0.215989,8556.662783,0.213904,0.015491
9807200,9807200,,15,17,32,15,17,32,0.003315,0.017521,0,7071,1,0.000032,12,0.198567,0.22201,18973.25403,0.169355,0.012417
9807208,9807208,,3,15,18,3,15,18,0.001757,0.016104,0,7693,1,0.000012,13,0.198884,0.228492,79189.215956,0.176471,0.007198
9808026,9808026,,5,13,18,5,13,18,0.001374,0.00831,0,8475,1,0.000014,14,0.195924,0.222569,8102.299342,0.156863,0.007848
9808037,9808037,,25,42,67,25,42,67,0.006165,0.025307,0,7176,1,0.000025,12,0.205635,0.234337,34852.979311,0.121891,0.014748
9808048,9808048,,19,46,65,19,46,65,0.00394,0.023382,0,7646,0,0.000029,12,0.217015,0.249618,160685.075921,0.17476,0.01394
9808051,9808051,,4,13,17,4,13,17,0.001824,0.017875,0,7549,1,0.000013,12,0.197263,0.221266,3984.445247,0.290441,0.007832
9808052,9808052,,41,13,54,41,13,54,0.006995,0.017478,0,6681,41,0.000047,13,0.196207,0.222909,13779.730806,0.130328,0.024426
9808081,9808081,,5,20,25,5,20,25,0.001921,0.011894,0,8474,1,0.000013,12,0.202842,0.234991,11059.47357,0.111667,0.00794
9808088,9808088,,83,17,100,83,17,100,0.017772,0.008904,0,6735,41,0.000085,13,0.190828,0.21692,32883.816865,0.090202,0.039021
9808126,9808126,,17,8,25,17,8,25,0.005408,0.006883,0,7427,1,0.000022,13,0.187751,0.209663,1633.938461,0.18,0.013094
9808143,9808143,,11,38,49,11,38,49,0.003655,0.021298,0,7650,1,0.000016,12,0.215104,0.245457,35033.407444,0.174745,0.011655
9808161,9808161,,24,32,56,24,32,56,0.005205,0.020258,0,8363,0,0.000019,12,0.215937,0.248269,36002.952807,0.150325,0.014406
9808168,9808168,,19,46,65,19,46,65,0.005237,0.020358,0,7172,13,0.00002,11,0.229311,0.266543,65514.793337,0.137019,0.012517
9808175,9808175,,11,30,41,11,30,41,0.003156,0.019392,0,7917,1,0.000016,12,0.210525,0.240632,43503.068284,0.115244,0.010382
9808177,9808177,,24,12,36,24,12,36,0.004482,0.017533,0,7891,1,0.000059,13,0.189654,0.213732,41065.889645,0.122222,0.015449
9809033,9809033,,46,48,94,46,48,94,0.010504,0.02405,0,7155,1,0.000041,13,0.217118,0.251437,534942.615322,0.082704,0.022945
9809045,9809045,,31,21,52,31,21,52,0.005454,0.017685,0,6736,41,0.000029,13,0.19146,0.219227,7554.996512,0.145551,0.016319
9809063,9809063,,4,16,20,4,16,20,0.001265,0.009294,0,8473,2,0.000013,13,0.199151,0.227106,19986.561158,0.192105,0.007405
9809106,9809106,,29,11,40,29,11,40,0.008307,0.017535,0,7404,1,0.000039,13,0.193345,0.219583,3787.337816,0.201923,0.019472
9809162,9809162,,19,18,37,19,18,37,0.003424,0.008457,0,7656,0,0.000023,12,0.201552,0.230079,14235.915726,0.108108,0.014821
9809172,9809172,,1,25,26,1,25,26,0.001157,0.018433,0,8471,1,0.000011,13,0.197261,0.2264,17640.054485,0.233846,0.006694
9809173,9809173,,2,17,19,2,17,19,0.001383,0.007954,0,8469,4,0.000012,14,0.203271,0.238302,60422.319037,0.19883,0.00696
9809193,9809193,,10,55,65,10,55,65,0.003262,0.025929,0,7177,1,0.000015,12,0.212912,0.248125,31717.183827,0.159135,0.009707
9809213,9809213,,21,30,51,21,30,51,0.004095,0.018561,0,7348,41,0.000024,12,0.196861,0.225292,60378.672285,0.178039,0.013127
9810053,9810053,,13,18,31,13,18,31,0.004092,0.019765,0,7780,1,0.000019,12,0.197503,0.224009,123087.88684,0.197849,0.010782
9810092,9810092,,38,14,52,38,14,52,0.006341,0.017211,0,7834,1,0.00003,13,0.198051,0.223214,14714.40745,0.126697,0.017645
9810152,9810152,,34,19,53,34,19,53,0.005108,0.00972,0,7430,4,0.000029,13,0.205366,0.235538,56275.506458,0.116836,0.017817
9810195,9810195,,17,46,63,17,46,63,0.00465,0.023687,0,7425,1,0.000023,11,0.221152,0.254226,162927.525027,0.09063,0.013523
9810200,9810200,,14,10,24,14,10,24,0.004137,0.017545,0,7412,1,0.000021,13,0.191698,0.215247,6973.825266,0.222826,0.012235
9810224,9810224,,21,17,38,21,17,38,0.005903,0.020832,0,7411,1,0.000024,14,0.19544,0.220978,5935.238913,0.169275,0.014624
9810225,9810225,,35,12,47,35,12,47,0.008462,0.003947,0,7410,1,0.000047,13,0.182014,0.205698,73836.692918,0.121184,0.021374
9810226,9810226,,51,26,77,51,26,77,0.01,0.022433,0,7057,1,0.000046,11,0.206838,0.238006,30409.080749,0.088517,0.02432
9810236,9810236,,6,2,8,6,2,8,0.001271,0.000268,0,7947,1,0.000024,14,0.171719,0.187083,201057.096602,0.071429,0.007923
9810244,9810244,,18,30,48,18,30,48,0.004269,0.020051,0,7688,1,0.000024,13,0.206842,0.236688,42729.491238,0.18484,0.013739
9810257,9810257,,8,11,19,8,11,19,0.002244,0.002411,0,8407,0,0.000014,13,0.185368,0.209016,918.190345,0.134503,0.009048
9811002,9811002,,23,16,39,23,16,39,0.004774,0.01645,0,7533,1,0.000026,12,0.195213,0.223198,172236.387259,0.172065,0.013954
9811008,9811008,,17,18,35,17,18,35,0.002949,0.001197,0,8110,0,0.000058,16,0.154669,0.177078,190439.20036,0.17395,0.013786
9811028,9811028,,13,27,40,13,27,40,0.002592,0.020988,0,7037,1,0.000028,13,0.195722,0.221875,62886.833023,0.111538,0.011751
9811042,9811042,,6,27,33,6,27,33,0.002192,0.02134,0,8468,1,0.000013,13,0.201283,0.22914,4120.447472,0.235795,0.00801
9811056,9811056,,46,16,62,46,16,62,0.007897,0.019161,0,8327,1,0.000043,12,0.192914,0.218731,39814.488083,0.089371,0.020121
9811057,9811057,,5,61,66,5,61,66,0.002198,0.026478,0,7840,1,0.000013,13,0.213095,0.248951,41544.243351,0.135897,0.008221
9811087,9811087,,4,26,30,4,26,30,0.001282,0.005501,0,8444,0,0.000013,13,0.195621,0.225292,28675.993451,0.190805,0.007515
9811131,9811131,,95,28,123,95,28,123,0.009085,0.018953,0,7845,4,0.000088,14,0.187463,0.215789,121318.425103,0.065107,0.049509
9811147,9811147,,9,23,32,9,23,32,0.002468,0.017748,0,8175,1,0.000017,13,0.198761,0.2313,18645.780848,0.15625,0.008887
9811192,9811192,,23,12,35,23,12,35,0.006367,0.004524,0,8051,1,0.000022,13,0.196097,0.222648,8653.881867,0.164706,0.014159
9811224,9811224,,21,4,25,21,4,25,0.005424,0.007254,0,7443,1,0.000036,13,0.184505,0.207449,7100.903105,0.195,0.013994
9811243,9811243,,5,6,11,5,6,11,0.0018,0.017468,0,8338,8,0.000029,15,0.177784,0.201701,2888.948812,0.327273,0.008581
9812007,9812007,,27,35,62,27,35,62,0.007938,0.022965,0,8139,1,0.000025,12,0.205818,0.235526,102373.775393,0.122158,0.015159
9812012,9812012,,23,12,35,23,12,35,0.005204,0.014384,0,7707,1,0.000028,13,0.20083,0.225992,27461.349607,0.091597,0.014144
9812016,9812016,,8,23,31,8,23,31,0.001995,0.017906,0,8467,1,0.000014,13,0.197796,0.228062,13869.3215,0.211828,0.008793
9812025,9812025,,18,26,44,18,26,44,0.004002,0.02256,0,7996,1,0.00002,11,0.208775,0.238662,22199.951852,0.209302,0.014608
9812034,9812034,,76,19,95,76,19,95,0.007879,0.015481,0,8313,1,0.000082,13,0.192543,0.220856,121545.109916,0.049832,0.027681
9812043,9812043,,15,7,22,15,7,22,0.002594,0.006548,0,8337,8,0.000052,15,0.170178,0.190997,18556.738362,0.270563,0.012722
9812044,9812044,,8,10,18,8,10,18,0.002466,0.015982,0,8237,1,0.000018,14,0.185088,0.21049,18621.693027,0.173203,0.008772
9812067,9812067,,45,32,77,45,32,77,0.010475,0.021068,0,7619,1,0.000035,11,0.201979,0.228843,40987.5255,0.145249,0.024204
9812087,9812087,,16,23,39,16,23,39,0.003634,0.00869,0,7837,41,0.000025,12,0.197776,0.224072,27422.78639,0.106613,0.01146
9812100,9812100,,20,21,41,20,21,41,0.004246,0.018668,0,7701,1,0.000021,14,0.195251,0.225094,4599.377279,0.206707,0.013188
9812117,9812117,,19,18,37,19,18,37,0.003457,0.01662,0,8431,1,0.000031,14,0.204359,0.233116,38456.323292,0.147147,0.011441
9812121,9812121,,27,18,45,27,18,45,0.006601,0.015528,0,7886,1,0.000032,12,0.198584,0.225722,66572.295303,0.182828,0.017081
9812169,9812169,,4,12,16,4,12,16,0.001811,0.016251,0,8466,1,0.000012,13,0.193428,0.219213,20693.181421,0.2125,0.007573
9812206,9812206,,6,10,16,6,10,16,0.001925,0.017957,0,8465,1,0.000017,12,0.194414,0.218605,2807.594839,0.266667,0.008035
9812240,9812240,,25,17,42,25,17,42,0.005739,0.009268,0,7842,1,0.000024,13,0.195056,0.223699,6614.836525,0.131243,0.014424
9812250,9812250,,2,43,45,2,43,45,0.001393,0.023733,0,8464,4,0.000012,12,0.2194,0.25311,595007.953754,0.087374,0.006966
9901002,9901002,,9,27,36,9,27,36,0.002246,0.015307,0,8455,1,0.000015,13,0.206728,0.237366,9788.78574,0.169048,0.008609
9901004,9901004,,18,35,53,18,35,53,0.004753,0.021071,0,7431,1,0.000022,11,0.213877,0.243909,58929.874265,0.116473,0.013337
9901030,9901030,,5,19,24,5,19,24,0.002073,0.019523,0,8454,1,0.000014,14,0.196399,0.225614,70834.393637,0.201087,0.008047
9901033,9901033,,8,15,23,8,15,23,0.003249,0.019373,0,7782,2,0.000015,14,0.20961,0.242821,17490.185057,0.26087,0.01013
9901048,9901048,,6,26,32,6,26,32,0.002403,0.02,0,8453,1,0.000015,14,0.206534,0.237405,17945.726666,0.148185,0.008286
9901076,9901076,,45,11,56,45,11,56,0.010667,0.017614,0,7435,1,0.00005,13,0.190709,0.214152,14212.53664,0.110714,0.024639
9901088,9901088,,1,18,19,1,18,19,0.001157,0.018454,0,8452,1,0.000011,12,0.196645,0.22676,3739.156021,0.152047,0.006694
9901091,9901091,,25,21,46,25,21,46,0.004837,0.009135,0,8287,1,0.000025,11,0.203036,0.230626,94825.571028,0.193237,0.017414
9901106,9901106,,14,11,25,14,11,25,0.003489,0.017362,0,8048,1,0.000019,12,0.19505,0.219078,4519.095434,0.285,0.011631
9901118,9901118,,17,20,37,17,20,37,0.003903,0.012095,0,8264,1,0.000019,14,0.189988,0.21689,275729.203327,0.158408,0.011236
9901131,9901131,,2,10,12,2,10,12,0.001168,0.015423,0,8450,1,0.000012,14,0.180652,0.203705,102181.062834,0.181818,0.006962
9901135,9901135,,15,72,87,15,72,87,0.004232,0.030176,0,8187,2,0.000018,13,0.222729,0.262195,118444.933638,0.103047,0.011365
9901139,9901139,,14,11,25,14,11,25,0.002595,0.015568,0,8442,1,0.000023,14,0.184393,0.208315,66216.250611,0.173333,0.010601
9901143,9901143,,13,12,25,13,12,25,0.003813,0.017706,0,7960,1,0.000017,12,0.188401,0.212543,757.440884,0.266667,0.010834
9902005,9902005,,22,18,40,22,18,40,0.002155,0.001899,0,8449,4,0.000025,17,0.18432,0.210825,52256.858934,0.197436,0.012773
9902007,9902007,,20,9,29,20,9,29,0.002955,0.006362,0,8443,1,0.00003,14,0.182343,0.204489,19382.699159,0.157635,0.012141
9902034,9902034,,18,9,27,18,9,27,0.00243,0.00709,0,8439,13,0.000021,12,0.19374,0.218157,15240.499809,0.150997,0.011489
9902042,9902042,,29,8,37,29,8,37,0.006526,0.015793,0,7706,1,0.000049,15,0.181351,0.202622,18115.671907,0.168168,0.016665
9902045,9902045,,15,52,67,15,52,67,0.003224,0.028703,0,8291,1,0.00002,12,0.230048,0.269685,33562.933798,0.097919,0.012238
9902052,9902052,,43,22,65,43,22,65,0.010858,0.02079,0,7445,1,0.00005,14,0.202112,0.231757,30727.215092,0.108654,0.02306
9902058,9902058,,38,41,79,38,41,79,0.004767,0.023932,0,8438,2,0.000032,14,0.227784,0.263757,245229.751857,0.071081,0.017885
9902059,9902059,,49,37,86,49,37,86,0.00763,0.020613,0,7855,2,0.000051,13,0.212511,0.245933,244366.819072,0.071546,0.024223
9902066,9902066,,19,8,27,19,8,27,0.002799,0.00646,0,8436,1,0.000051,14,0.18595,0.20835,30045.394219,0.098291,0.014305
9902068,9902068,,4,15,19,4,15,19,0.002202,0.017692,0,8294,1,0.000014,15,0.18574,0.21419,4388.015873,0.21345,0.007789
9902079,9902079,,16,27,43,16,27,43,0.002949,0.021063,0,8265,1,0.00002,13,0.201226,0.234676,6672.996693,0.16722,0.010963
9902086,9902086,,4,20,24,4,20,24,0.00171,0.021273,0,8055,1,0.000013,13,0.195458,0.223189,3271.57886,0.222826,0.007956
9902088,9902088,,56,6,62,56,6,62,0.007949,0.001039,0,8339,8,0.0001,16,0.158075,0.175851,9674.177663,0.149392,0.028828
9902095,9902095,,31,23,54,31,23,54,0.00479,0.02359,0,8049,1,0.000035,13,0.200414,0.228252,16466.105592,0.151642,0.01804
9902106,9902106,,7,30,37,7,30,37,0.00233,0.022002,0,7603,1,0.000017,16,0.197637,0.225623,32315.48538,0.224474,0.00903
9902110,9902110,,27,15,42,27,15,42,0.005003,0.004148,0,8053,1,0.000027,14,0.198049,0.222234,21335.715008,0.159117,0.015927
9902118,9902118,,12,37,49,12,37,49,0.002726,0.021384,0,8364,1,0.000015,11,0.21512,0.249823,74355.58163,0.151786,0.010033
9902122,9902122,,5,29,34,5,29,34,0.001745,0.017658,0,8434,41,0.000014,13,0.202483,0.229485,58287.908422,0.21123,0.007847
9902123,9902123,,9,11,20,9,11,20,0.003,0.017234,0,8191,1,0.000016,12,0.189163,0.212269,110.411335,0.355263,0.008855
9902168,9902168,,16,19,35,16,19,35,0.002864,0.014883,0,8432,1,0.000028,13,0.198278,0.224291,14668.014185,0.153782,0.010542
9902173,9902173,,46,9,55,46,9,55,0.007112,0.001187,0,8343,8,0.000081,13,0.184509,0.205212,96981.420314,0.1633,0.024735
9902197,9902197,,19,31,50,19,31,50,0.004711,0.023779,0,8430,1,0.000019,13,0.207174,0.23597,23790.342165,0.154286,0.011764
9902210,9902210,,47,33,80,47,33,80,0.007632,0.023834,0,8301,1,0.000039,13,0.211086,0.246021,64767.173614,0.090032,0.023417
9903007,9903007,,11,4,15,11,4,15,0.003502,0.015292,0,8416,1,0.000015,15,0.179377,0.202764,1142.642315,0.157143,0.009379
9903029,9903029,,16,51,67,16,51,67,0.004517,0.014505,0,8120,1,0.000017,13,0.223419,0.257634,213520.51158,0.105834,0.011457
9903036,9903036,,18,11,29,18,11,29,0.004273,0.007542,0,7689,1,0.000024,11,0.192862,0.216536,4766.436116,0.19335,0.012195
9903043,9903043,,10,17,27,10,17,27,0.002762,0.013236,0,7795,1,0.000018,12,0.194548,0.220107,5530.45975,0.128205,0.009955
9903048,9903048,,33,11,44,33,11,44,0.008357,0.016522,0,7604,1,0.000036,17,0.185953,0.209757,10220.016416,0.149577,0.018235
9903054,9903054,,7,30,37,7,30,37,0.001726,0.019752,0,8415,1,0.000014,14,0.194873,0.22601,43921.703886,0.157658,0.008238
9903058,9903058,,5,24,29,5,24,29,0.001758,0.010248,0,8414,1,0.000013,14,0.19487,0.22379,60613.83793,0.14532,0.007846
9903065,9903065,,4,19,23,4,19,23,0.00171,0.015645,0,8373,1,0.000014,13,0.199169,0.236501,25635.498071,0.164032,0.007581
9903067,9903067,,11,15,26,11,15,26,0.003148,0.013033,0,8367,1,0.000019,13,0.195537,0.222242,5434.661423,0.147692,0.009661
9903078,9903078,,16,31,47,16,31,47,0.004847,0.02085,0,7961,1,0.00002,14,0.199666,0.228422,28094.940963,0.138298,0.012372
9903079,9903079,,2,17,19,2,17,19,0.001253,0.018139,0,8413,1,0.000011,11,0.202938,0.23071,1900.572588,0.248538,0.006949
9903080,9903080,,6,23,29,6,23,29,0.00193,0.02168,0,8412,1,0.000014,13,0.21079,0.23836,28215.650779,0.163793,0.008964
9903090,9903090,,22,26,48,22,26,48,0.006345,0.019611,0,8052,1,0.000023,12,0.207496,0.233414,77518.272697,0.203901,0.015044
9903094,9903094,,33,26,59,33,26,59,0.008934,0.020683,0,7605,1,0.000029,15,0.191515,0.21994,15313.386888,0.164231,0.019185
9903120,9903120,,8,38,46,8,38,46,0.002524,0.022393,0,8176,1,0.000014,13,0.208373,0.242599,21627.14665,0.123671,0.008898
9903128,9903128,,13,38,51,13,38,51,0.002533,0.020879,0,8059,1,0.000017,13,0.208161,0.240298,27060.857328,0.143922,0.010424
9903163,9903163,,23,19,42,23,19,42,0.004889,0.00944,0,8146,1,0.000021,13,0.212857,0.246073,115705.783058,0.122532,0.013343
9903178,9903178,,8,23,31,8,23,31,0.002408,0.017895,0,8370,1,0.000017,11,0.192732,0.218496,73764.891537,0.23871,0.008813
9903186,9903186,,19,19,38,19,19,38,0.004645,0.006144,0,8054,1,0.00002,13,0.196422,0.219663,7082.2917,0.233997,0.013281
9903195,9903195,,4,19,23,4,19,23,0.001302,0.018264,0,8408,1,0.000013,13,0.202582,0.229889,2126.051696,0.215415,0.007642
9903204,9903204,,5,4,9,5,4,9,0.001288,0.005798,0,8406,2,0.000015,14,0.175365,0.196904,63464.644008,0.194444,0.007679
9903209,9903209,,2,14,16,2,14,16,0.001371,0.017839,0,8405,1,0.000012,13,0.190128,0.21387,16252.599155,0.2875,0.006926
9903222,9903222,,2,17,19,2,17,19,0.001389,0.016943,0,8374,1,0.000012,11,0.19107,0.215726,3474.867299,0.353801,0.007034
9903227,9903227,,4,23,27,4,23,27,0.002015,0.02232,0,8404,1,0.000014,14,0.197587,0.224178,1579.999862,0.210826,0.007699
9903228,9903228,,35,12,47,35,12,47,0.008272,0.018109,0,8132,1,0.000033,14,0.184896,0.208474,3099.258956,0.144311,0.016786
9903237,9903237,,10,26,36,10,26,36,0.002464,0.018587,0,8403,1,0.000019,12,0.199714,0.226929,136197.325931,0.107937,0.009121
9903240,9903240,,1,14,15,1,14,15,0.001157,0.017681,0,8401,1,0.000011,13,0.182453,0.20788,237792.14911,0.242857,0.006694
9903244,9903244,,5,25,30,5,25,30,0.001258,0.019713,0,8375,1,0.00002,11,0.200125,0.229296,73056.563852,0.189655,0.007617
9903248,9903248,,5,14,19,5,14,19,0.001548,0.01763,0,8371,1,0.000017,12,0.18975,0.214757,26620.832063,0.28655,0.007791
9903259,9903259,,6,8,14,6,8,14,0.001925,0.016433,0,8369,1,0.000014,13,0.18299,0.20564,304.466013,0.285714,0.007893
9904013,9904013,,15,36,51,15,36,51,0.003828,0.022245,0,8131,1,0.00002,13,0.213239,0.24166,36341.05103,0.153333,0.010723
9904024,9904024,,20,8,28,20,8,28,0.003394,0.001042,0,8266,1,0.000022,13,0.18477,0.20762,65875.396036,0.202381,0.012504
9904035,9904035,,3,9,12,3,9,12,0.001619,0.007311,0,8368,1,0.000013,14,0.178102,0.201468,653.69054,0.174242,0.007348
9904040,9904040,,14,10,24,14,10,24,0.002855,0.015831,0,8267,1,0.000017,13,0.182948,0.206924,1134.573883,0.262681,0.010723
9904050,9904050,,8,34,42,8,34,42,0.002417,0.020318,0,8365,1,0.000013,11,0.214984,0.249042,20761.321452,0.142276,0.008781
9904068,9904068,,5,7,12,5,7,12,0.002269,0.00703,0,8362,1,0.000013,14,0.193675,0.219463,5714.037582,0.356061,0.007965
9904073,9904073,,14,33,47,14,33,47,0.003191,0.02035,0,8361,1,0.000017,12,0.208163,0.241861,61346.993547,0.112858,0.010369
9904098,9904098,,5,28,33,5,28,33,0.002218,0.019825,0,8355,1,0.000013,17,0.190033,0.216073,3044.03736,0.311553,0.00778
9904101,9904101,,4,7,11,4,7,11,0.001668,0.016692,0,8354,1,0.000015,14,0.182643,0.204924,24002.511019,0.290909,0.007371
9904113,9904113,,3,23,26,3,23,26,0.001455,0.018542,0,8351,1,0.000016,12,0.208387,0.235274,46975.889092,0.166154,0.007577
9904120,9904120,,53,16,69,53,16,69,0.007842,0.017117,0,8345,8,0.000085,13,0.179632,0.203878,73035.003233,0.137042,0.026701
9904131,9904131,,33,47,80,33,47,80,0.006981,0.015122,0,8333,1,0.000027,12,0.222475,0.258588,79016.171412,0.109652,0.021451
9904143,9904143,,29,25,54,29,25,54,0.004947,0.018201,0,8332,1,0.000033,14,0.197395,0.226493,279129.533579,0.083857,0.014943
9904149,9904149,,21,18,39,21,18,39,0.005533,0.019046,0,8311,1,0.000022,13,0.191204,0.216279,1449.928801,0.207827,0.011888
9904164,9904164,,3,11,14,3,11,14,0.001608,0.016857,0,8310,1,0.000014,15,0.178833,0.201878,3119.232184,0.351648,0.007254
9904190,9904190,,2,27,29,2,27,29,0.001391,0.020896,0,8304,1,0.000012,14,0.212375,0.243108,34178.513377,0.181034,0.006942
9904198,9904198,,14,25,39,14,25,39,0.003873,0.013357,0,8292,1,0.00002,13,0.208293,0.237361,103253.240137,0.170715,0.011831
9904217,9904217,,7,22,29,7,22,29,0.001601,0.003333,0,8278,2,0.000017,13,0.200857,0.230988,67440.876454,0.064039,0.009128
9905002,9905002,,14,18,32,14,18,32,0.00331,0.00808,0,8275,1,0.000018,12,0.19437,0.219945,6654.165657,0.231855,0.010184
9905004,9905004,,12,35,47,12,35,47,0.003298,0.010964,0,8274,2,0.000015,13,0.20294,0.234499,141797.746392,0.13506,0.010356
9905020,9905020,,42,27,69,42,27,69,0.010338,0.019108,0,7730,1,0.000036,16,0.200143,0.22998,57093.556644,0.188193,0.023136
9905046,9905046,,14,21,35,14,21,35,0.003738,0.013179,0,8245,1,0.000021,13,0.194364,0.21746,34643.310383,0.184034,0.011966
9905048,9905048,,12,20,32,12,20,32,0.003907,0.01782,0,8192,1,0.000017,12,0.192389,0.216247,10517.83095,0.302419,0.010509
9905064,9905064,,29,32,61,29,32,61,0.007038,0.02216,0,8189,1,0.000022,12,0.222056,0.25714,31334.419698,0.123224,0.014888
9905085,9905085,,40,20,60,40,20,60,0.009315,0.018514,0,7857,1,0.000032,17,0.187885,0.215829,12661.992288,0.225141,0.021011
9905097,9905097,,2,32,34,2,32,34,0.001377,0.019201,0,7856,1,0.000012,12,0.206137,0.234664,6191.715479,0.193405,0.007017
9709146,9709146,,21,47,68,21,47,68,0.00183,0.008026,0,4507,0,0.000025,15,0.21716,0.26337,40942.042777,0.089772,0.008832
9902033,9902033,,30,14,44,30,14,44,0.001275,0.001287,0,8541,4,0.000037,14,0.182937,0.206559,90093.677976,0.09408,0.009643
9207064,9207064,,16,0,16,16,0,16,0.000576,0,0,2746,9,0.000054,0,0,0,0,0.041667,0.005437
9212023,9212023,,14,1,15,14,1,15,0.000437,0.000007,0,6110,1,0.000031,1,1,1,273.424874,0.061905,0.004633
9407198,9407198,,5,4,9,5,4,9,0.000123,0.000481,0,8543,13,0.000013,5,0.33515,0.393496,186.380015,0.222222,0.001547
9906053,9906053,,2,9,11,2,9,11,0.000129,0.002778,0,9929,4,0.000011,13,0.176352,0.199229,22.445372,0.263636,0.000665
9908008,9908008,,6,6,12,6,6,12,0.000357,0.000726,0,9928,52,0.000014,11,0.183236,0.203519,5374.745075,0.136364,0.001608
1055,1055,,27,32,59,27,32,59,0.003771,0.021979,0,9935,52,0.000021,11,0.21458,0.242731,24542.745411,0.121859,0.008851
9712049,9712049,,18,39,57,18,39,57,0.003393,0.011381,0,5612,2,0.00004,15,0.202972,0.241852,23064.71558,0.131266,0.00897
9807082,9807082,,30,16,46,30,16,46,0.003152,0.001879,0,7660,4,0.000025,14,0.200339,0.227147,17919.065718,0.112077,0.011782
9907186,9907186,,22,11,33,22,11,33,0.001671,0.007895,0,9934,52,0.000022,13,0.194836,0.219318,5048.318977,0.196023,0.008254
9910145,9910145,,6,17,23,6,17,23,0.000946,0.011038,0,9933,41,0.000015,11,0.22677,0.257744,41222.467128,0.162055,0.001903
9610104,9610104,,8,8,16,8,8,16,0.000148,0.000006,0,4418,6,0.000031,5,0.468085,0.620455,67288.630103,0.125,0.002575
9709139,9709139,,10,52,62,10,52,62,0.001745,0.014414,0,4952,2,0.000057,11,0.218957,0.258164,106965.618977,0.141195,0.009886
9711001,9711001,,10,42,52,10,42,52,0.001998,0.009062,0,5368,2,0.000045,15,0.213476,0.254642,218656.389464,0.111614,0.006911
9711017,9711017,,14,13,27,14,13,27,0.001275,0.003404,0,5599,0,0.000018,13,0.19924,0.227109,13676.598063,0.088319,0.004689
9712075,9712075,,23,30,53,23,30,53,0.002485,0.009436,0,5575,2,0.000031,15,0.201961,0.235861,12700.872587,0.161829,0.008384
9611214,9611214,,44,51,95,44,51,95,0.005554,0.01634,0,3622,2,0.000058,12,0.233984,0.285934,68953.462846,0.071557,0.019586
9505067,9505067,,34,16,50,34,16,50,0.00106,0.003544,0,888,4,0.000083,6,0.280749,0.346905,1192.671177,0.20449,0.016119
9605108,9605108,,19,12,31,19,12,31,0.000275,0.000644,0,3592,4,0.000031,10,0.178297,0.220799,2233.880395,0.205376,0.006563
9605113,9605113,,29,18,47,29,18,47,0.000645,0.002886,0,3591,4,0.000032,10,0.184073,0.240764,1358.950234,0.185939,0.009303
9606184,9606184,,19,15,34,19,15,34,0.000346,0.000772,0,3593,4,0.000027,10,0.197557,0.238583,9648.102865,0.229947,0.006451
9607021,9607021,,18,10,28,18,10,28,0.001028,0.000588,0,3594,4,0.000025,11,0.172414,0.206809,10172.688146,0.214286,0.006779
9608046,9608046,,12,10,22,12,10,22,0.000173,0.000714,0,3595,4,0.00002,12,0.165117,0.203615,276.852151,0.294372,0.004015
9704185,9704185,,29,29,58,29,29,58,0.002309,0.00429,0,4343,0,0.000039,12,0.211114,0.251427,45239.167181,0.101028,0.010755
9708117,9708117,,31,18,49,31,18,49,0.004403,0.003931,0,4338,0,0.000026,12,0.197835,0.228139,24259.429074,0.084184,0.012401
9801076,9801076,,35,18,53,35,18,53,0.008782,0.010544,0,5373,1,0.000108,14,0.192854,0.223875,9831.358184,0.147315,0.026568
9802103,9802103,,29,20,49,29,20,49,0.002851,0.003395,0,5053,0,0.000035,13,0.193231,0.225103,26599.169004,0.138605,0.01495
9803033,9803033,,12,13,25,12,13,25,0.001019,0.001381,0,5831,4,0.000019,12,0.208597,0.238732,2549.546115,0.23,0.005236
9803086,9803086,,38,31,69,38,31,69,0.005508,0.009377,0,5832,4,0.000037,12,0.214594,0.249664,111674.852214,0.098465,0.017773
9803140,9803140,,16,31,47,16,31,47,0.00283,0.00434,0,6368,4,0.000021,13,0.220578,0.256888,72274.833367,0.097132,0.007079
9803186,9803186,,8,16,24,8,16,24,0.000759,0.002219,0,6357,4,0.000016,12,0.209097,0.239448,1536.553095,0.259058,0.003737
9804026,9804026,,107,25,132,107,25,132,0.007721,0.004336,0,5057,0,0.000104,14,0.180465,0.212526,46255.324419,0.104326,0.047836
9805029,9805029,,10,26,36,10,26,36,0.000662,0.003106,0,7651,4,0.000015,12,0.211306,0.244835,7284.617566,0.215873,0.003493
9806092,9806092,,10,22,32,10,22,32,0.000812,0.003146,0,7659,4,0.000015,14,0.212672,0.244308,3586.992575,0.204637,0.003362
9803193,9803193,,19,40,59,19,40,59,0.00538,0.026449,0,5821,1,0.000027,13,0.213669,0.247429,9509.67019,0.230567,0.011477
9808139,9808139,,89,45,134,89,45,134,0.007054,0.021368,0,7679,0,0.000059,13,0.218395,0.2521,158161.085511,0.086017,0.034985
9809158,9809158,,20,4,24,20,4,24,0.00224,0.000704,0,7658,1,0.000032,11,0.180806,0.198802,17166.936742,0.112319,0.007293
9803054,9803054,,36,37,73,36,37,73,0.004155,0.007668,0,5943,4,0.000032,12,0.2169,0.253564,101131.81859,0.136606,0.014108
9902196,9902196,,27,26,53,27,26,53,0.003625,0.004152,0,8056,1,0.000027,12,0.201277,0.227885,37861.160456,0.116836,0.010731
9903053,9903053,,30,25,55,30,25,55,0.001233,0.002166,0,9496,0,0.000025,15,0.183038,0.218147,13171.138297,0.100337,0.010525
9905024,9905024,,11,15,26,11,15,26,0.000828,0.001936,0,9498,52,0.000015,15,0.18704,0.213432,7776.475621,0.086154,0.003768
9906046,9906046,,18,23,41,18,23,41,0.000894,0.001871,0,9497,0,0.000018,15,0.195915,0.225811,12591.273117,0.117073,0.00681
9811201,9811201,,21,41,62,21,41,62,0.002344,0.024463,0,8286,52,0.000023,13,0.211673,0.245737,57535.156245,0.093337,0.007303
9203058,9203058,,1,0,1,1,0,1,0.00013,0,0,9932,41,0.000011,0,0,0,0,0,0.000266
1056,1056,,23,12,35,23,12,35,0.004236,0.016897,0,9941,1,0.000022,12,0.201224,0.222984,69456.457402,0.113445,0.007285
9304146,9304146,,18,0,18,18,0,18,0.002037,0,0,183,1,0.000069,0,0,0,0,0.019608,0.008725
9912155,9912155,,11,29,40,11,29,40,0.002777,0.023474,0,9940,1,0.000016,11,0.229518,0.261708,64814.662962,0.142308,0.003722
9308121,9308121,,1,0,1,1,0,1,0.000276,0,0,9939,1,0.00001,0,0,0,0,0,0.000308
9404180,9404180,,25,10,35,25,10,35,0.00134,0.00007,0,3774,9,0.000038,5,0.306931,0.42043,59203.926234,0.061345,0.007059
9506118,9506118,,6,14,20,6,14,20,0.000306,0.000274,0,7097,9,0.000017,5,0.338912,0.412551,12480.528467,0.084211,0.001784
9512023,9512023,,4,12,16,4,12,16,0.000278,0.000104,0,9938,9,0.000013,6,0.28268,0.349326,4562.153504,0.179167,0.001062
9701113,9701113,,2,10,12,2,10,12,0.000276,0.000234,0,9937,9,0.000013,12,0.185128,0.21306,2255.542031,0.181818,0.000527
9909222,9909222,,7,17,24,7,17,24,0.001069,0.019371,0,9936,1,0.000013,11,0.229036,0.260296,34234.628514,0.153986,0.00191
1057,1057,,2,27,29,2,27,29,0.000568,0.021076,0,9942,1,0.00001,12,0.199288,0.228107,88.020545,0.190887,0.000438
9612229,9612229,,44,35,79,44,35,79,0.006649,0.006972,0,3513,13,0.000063,11,0.225265,0.268576,66912.558042,0.062317,0.01918
9505058,9505058,,20,2,22,20,2,22,0.000439,0.000003,0,2122,28,0.000053,1,1,1,27677.685587,0.108225,0.006442
9506200,9506200,,41,34,75,41,34,75,0.005019,0.006028,0,1132,13,0.000139,9,0.261213,0.322275,118533.715527,0.095315,0.027505
9509108,9509108,,44,27,71,44,27,71,0.00406,0.001853,0,1408,13,0.000123,9,0.228382,0.280175,45501.76683,0.068612,0.021636
9512157,9512157,,11,13,24,11,13,24,0.001301,0.001546,0,1809,13,0.000029,10,0.21862,0.260806,3960.085876,0.172101,0.006688
9603195,9603195,,86,14,100,86,14,100,0.010632,0.003568,0,2091,13,0.000145,10,0.219881,0.258275,9301.321876,0.089192,0.042049
9604134,9604134,,30,20,50,30,20,50,0.002867,0.004812,0,2084,13,0.00007,10,0.227445,0.269416,46199.23717,0.150204,0.017795
9604193,9604193,,12,15,27,12,15,27,0.001824,0.002557,0,2119,13,0.000021,11,0.205589,0.241363,9139.110461,0.15812,0.007033
9605085,9605085,,39,48,87,39,48,87,0.004901,0.011237,0,2107,13,0.000055,9,0.241951,0.288472,50996.735024,0.09035,0.016234
9605091,9605091,,36,31,67,36,31,67,0.005071,0.005425,0,2096,13,0.000064,10,0.22595,0.272134,9803.733486,0.1436,0.017679
9605146,9605146,,25,10,35,25,10,35,0.003088,0.003176,0,2760,13,0.000041,12,0.211341,0.243712,10232.100837,0.113445,0.012463
9609217,9609217,,53,24,77,53,24,77,0.006044,0.009809,0,2824,2,0.000059,12,0.213266,0.252943,9613.655394,0.071599,0.023333
9610018,9610018,,20,6,26,20,6,26,0.00137,0.001251,0,2823,2,0.000031,12,0.202279,0.230535,31678.310695,0.064615,0.005923
9610125,9610125,,38,33,71,38,33,71,0.004616,0.011783,0,2762,2,0.000068,11,0.225021,0.269614,36506.425307,0.107042,0.019682
9605216,9605216,,16,20,36,16,20,36,0.001379,0.004202,0,2438,13,0.000038,10,0.226877,0.264057,8064.205444,0.128571,0.005819
9609056,9609056,,11,23,34,11,23,34,0.001648,0.00387,0,2828,13,0.000017,10,0.232206,0.272232,5470.608764,0.177362,0.004986
9611029,9611029,,3,18,21,3,18,21,0.000176,0.007702,0,2827,13,0.000014,12,0.217463,0.255605,773.233329,0.2,0.001472
9606193,9606193,,71,29,100,71,29,100,0.008313,0.006693,0,2338,13,0.000068,9,0.227692,0.268231,44998.482479,0.086263,0.026882
9610046,9610046,,3,25,28,3,25,28,0.000099,0.004416,0,3512,13,0.00002,10,0.226071,0.266455,5163.94329,0.160053,0.001426
9610112,9610112,,4,12,16,4,12,16,0.000932,0.005152,0,3427,13,0.000013,10,0.199711,0.230053,69.561431,0.233333,0.002211
9610138,9610138,,15,36,51,15,36,51,0.001975,0.012499,0,3428,13,0.000022,9,0.241504,0.282712,6856.530812,0.150196,0.006491
9612142,9612142,,10,16,26,10,16,26,0.000877,0.00187,0,3510,13,0.000016,11,0.22055,0.255423,3772.527768,0.115385,0.003966
9605082,9605082,,36,13,49,36,13,49,0.003447,0.00331,0,2116,13,0.000059,10,0.21707,0.248888,59446.808522,0.103316,0.01658
9607227,9607227,,82,16,98,82,16,98,0.006728,0.002887,0,2957,2,0.000158,10,0.20461,0.235103,80999.541949,0.091837,0.041624
9703124,9703124,,12,16,28,12,16,28,0.000652,0.003639,0,3391,13,0.000025,13,0.214661,0.249387,8979.680136,0.170635,0.005164
9803174,9803174,,9,43,52,9,43,52,0.00286,0.026724,0,5822,1,0.000022,13,0.214361,0.24856,25683.726661,0.2681,0.007216
9803196,9803196,,13,9,22,13,9,22,0.00232,0.015667,0,5565,1,0.000022,13,0.188159,0.213767,211833.663853,0.151515,0.006353
9305047,9305047,,75,5,80,75,5,80,0.001788,0.000168,0,676,26,0.000168,3,0.7,0.833333,15469.752245,0.055063,0.027848
9803252,9803252,,16,15,31,16,15,31,0.00414,0.016683,0,5919,1,0.00004,14,0.197027,0.226905,1953.07951,0.233333,0.011956
9804175,9804175,,14,17,31,14,17,31,0.003274,0.021292,0,6083,1,0.000038,14,0.196422,0.225219,1591.705631,0.264516,0.009249
9805064,9805064,,14,17,31,14,17,31,0.003081,0.019258,0,6280,1,0.000024,12,0.202744,0.230732,10794.93795,0.241935,0.006122
9809055,9809055,,8,22,30,8,22,30,0.002008,0.0218,0,7422,1,0.000016,12,0.204067,0.229502,3740.510933,0.195402,0.003592
9809061,9809061,,24,32,56,24,32,56,0.004967,0.015697,0,7156,2,0.000027,14,0.199654,0.23097,25053.824817,0.114935,0.009047
1060,1060,,2,7,9,2,7,9,0,0,0,9947,20,0.000011,8,0.21939,0.257086,27.059735,0.208333,0.000445
9406199,9406199,,15,0,15,15,0,15,0.000002,0,0,4167,20,0.000078,0,0,0,0,0.142857,0.004373
9410141,9410141,,30,1,31,30,1,31,0.00001,0.000002,0,3042,20,0.000072,2,0.666667,0.75,1635.171832,0.167742,0.009682
9512108,9512108,,8,1,9,8,1,9,0.000002,0,0,9800,20,0.00002,1,1,1,1.116667,0.236111,0.002278
9601128,9601128,,17,2,19,17,2,19,0.000004,0.000002,0,5207,20,0.000038,2,0.571429,0.625,20.595707,0.178363,0.00523
9605039,9605039,,11,32,43,11,32,43,0.000002,0.000096,0,9946,20,0.000021,7,0.273554,0.346047,4531.129514,0.074751,0.00282
9612117,9612117,,18,11,29,18,11,29,0.000004,0.000004,0,5212,20,0.000038,8,0.19184,0.253281,35127.998188,0.150246,0.005335
9709155,9709155,,4,3,7,4,3,7,0,0,0,9943,20,0.000017,3,0.454545,0.566667,12.122655,0.166667,0.001006
9405190,9405190,,66,1,67,66,1,67,0.000149,0,0,3040,20,0.000286,1,1,1,97.729893,0.089326,0.019951
9508017,9508017,,38,7,45,38,7,45,0.000036,0.000003,0,4169,20,0.000096,1,1,1,17781.161172,0.112121,0.011514
9301114,9301114,,75,0,75,75,0,75,0.00015,0,0,3037,20,0.000327,0,0,0,0,0.066306,0.023188
9307174,9307174,,64,0,64,64,0,64,0.000063,0,0,3036,20,0.000265,0,0,0,0,0.071429,0.019607
9308134,9308134,,12,2,14,12,2,14,0.000037,0.000006,0,1890,52,0.000027,1,1,1,2225.360475,0.049451,0.002937
9310032,9310032,,30,0,30,30,0,30,0.000028,0,0,3039,20,0.000471,0,0,0,0,0.118391,0.01046
9402077,9402077,,79,2,81,79,2,81,0.000087,0.000002,0,3043,20,0.000172,1,1,1,1097.769931,0.072222,0.023117
9403171,9403171,,19,0,19,19,0,19,0.000005,0,0,4164,20,0.000052,0,0,0,0,0.111111,0.005789
9410084,9410084,,11,6,17,11,6,17,0.000441,0.00005,0,2282,9,0.000023,4,0.48,0.572917,40344.09073,0.1875,0.003228
9410138,9410138,,67,6,73,67,6,73,0.000143,0.000005,0,3044,20,0.00012,2,0.875,0.928571,19330.206235,0.079148,0.019509
9501019,9501019,,2,10,12,2,10,12,0.000001,0.000054,0,9945,52,0.000011,5,0.321285,0.419583,561.487725,0.143939,0.000522
9501042,9501042,,7,3,10,7,3,10,0.000002,0.000002,0,4187,20,0.000018,2,0.8,0.875,2566.707293,0.122222,0.002145
9506019,9506019,,47,12,59,47,12,59,0.000058,0.00001,0,3048,20,0.000068,2,0.833333,0.9,18111.213467,0.115137,0.013927
9506040,9506040,,2,6,8,2,6,8,0.000007,0.000016,0,9944,52,0.000011,5,0.360656,0.497727,112.818926,0.25,0.000515
9510240,9510240,,7,1,8,7,1,8,0.000002,0,0,9801,20,0.000019,1,1,1,0.5,0.25,0.002007
9511128,9511128,,15,6,21,15,6,21,0.000005,0.000003,0,4137,20,0.000025,3,0.631579,0.736111,23715.406071,0.147619,0.004523
9512073,9512073,,24,7,31,24,7,31,0.000006,0.000006,0,4161,20,0.000043,2,0.818182,0.888889,5742.703053,0.126882,0.007074
9512125,9512125,,6,10,16,6,10,16,0.000019,0.000131,0,4233,52,0.000015,5,0.355372,0.434496,11673.653073,0.154167,0.001617
9601034,9601034,,2,10,12,2,10,12,0.000001,0.000061,0,4234,52,0.000012,6,0.282468,0.366858,26258.178617,0.227273,0.000558
9601112,9601112,,7,25,32,7,25,32,0.000002,0.000013,0,4172,20,0.000023,6,0.275956,0.370957,92791.206006,0.11996,0.002449
9602012,9602012,,14,12,26,14,12,26,0.000014,0.000009,0,4138,20,0.000033,4,0.645161,0.779167,12668.975063,0.150769,0.004472
9604124,9604124,,13,11,24,13,11,24,0.000004,0.000006,0,4146,20,0.000032,4,0.516667,0.63172,43007.834399,0.119565,0.003455
9503225,9503225,,17,5,22,17,5,22,0.000015,0.000005,0,4170,20,0.000044,2,0.692308,0.777778,973.06984,0.238095,0.006088
9507159,9507159,,14,0,14,14,0,14,0.000016,0,0,5201,20,0.000044,0,0,0,0,0.131868,0.004271
9603005,9603005,,1,1,2,1,1,2,0,0,0,5211,20,0.000013,2,0.666667,0.75,248.994488,0,0.000355
9604114,9604114,,13,6,19,13,6,19,0.000027,0.000007,0,5210,20,0.000026,3,0.592593,0.677083,335.062015,0.172515,0.003857
9610012,9610012,,28,12,40,28,12,40,0.000025,0.000008,0,5209,20,0.000054,7,0.224947,0.290961,34383.080803,0.15,0.008357
9610223,9610223,,14,3,17,14,3,17,0.000001,0,0,5202,20,0.000048,2,0.8,0.875,756.915739,0.051471,0.003547
9403111,9403111,,21,0,21,21,0,21,0.000001,0,0,4165,20,0.000065,0,0,0,0,0.078571,0.005529
1061,1061,,1,2,3,1,2,3,0,0,0,9950,52,0.000012,1,1,1,0,0.5,0.000226
9706214,9706214,,6,0,6,6,0,6,0,0,0,9948,52,0.000056,0,0,0,0,0.2,0.001361
9812099,9812099,,4,1,5,4,1,5,0,0,0,9949,52,0.000027,1,1,1,0,0.3,0.000896
1062,1062,,7,12,19,7,12,19,0.000167,0.000173,0,9958,0,0.000013,13,0.179987,0.202324,6021.58221,0.157895,0.002323
9310008,9310008,,30,2,32,30,2,32,0.000994,0.00008,0,1353,0,0.00004,1,1,1,51.155184,0.118952,0.011013
9405002,9405002,,23,15,38,23,15,38,0.001047,0.000649,0,637,0,0.000063,5,0.339888,0.432369,76671.680166,0.075391,0.008744
9405024,9405024,,40,0,40,40,0,40,0.000826,0,0,629,0,0.000096,0,0,0,0,0.074359,0.015238
9407049,9407049,,17,6,23,17,6,23,0.000758,0.000132,0,1713,0,0.000024,2,0.8,0.875,365.986535,0.199605,0.006548
9810187,9810187,,3,19,22,3,19,22,0.000033,0.001694,0,9957,0,0.000012,13,0.178836,0.205608,5735.31057,0.147186,0.000799
9812068,9812068,,3,44,47,3,44,47,0.000033,0.007971,0,9953,0,0.000013,13,0.204635,0.249666,3755.878167,0.132747,0.000714
9901150,9901150,,3,21,24,3,21,24,0.000033,0.006035,0,9952,0,0.000013,12,0.204289,0.235655,10411.940029,0.125,0.000714
9211027,9211027,,3,1,4,3,1,4,0.000047,0.000018,0,30,0,0.000079,1,1,1,1.874993,0.166667,0.001572
9208038,9208038,,5,0,5,5,0,5,0.000213,0,0,612,0,0.000028,0,0,0,0,0.1,0.001596
9309133,9309133,,20,1,21,20,1,21,0.000993,0.000062,0,636,0,0.000038,1,1,1,5.978053,0.130952,0.009079
9310184,9310184,,6,2,8,6,2,8,0.000223,0.000019,0,635,0,0.000022,1,1,1,4.863095,0.232143,0.002081
9312122,9312122,,6,2,8,6,2,8,0.000245,0.00008,0,633,0,0.000017,1,1,1,0.950462,0.142857,0.001568
9403037,9403037,,1,2,3,1,2,3,0.000008,0,0,632,3,0.000014,1,1,1,31217.343388,0,0.000415
9304055,9304055,,32,4,36,32,4,36,0.000638,0.000085,0,615,0,0.000082,2,0.833333,0.9,2570.397187,0.10873,0.012362
9410056,9410056,,20,7,27,20,7,27,0.000798,0.000191,0,628,0,0.000062,2,0.733333,0.818182,12439.41809,0.111111,0.007359
9411218,9411218,,5,3,8,5,3,8,0.00001,0.000003,0,624,9,0.000029,3,0.538462,0.666667,34836.850115,0.142857,0.001935
9510009,9510009,,20,24,44,20,24,44,0.00065,0.000726,0,1714,0,0.00003,9,0.247054,0.308198,7192.003876,0.163848,0.00739
9707105,9707105,,11,15,26,11,15,26,0.000092,0.000187,0,9956,0,0.00002,14,0.18871,0.217532,6617.028824,0.130769,0.002692
9711158,9711158,,29,20,49,29,20,49,0.001349,0.00214,0,7639,0,0.000048,14,0.188974,0.221613,8219.427023,0.233418,0.013983
9610157,9610157,,21,61,82,21,61,82,0.002377,0.014558,0,2493,0,0.000027,11,0.244196,0.298419,105268.619697,0.114423,0.008645
9706211,9706211,,8,37,45,8,37,45,0.000902,0.011513,0,5866,0,0.000014,11,0.226449,0.267968,30133.50355,0.130808,0.002863
9504129,9504129,,34,25,59,34,25,59,0.002202,0.003351,0,1323,0,0.000038,8,0.259387,0.322116,28707.57018,0.126534,0.015159
9802099,9802099,,5,70,75,5,70,75,0.000284,0.011813,0,5957,0,0.000011,13,0.210888,0.264711,27424.440487,0.107027,0.001411
9805198,9805198,,2,6,8,2,6,8,0.000118,0.000013,0,9951,4,0.000012,9,0.204724,0.259239,784.746003,0.214286,0.000459
1063,1063,,16,16,32,16,16,32,0.001273,0.01145,0,9959,1,0.000019,13,0.183921,0.20566,2118.996434,0.240927,0.005045
9206008,9206008,,6,0,6,6,0,6,0.000329,0,0,5258,1,0.000019,0,0,0,0,0.166667,0.002165
9908189,9908189,,28,31,59,28,31,59,0.002639,0.009445,0,9695,1,0.000027,12,0.201575,0.22746,61529.44775,0.115137,0.00869
9303007,9303007,,59,5,64,59,5,64,0.005186,0.000511,0,263,13,0.000139,3,0.588235,0.716667,18637.391969,0.044891,0.022027
9611041,9611041,,20,16,36,20,16,36,0.002035,0.000823,0,5259,1,0.000027,7,0.265388,0.311131,40297.224045,0.101587,0.006688
9304102,9304102,,41,5,46,41,5,46,0.001058,0.000071,0,485,13,0.000108,3,0.615385,0.770833,1944.96586,0.064734,0.014705
9903169,9903169,,1,4,5,1,4,5,0.000111,0.001466,0,9694,41,0.000011,13,0.182171,0.204112,124.92391,0.2,0.000435
9906191,9906191,,5,31,36,5,31,36,0.000728,0.019832,0,9693,1,0.000012,11,0.232271,0.26501,16150.880138,0.177778,0.001482
9907057,9907057,,2,7,9,2,7,9,0.000111,0.000018,0,9692,6,0.000014,4,0.533333,0.677083,14380.517769,0.194444,0.0007
1064,1064,,2,13,15,2,13,15,0.000009,0.000014,0,9963,23,0.000011,12,0.190464,0.244671,314.21704,0.190476,0.000438
9203016,9203016,,20,0,20,20,0,20,0.000064,0,0,3046,23,0.000151,0,0,0,0,0.092105,0.005099
9303077,9303077,,5,1,6,5,1,6,0,0.000001,0,4115,23,0.00002,1,1,1,0,0.166667,0.001144
9502140,9502140,,16,5,21,16,5,21,0.000034,0.000007,0,4113,23,0.000033,7,0.334552,0.377466,9902.082541,0.138095,0.00395
9603012,9603012,,13,13,26,13,13,26,0.000002,0.000008,0,5556,23,0.000026,11,0.18863,0.239159,38527.939496,0.076923,0.003096
9607215,9607215,,12,7,19,12,7,19,0.00001,0.000008,0,9961,23,0.000026,7,0.340388,0.388132,4004.531567,0.116959,0.002815
9708035,9708035,,4,8,12,4,8,12,0.000001,0.000008,0,9962,23,0.000012,12,0.183481,0.235361,132.500125,0.318182,0.000909
9210091,9210091,,12,0,12,12,0,12,0.000027,0,0,469,23,0.000301,0,0,0,0,0.098485,0.003635
9301097,9301097,,34,9,43,34,9,43,0.000073,0.000224,0,473,23,0.000117,2,0.8,0.875,15297.206288,0.086379,0.010792
9203038,9203038,,7,0,7,7,0,7,0.000025,0,0,2177,23,0.000132,0,0,0,0,0.285714,0.002277
9207114,9207114,,21,0,21,21,0,21,0.000009,0,0,842,23,0.000192,0,0,0,0,0.057143,0.005772
9211028,9211028,,4,0,4,4,0,4,0.000001,0,0,2183,2,0.000034,0,0,0,0,0.083333,0.001133
9302050,9302050,,21,2,23,21,2,23,0.000005,0.000001,0,2182,23,0.000083,1,1,1,178.940729,0.146245,0.00621
9307086,9307086,,3,0,3,3,0,3,0,0,0,4112,22,0.000032,0,0,0,0,0,0.000788
9408100,9408100,,3,1,4,3,1,4,0,0,0,2113,26,0.000027,1,1,1,11992.623464,0,0.000789
9505099,9505099,,2,3,5,2,3,5,0,0.000001,0,5554,23,0.000015,4,0.369565,0.428922,10257.273964,0.25,0.000606
9510087,9510087,,41,7,48,41,7,48,0.000252,0.000016,0,2603,23,0.000119,10,0.219884,0.27324,132485.934145,0.059397,0.011945
9601095,9601095,,1,4,5,1,4,5,0,0.000002,0,5551,23,0.000012,6,0.319797,0.371164,828.415889,0.1,0.000307
9509044,9509044,,1,3,4,1,3,4,0,0.00001,0,9960,9,0.000013,3,0.473684,0.592593,240.393655,0,0.000299
9611056,9611056,,2,4,6,2,4,6,0.000012,0.000012,0,5550,23,0.000013,12,0.181116,0.211861,387.392036,0.266667,0.000569
1065,1065,,4,17,21,4,17,21,0.00077,0.019627,0,9964,1,0.000012,11,0.231159,0.262652,5186.010115,0.180952,0.001344
9611099,9611099,,10,11,21,10,11,21,0.000664,0.003241,0,3423,2,0.000047,14,0.191982,0.226231,4788.122889,0.080952,0.005218
9704131,9704131,,54,7,61,54,7,61,0.003692,0.000229,0,4123,2,0.000086,11,0.197634,0.227613,563026.607545,0.052459,0.018783
9707011,9707011,,13,28,41,13,28,41,0.00059,0.005897,0,4332,2,0.000027,13,0.208855,0.244645,14507.031362,0.140854,0.004783
9707113,9707113,,9,4,13,9,4,13,0.000442,0.000548,0,4333,2,0.00002,13,0.179218,0.201354,313.51791,0.314103,0.00381
9711160,9711160,,5,24,29,5,24,29,0.000931,0.006986,0,6690,2,0.000013,14,0.19802,0.235148,8168.552131,0.126847,0.002112
9712115,9712115,,42,60,102,42,60,102,0.003155,0.010181,0,5697,2,0.000034,13,0.219312,0.262458,195266.929044,0.064454,0.0135
9805205,9805205,,7,2,9,7,2,9,0.00044,0.000077,0,6689,13,0.000015,15,0.154885,0.170671,5855.4235,0.194444,0.002676
9804056,9804056,,16,32,48,16,32,48,0.001033,0.018617,0,6283,1,0.000029,13,0.207171,0.243785,15203.948065,0.078457,0.006068
9810230,9810230,,33,1,34,33,1,34,0.002349,0.000089,0,8312,1,0.000049,16,0.142572,0.152427,3.957432,0.14082,0.009702
9812047,9812047,,13,11,24,13,11,24,0.001753,0.017389,0,8330,1,0.000027,14,0.192311,0.218955,24028.563759,0.163043,0.004307
9812160,9812160,,11,55,66,11,55,66,0.00183,0.012007,0,8064,13,0.000016,13,0.191786,0.234254,21028.125215,0.099068,0.003408
9812196,9812196,,7,68,75,7,68,75,0.002413,0.038127,0,7965,2,0.000014,11,0.239944,0.283224,86705.774681,0.105586,0.005751
9206049,9206049,,60,1,61,60,1,61,0.0004,0.000004,0,618,22,0.000292,1,1,1,1007.597256,0.040437,0.01627
9411093,9411093,,11,9,20,11,9,20,0.000811,0.00002,0,3769,22,0.000026,3,0.666667,0.770833,38445.775009,0.110526,0.003097
9601010,9601010,,8,24,32,8,24,32,0.001426,0.00286,0,1807,13,0.000019,11,0.210927,0.259025,3594.41428,0.159274,0.004773
9803124,9803124,,3,41,44,3,41,44,0.001157,0.02027,0,5904,2,0.000012,14,0.212138,0.248755,33785.807835,0.172304,0.002215
9810128,9810128,,5,11,16,5,11,16,0.001384,0.018502,0,8122,1,0.000012,15,0.185239,0.210129,8767.14419,0.1375,0.002376
9904086,9904086,,6,23,29,6,23,29,0.001235,0.012557,0,8751,2,0.000013,13,0.188837,0.21886,1009.365111,0.149015,0.00187
1066,1066,,12,35,47,12,35,47,0.000817,0.004715,0,9989,3,0.000018,13,0.209706,0.238706,61417.767026,0.120722,0.004951
9807008,9807008,,13,32,45,13,32,45,0.00239,0.011467,0,7046,1,0.000016,13,0.217911,0.252689,29197.448244,0.071717,0.005704
9904020,9904020,,20,15,35,20,15,35,0.000974,0.001717,0,9393,25,0.000023,15,0.191115,0.21837,57733.085129,0.095798,0.005606
9907098,9907098,,9,21,30,9,21,30,0.000224,0.005258,0,9988,25,0.000016,14,0.191931,0.219643,26842.507214,0.07931,0.002605
9910249,9910249,,9,48,57,9,48,57,0.000694,0.00377,0,9972,3,0.000016,12,0.223311,0.256237,34939.778406,0.161028,0.003618
9912142,9912142,,4,15,19,4,15,19,0.000071,0.002256,0,9965,4,0.000018,16,0.173449,0.199728,27420.432269,0.119883,0.001011
9407118,9407118,,44,7,51,44,7,51,0.001762,0.000349,0,867,13,0.000211,6,0.288557,0.353448,41465.040324,0.023922,0.017804
9305068,9305068,,53,0,53,53,0,53,0.003417,0,0,304,4,0.000351,0,0,0,0,0.058418,0.020672
9505187,9505187,,33,8,41,33,8,41,0.002168,0.0013,0,967,4,0.000113,8,0.231321,0.27492,3877.896132,0.116463,0.016787
9512116,9512116,,12,7,19,12,7,19,0.00046,0.001313,0,2141,4,0.000054,11,0.157061,0.195137,759.451294,0.152047,0.004806
9702099,9702099,,39,24,63,39,24,63,0.005715,0.008454,0,3578,2,0.000084,11,0.224108,0.26153,38763.921045,0.092678,0.021099
9401133,9401133,,43,0,43,43,0,43,0.002376,0,0,328,4,0.000186,0,0,0,0,0.073643,0.017065
9605229,9605229,,40,18,58,40,18,58,0.000712,0.002486,0,3382,4,0.000083,12,0.188259,0.229205,21061.332603,0.090139,0.011751
9611106,9611106,,14,19,33,14,19,33,0.000441,0.002443,0,4492,4,0.000019,11,0.185962,0.211716,2725.638147,0.14678,0.004271
9702166,9702166,,26,31,57,26,31,57,0.002865,0.004859,0,3945,4,0.000026,13,0.196193,0.234417,70624.718747,0.10589,0.009733
9711145,9711145,,17,11,28,17,11,28,0.001122,0.003728,0,4978,4,0.000026,12,0.189117,0.21579,4075.318309,0.104497,0.00606
9712135,9712135,,10,20,30,10,20,30,0.001729,0.005941,0,6367,4,0.000013,12,0.20146,0.232239,1020.872412,0.174713,0.003376
9312143,9312143,,5,6,11,5,6,11,0.000233,0.000128,0,580,13,0.000029,3,0.5,0.576923,18740.845458,0.054545,0.002077
9402080,9402080,,7,2,9,7,2,9,0.000215,0.000034,0,486,13,0.000023,3,0.461538,0.509259,108.07647,0.194444,0.002931
9612164,9612164,,32,32,64,32,32,64,0.003351,0.011123,0,3236,0,0.000048,11,0.229491,0.269095,273544.941804,0.091022,0.013385
9806036,9806036,,2,19,21,2,19,21,0.000211,0.001409,0,7045,13,0.000011,12,0.200877,0.232671,5043.391303,0.05,0.000602
9903156,9903156,,24,17,41,24,17,41,0.002657,0.001148,0,8881,2,0.000021,13,0.193048,0.218437,14120.828911,0.119512,0.006919
9903207,9903207,,10,65,75,10,65,75,0.000956,0.008343,0,9386,4,0.000016,14,0.219223,0.258189,79841.27293,0.073333,0.002617
9707224,9707224,,57,27,84,57,27,84,0.00534,0.008214,0,4893,0,0.000061,14,0.191819,0.230561,37240.730423,0.067126,0.025303
9903093,9903093,,42,28,70,42,28,70,0.005225,0.005226,0,8289,4,0.000031,11,0.203937,0.235626,25024.988856,0.116356,0.018967
9801040,9801040,,6,5,11,6,5,11,0.000288,0.000014,0,8668,30,0.000018,12,0.141958,0.154946,45962.094664,0.045455,0.001995
9805078,9805078,,18,18,36,18,18,36,0.001418,0.005451,0,7756,2,0.000024,12,0.203799,0.23911,6508.611198,0.11746,0.007335
9809100,9809100,,43,33,76,43,33,76,0.004895,0.00662,0,7757,2,0.000034,11,0.229773,0.263756,181506.061252,0.084211,0.017577
9905157,9905157,,34,13,47,34,13,47,0.002493,0.001596,0,8661,3,0.000039,15,0.189708,0.217166,10210.156575,0.157724,0.015574
9605156,9605156,,2,0,2,2,0,2,0.000062,0,0,8518,30,0.000018,0,0,0,0,0,0.000525
9703143,9703143,,1,8,9,1,8,9,0.000062,0.000812,0,9987,28,0.000011,10,0.206642,0.234437,657.640606,0.083333,0.000286
9907014,9907014,,17,9,26,17,9,26,0.001034,0.000745,0,9986,2,0.000022,18,0.177856,0.203182,11715.443333,0.084615,0.004906
9907075,9907075,,13,32,45,13,32,45,0.002839,0.02226,0,9973,13,0.000014,12,0.203981,0.235461,7386.842706,0.194949,0.003495
9908029,9908029,,1,5,6,1,5,6,0.000085,0.000675,0,9871,3,0.000013,16,0.172449,0.195063,65.114592,0.433333,0.001318
9907140,9907140,,31,78,109,31,78,109,0.002298,0.017787,0,9971,3,0.000027,13,0.227012,0.267054,97080.40224,0.089365,0.00939
9910217,9910217,,8,30,38,8,30,38,0.000548,0.00752,0,9966,3,0.000012,13,0.201201,0.227854,2924.545813,0.210526,0.002494
9202011,9202011,,52,0,52,52,0,52,0.000534,0,0,312,6,0.000357,0,0,0,0,0.026018,0.015674
9810223,9810223,,4,16,20,4,16,20,0.00055,0.002592,0,7620,4,0.000012,13,0.180583,0.203628,6674.512775,0.165789,0.001403
1067,1067,,2,9,11,2,9,11,0,0.000003,0,10035,22,0.000015,11,0.177798,0.21268,456.81528,0.181818,0.000452
9309148,9309148,,22,1,23,22,1,23,0.000003,0.000003,0,4275,22,0.000112,2,0.571429,0.625,425.470417,0.134387,0.005973
9405193,9405193,,14,1,15,14,1,15,0.000002,0,0,4276,22,0.000047,3,0.416667,0.5,9814.958776,0.157143,0.003849
9503126,9503126,,4,1,5,4,1,5,0.000001,0,0,10034,22,0.000025,1,1,1,136.251504,0,0.000941
9505117,9505117,,24,8,32,24,8,32,0.000034,0.000002,0,10011,22,0.000049,3,0.608696,0.75,17395.7114,0.083669,0.005892
9510108,9510108,,17,6,23,17,6,23,0.00003,0.000001,0,9999,22,0.00003,10,0.182583,0.211939,15244.124821,0.1917,0.00429
9701091,9701091,,18,9,27,18,9,27,0.000004,0.000012,0,10028,22,0.000065,5,0.392405,0.533333,1030.526536,0.132479,0.0045
9705034,9705034,,12,14,26,12,14,26,0.000004,0.000002,0,10032,22,0.000021,7,0.286096,0.396818,22093.001707,0.123077,0.002961
9802141,9802141,,10,23,33,10,23,33,0.000023,0.000009,0,10020,22,0.000024,11,0.181313,0.22783,16460.878714,0.118371,0.002338
9904126,9904126,,10,10,20,10,10,20,0.000153,0.000008,0,10021,22,0.000019,11,0.172189,0.2034,25406.031316,0.221053,0.002365
9302023,9302023,,52,3,55,52,3,55,0.000244,0.000008,0,620,22,0.000256,1,1,1,13811.130781,0.049158,0.014514
9310021,9310021,,2,0,2,2,0,2,0,0,0,10033,22,0.000036,0,0,0,0,0,0.000472
9301037,9301037,,30,0,30,30,0,30,0.000091,0,0,3409,22,0.000209,0,0,0,0,0.07931,0.007691
9309151,9309151,,11,1,12,11,1,12,0.000033,0.000001,0,10006,22,0.000099,1,1,1,4,0.159091,0.002934
9311091,9311091,,5,2,7,5,2,7,0,0.000001,0,10010,22,0.000019,1,1,1,786.158279,0.285714,0.001384
9403010,9403010,,10,0,10,10,0,10,0.000033,0,0,10005,22,0.000039,0,0,0,0,0.111111,0.002561
9405181,9405181,,4,3,7,4,3,7,0,0.000001,0,10009,22,0.000019,3,0.5,0.642857,7.22619,0.190476,0.001054
9411116,9411116,,7,4,11,7,4,11,0.000003,0.000002,0,10008,22,0.000026,1,1,1,3055.116667,0.2,0.001786
9204089,9204089,,31,0,31,31,0,31,0.000001,0,0,3796,22,0.000294,0,0,0,0,0.070968,0.00823
9205086,9205086,,15,1,16,15,1,16,0.00003,0,0,9991,22,0.000087,1,1,1,24.741459,0.245833,0.004062
9305128,9305128,,15,4,19,15,4,19,0.000008,0,0,9996,22,0.000037,1,1,1,2142.315289,0.181287,0.00395
9305130,9305130,,22,1,23,22,1,23,0.000031,0,0,9992,22,0.000054,2,0.666667,0.75,213.952376,0.203557,0.005761
9505177,9505177,,2,7,9,2,7,9,0.000001,0.00017,0,5325,13,0.000018,9,0.216487,0.257417,14024.322101,0.166667,0.000626
9510021,9510021,,3,7,10,3,7,10,0,0.00002,0,4159,28,0.000019,3,0.580645,0.675926,7399.289052,0.133333,0.000919
9601116,9601116,,17,8,25,17,8,25,0.000019,0.000014,0,10027,22,0.000032,2,0.9,0.944444,772.200625,0.148333,0.004424
9601141,9601141,,11,5,16,11,5,16,0.000024,0.000011,0,10026,22,0.000028,3,0.555556,0.7,2003.24959,0.225,0.003104
9606141,9606141,,14,2,16,14,2,16,0.000002,0.000006,0,9634,26,0.000071,4,0.424242,0.494048,1151.135712,0.075,0.003601
9403042,9403042,,2,1,3,2,1,3,0,0,0,10025,22,0.000016,2,0.571429,0.625,6767.500564,0,0.000602
9404107,9404107,,6,2,8,6,2,8,0,0,0,10031,22,0.000032,3,0.461538,0.583333,2248.5,0.071429,0.001417
9409187,9409187,,12,0,12,12,0,12,0.000003,0,0,3718,22,0.000056,0,0,0,0,0.204545,0.003062
9602106,9602106,,5,7,12,5,7,12,0.000003,0.000001,0,8892,22,0.000019,6,0.278607,0.369643,5776.53969,0.166667,0.001327
9608180,9608180,,9,9,18,9,9,18,0.000002,0.000001,0,8901,22,0.000029,7,0.243728,0.345378,47124.172888,0.107843,0.002228
9701065,9701065,,9,10,19,9,10,19,0.000003,0.000015,0,10029,22,0.000017,5,0.397436,0.549462,685.671906,0.184211,0.002312
9202007,9202007,,5,0,5,5,0,5,0,0,0,1577,22,0.000024,0,0,0,0,0.2,0.001244
9210075,9210075,,4,1,5,4,1,5,0,0,0,9994,22,0.000025,1,1,1,0,0.3,0.001106
9303019,9303019,,1,0,1,1,0,1,0,0,0,10019,22,0.000011,0,0,0,0,0,0.000286
9304111,9304111,,6,0,6,6,0,6,0.000048,0,0,10018,2,0.00002,0,0,0,0,0,0.001401
9306017,9306017,,14,0,14,14,0,14,0.00022,0,0,10017,22,0.000061,0,0,0,0,0.021978,0.003483
9309055,9309055,,57,1,58,57,1,58,0.000073,0.000006,0,1365,28,0.000496,1,1,1,4823.616034,0.081367,0.016736
9310001,9310001,,2,2,4,2,2,4,0,0,0,10016,15,0.000013,1,1,1,743.413396,0,0.000505
9412133,9412133,,17,0,17,17,0,17,0.000002,0,0,9990,22,0.000067,0,0,0,0,0.194853,0.004377
9504101,9504101,,9,2,11,9,2,11,0.000023,0,0,10012,22,0.00002,2,0.75,0.833333,17.311962,0.290909,0.002254
9506177,9506177,,18,6,24,18,6,24,0.000024,0.000004,0,9997,22,0.00004,2,0.75,0.833333,1831.260593,0.182971,0.004586
9603149,9603149,,11,6,17,11,6,17,0.000099,0.000001,0,10004,22,0.000024,11,0.155545,0.177457,1287.328636,0.268382,0.00274
9606188,9606188,,6,8,14,6,8,14,0.000025,0.000013,0,10003,22,0.000015,11,0.184638,0.226832,5321.3938,0.230769,0.00151
9607143,9607143,,3,1,4,3,1,4,0.000001,0,0,10015,22,0.000014,2,0.666667,0.75,2336,0,0.000724
9607220,9607220,,8,5,13,8,5,13,0,0.000001,0,9998,22,0.000026,4,0.482143,0.552469,1671.950997,0.217949,0.002083
9609203,9609203,,11,11,22,11,11,22,0.000175,0.000003,0,10013,22,0.00002,11,0.178732,0.214288,21290.669989,0.220779,0.002692
9610087,9610087,,14,10,24,14,10,24,0.000009,0.000002,0,10000,22,0.000025,11,0.158099,0.185902,9785.817215,0.141304,0.003343
1068,1068,,21,24,45,21,24,45,0.001365,0.000748,0,10049,2,0.000024,12,0.200477,0.223045,20413.084398,0.126263,0.005585
9506207,9506207,,21,14,35,21,14,35,0.000273,0.003207,0,2452,0,0.000057,7,0.259497,0.304801,13613.722976,0.104202,0.007292
9509141,9509141,,58,2,60,58,2,60,0.004161,0.000067,0,1169,2,0.000168,13,0.166001,0.193266,16681.112496,0.062147,0.02381
9702133,9702133,,75,17,92,75,17,92,0.006532,0.007467,0,3404,2,0.000067,11,0.208942,0.239856,16429.465015,0.079551,0.025285
9705226,9705226,,35,7,42,35,7,42,0.001894,0.002119,0,5233,2,0.000059,14,0.157273,0.197332,5182.414967,0.108014,0.011169
9712103,9712103,,20,11,31,20,11,31,0.001156,0.003251,0,7203,2,0.000034,12,0.178088,0.204032,6673.978022,0.143011,0.007399
9804010,9804010,,32,13,45,32,13,45,0.002213,0.000232,0,7211,4,0.000033,13,0.173291,0.197363,90329.416397,0.128283,0.010656
9804168,9804168,,23,19,42,23,19,42,0.001675,0.001465,0,7213,4,0.000023,15,0.187306,0.216158,24451.981134,0.178281,0.006337
9806160,9806160,,11,8,19,11,8,19,0.00082,0.000333,0,7446,2,0.000017,12,0.180915,0.201722,575.38037,0.187135,0.002945
9809121,9809121,,32,5,37,32,5,37,0.002023,0.000414,0,7200,2,0.000041,10,0.194802,0.217211,1409.441006,0.148649,0.01209
9809153,9809153,,9,3,12,9,3,12,0.000473,0.000099,0,8480,2,0.000028,12,0.174256,0.192631,7889.223587,0.113636,0.00378
9809190,9809190,,26,14,40,26,14,40,0.001503,0.000842,0,7201,2,0.000031,14,0.183084,0.208803,37109.711007,0.189744,0.009411
9810154,9810154,,8,15,23,8,15,23,0.001574,0.002573,0,7351,2,0.000014,14,0.181664,0.206903,27826.716744,0.201581,0.002767
9810239,9810239,,27,15,42,27,15,42,0.002159,0.002058,0,7538,4,0.000023,14,0.184054,0.208583,18041.986416,0.1777,0.007763
9811017,9811017,,28,14,42,28,14,42,0.002744,0.006496,0,7540,4,0.000023,14,0.200865,0.230223,22474.708186,0.150987,0.008371
9811232,9811232,,61,37,98,61,37,98,0.003227,0.006996,0,7204,2,0.000078,12,0.201169,0.23808,84984.05594,0.069956,0.022584
9812051,9812051,,16,33,49,16,33,49,0.001021,0.003085,0,7220,2,0.000023,14,0.185485,0.221171,73602.59112,0.105442,0.004831
9905218,9905218,,15,7,22,15,7,22,0.000618,0.000274,0,8479,2,0.000041,13,0.169398,0.190738,3379.550223,0.188312,0.005268
9909021,9909021,,12,11,23,12,11,23,0.000093,0.000584,0,10048,2,0.000036,15,0.166759,0.190086,14592.791368,0.175889,0.003258
9911221,9911221,,26,25,51,26,25,51,0.001558,0.007609,0,10046,4,0.000023,12,0.211972,0.239985,51008.91929,0.128235,0.006625
9410205,9410205,,12,5,17,12,5,17,0.000547,0.000814,0,2451,0,0.000031,6,0.3,0.357071,612.30238,0.106618,0.004418
9412079,9412079,,6,5,11,6,5,11,0.000097,0.000484,0,2447,0,0.000045,5,0.324859,0.385362,4078.836023,0.236364,0.002291
9503170,9503170,,22,10,32,22,10,32,0.000963,0.001216,0,2450,0,0.000041,7,0.25125,0.317294,3802.068286,0.074597,0.007118
9504143,9504143,,22,3,25,22,3,25,0.000401,0.000019,0,2449,0,0.000051,6,0.254167,0.293579,1260.124868,0.153333,0.006824
9509050,9509050,,21,20,41,21,20,41,0.001095,0.00243,0,1163,13,0.000136,12,0.196646,0.248622,104891.952404,0.066463,0.012076
9406217,9406217,,48,0,48,48,0,48,0.001803,0,0,2989,2,0.000132,0,0,0,0,0.099291,0.016656
9601115,9601115,,63,4,67,63,4,67,0.003511,0.001068,0,2487,4,0.000209,11,0.172101,0.203255,64702.542768,0.102216,0.021926
9704214,9704214,,45,9,54,45,9,54,0.001798,0.001286,0,4885,4,0.000053,13,0.174034,0.196553,10477.912924,0.154088,0.013082
9705189,9705189,,26,8,34,26,8,34,0.001172,0.000388,0,4909,4,0.000051,17,0.148946,0.186035,22491.311637,0.080214,0.008539
9706007,9706007,,19,16,35,19,16,35,0.001833,0.002623,0,4902,4,0.000024,12,0.185185,0.211118,30473.11882,0.17395,0.007239
9706013,9706013,,22,2,24,22,2,24,0.000896,0.001068,0,4714,4,0.00003,12,0.150988,0.177646,344.031039,0.188406,0.007355
9706079,9706079,,23,19,42,23,19,42,0.001603,0.002949,0,4904,4,0.000026,13,0.166785,0.192562,15027.160566,0.163182,0.007107
9706099,9706099,,31,54,85,31,54,85,0.002099,0.005065,0,4907,4,0.000028,13,0.186747,0.226627,98973.108113,0.12577,0.00968
9707133,9707133,,38,5,43,38,5,43,0.002782,0.001284,0,5968,4,0.000048,14,0.152533,0.179612,18252.612266,0.040421,0.011516
9710250,9710250,,14,14,28,14,14,28,0.00044,0.000173,0,7188,4,0.000035,14,0.170254,0.195619,47098.754047,0.132275,0.004045
9711135,9711135,,9,8,17,9,8,17,0.000427,0.00009,0,7209,4,0.00002,14,0.166211,0.188416,6605.385264,0.253676,0.002576
9712128,9712128,,7,9,16,7,9,16,0.000426,0.000095,0,7210,4,0.000016,14,0.166248,0.188631,6237.415275,0.279167,0.002085
9801099,9801099,,5,3,8,5,3,8,0.000029,0.000003,0,7208,17,0.000017,3,0.44,0.545455,12172.238693,0.232143,0.001528
9604147,9604147,,31,1,32,31,1,32,0.000613,0.000041,0,3599,4,0.000088,12,0.14701,0.164783,2700.299374,0.138105,0.009525
9605149,9605149,,28,3,31,28,3,31,0.000667,0.000882,0,3695,4,0.000061,12,0.148367,0.171485,1804.444086,0.172043,0.008612
9607089,9607089,,30,6,36,30,6,36,0.001992,0.000924,0,3696,4,0.000053,11,0.169024,0.198415,43516.359613,0.138095,0.010865
9703147,9703147,,44,8,52,44,8,52,0.001288,0.001231,0,4884,4,0.000067,13,0.169736,0.190614,7532.743755,0.148567,0.012883
9706078,9706078,,37,14,51,37,14,51,0.001344,0.003311,0,4890,4,0.000049,13,0.182163,0.211637,41279.85306,0.084706,0.009981
9710142,9710142,,37,14,51,37,14,51,0.001911,0.001351,0,4892,4,0.000035,13,0.169601,0.192947,33930.983477,0.154118,0.010224
9801121,9801121,,32,18,50,32,18,50,0.003736,0.004865,0,6408,4,0.000034,14,0.21792,0.260562,147030.208438,0.119592,0.012036
9803176,9803176,,24,13,37,24,13,37,0.000626,0.001239,0,7212,4,0.000024,14,0.171016,0.198101,7334.682,0.183183,0.006207
9612174,9612174,,22,7,29,22,7,29,0.000838,0.000361,0,3394,2,0.000046,12,0.178907,0.20161,10229.760284,0.16133,0.009778
9706208,9706208,,22,18,40,22,18,40,0.000983,0.004472,0,5247,2,0.000025,11,0.215292,0.247963,8375.556978,0.145513,0.006601
9708011,9708011,,17,19,36,17,19,36,0.00092,0.002278,0,5249,2,0.000026,11,0.215557,0.248685,14544.464431,0.145238,0.005666
9710236,9710236,,19,6,25,19,6,25,0.00058,0.001204,0,6640,2,0.000039,11,0.175984,0.197765,558.781575,0.14,0.005789
9502141,9502141,,46,13,59,46,13,59,0.00284,0.000197,0,2956,2,0.000054,6,0.453333,0.622059,19134.452659,0.129456,0.015288
9707061,9707061,,46,2,48,46,2,48,0.002738,0.000078,0,5686,2,0.000057,11,0.169374,0.183189,610.785946,0.120567,0.016092
9709069,9709069,,17,20,37,17,20,37,0.001164,0.00245,0,5367,2,0.000079,15,0.189431,0.223985,28591.257645,0.123874,0.008287
9711203,9711203,,20,30,50,20,30,50,0.00088,0.005522,0,5688,2,0.000036,15,0.194316,0.236704,99902.077252,0.120408,0.006621
9802032,9802032,,21,66,87,21,66,87,0.001575,0.00817,0,7193,2,0.000021,18,0.200542,0.243703,52545.489354,0.10572,0.006211
9804051,9804051,,28,26,54,28,26,54,0.001603,0.001762,0,7198,2,0.000033,14,0.184554,0.214247,119551.698015,0.122292,0.011392
9709122,9709122,,25,42,67,25,42,67,0.005228,0.008674,0,5108,2,0.000031,13,0.202508,0.241515,19125.905609,0.145862,0.013339
9806028,9806028,,45,17,62,45,17,62,0.006619,0.006474,0,6409,2,0.00004,14,0.192113,0.220287,22108.73419,0.115019,0.017162
9806161,9806161,,12,23,35,12,23,35,0.00084,0.001557,0,7350,2,0.000017,14,0.181386,0.210888,27572.8616,0.153782,0.003154
9809076,9809076,,17,26,43,17,26,43,0.002802,0.004528,0,7347,2,0.000021,13,0.198103,0.225457,101527.041036,0.168882,0.005986
9810024,9810024,,14,33,47,14,33,47,0.001938,0.00993,0,7349,2,0.000018,13,0.201109,0.231111,65882.337586,0.161425,0.004597
9701158,9701158,,11,6,17,11,6,17,0.000697,0.001936,0,4889,4,0.000024,13,0.175237,0.20209,1337.995473,0.205882,0.003458
9810075,9810075,,19,21,40,19,21,40,0.003651,0.010127,0,7539,2,0.000019,14,0.197895,0.227193,13326.88842,0.196795,0.006841
9411235,9411235,,18,4,22,18,4,22,0.000299,0.000489,0,3345,2,0.000099,3,0.5,0.583333,82.096767,0.162338,0.006641
9506137,9506137,,15,11,26,15,11,26,0.000613,0.002508,0,3299,4,0.000036,10,0.210431,0.260666,949.123888,0.130769,0.004855
9512180,9512180,,40,8,48,40,8,48,0.002353,0.002657,0,2160,0,0.000061,12,0.180289,0.209382,2726.742042,0.089982,0.016989
9607171,9607171,,5,6,11,5,6,11,0.00016,0.000249,0,5154,2,0.000017,12,0.187512,0.215413,5879.403074,0.218182,0.001788
9811130,9811130,,21,5,26,21,5,26,0.001729,0.000141,0,7189,2,0.000028,15,0.152749,0.172428,18312.013781,0.193846,0.008276
9612191,9612191,,7,5,12,7,5,12,0.000195,0.000242,0,3407,2,0.000019,11,0.190203,0.212458,1665.747229,0.151515,0.002357
9701127,9701127,,36,32,68,36,32,68,0.003035,0.001992,0,3401,2,0.000042,12,0.206051,0.240016,91474.954467,0.119183,0.012985
9705118,9705118,,10,20,30,10,20,30,0.000749,0.003004,0,5687,2,0.000015,12,0.199005,0.231822,1157.254652,0.23908,0.003023
9806009,9806009,,8,78,86,8,78,86,0.000827,0.013851,0,7216,4,0.000014,13,0.225934,0.271716,48740.997125,0.07606,0.00206
9810109,9810109,,4,6,10,4,6,10,0.000307,0.000153,0,7206,2,0.000012,11,0.171051,0.187508,7174.111068,0.2,0.001083
9811244,9811244,,26,16,42,26,16,42,0.001493,0.000872,0,7202,2,0.000028,13,0.173918,0.198146,23380.255687,0.171312,0.007855
9703217,9703217,,97,35,132,97,35,132,0.009943,0.01233,0,4264,2,0.000108,12,0.209721,0.248774,86553.434339,0.064076,0.04515
9710219,9710219,,15,12,27,15,12,27,0.00224,0.004035,0,5221,2,0.00004,14,0.189681,0.218401,28591.476866,0.247863,0.010347
9801127,9801127,,39,9,48,39,9,48,0.003641,0.005933,0,6486,2,0.000053,17,0.174253,0.205137,25252.651747,0.106826,0.014941
9805054,9805054,,9,11,20,9,11,20,0.000628,0.001943,0,7237,2,0.000021,18,0.163556,0.19482,19361.404427,0.142105,0.003907
9807197,9807197,,8,12,20,8,12,20,0.00058,0.002332,0,7238,2,0.00002,14,0.182018,0.208,65616.543737,0.221053,0.003671
9905174,9905174,,23,55,78,23,55,78,0.005111,0.028843,0,7796,1,0.000023,13,0.210385,0.245962,59757.046828,0.095904,0.008994
9906239,9906239,,5,10,15,5,10,15,0.000488,0.003769,0,7185,2,0.000017,14,0.178903,0.206951,11640.646211,0.161905,0.002768
9906244,9906244,,13,18,31,13,18,31,0.00039,0.002169,0,7275,2,0.000023,14,0.183886,0.210706,155678.593827,0.166667,0.004405
9907214,9907214,,8,6,14,8,6,14,0.000599,0.00039,0,7221,2,0.000017,15,0.168054,0.193145,25484.768988,0.142857,0.003498
9808029,9808029,,4,6,10,4,6,10,0.000025,0.002698,0,10047,2,0.000015,14,0.168279,0.189271,7565.354484,0.233333,0.001119
9808039,9808039,,28,13,41,28,13,41,0.005333,0.017722,0,7391,2,0.000031,13,0.199302,0.224647,25194.916392,0.130488,0.008734
9811031,9811031,,18,22,40,18,22,40,0.000323,0.002075,0,10045,4,0.000026,14,0.158195,0.186445,37321.070227,0.078846,0.004712
9907107,9907107,,15,29,44,15,29,44,0.00166,0.010083,0,9831,1,0.000018,11,0.235738,0.270602,83455.242689,0.078753,0.004533
9909020,9909020,,14,18,32,14,18,32,0.001323,0.003694,0,10036,4,0.000016,19,0.189291,0.217244,6318.071912,0.131048,0.004018
1069,1069,,0,1,1,0,1,1,0,0,0,10050,25,0.00001,2,0.666667,0.75,0,0,0
1070,1070,,2,10,12,2,10,12,0,0.000007,0,10109,28,0.000014,15,0.133514,0.154986,128.281257,0.19697,0.000438
9407168,9407168,,43,0,43,43,0,43,0.000187,0,0,1516,28,0.000243,0,0,0,0,0.039867,0.010605
9603157,9603157,,20,2,22,20,2,22,0.000217,0.000002,0,10051,28,0.000127,5,0.306667,0.367391,555.344448,0.142857,0.00491
9604163,9604163,,10,5,15,10,5,15,0.000125,0.000009,0,10092,28,0.000019,3,0.571429,0.680556,89.572459,0.152381,0.002351
9701172,9701172,,22,1,23,22,1,23,0.000024,0.000003,0,10052,28,0.000072,6,0.242424,0.286111,929.017691,0.12253,0.005246
9705218,9705218,,6,2,8,6,2,8,0.000001,0.000005,0,10074,28,0.000019,6,0.244898,0.306944,401.501106,0.214286,0.001401
9711016,9711016,,6,7,13,6,7,13,0,0.00187,0,10100,28,0.000016,11,0.161743,0.190513,4403.594283,0.166667,0.001387
9711126,9711126,,9,2,11,9,2,11,0.000001,0.000003,0,10053,28,0.00003,6,0.25,0.314667,8,0.254545,0.002119
9803226,9803226,,7,3,10,7,3,10,0.000001,0,0,10055,28,0.000019,7,0.214286,0.299735,2290.75,0.266667,0.001653
9811079,9811079,,5,5,10,5,5,10,0.000001,0.000005,0,10056,28,0.000015,6,0.271845,0.388095,5.75,0.333333,0.001168
9910035,9910035,,2,13,15,2,13,15,0,0.000007,0,10108,28,0.000012,14,0.147983,0.174829,1704.736279,0.247619,0.000451
9511192,9511192,,8,3,11,8,3,11,0,0,0,4362,28,0.00009,4,0.4,0.465909,28075.918325,0.072727,0.002028
9306023,9306023,,31,0,31,31,0,31,0.000134,0,0,2120,28,0.000221,0,0,0,0,0.107527,0.007859
9401056,9401056,,15,1,16,15,1,16,0.000127,0.000002,0,2121,28,0.000059,1,1,1,0.333333,0.179167,0.003807
9409113,9409113,,46,3,49,46,3,49,0.000039,0.000003,0,3611,28,0.000254,2,0.8,0.875,5265.902201,0.064626,0.013066
9504086,9504086,,9,3,12,9,3,12,0.000019,0,0,4359,28,0.00005,3,0.571429,0.666667,24506.029095,0.083333,0.002388
9610002,9610002,,11,3,14,11,3,14,0.00023,0.000005,0,7563,26,0.000024,10,0.172994,0.190848,14885.652121,0.252747,0.002688
9710128,9710128,,7,3,10,7,3,10,0.000199,0.000007,0,10099,26,0.000029,11,0.138367,0.15001,4534.277575,0.144444,0.00165
9803074,9803074,,2,3,5,2,3,5,0,0.000003,0,10054,28,0.000017,6,0.257426,0.341026,8,0.45,0.000485
9605027,9605027,,6,3,9,6,3,9,0.000001,0.00002,0,10075,28,0.000016,6,0.271062,0.314414,598.821737,0.222222,0.001394
9710203,9710203,,6,15,21,6,15,21,0.000001,0.000026,0,10096,28,0.000015,13,0.137346,0.161018,6498.272327,0.128571,0.001375
9802119,9802119,,3,7,10,3,7,10,0,0.000005,0,10106,28,0.000012,12,0.141876,0.16631,7459.027091,0.188889,0.00069
9805159,9805159,,3,16,19,3,16,19,0,0.000009,0,10107,28,0.000013,14,0.155784,0.187483,27915.399348,0.125731,0.000677
9810144,9810144,,1,11,12,1,11,12,0,0.000007,0,10097,28,0.000011,14,0.127809,0.151287,156.616545,0.151515,0.000232
9905116,9905116,,5,10,15,5,10,15,0,0.000007,0,10081,28,0.000014,14,0.151922,0.181453,3639.54451,0.147619,0.001122
9510186,9510186,,7,15,22,7,15,22,0.000484,0.00277,0,2172,0,0.00002,8,0.23038,0.280165,2322.486211,0.151515,0.003342
9512188,9512188,,18,22,40,18,22,40,0.001887,0.004357,0,2105,13,0.000025,9,0.237028,0.286562,5372.064954,0.158333,0.007394
9602067,9602067,,14,15,29,14,15,29,0.001135,0.00164,0,2103,13,0.000026,10,0.216862,0.254314,17867.52492,0.142857,0.006386
9604177,9604177,,13,12,25,13,12,25,0.000704,0.00235,0,3336,13,0.000032,10,0.219904,0.252314,8296.496681,0.086667,0.004157
9607077,9607077,,41,12,53,41,12,53,0.003798,0.001254,0,2191,13,0.000062,12,0.202941,0.238973,39770.035543,0.162192,0.018279
9608059,9608059,,49,15,64,49,15,64,0.005235,0.001599,0,2339,13,0.000047,10,0.218818,0.252293,21671.019173,0.147073,0.019416
9608099,9608099,,36,31,67,36,31,67,0.003411,0.004001,0,2466,13,0.000037,12,0.235991,0.281242,17064.629378,0.137494,0.014293
9609204,9609204,,29,29,58,29,29,58,0.003832,0.010106,0,3507,13,0.000036,10,0.233577,0.277549,4345.653652,0.126739,0.012357
9611140,9611140,,24,20,44,24,20,44,0.003283,0.00463,0,3529,13,0.000033,10,0.219648,0.257093,8996.162527,0.17389,0.011245
9611162,9611162,,4,23,27,4,23,27,0.000735,0.004726,0,4568,13,0.000015,10,0.225736,0.264574,5442.124224,0.182336,0.002454
9611163,9611163,,26,15,41,26,15,41,0.003322,0.00538,0,3530,13,0.000031,10,0.224298,0.25837,3745.55744,0.139024,0.01108
9702087,9702087,,8,5,13,8,5,13,0.000165,0.000254,0,4562,2,0.000021,14,0.164188,0.185421,12025.252541,0.115385,0.00284
9611237,9611237,,2,16,18,2,16,18,0.000157,0.002191,0,4584,13,0.000014,11,0.208149,0.240286,9523.85482,0.101307,0.001092
9612015,9612015,,18,42,60,18,42,60,0.002428,0.010925,0,3505,13,0.000036,11,0.225843,0.272638,35680.45781,0.101977,0.006871
9702010,9702010,,13,14,27,13,14,27,0.001866,0.00123,0,4574,13,0.000018,11,0.214508,0.249179,1644.734747,0.264957,0.00578
9702110,9702110,,46,49,95,46,49,95,0.001616,0.004714,0,4583,0,0.000059,11,0.226881,0.27568,83406.198366,0.083427,0.018795
9911240,9911240,,8,25,33,8,25,33,0.001275,0.019748,0,9709,1,0.000019,13,0.203119,0.229939,4693.314115,0.139205,0.003149
9912002,9912002,,15,10,25,15,10,25,0.001929,0.002042,0,9707,25,0.000022,12,0.200916,0.224538,7071.86188,0.101667,0.00623
1072,1072,,2,5,7,2,5,7,0.000405,0.015026,0,10111,1,0.000011,12,0.191587,0.210709,1.679373,0.309524,0.000531
9906118,9906118,,7,3,10,7,3,10,0.001055,0.00749,0,8848,41,0.000017,11,0.225411,0.254304,44337.508468,0.188889,0.002332
9906195,9906195,,10,6,16,10,6,16,0.001785,0.002014,0,10110,1,0.000017,11,0.225341,0.254355,11656.887646,0.116667,0.002671
9307126,9307126,,8,4,12,8,4,12,0.000074,0.000001,0,2573,23,0.000023,3,0.518519,0.607143,4819.837437,0.121212,0.002478
1073,1073,,6,7,13,6,7,13,0.000341,0.002131,0,10114,30,0.00002,13,0.191091,0.208852,1793.769606,0.24359,0.004006
9909202,9909202,,46,21,67,46,21,67,0.002259,0.009146,0,9523,30,0.000056,13,0.203832,0.228549,40177.323468,0.096789,0.018039
9910135,9910135,,31,11,42,31,11,42,0.001281,0.002917,0,10112,30,0.000041,13,0.193095,0.212381,7545.906929,0.163182,0.011878
9910196,9910196,,36,14,50,36,14,50,0.00163,0.003026,0,10113,30,0.000044,13,0.194655,0.216185,14828.165758,0.130612,0.01409
9601148,9601148,,15,1,16,15,1,16,0.000189,0.001027,0,3375,23,0.000196,6,0.262295,0.292839,5190.925596,0.083333,0.005448
9905162,9905162,,21,39,60,21,39,60,0.001408,0.006465,0,8497,2,0.000028,12,0.206799,0.236175,123093.657717,0.067232,0.007939
9909139,9909139,,40,1,41,40,1,41,0.001802,0.000785,0,9522,30,0.000045,13,0.183897,0.198875,0,0.084146,0.013049
1074,1074,,4,6,10,4,6,10,0.000002,0.000063,0,10117,4,0.000014,13,0.171502,0.192511,929.960472,0.355556,0.000903
9804124,9804124,,45,41,86,45,41,86,0.001967,0.005017,0,6075,4,0.000062,12,0.203333,0.240007,601628.760713,0.114501,0.014402
9805106,9805106,,30,15,45,30,15,45,0.00094,0.002763,0,8805,4,0.000046,13,0.180324,0.211635,19444.550445,0.129798,0.008289
9809068,9809068,,24,17,41,24,17,41,0.000879,0.001828,0,8807,4,0.000038,13,0.180588,0.212419,17165.624207,0.15061,0.00667
9812232,9812232,,22,5,27,22,5,27,0.000522,0.001086,0,8808,4,0.000033,13,0.171923,0.193673,424.504852,0.195157,0.005815
9905011,9905011,,26,5,31,26,5,31,0.000612,0.000083,0,10115,4,0.000033,13,0.17188,0.192955,1789.288154,0.144086,0.0066
9907102,9907102,,12,6,18,12,6,18,0.000416,0.000073,0,10116,4,0.000019,13,0.171503,0.19256,1653.364966,0.271242,0.003059
9603028,9603028,,30,12,42,30,12,42,0.001796,0.002891,0,3093,4,0.000026,14,0.195687,0.237271,107427.622553,0.26597,0.012267
9603069,9603069,,20,23,43,20,23,43,0.001122,0.004279,0,3074,4,0.000031,13,0.209302,0.258866,24828.713683,0.192691,0.00729
9610156,9610156,,59,41,100,59,41,100,0.004333,0.004932,0,3474,4,0.000044,10,0.227761,0.272079,75938.535838,0.155859,0.02035
9612134,9612134,,3,24,27,3,24,27,0.000158,0.004829,0,5947,4,0.000012,9,0.24329,0.281465,10714.922665,0.198006,0.00138
9701055,9701055,,41,36,77,41,36,77,0.002801,0.004394,0,4005,4,0.000027,11,0.196676,0.234431,20090.643455,0.191388,0.013768
9702083,9702083,,23,42,65,23,42,65,0.001939,0.004654,0,4069,4,0.000019,12,0.201671,0.24625,30843.475676,0.195673,0.008845
9708170,9708170,,36,28,64,36,28,64,0.002177,0.004247,0,5802,4,0.000029,12,0.207464,0.2488,21577.6648,0.16121,0.011692
9709053,9709053,,61,22,83,61,22,83,0.003802,0.002791,0,5944,4,0.00004,11,0.207323,0.243824,37217.302286,0.138113,0.018962
9710239,9710239,,35,31,66,35,31,66,0.002651,0.004551,0,5799,4,0.00002,13,0.208899,0.245955,92181.4576,0.133566,0.011464
9802130,9802130,,9,68,77,9,68,77,0.000502,0.003492,0,6073,4,0.000014,17,0.205262,0.255601,398271.686597,0.117567,0.003077
9803123,9803123,,16,19,35,16,19,35,0.001237,0.00598,0,5945,4,0.000016,12,0.213737,0.247439,33928.383119,0.213445,0.005074
9406192,9406192,,17,3,20,17,3,20,0.000127,0.00001,0,2037,22,0.000047,1,1,1,2431.944175,0.081579,0.005235
9411136,9411136,,8,2,10,8,2,10,0.00006,0.000002,0,3768,22,0.000021,4,0.323077,0.388889,665.84734,0.111111,0.002276
9512065,9512065,,5,13,18,5,13,18,0.000056,0.000016,0,2783,6,0.000017,15,0.183277,0.218074,83526.147201,0.091503,0.00163
9512158,9512158,,8,2,10,8,2,10,0.000056,0.000004,0,8804,6,0.000023,2,0.666667,0.75,494.326262,0.088889,0.002291
9401021,9401021,,49,0,49,49,0,49,0.002335,0,0,558,4,0.000119,0,0,0,0,0.076105,0.01749
9804125,9804125,,26,11,37,26,11,37,0.001265,0.002264,0,8806,4,0.000031,12,0.178157,0.203906,5750.163245,0.186937,0.007429
9804126,9804126,,35,44,79,35,44,79,0.002727,0.005694,0,5948,4,0.000033,13,0.197414,0.233947,120709.362049,0.164882,0.011958
1075,1075,,0,2,2,0,2,2,0,0.000002,0,10118,23,0.00001,18,0.103434,0.11495,0,0.5,0
1076,1076,,1,15,16,1,15,16,0.000054,0.001046,0,10120,2,0.00001,14,0.178888,0.20027,17.996107,0.241667,0.00024
9401062,9401062,,21,3,24,21,3,24,0.000292,0.000117,0,723,26,0.000044,2,0.8,0.875,1501.120804,0.077899,0.005827
9407114,9407114,,28,15,43,28,15,43,0.000579,0.000425,0,725,26,0.000041,5,0.388626,0.482927,13937.464564,0.105759,0.007503
9611011,9611011,,14,11,25,14,11,25,0.000139,0.000178,0,8798,26,0.000025,10,0.216582,0.266301,25767.707973,0.113333,0.004678
9703189,9703189,,15,13,28,15,13,28,0.000249,0.000244,0,8799,26,0.000025,11,0.193255,0.24516,15777.222818,0.119048,0.00492
9809095,9809095,,17,21,38,17,21,38,0.001374,0.003307,0,7379,2,0.000021,15,0.171321,0.19841,187709.464181,0.133713,0.005138
9901053,9901053,,5,16,21,5,16,21,0.000422,0.001554,0,8800,2,0.000012,14,0.184941,0.210207,15269.055668,0.195238,0.001346
9903246,9903246,,19,35,54,19,35,54,0.001912,0.005092,0,8802,2,0.000019,13,0.20749,0.238193,149760.943475,0.105521,0.005409
9911249,9911249,,6,20,26,6,20,26,0.000092,0.001243,0,10119,2,0.000013,14,0.180524,0.203624,7968.20988,0.186154,0.001376
9207065,9207065,,18,1,19,18,1,19,0.000333,0,0,135,26,0.000184,1,1,1,1378.619335,0.090643,0.005304
9303159,9303159,,17,4,21,17,4,21,0.000195,0.000171,0,184,26,0.000137,2,0.833333,0.9,1988.721239,0.197619,0.007067
9309119,9309119,,29,9,38,29,9,38,0.000411,0.000215,0,680,26,0.000064,2,0.695652,0.78125,12692.231618,0.125178,0.008619
9310041,9310041,,26,3,29,26,3,29,0.000177,0.000115,0,668,26,0.000058,1,1,1,197.431308,0.099754,0.007186
9311156,9311156,,22,6,28,22,6,28,0.00086,0.000205,0,147,26,0.000066,2,0.636364,0.714286,25159.968591,0.149471,0.007581
9401041,9401041,,9,8,17,9,8,17,0.000568,0.000218,0,724,26,0.00002,3,0.525,0.642857,997.983816,0.213235,0.002943
9308158,9308158,,5,1,6,5,1,6,0.000219,0.000006,0,697,26,0.000025,2,0.6,0.666667,17.666507,0.066667,0.0015
9311130,9311130,,19,13,32,19,13,32,0.001125,0.000375,0,682,26,0.000036,4,0.475,0.562865,31149.464682,0.076613,0.005868
9407176,9407176,,11,13,24,11,13,24,0.000612,0.000511,0,685,26,0.000031,4,0.439153,0.51004,9783.668842,0.175725,0.004066
9411210,9411210,,68,62,130,68,62,130,0.002928,0.001714,0,775,4,0.000106,7,0.335005,0.459816,814098.473537,0.027788,0.020727
9502132,9502132,,20,6,26,20,6,26,0.000062,0.000088,0,3145,26,0.000036,4,0.571429,0.715278,8236.712645,0.056923,0.005109
9506174,9506174,,16,1,17,16,1,17,0.00005,0.000001,0,3872,26,0.000033,1,1,1,2008.045381,0.080882,0.004156
9601069,9601069,,23,3,26,23,3,26,0.000093,0.000001,0,3871,26,0.000044,4,0.44898,0.511364,55008.553996,0.046154,0.005787
9601153,9601153,,4,4,8,4,4,8,0.000006,0.000003,0,3873,26,0.000018,5,0.343137,0.41381,527.770726,0.232143,0.001149
9609022,9609022,,6,20,26,6,20,26,0.000373,0.000506,0,8797,22,0.000015,9,0.25142,0.311606,28138.244745,0.063077,0.001503
9302104,9302104,,24,0,24,24,0,24,0.001585,0,0,3629,1,0.000167,0,0,0,0,0.083333,0.009266
9404175,9404175,,13,11,24,13,11,24,0.000057,0.000263,0,687,26,0.000032,3,0.478873,0.593137,1680.034173,0.233696,0.004016
9408115,9408115,,9,12,21,9,12,21,0.000048,0.000285,0,702,26,0.000018,5,0.372642,0.456962,338.892472,0.288095,0.002799
9409044,9409044,,7,0,7,7,0,7,0.000055,0,0,701,4,0.00002,0,0,0,0,0.047619,0.002442
9304015,9304015,,13,5,18,13,5,18,0.000082,0.000115,0,679,26,0.000064,1,1,1,6954.35799,0.091503,0.003837
9309107,9309107,,22,9,31,22,9,31,0.000349,0.000172,0,674,26,0.000055,2,0.909091,0.95,54234.3192,0.105376,0.006483
9402097,9402097,,15,1,16,15,1,16,0.000086,0.000007,0,688,4,0.000046,2,0.666667,0.75,199.859391,0.070833,0.004332
9705102,9705102,,14,18,32,14,18,32,0.00015,0.000118,0,7378,26,0.000022,13,0.185853,0.234126,176553.398585,0.060484,0.003439
9710204,9710204,,2,3,5,2,3,5,0.000416,0.0024,0,7362,2,0.000011,15,0.172042,0.195657,4.898647,0.3,0.000625
9805071,9805071,,25,13,38,25,13,38,0.00209,0.00357,0,7361,2,0.000027,14,0.183728,0.21025,25444.96936,0.179232,0.008239
9806037,9806037,,16,15,31,16,15,31,0.000291,0.000217,0,7358,26,0.000025,10,0.192464,0.247723,48313.790272,0.180645,0.004016
9710078,9710078,,30,18,48,30,18,48,0.004021,0.00793,0,5590,0,0.000031,12,0.195847,0.22736,15691.271753,0.152039,0.010538
9710102,9710102,,21,39,60,21,39,60,0.002846,0.011923,0,6237,0,0.000021,13,0.206002,0.249112,17507.648963,0.110734,0.007852
9804121,9804121,,41,29,70,41,29,70,0.003931,0.009669,0,6420,2,0.000037,13,0.203497,0.237318,45137.295512,0.113043,0.012712
9807232,9807232,,32,18,50,32,18,50,0.003189,0.004752,0,7712,2,0.000027,14,0.185058,0.212975,7623.999966,0.152653,0.009839
9210016,9210016,,2,0,2,2,0,2,0.000075,0,0,8801,25,0.000011,0,0,0,0,0,0.000689
9311072,9311072,,4,4,8,4,4,8,0.000086,0.000132,0,151,26,0.000032,2,0.833333,0.9,3298.486926,0.196429,0.00216
9709029,9709029,,31,7,38,31,7,38,0.003612,0.004617,0,5164,2,0.00003,14,0.186855,0.212208,5327.931176,0.177098,0.010264
9801047,9801047,,19,7,26,19,7,26,0.002388,0.004524,0,5610,2,0.000024,15,0.173677,0.195624,1020.464256,0.218462,0.006888
9806173,9806173,,8,28,36,8,28,36,0.001278,0.012386,0,7713,2,0.000013,13,0.207018,0.23785,21538.148633,0.2,0.002855
9901093,9901093,,23,17,40,23,17,40,0.002157,0.004219,0,8273,2,0.000021,14,0.188453,0.216298,80853.198762,0.189103,0.007115
1077,1077,,6,58,64,6,58,64,0.000599,0.021926,0,10176,0,0.000012,11,0.239776,0.276764,28754.749764,0.121776,0.002637
9302099,9302099,,15,2,17,15,2,17,0.00129,0.000169,0,7751,0,0.000016,1,1,1,348.405464,0.180147,0.005784
9703059,9703059,,58,36,94,58,36,94,0.004898,0.006324,0,4878,0,0.000039,12,0.223495,0.270513,31424.934904,0.065088,0.019313
9705037,9705037,,55,12,67,55,12,67,0.002336,0.002055,0,4430,0,0.000087,13,0.193399,0.224108,8876.549109,0.119855,0.020581
9804092,9804092,,80,51,131,80,51,131,0.007307,0.007461,0,5869,0,0.000086,13,0.211374,0.244414,164853.15027,0.098415,0.033976
9807011,9807011,,56,41,97,56,41,97,0.005223,0.006882,0,7752,0,0.000045,14,0.191638,0.223417,29122.338696,0.104596,0.022091
9810214,9810214,,45,22,67,45,22,67,0.005963,0.002044,0,7440,0,0.000035,13,0.181611,0.211094,23245.967924,0.142017,0.019949
9812158,9812158,,33,15,48,33,15,48,0.002844,0.001387,0,8611,0,0.000027,13,0.195915,0.221529,6647.181833,0.147163,0.013068
9904069,9904069,,35,13,48,35,13,48,0.004188,0.002085,0,8609,0,0.000027,14,0.183738,0.208398,4935.434055,0.181294,0.01536
9907184,9907184,,33,34,67,33,34,67,0.003245,0.004013,0,8613,0,0.000025,13,0.201767,0.229962,22579.832275,0.127092,0.013225
9908064,9908064,,54,31,85,54,31,85,0.003982,0.00409,0,10128,0,0.000034,13,0.199962,0.227581,17472.739479,0.133894,0.020665
9908072,9908072,,72,37,109,72,37,109,0.006315,0.003437,0,9677,0,0.000041,15,0.196049,0.225898,24924.576107,0.101597,0.027545
9909010,9909010,,16,23,39,16,23,39,0.002426,0.001625,0,10135,0,0.000016,13,0.192746,0.218238,9506.895074,0.22807,0.006091
9909107,9909107,,13,21,34,13,21,34,0.001332,0.001995,0,10122,52,0.000014,11,0.202085,0.225611,11038.976869,0.16221,0.004397
9909116,9909116,,13,14,27,13,14,27,0.001572,0.001013,0,10148,0,0.000014,14,0.185079,0.210633,30642.508938,0.196581,0.004016
9909172,9909172,,71,56,127,71,56,127,0.004809,0.003741,0,9681,0,0.000048,11,0.221055,0.252355,185590.243483,0.081052,0.028848
9911081,9911081,,49,53,102,49,53,102,0.004943,0.00577,0,10149,0,0.000031,12,0.211231,0.241366,99797.345723,0.117744,0.018834
9912257,9912257,,21,47,68,21,47,68,0.003609,0.02264,0,10175,1,0.000018,11,0.236184,0.270605,75786.284418,0.13367,0.006813
9211084,9211084,,5,1,6,5,1,6,0.000474,0.000163,0,978,0,0.000027,1,1,1,756.754309,0.1,0.002121
9408119,9408119,,5,7,12,5,7,12,0.00045,0.000011,0,4667,52,0.000017,2,0.64,0.71875,38914.601583,0.090909,0.001749
9311038,9311038,,5,0,5,5,0,5,0.000673,0,0,1904,0,0.000016,0,0,0,0,0.4,0.002622
9607041,9607041,,45,21,66,45,21,66,0.00504,0.005962,0,2308,0,0.00005,12,0.216202,0.251368,3593.160152,0.134965,0.02176
9612093,9612093,,3,7,10,3,7,10,0.000166,0.000023,0,4661,52,0.000012,4,0.445946,0.535354,52381.210035,0.188889,0.001297
9510098,9510098,,14,18,32,14,18,32,0.001378,0.005079,0,1509,13,0.000028,9,0.243,0.296928,16914.993242,0.128024,0.007855
9605011,9605011,,21,43,64,21,43,64,0.001832,0.001435,0,2433,0,0.000021,12,0.223214,0.278638,31369.914248,0.130952,0.008596
9602075,9602075,,7,5,12,7,5,12,0.000225,0.000004,0,4428,0,0.000029,5,0.342857,0.4625,33941.36373,0.113636,0.002474
9505171,9505171,,32,8,40,32,8,40,0.00075,0.000318,0,2453,0,0.000071,7,0.226601,0.287026,2617.81225,0.064103,0.011051
9509115,9509115,,20,2,22,20,2,22,0.00046,0.000089,0,1393,0,0.000046,7,0.24297,0.268177,218.940459,0.125541,0.007579
9402006,9402006,,14,1,15,14,1,15,0.000144,0.000023,0,1395,0,0.000103,6,0.214953,0.257609,10304.184882,0.119048,0.006114
9503055,9503055,,10,1,11,10,1,11,0.000145,0.000002,0,1396,0,0.000047,7,0.180077,0.212969,15.226129,0.154545,0.004231
9201028,9201028,,2,0,2,2,0,2,0.000063,0,0,1742,0,0.000015,0,0,0,0,0.5,0.001545
9505194,9505194,,4,2,6,4,2,6,0.000075,0.000003,0,1397,0,0.000022,7,0.183206,0.229365,1463.300923,0.433333,0.002841
9506001,9506001,,3,2,5,3,2,5,0.00008,0.000003,0,1740,0,0.000016,7,0.183206,0.229365,0,0.45,0.001785
9606145,9606145,,4,4,8,4,4,8,0.000129,0.000237,0,4431,0,0.000016,9,0.202627,0.23155,2140.911841,0.089286,0.001892
9704101,9704101,,3,5,8,3,5,8,0.000086,0.000542,0,4444,2,0.000022,12,0.199462,0.22206,16558.248052,0.071429,0.001179
9705182,9705182,,2,10,12,2,10,12,0.000056,0.001489,0,4432,0,0.000015,13,0.182654,0.207881,9704.763051,0.136364,0.00108
9704059,9704059,,75,27,102,75,27,102,0.007868,0.002766,0,4412,0,0.000109,12,0.204316,0.24204,407266.287252,0.122209,0.039755
9705163,9705163,,84,11,95,84,11,95,0.008961,0.001787,0,5049,0,0.000105,12,0.190877,0.221001,126914.274814,0.150952,0.04174
9706051,9706051,,77,10,87,77,10,87,0.007739,0.001966,0,5050,0,0.000094,12,0.184496,0.211819,989.745884,0.17375,0.037515
9706158,9706158,,32,37,69,32,37,69,0.002626,0.005112,0,4414,0,0.000037,11,0.221038,0.257841,145160.141619,0.101023,0.0139
9801114,9801114,,22,17,39,22,17,39,0.001821,0.003095,0,5056,0,0.000028,15,0.185265,0.217358,19983.297866,0.214575,0.011446
9701021,9701021,,7,1,8,7,1,8,0.000088,0,0,5868,23,0.000063,1,1,1,9781.75,0.107143,0.002451
9709159,9709159,,12,15,27,12,15,27,0.001402,0.005001,0,4922,0,0.000019,14,0.192297,0.226099,1449.671575,0.222222,0.005547
9801058,9801058,,6,23,29,6,23,29,0.001475,0.009016,0,5529,13,0.000021,13,0.211497,0.245662,107820.559215,0.08867,0.004131
9802094,9802094,,2,2,4,2,2,4,0.000111,0.000093,0,5861,0,0.000013,12,0.180521,0.199684,2510.152327,0.166667,0.00119
9803141,9803141,,65,23,88,65,23,88,0.005021,0.003798,0,5824,0,0.000073,12,0.189895,0.219934,17544.124124,0.140021,0.031308
9803168,9803168,,7,41,48,7,41,48,0.001509,0.008861,0,5860,0,0.000015,16,0.194144,0.231906,9015.566001,0.1875,0.00406
9406132,9406132,,63,6,69,63,6,69,0.001535,0.000397,0,604,0,0.000371,3,0.558824,0.640351,18804.797715,0.060102,0.02914
9505018,9505018,,34,3,37,34,3,37,0.000911,0.000073,0,1699,0,0.000081,3,0.529412,0.62963,2141.676385,0.154655,0.01583
9505046,9505046,,38,16,54,38,16,54,0.000953,0.000282,0,1702,0,0.000086,9,0.260536,0.311371,35087.906037,0.120894,0.0166
9605170,9605170,,31,12,43,31,12,43,0.000364,0.000148,0,4406,0,0.000053,8,0.23312,0.277288,8496.455965,0.096346,0.008997
9605180,9605180,,20,4,24,20,4,24,0.000327,0.00005,0,4936,0,0.00004,8,0.199434,0.252465,392.889576,0.139493,0.006336
9708049,9708049,,24,43,67,24,43,67,0.001173,0.004042,0,7746,0,0.000035,16,0.203623,0.256905,83130.049925,0.08028,0.00849
9709093,9709093,,9,6,15,9,6,15,0.000704,0.000186,0,8091,0,0.000022,16,0.17795,0.205126,16598.804271,0.195238,0.003844
9710149,9710149,,10,41,51,10,41,51,0.000407,0.00229,0,8085,0,0.000021,12,0.194579,0.230366,138301.566806,0.092549,0.005332
9803143,9803143,,4,18,22,4,18,22,0.000345,0.000879,0,8092,4,0.000019,13,0.193289,0.223047,57662.344462,0.125541,0.002507
9804110,9804110,,55,16,71,55,16,71,0.005352,0.00438,0,5870,0,0.000065,14,0.183432,0.206748,6041.587428,0.214688,0.025405
9806008,9806008,,49,39,88,49,39,88,0.005055,0.007746,0,7622,0,0.000043,13,0.209289,0.239309,32188.355056,0.174896,0.020467
9806044,9806044,,47,19,66,47,19,66,0.004331,0.004266,0,7623,0,0.000045,13,0.199075,0.224135,22860.482337,0.227273,0.021462
9806143,9806143,,35,24,59,35,24,59,0.003562,0.004816,0,7643,0,0.000034,13,0.202638,0.228822,9921.562547,0.230567,0.014028
9807240,9807240,,1,46,47,1,46,47,0.000081,0.004046,0,8086,0,0.000018,14,0.200808,0.232107,40029.615259,0.13506,0.001239
9711059,9711059,,27,23,50,27,23,50,0.003164,0.003675,0,6139,0,0.000025,12,0.199185,0.232006,29140.989522,0.159184,0.010177
9806129,9806129,,16,28,44,16,28,44,0.001602,0.003355,0,7439,0,0.000019,12,0.189777,0.219968,21308.504872,0.196089,0.006098
9412076,9412076,,6,6,12,6,6,12,0.000415,0.000097,0,4528,13,0.000019,4,0.353488,0.401316,39298.357886,0.113636,0.002893
9806080,9806080,,47,20,67,47,20,67,0.002552,0.003392,0,7642,0,0.000042,14,0.218226,0.253229,101099.572613,0.088648,0.019501
9811013,9811013,,20,37,57,20,37,57,0.001677,0.008497,0,7740,0,0.000021,13,0.204245,0.237691,32390.594317,0.10495,0.00694
9307123,9307123,,11,9,20,11,9,20,0.000673,0.000172,0,1156,13,0.000022,3,0.428571,0.535354,14406.872769,0.031579,0.003275
9901085,9901085,,24,16,40,24,16,40,0.00287,0.00361,0,7904,1,0.000027,13,0.213398,0.245293,65775.035579,0.117949,0.00936
9904007,9904007,,18,18,36,18,18,36,0.001831,0.002,0,8608,0,0.00002,13,0.187012,0.209762,1900.516185,0.275397,0.006832
9904211,9904211,,14,33,47,14,33,47,0.001715,0.003421,0,8655,0,0.000017,14,0.185075,0.212006,16681.441027,0.196577,0.00574
9905033,9905033,,13,26,39,13,26,39,0.001628,0.00283,0,8654,0,0.000015,13,0.1899,0.215444,858.376112,0.239541,0.005023
9905042,9905042,,13,5,18,13,5,18,0.001367,0.006525,0,8642,1,0.00002,14,0.181059,0.201826,360.231865,0.238562,0.003578
9906057,9906057,,14,26,40,14,26,40,0.002115,0.009455,0,8644,1,0.000023,11,0.208088,0.233094,63625.354233,0.152564,0.004733
9906081,9906081,,24,42,66,24,42,66,0.003192,0.022048,0,8646,1,0.000022,12,0.213866,0.246447,35209.620743,0.132634,0.007089
9906090,9906090,,8,5,13,8,5,13,0.000391,0.000837,0,8652,1,0.000015,13,0.187151,0.207226,3567.889439,0.192308,0.002338
9906101,9906101,,19,45,64,19,45,64,0.002881,0.012843,0,8647,1,0.000018,12,0.211831,0.243798,20135.429635,0.131944,0.005825
9906179,9906179,,5,21,26,5,21,26,0.000521,0.004146,0,8653,1,0.000013,13,0.195902,0.222469,2776.204055,0.189231,0.00172
9906196,9906196,,4,20,24,4,20,24,0.000168,0.017655,0,8651,1,0.000012,16,0.199181,0.225615,3930.117866,0.248188,0.001216
9906210,9906210,,4,11,15,4,11,15,0.000672,0.002125,0,8650,1,0.000012,12,0.19654,0.218526,1227.618899,0.219048,0.001373
9906220,9906220,,25,39,64,25,39,64,0.003263,0.022972,0,8649,1,0.000029,12,0.211433,0.240989,33512.407816,0.138145,0.00793
9906039,9906039,,38,63,101,38,63,101,0.002459,0.007201,0,8607,0,0.000032,12,0.217484,0.254422,96452.257132,0.091386,0.013187
9904071,9904071,,36,23,59,36,23,59,0.003077,0.003752,0,8591,0,0.000027,13,0.201823,0.229002,14829.266541,0.152835,0.016869
9903145,9903145,,20,20,40,20,20,40,0.002111,0.004564,0,8930,0,0.000021,13,0.20867,0.240299,17744.185608,0.164744,0.009495
9907112,9907112,,16,35,51,16,35,51,0.001067,0.007634,0,10126,0,0.000018,13,0.196659,0.226781,21177.823536,0.13098,0.00577
9907203,9907203,,3,42,45,3,42,45,0.000176,0.005278,0,10127,0,0.000012,14,0.196516,0.226067,6087.638943,0.193434,0.001808
9907054,9907054,,6,55,61,6,55,61,0.000512,0.011382,0,10132,0,0.000012,13,0.211232,0.244927,13286.842945,0.112842,0.001987
9703029,9703029,,3,18,21,3,18,21,0.000104,0.001723,0,3667,0,0.000014,12,0.206678,0.242823,30785.346303,0.159524,0.001491
9903181,9903181,,6,18,24,6,18,24,0.000706,0.017947,0,8288,1,0.000013,11,0.199275,0.227932,5275.205831,0.211957,0.002039
9906012,9906012,,15,33,48,15,33,48,0.001872,0.012664,0,10121,1,0.000016,10,0.236512,0.271865,36833.144345,0.182181,0.006551
9909023,9909023,,4,2,6,4,2,6,0.000012,0,0,10147,28,0.000032,15,0.137993,0.150842,29083.650157,0.133333,0.00099
9505098,9505098,,10,18,28,10,18,28,0.000194,0.001175,0,1711,0,0.000022,8,0.249678,0.303342,28147.046271,0.104497,0.004756
9507162,9507162,,4,4,8,4,4,8,0.000112,0.000013,0,4408,0,0.000013,9,0.201106,0.228674,537.808738,0.25,0.002306
9512155,9512155,,11,24,35,11,24,35,0.000362,0.004767,0,1737,0,0.000021,10,0.226103,0.273233,8363.293707,0.105042,0.00549
9607144,9607144,,8,11,19,8,11,19,0.00059,0.000725,0,4403,0,0.000015,10,0.211834,0.2437,14938.794106,0.081871,0.004065
9810010,9810010,,27,16,43,27,16,43,0.002001,0.003231,0,8595,0,0.000022,14,0.213988,0.245097,42326.653998,0.154485,0.008738
9901098,9901098,,3,14,17,3,14,17,0.000085,0.000189,0,9680,0,0.000011,16,0.168584,0.195696,4226.004138,0.102941,0.001329
9903051,9903051,,18,24,42,18,24,42,0.001031,0.004972,0,8599,0,0.000025,14,0.196178,0.223265,49263.694458,0.160859,0.007026
9903160,9903160,,16,16,32,16,16,32,0.000634,0.001659,0,8600,0,0.000018,14,0.194847,0.218896,14502.574808,0.217742,0.005784
9905098,9905098,,13,23,36,13,23,36,0.000529,0.002424,0,8601,0,0.000016,14,0.189162,0.214319,2235.609672,0.236508,0.004901
9905137,9905137,,26,23,49,26,23,49,0.003149,0.004557,0,8585,0,0.00002,14,0.194167,0.224423,7263.034078,0.191752,0.008698
9906222,9906222,,4,26,30,4,26,30,0.000301,0.00337,0,9679,0,0.000013,14,0.196719,0.225781,3357.37991,0.208046,0.001537
9907023,9907023,,5,17,22,5,17,22,0.000301,0.005737,0,9678,0,0.000012,11,0.235517,0.267909,35166.592374,0.145022,0.00195
9909212,9909212,,8,42,50,8,42,50,0.000936,0.007296,0,10143,0,0.000012,15,0.22006,0.261414,21755.203233,0.106531,0.003286
9910094,9910094,,8,50,58,8,50,58,0.00097,0.023692,0,10141,0,0.000014,13,0.206046,0.240396,45890.376597,0.108893,0.002725
9910228,9910228,,23,63,86,23,63,86,0.002922,0.004951,0,10134,0,0.00002,12,0.212233,0.245052,66793.048023,0.113406,0.009915
9908125,9908125,,13,30,43,13,30,43,0.002292,0.019696,0,10174,1,0.000014,12,0.218295,0.247592,36128.056174,0.1268,0.003524
9911096,9911096,,100,31,131,100,31,131,0.019905,0.023411,0,8844,1,0.000059,11,0.213587,0.242236,41753.678773,0.096007,0.040744
9912145,9912145,,7,34,41,7,34,41,0.001703,0.007132,0,10168,0,0.000012,11,0.238356,0.273453,34624.61815,0.091463,0.002881
1080,1080,,0,11,11,0,11,11,0,0.011656,0,10191,13,0.00001,13,0.168988,0.19142,0,0.081818,0
9606062,9606062,,2,1,3,2,1,3,0.000142,0.000007,0,10189,13,0.000013,1,1,1,0.5,0.333333,0.000445
9610014,9610014,,3,2,5,3,2,5,0.000204,0.000008,0,10188,13,0.000015,3,0.5,0.551282,17184.116231,0.1,0.001329
9703164,9703164,,1,4,5,1,4,5,0.000137,0.000459,0,10190,13,0.000011,5,0.322078,0.374866,30.94359,0.15,0.000219
9705209,9705209,,4,39,43,4,39,43,0.000614,0.004127,0,8138,13,0.000012,11,0.217111,0.264121,59989.631276,0.05814,0.001369
9908150,9908150,,7,4,11,7,4,11,0.000692,0.000537,0,10185,1,0.000016,13,0.171765,0.186154,3513.670533,0.154545,0.001762
9910074,9910074,,8,5,13,8,5,13,0.001769,0.010513,0,10184,1,0.000018,14,0.171228,0.191795,4519.549981,0.192308,0.001986
9206048,9206048,,35,2,37,35,2,37,0.001357,0.000011,0,47,13,0.000217,1,1,1,810.588062,0.084835,0.013198
9210119,9210119,,45,11,56,45,11,56,0.002225,0.000673,0,105,13,0.000292,2,0.58209,0.641026,82708.102607,0.03961,0.021655
9302037,9302037,,15,4,19,15,4,19,0.000251,0.00005,0,69,13,0.000062,1,1,1,4792.996504,0.087719,0.005431
9302070,9302070,,7,6,13,7,6,13,0.000062,0.000067,0,67,5,0.000057,4,0.518519,0.666667,9097.714821,0.089744,0.003224
9302083,9302083,,35,3,38,35,3,38,0.000503,0.000032,0,62,13,0.000143,1,1,1,686.692851,0.059033,0.012207
9201019,9201019,,16,0,16,16,0,16,0.000263,0,0,2,26,0.002042,0,0,0,0,0.1125,0.011669
9205025,9205025,,5,0,5,5,0,5,0.000189,0,0,298,2,0.000057,0,0,0,0,0.15,0.005746
9205052,9205052,,11,0,11,11,0,11,0.000411,0,0,279,13,0.000272,0,0,0,0,0.118182,0.008334
9205091,9205091,,10,0,10,10,0,10,0.000481,0,0,4,13,0.000299,0,0,0,0,0.088889,0.008886
9212026,9212026,,3,2,5,3,2,5,0.000076,0.000033,0,281,13,0.000071,1,1,1,35.116474,0.2,0.005417
9302038,9302038,,36,4,40,36,4,40,0.00304,0.000159,0,20,13,0.000928,2,0.75,0.833333,1583.021311,0.083974,0.040486
9303074,9303074,,6,0,6,6,0,6,0.000117,0,0,278,13,0.000078,0,0,0,0,0.066667,0.006154
9402120,9402120,,23,19,42,23,19,42,0.00082,0.000842,0,264,13,0.000107,4,0.382979,0.512731,51089.147857,0.076655,0.01471
9307039,9307039,,17,6,23,17,6,23,0.000662,0.000079,0,1747,2,0.000057,2,0.8,0.875,4615.511074,0.150198,0.005755
9601155,9601155,,1,4,5,1,4,5,0,0.000008,0,10187,22,0.000016,3,0.545455,0.638889,11597.443777,0.05,0.000247
9209122,9209122,,18,1,19,18,1,19,0.000105,0.000003,0,164,5,0.000208,1,1,1,3086.709847,0.061404,0.005248
9211080,9211080,,10,0,10,10,0,10,0.000311,0,0,393,5,0.000051,0,0,0,0,0.044444,0.002907
9303048,9303048,,84,1,85,84,1,85,0.002503,0.000018,0,372,5,0.000598,1,1,1,3993.301369,0.057143,0.027867
9305109,9305109,,31,6,37,31,6,37,0.001135,0.000013,0,398,5,0.000061,3,0.397436,0.478495,26384.750232,0.048799,0.0093
9305179,9305179,,3,6,9,3,6,9,0.000058,0.000047,0,5257,9,0.000013,2,0.875,0.928571,18521.69172,0.069444,0.00085
9309050,9309050,,24,3,27,24,3,27,0.000165,0.000002,0,1641,5,0.000068,2,0.714286,0.8,12594.716666,0.162393,0.007246
9401072,9401072,,67,2,69,67,2,69,0.00127,0.000097,0,375,5,0.000147,2,0.75,0.833333,522.498142,0.066709,0.020374
9401125,9401125,,42,1,43,42,1,43,0.000393,0.000029,0,373,5,0.000108,2,0.666667,0.75,1.25,0.10299,0.012576
9403008,9403008,,12,5,17,12,5,17,0.000922,0.000673,0,3369,13,0.000021,4,0.32973,0.386612,200.268865,0.150735,0.003302
9405143,9405143,,27,2,29,27,2,29,0.00014,0.000002,0,1660,5,0.000075,2,0.625,0.7,4219.517206,0.131773,0.007791
9407001,9407001,,33,14,47,33,14,47,0.000277,0.000305,0,1650,5,0.000059,6,0.331034,0.409144,63709.015817,0.10592,0.00981
9409168,9409168,,11,7,18,11,7,18,0.00014,0.000112,0,1554,5,0.000023,4,0.351724,0.441176,13559.113085,0.147059,0.003483
9409195,9409195,,5,0,5,5,0,5,0.000309,0,0,4546,0,0.000014,0,0,0,0,0.05,0.001856
9603072,9603072,,2,13,15,2,13,15,0.000085,0.000764,0,8137,5,0.000011,12,0.16616,0.203458,16189.473871,0.185714,0.000574
9603173,9603173,,3,7,10,3,7,10,0.000092,0.000675,0,5256,13,0.000013,4,0.338624,0.407552,24.888364,0.233333,0.000856
9609085,9609085,,10,25,35,10,25,35,0.000471,0.001017,0,4619,5,0.000017,11,0.196419,0.233618,113012.83139,0.093277,0.002923
9208018,9208018,,4,0,4,4,0,4,0.000316,0,0,5302,1,0.000026,0,0,0,0,0.083333,0.001089
9906226,9906226,,19,28,47,19,28,47,0.003666,0.021931,0,8677,1,0.000026,12,0.204603,0.23029,21221.695407,0.155412,0.005522
9811233,9811233,,6,6,12,6,6,12,0.000438,0.000001,0,10181,6,0.000027,16,0.157581,0.174822,78414.510757,0.060606,0.001604
9905178,9905178,,9,0,9,9,0,9,0.000805,0,0,10183,1,0.000035,0,0,0,0,0.069444,0.002229
9905179,9905179,,25,5,30,25,5,30,0.004057,0.010475,0,10182,1,0.000041,13,0.182928,0.203395,87782.508885,0.109195,0.006391
1081,1081,,1,13,14,1,13,14,0.000002,0.000017,0,10214,23,0.000011,11,0.174656,0.245462,37493.23088,0.164835,0.000571
9502031,9502031,,37,12,49,37,12,49,0.000006,0.000015,0,4459,23,0.000066,3,0.492958,0.609524,14311.995601,0.096514,0.009443
9510201,9510201,,26,8,34,26,8,34,0.000006,0.000001,0,4475,23,0.000039,9,0.188837,0.256003,22405.023377,0.116756,0.006365
9601124,9601124,,17,7,24,17,7,24,0.000009,0.000132,0,6613,23,0.000029,5,0.389381,0.483333,8292.293536,0.057971,0.004087
9708077,9708077,,8,10,18,8,10,18,0.000002,0.000014,0,10211,23,0.000016,9,0.190432,0.264019,294.881704,0.222222,0.001902
9805084,9805084,,14,8,22,14,8,22,0.000001,0.000003,0,10201,23,0.000043,10,0.189394,0.244288,10936.768747,0.138528,0.003424
9807023,9807023,,4,10,14,4,10,14,0.000001,0.000017,0,10212,23,0.000013,10,0.167607,0.240001,66.783686,0.258242,0.000966
9809210,9809210,,6,14,20,6,14,20,0.000001,0.000007,0,10204,23,0.000016,10,0.192078,0.255982,11284.075264,0.113158,0.00145
9901046,9901046,,4,13,17,4,13,17,0.000001,0.000014,0,10213,23,0.000012,9,0.192065,0.272466,16762.619583,0.25,0.000927
9905083,9905083,,8,14,22,8,14,22,0.000028,0.000003,0,10206,23,0.000019,10,0.19088,0.254615,35856.78384,0.155844,0.002194
9209062,9209062,,15,0,15,15,0,15,0.000001,0,0,4458,23,0.000038,0,0,0,0,0.07619,0.003728
9403180,9403180,,13,2,15,13,2,15,0.000002,0,0,4457,23,0.000027,2,0.666667,0.75,0,0.266667,0.003511
9502030,9502030,,22,3,25,22,3,25,0.000004,0,0,4460,23,0.000044,2,0.8,0.875,64.108999,0.123333,0.005588
9505009,9505009,,21,12,33,21,12,33,0.000007,0.00001,0,4461,23,0.000035,4,0.405405,0.508333,6481.087343,0.160985,0.005469
9508034,9508034,,10,10,20,10,10,20,0.000003,0.000002,0,4467,23,0.000025,8,0.214128,0.286647,23485.658958,0.181579,0.002656
9508174,9508174,,3,13,16,3,13,16,0.000001,0.000011,0,4474,23,0.000016,4,0.403509,0.502415,27107.70288,0.15,0.000863
9310167,9310167,,9,0,9,9,0,9,0.000006,0,0,6612,23,0.000019,0,0,0,0,0.222222,0.002201
9408053,9408053,,17,3,20,17,3,20,0.000646,0.000048,0,4481,3,0.000029,3,0.41791,0.470238,490.407082,0.086842,0.004495
9511066,9511066,,10,17,27,10,17,27,0.000005,0.000088,0,4469,23,0.000026,8,0.215217,0.301395,3120.290911,0.15812,0.002565
9501004,9501004,,20,5,25,20,5,25,0.000042,0,0,10194,23,0.000064,2,0.857143,0.916667,6296.036708,0.096667,0.004852
9604027,9604027,,15,23,38,15,23,38,0.000201,0.000075,0,4477,23,0.000035,9,0.215712,0.292441,222377.632239,0.116643,0.004244
9609037,9609037,,10,13,23,10,13,23,0.000002,0.000013,0,10200,23,0.000024,10,0.195665,0.252299,5753.001689,0.164032,0.002797
9804156,9804156,,3,17,20,3,17,20,0,0.000022,0,10199,23,0.000018,6,0.378723,0.483146,649.673982,0.107895,0.000807
9305167,9305167,,8,0,8,8,0,8,0.000039,0,0,7880,2,0.00003,0,0,0,0,0.232143,0.002066
9306111,9306111,,7,3,10,7,3,10,0.000004,0.000001,0,4472,23,0.000018,1,1,1,185.751067,0.144444,0.001692
9310013,9310013,,6,5,11,6,5,11,0.000022,0.000048,0,755,23,0.000022,2,0.777778,0.857143,22352.569733,0.081818,0.002048
9507026,9507026,,7,5,12,7,5,12,0.000001,0.000006,0,4471,23,0.000015,3,0.551724,0.635417,4789.923621,0.174242,0.001658
9704209,9704209,,1,7,8,1,7,8,0,0.000001,0,10203,23,0.000011,11,0.179318,0.22107,83.945078,0.339286,0.00026
9806114,9806114,,8,1,9,8,1,9,0,0,0,10202,23,0.00002,11,0.159618,0.18775,0,0.333333,0.00195
9811252,9811252,,5,7,12,5,7,12,0,0.000006,0,10210,23,0.000026,2,0.769231,0.85,11523.301446,0.113636,0.001129
9507023,9507023,,18,5,23,18,5,23,0.000018,0.000001,0,10195,23,0.000038,3,0.7,0.833333,2474.623881,0.132411,0.004428
9809208,9809208,,6,8,14,6,8,14,0.000001,0.000003,0,10205,23,0.000017,10,0.186441,0.235639,379.871141,0.258242,0.001465
9810125,9810125,,3,8,11,3,8,11,0,0.000002,0,10197,23,0.000025,3,0.769231,0.883333,7650.401381,0.263636,0.000722
1082,1082,,42,33,75,42,33,75,0.004448,0.015058,0,10248,25,0.000033,14,0.21753,0.248155,195070.552641,0.073333,0.014604
9810068,9810068,,35,5,40,35,5,40,0.000791,0.000114,0,9413,5,0.000045,16,0.156889,0.171256,31233.453877,0.107692,0.009726
9812086,9812086,,6,12,18,6,12,18,0.000432,0.002536,0,9668,0,0.000015,14,0.183723,0.208748,1431.026288,0.179739,0.002598
9911011,9911011,,47,30,77,47,30,77,0.002294,0.003378,0,10242,0,0.000043,15,0.195752,0.227838,71659.395163,0.070403,0.017949
9911154,9911154,,7,22,29,7,22,29,0.001114,0.001332,0,10246,13,0.000013,13,0.190565,0.215304,29574.681752,0.162562,0.002754
9912022,9912022,,8,30,38,8,30,38,0.000414,0.001658,0,10247,13,0.000017,12,0.206928,0.234483,35362.206715,0.110242,0.002624
9912152,9912152,,92,18,110,92,18,110,0.005573,0.002302,0,10243,0,0.00006,16,0.177088,0.205547,33273.769703,0.078399,0.035883
9912164,9912164,,27,133,160,27,133,160,0.00608,0.048381,0,10240,1,0.00002,13,0.244997,0.289152,313085.64034,0.055621,0.008784
9201029,9201029,,43,0,43,43,0,43,0.003677,0,0,80,13,0.000379,0,0,0,0,0.052602,0.01896
9211015,9211015,,30,6,36,30,6,36,0.002518,0.000236,0,424,13,0.000104,3,0.404255,0.473684,8785.805431,0.057937,0.01162
9309091,9309091,,1,0,1,1,0,1,0.000027,0,0,1831,13,0.000025,0,0,0,0,0,0.001959
9505116,9505116,,9,9,18,9,9,18,0.000519,0.000307,0,1027,13,0.000028,8,0.20688,0.245206,9223.086333,0.098039,0.004172
9506113,9506113,,23,26,49,23,26,49,0.002067,0.00356,0,1108,13,0.000122,8,0.274962,0.330098,99649.033965,0.095663,0.015861
9502049,9502049,,5,0,5,5,0,5,0.000051,0,0,1925,41,0.000022,0,0,0,0,0,0.002176
9502107,9502107,,35,1,36,35,1,36,0.001698,0.000029,0,912,13,0.000141,1,1,1,93.283708,0.069048,0.012015
9606009,9606009,,13,35,48,13,35,48,0.000932,0.013811,0,1924,0,0.000033,9,0.241163,0.28398,11116.681164,0.14273,0.005479
9609218,9609218,,6,0,6,6,0,6,0.000114,0,0,2676,2,0.000029,0,0,0,0,0.133333,0.002159
9706050,9706050,,31,67,98,31,67,98,0.002787,0.009168,0,4261,4,0.000027,10,0.237595,0.283434,507104.362573,0.108142,0.01348
9707163,9707163,,36,0,36,36,0,36,0.000184,0,0,8217,5,0.000207,0,0,0,0,0.146032,0.01026
9802074,9802074,,36,4,40,36,4,40,0.000689,0.001863,0,9388,5,0.000106,6,0.267748,0.31048,9228.106387,0.135897,0.010287
9808140,9808140,,41,4,45,41,4,45,0.000643,0.000017,0,9412,5,0.000093,7,0.215655,0.251058,8638.080269,0.122727,0.011039
9808101,9808101,,52,53,105,52,53,105,0.00202,0.006435,0,8098,0,0.000042,13,0.214898,0.252576,60798.542913,0.110531,0.016855
9702174,9702174,,60,5,65,60,5,65,0.002805,0.000698,0,3990,4,0.000126,10,0.181866,0.21565,13472.744739,0.066346,0.020249
9509021,9509021,,15,6,21,15,6,21,0.000264,0.000228,0,7462,28,0.000034,8,0.217303,0.244806,11220.926661,0.069048,0.004082
9806040,9806040,,15,15,30,15,15,30,0.001529,0.00136,0,7687,13,0.000018,14,0.189454,0.218697,12337.102411,0.183908,0.00498
9809187,9809187,,46,19,65,46,19,65,0.003321,0.003486,0,7843,0,0.000045,14,0.183578,0.216985,31662.497825,0.090865,0.017449
9811034,9811034,,13,28,41,13,28,41,0.001507,0.003227,0,8358,13,0.000018,14,0.200632,0.243891,15559.975854,0.131707,0.004453
9812127,9812127,,42,18,60,42,18,60,0.002749,0.001546,0,8306,0,0.00004,15,0.184248,0.217703,22416.469053,0.10452,0.015426
9905156,9905156,,28,15,43,28,15,43,0.002111,0.000919,0,9396,13,0.000028,16,0.182756,0.208061,50214.903077,0.099114,0.008457
9906190,9906190,,1,14,15,1,14,15,0.00004,0.00132,0,10241,0,0.000011,14,0.190845,0.216798,551.014164,0.161905,0.000626
9805176,9805176,,15,5,20,15,5,20,0.001004,0.000275,0,7686,13,0.000019,14,0.179784,0.202274,2193.908296,0.134211,0.004476
9811024,9811024,,26,23,49,26,23,49,0.002377,0.002825,0,7836,2,0.000027,14,0.19653,0.228831,35626.601893,0.09949,0.008549
9906162,9906162,,7,23,30,7,23,30,0.000884,0.002127,0,10245,2,0.000013,13,0.201503,0.229623,8511.036887,0.170115,0.001856
9812205,9812205,,30,30,60,30,30,60,0.00104,0.003303,0,9486,10,0.000033,13,0.218189,0.254463,64980.660634,0.058757,0.01027
9911206,9911206,,41,24,65,41,24,65,0.002118,0.00391,0,10244,30,0.000039,12,0.215636,0.240968,114077.189143,0.053846,0.014765
9508001,9508001,,6,3,9,6,3,9,0.000189,0.0008,0,1417,0,0.000018,8,0.215742,0.250331,10.568803,0.25,0.00302
9203018,9203018,,43,0,43,43,0,43,0.005516,0,0,355,1,0.000145,0,0,0,0,0.099668,0.016515
9410046,9410046,,22,15,37,22,15,37,0.002612,0.001572,0,861,13,0.000075,6,0.317416,0.414897,16695.236252,0.08033,0.010858
9611008,9611008,,99,9,108,99,9,108,0.007734,0.002809,0,2987,2,0.000162,13,0.19542,0.225733,31011.789845,0.085237,0.04615
9710119,9710119,,60,15,75,60,15,75,0.004681,0.004161,0,5691,13,0.000081,14,0.185586,0.220566,30351.38516,0.051892,0.020603
9711089,9711089,,18,30,48,18,30,48,0.002925,0.004657,0,6140,0,0.00002,12,0.189646,0.227532,13256.390282,0.10195,0.005728
9807115,9807115,,39,19,58,39,19,58,0.007882,0.012229,0,6675,41,0.000066,12,0.198837,0.227347,39298.457658,0.107078,0.016761
9808100,9808100,,28,66,94,28,66,94,0.004558,0.038832,0,7053,1,0.000029,11,0.217659,0.256733,93400.637826,0.079959,0.009013
9810090,9810090,,22,12,34,22,12,34,0.004297,0.012989,0,7867,1,0.000028,13,0.194431,0.220967,15650.153738,0.163102,0.008582
9902171,9902171,,9,13,22,9,13,22,0.001081,0.001643,0,8849,2,0.000017,15,0.166159,0.193454,12818.58808,0.190476,0.003557
9903143,9903143,,19,27,46,19,27,46,0.003422,0.017465,0,7902,1,0.000021,13,0.188595,0.220673,11617.116208,0.151208,0.006284
9908109,9908109,,25,18,43,25,18,43,0.004454,0.018313,0,10225,1,0.000024,12,0.204253,0.228878,12483.619327,0.158915,0.006962
9910036,9910036,,22,56,78,22,56,78,0.004643,0.02365,0,10227,1,0.000019,11,0.237682,0.273519,97481.695547,0.10989,0.006964
9910110,9910110,,16,32,48,16,32,48,0.002929,0.024917,0,10239,1,0.000018,11,0.231074,0.264684,25557.192872,0.162234,0.004882
9911067,9911067,,10,46,56,10,46,56,0.001143,0.011955,0,10238,0,0.000019,13,0.200172,0.231706,50780.196728,0.062013,0.004915
9911124,9911124,,8,24,32,8,24,32,0.001585,0.019627,0,10231,1,0.000014,11,0.230857,0.261728,62886.756529,0.207661,0.002195
9911169,9911169,,28,40,68,28,40,68,0.003794,0.014482,0,10230,30,0.000026,11,0.243138,0.27699,129701.667228,0.124451,0.011348
1083,1083,,12,64,76,12,64,76,0.000695,0.010453,0,10258,0,0.000016,12,0.226943,0.262904,51793.749793,0.082632,0.003251
9803145,9803145,,24,21,45,24,21,45,0.003579,0.002188,0,6160,0,0.000025,15,0.180744,0.211535,24188.640975,0.135354,0.007878
9805191,9805191,,16,35,51,16,35,51,0.001009,0.023806,0,7758,2,0.000023,14,0.209452,0.245082,21671.799957,0.075686,0.005253
9807067,9807067,,14,32,46,14,32,46,0.000707,0.001493,0,7744,0,0.000016,15,0.197349,0.236935,14369.081582,0.163768,0.003791
9901020,9901020,,15,34,49,15,34,49,0.001228,0.004516,0,8560,0,0.000015,14,0.202994,0.234735,14184.631962,0.125425,0.004082
9901162,9901162,,6,23,29,6,23,29,0.000663,0.004401,0,8561,0,0.000011,14,0.190485,0.219788,1605.769434,0.174877,0.001727
9902202,9902202,,9,10,19,9,10,19,0.001079,0.00042,0,10169,0,0.000013,15,0.184667,0.209502,915.86122,0.239766,0.002543
9903010,9903010,,8,22,30,8,22,30,0.001241,0.004143,0,9092,2,0.000012,14,0.198984,0.228181,9514.384918,0.190805,0.002177
9903113,9903113,,18,44,62,18,44,62,0.002034,0.006526,0,10250,0,0.000021,11,0.224959,0.261153,29424.762297,0.107615,0.004769
9905173,9905173,,5,39,44,5,39,44,0.000887,0.02096,0,10171,0,0.000012,12,0.222405,0.256346,12258.420369,0.115222,0.001453
9906018,9906018,,18,154,172,18,154,172,0.000851,0.022313,0,10253,0,0.000021,15,0.233153,0.28759,145828.192655,0.060384,0.004703
9910115,9910115,,8,26,34,8,26,34,0.000356,0.004052,0,10254,0,0.000017,16,0.205748,0.242516,17007.312568,0.188948,0.002147
9910144,9910144,,7,26,33,7,26,33,0.000618,0.006226,0,10257,0,0.000012,14,0.204485,0.236088,5927.996553,0.178977,0.001882
9912067,9912067,,23,9,32,23,9,32,0.002057,0.002183,0,10255,0,0.000036,17,0.185509,0.212508,35655.29429,0.076613,0.006271
9210076,9210076,,9,0,9,9,0,9,0.000793,0,0,489,0,0.000041,0,0,0,0,0.152778,0.003566
9211083,9211083,,6,0,6,6,0,6,0.000056,0,0,488,9,0.000047,0,0,0,0,0.066667,0.002279
9212099,9212099,,5,2,7,5,2,7,0.000103,0.000039,0,487,13,0.000033,3,0.5,0.611111,43.236638,0.142857,0.001976
9310202,9310202,,48,3,51,48,3,51,0.001893,0.000028,0,233,41,0.000085,3,0.541667,0.602564,1983.558185,0.109412,0.019698
9311010,9311010,,51,3,54,51,3,54,0.002494,0.000009,0,253,41,0.000107,4,0.458333,0.575758,2690.327688,0.089099,0.025474
9205008,9205008,,19,0,19,19,0,19,0.001065,0,0,23,4,0.001241,0,0,0,0,0.076023,0.024464
9407102,9407102,,4,1,5,4,1,5,0.000272,0,0,307,22,0.000048,1,1,1,15863.327315,0,0.002466
9309145,9309145,,158,1,159,158,1,159,0.015678,0.000097,0,338,13,0.001072,1,1,1,2358.435825,0.047488,0.107118
9310118,9310118,,39,1,40,39,1,40,0.001213,0.000001,0,302,13,0.000462,1,1,1,15233.817593,0.044231,0.026385
9405117,9405117,,53,2,55,53,2,55,0.005314,0.000037,0,336,13,0.000402,1,1,1,6194.613592,0.089899,0.042561
9311185,9311185,,14,3,17,14,3,17,0.000572,0.000079,0,267,0,0.00006,3,0.5,0.558824,787.969912,0.150735,0.007447
9411099,9411099,,51,20,71,51,20,71,0.002564,0.000523,0,859,41,0.000077,5,0.373473,0.439953,54642.769828,0.073441,0.023378
9411198,9411198,,27,17,44,27,17,44,0.000984,0.000841,0,1078,3,0.000046,7,0.34258,0.410575,20718.6384,0.089323,0.011862
9503228,9503228,,14,4,18,14,4,18,0.001887,0.003223,0,570,0,0.000116,8,0.245735,0.278784,82752.544476,0.248366,0.012071
9503237,9503237,,4,2,6,4,2,6,0.000183,0.001513,0,520,0,0.000087,8,0.225778,0.252046,3460.130021,0.2,0.003655
9508046,9508046,,3,16,19,3,16,19,0.000376,0.006055,0,1233,0,0.00003,9,0.2326,0.278498,386.964986,0.260234,0.003405
9508033,9508033,,15,4,19,15,4,19,0.000247,0.000013,0,1718,0,0.000068,7,0.218354,0.261663,31962.825346,0.169591,0.008873
9510223,9510223,,13,11,24,13,11,24,0.000214,0.000146,0,1723,0,0.00005,10,0.212913,0.24988,13247.470193,0.172101,0.007699
9502106,9502106,,9,5,14,9,5,14,0.000727,0.000328,0,2845,2,0.000027,5,0.26936,0.321458,589.70854,0.164835,0.004755
9701075,9701075,,8,15,23,8,15,23,0.00106,0.004784,0,4267,2,0.00002,13,0.201975,0.234413,377.30013,0.221344,0.004402
9601179,9601179,,7,17,24,7,17,24,0.000687,0.005598,0,2820,0,0.000063,11,0.217606,0.258285,12549.337006,0.115942,0.003378
9611017,9611017,,12,13,25,12,13,25,0.001234,0.002324,0,4345,0,0.000018,12,0.211133,0.247013,3946.067985,0.193333,0.004927
9611195,9611195,,9,20,29,9,20,29,0.000608,0.005583,0,4941,0,0.000019,12,0.212328,0.249269,45971.403742,0.12931,0.003214
9701142,9701142,,14,25,39,14,25,39,0.001776,0.005421,0,4933,2,0.000016,12,0.203941,0.241401,33573.976583,0.097841,0.004721
9703049,9703049,,13,19,32,13,19,32,0.001305,0.005627,0,4346,0,0.000017,13,0.208281,0.24845,3958.700305,0.164315,0.00507
9703076,9703076,,17,21,38,17,21,38,0.001472,0.00347,0,4347,0,0.000021,14,0.206361,0.246072,9120.925816,0.153627,0.006737
9703206,9703206,,3,51,54,3,51,54,0.000519,0.002217,0,4929,0,0.000011,11,0.22881,0.279389,33952.636195,0.109015,0.001571
9705023,9705023,,9,12,21,9,12,21,0.00106,0.002906,0,4927,2,0.000016,13,0.195231,0.222636,27153.62465,0.088095,0.003679
9605012,9605012,,10,25,35,10,25,35,0.00051,0.001038,0,2491,0,0.000015,12,0.206588,0.255509,543.448445,0.20084,0.003621
9605145,9605145,,14,8,22,14,8,22,0.000664,0.000177,0,4928,0,0.000029,9,0.241549,0.281855,20210.585378,0.073593,0.004229
9611176,9611176,,25,24,49,25,24,49,0.001699,0.003568,0,4586,0,0.000022,11,0.224959,0.264976,10295.773489,0.115646,0.007339
9509017,9509017,,8,29,37,8,29,37,0.000748,0.000862,0,1738,0,0.000014,10,0.238487,0.298855,15470.953876,0.141892,0.003591
9707241,9707241,,18,13,31,18,13,31,0.002443,0.003238,0,5250,0,0.000026,13,0.187413,0.218708,33335.636442,0.191398,0.006339
9802016,9802016,,25,31,56,25,31,56,0.002268,0.00335,0,6159,0,0.000038,14,0.191839,0.223453,75403.695505,0.051299,0.009031
9712241,9712241,,8,24,32,8,24,32,0.00066,0.001757,0,6502,4,0.000021,14,0.192844,0.224383,88417.197364,0.068548,0.003226
9712156,9712156,,6,16,22,6,16,22,0.001327,0.00149,0,6238,0,0.000015,14,0.180763,0.211201,10649.812339,0.112554,0.003605
9708089,9708089,,19,20,39,19,20,39,0.002871,0.006374,0,4700,2,0.000021,11,0.201597,0.234009,57369.426781,0.096491,0.008278
9710124,9710124,,5,28,33,5,28,33,0.001047,0.00701,0,4970,2,0.000013,15,0.193817,0.231543,36469.790904,0.138258,0.002013
9803206,9803206,,17,4,21,17,4,21,0.003207,0.000875,0,6554,1,0.000042,16,0.155338,0.173385,5761.753191,0.066667,0.008135
9307171,9307171,,25,6,31,25,6,31,0.000567,0.000121,0,614,0,0.000067,2,0.8,0.875,6916.893886,0.208602,0.010211
9709061,9709061,,7,17,24,7,17,24,0.00032,0.004142,0,6644,0,0.000014,13,0.191906,0.229402,1458.828004,0.148551,0.002175
9511079,9511079,,11,7,18,11,7,18,0.002227,0.005323,0,1421,0,0.000136,11,0.199146,0.229095,3544.339276,0.176471,0.013481
9511098,9511098,,13,28,41,13,28,41,0.001996,0.010604,0,1440,0,0.000061,10,0.235176,0.285519,9024.43734,0.161585,0.008486
9512028,9512028,,12,2,14,12,2,14,0.001881,0.001764,0,1606,2,0.000032,13,0.162306,0.184146,607.325408,0.137363,0.005815
9602140,9602140,,41,9,50,41,9,50,0.00468,0.002774,0,2108,13,0.000063,10,0.190946,0.227844,3921.898228,0.100408,0.017277
9605023,9605023,,4,29,33,4,29,33,0.001,0.012002,0,5509,0,0.000013,10,0.228001,0.275067,8282.497181,0.202652,0.001946
9612202,9612202,,33,24,57,33,24,57,0.004081,0.008035,0,4563,13,0.00006,10,0.23464,0.277449,29292.620909,0.115288,0.013757
9612254,9612254,,12,1,13,12,1,13,0.003677,0.000448,0,3432,0,0.000016,5,0.315029,0.360703,49.896169,0.153846,0.005445
9703133,9703133,,7,12,19,7,12,19,0.001052,0.006504,0,5734,2,0.000013,13,0.192284,0.218984,21692.333656,0.236842,0.002537
9704030,9704030,,12,25,37,12,25,37,0.001692,0.008412,0,4265,2,0.000018,13,0.200077,0.23422,17827.53049,0.175676,0.00529
9704054,9704054,,37,16,53,37,16,53,0.003352,0.002811,0,4647,0,0.00005,11,0.211052,0.240124,47113.942936,0.167634,0.013352
9704086,9704086,,7,20,27,7,20,27,0.001214,0.004844,0,3732,2,0.000016,13,0.195725,0.222831,15729.649489,0.249288,0.003471
9705014,9705014,,6,17,23,6,17,23,0.000546,0.003317,0,6169,2,0.000015,15,0.185319,0.212312,38843.341301,0.140316,0.002274
9705116,9705116,,38,28,66,38,28,66,0.005135,0.011376,0,4511,2,0.000033,12,0.204368,0.243704,33984.925833,0.1,0.014608
9707205,9707205,,3,45,48,3,45,48,0.000795,0.017458,0,5510,2,0.000013,12,0.209534,0.252579,18717.462044,0.141844,0.001694
9708064,9708064,,19,14,33,19,14,33,0.001418,0.001054,0,4698,0,0.000022,14,0.18357,0.210159,52558.036467,0.233902,0.005796
9708083,9708083,,11,17,28,11,17,28,0.002502,0.005027,0,4329,2,0.000017,14,0.194098,0.223728,4307.176685,0.234127,0.004428
9709015,9709015,,14,35,49,14,35,49,0.002531,0.006959,0,4330,2,0.000024,12,0.205715,0.241622,25846.048437,0.131803,0.006733
9710027,9710027,,8,45,53,8,45,53,0.00187,0.014237,0,5240,2,0.000015,12,0.218166,0.256858,30509.058106,0.160015,0.003789
9710122,9710122,,13,36,49,13,36,49,0.000958,0.005276,0,5573,2,0.000019,12,0.208666,0.249114,91150.03435,0.060374,0.004109
9711040,9711040,,5,32,37,5,32,37,0.000859,0.008664,0,6163,2,0.000013,11,0.223058,0.261668,35934.254105,0.107357,0.002275
9711105,9711105,,5,18,23,5,18,23,0.001623,0.005686,0,6638,2,0.000011,15,0.194427,0.226766,11807.857834,0.152174,0.002148
9712013,9712013,,20,23,43,20,23,43,0.003479,0.005099,0,5291,2,0.000028,13,0.198186,0.22985,19297.799889,0.223145,0.009939
9712155,9712155,,9,19,28,9,19,28,0.001833,0.003431,0,6395,0,0.000016,16,0.188378,0.219652,7700.289263,0.218254,0.00342
9712162,9712162,,15,27,42,15,27,42,0.001267,0.004591,0,6711,2,0.00002,13,0.207819,0.242582,15745.137177,0.108014,0.005392
9801034,9801034,,11,21,32,11,21,32,0.001783,0.006407,0,6814,2,0.000022,15,0.194339,0.224069,9420.200247,0.208669,0.005155
9801132,9801132,,19,109,128,19,109,128,0.003862,0.022679,0,6224,0,0.000028,14,0.239379,0.299888,191987.406382,0.082,0.007382
9801144,9801144,,9,87,96,9,87,96,0.00168,0.016408,0,6222,13,0.000014,13,0.213633,0.273838,52299.602466,0.093421,0.003853
9803004,9803004,,9,50,59,9,50,59,0.002163,0.012369,0,6927,2,0.000013,14,0.208132,0.249572,7379.424516,0.14173,0.003524
9803050,9803050,,11,16,27,11,16,27,0.001653,0.008643,0,6926,2,0.000015,14,0.202733,0.232247,2836.256973,0.115385,0.00376
9803198,9803198,,3,25,28,3,25,28,0.000767,0.006646,0,6924,2,0.000011,15,0.198208,0.230461,348.329893,0.332011,0.001588
9804152,9804152,,3,7,10,3,7,10,0.000686,0.001036,0,6923,2,0.000014,12,0.204683,0.230297,53906.390155,0.1,0.001516
9805180,9805180,,12,15,27,12,15,27,0.001192,0.003222,0,6894,13,0.000016,11,0.189141,0.220112,7683.391678,0.111111,0.004068
9806018,9806018,,25,15,40,25,15,40,0.004793,0.004899,0,6407,2,0.000028,14,0.182932,0.209184,2009.927541,0.235256,0.010283
9806066,9806066,,22,21,43,22,21,43,0.004134,0.011012,0,6410,2,0.000024,13,0.207945,0.238964,18145.977157,0.256921,0.00879
9806126,9806126,,6,36,42,6,36,42,0.000789,0.004098,0,6904,0,0.000012,14,0.209543,0.241279,85507.262246,0.175377,0.00212
9806169,9806169,,30,45,75,30,45,75,0.002393,0.007572,0,6893,2,0.000024,13,0.203475,0.239742,52356.938332,0.078919,0.009261
9807006,9807006,,5,16,21,5,16,21,0.000715,0.003196,0,6872,13,0.000016,13,0.178656,0.20529,1824.902084,0.135714,0.002535
9807135,9807135,,11,28,39,11,28,39,0.001954,0.027669,0,6867,0,0.000019,13,0.218778,0.255598,39813.60919,0.1417,0.004016
9807199,9807199,,12,23,35,12,23,35,0.001575,0.002974,0,6813,0,0.000016,14,0.19004,0.221921,24991.123985,0.173109,0.003889
9808128,9808128,,13,9,22,13,9,22,0.001452,0.002616,0,6809,2,0.000024,15,0.184473,0.211017,732.067828,0.188312,0.005429
9710198,9710198,,10,66,76,10,66,76,0.000448,0.012413,0,6103,0,0.000017,11,0.244419,0.296173,56999.683953,0.083333,0.003184
9807124,9807124,,28,84,112,28,84,112,0.001128,0.006929,0,7747,0,0.000028,12,0.218257,0.262403,115389.10681,0.079794,0.0091
9808024,9808024,,13,29,42,13,29,42,0.000874,0.005361,0,7745,0,0.000015,16,0.18226,0.222626,3911.858966,0.212544,0.003382
9808131,9808131,,17,21,38,17,21,38,0.001185,0.001976,0,7743,0,0.000025,15,0.180168,0.212223,20208.318501,0.125889,0.006515
9808169,9808169,,19,39,58,19,39,58,0.000956,0.003845,0,7721,9,0.000016,12,0.213517,0.245525,108084.789877,0.188143,0.005642
9811198,9811198,,5,16,21,5,16,21,0.000274,0.00424,0,7739,4,0.000025,13,0.188134,0.220481,66949.79619,0.083333,0.001436
9712079,9712079,,4,12,16,4,12,16,0.000901,0.001845,0,6879,2,0.000012,12,0.20096,0.228923,1307.762639,0.175,0.001938
9511228,9511228,,14,38,52,14,38,52,0.000995,0.008806,0,1619,0,0.000033,13,0.227393,0.289085,15327.471102,0.118778,0.006217
9508078,9508078,,23,16,39,23,16,39,0.00184,0.000468,0,1399,0,0.00003,9,0.248218,0.291034,26743.886107,0.091093,0.009481
9703195,9703195,,7,31,38,7,31,38,0.000341,0.007221,0,4588,0,0.000014,11,0.214886,0.256182,7623.918446,0.186344,0.002167
9805083,9805083,,14,16,30,14,16,30,0.001838,0.001495,0,6874,2,0.000026,14,0.197166,0.230432,50493.54804,0.057471,0.005887
9812154,9812154,,2,24,26,2,24,26,0.000508,0.00415,0,10170,0,0.00001,14,0.196217,0.224618,68.842077,0.203077,0.000603
9607184,9607184,,17,45,62,17,45,62,0.002858,0.011362,0,2337,0,0.00002,9,0.240396,0.287665,11349.487368,0.182708,0.006585
9806123,9806123,,1,112,113,1,112,113,0.000262,0.034597,0,10252,0,0.00001,13,0.244324,0.296333,7096.270731,0.069769,0.000346
9901117,9901117,,7,40,47,7,40,47,0.000574,0.006089,0,8604,0,0.000012,16,0.187582,0.231885,2986.550973,0.190102,0.001751
9903124,9903124,,25,81,106,25,81,106,0.003375,0.032274,0,7727,0,0.000023,16,0.227358,0.270153,95300.082012,0.067385,0.008221
9903232,9903232,,4,22,26,4,22,26,0.000522,0.00229,0,10249,0,0.000011,14,0.205999,0.234574,3601.470271,0.169231,0.001124
9905209,9905209,,9,20,29,9,20,29,0.001688,0.01893,0,10172,1,0.000013,11,0.231648,0.26329,22780.300151,0.17734,0.002597
9908035,9908035,,8,21,29,8,21,29,0.001676,0.006983,0,10173,1,0.000013,11,0.23339,0.266266,11623.39531,0.176108,0.002235
9601048,9601048,,4,2,6,4,2,6,0.000074,0,0,9273,28,0.00002,3,0.545455,0.638889,502.736545,0.033333,0.001037
9607193,9607193,,8,16,24,8,16,24,0.000456,0.006461,0,4344,0,0.000015,10,0.222269,0.263487,1764.326619,0.164855,0.002476
9907133,9907133,,8,58,66,8,58,66,0.000432,0.006171,0,10256,0,0.000014,14,0.216868,0.255625,48805.723153,0.078089,0.002241
1084,1084,,91,8,99,91,8,99,0.003965,0.000614,0,10260,3,0.000116,13,0.182134,0.201294,13740.502288,0.141002,0.050129
9912120,9912120,,22,4,26,22,4,26,0.00058,0.000117,0,9909,3,0.00005,13,0.13762,0.154864,20596.414175,0.209231,0.013482
9912121,9912121,,33,11,44,33,11,44,0.001233,0.005942,0,10259,3,0.00006,14,0.18547,0.212714,54100.110386,0.134249,0.019337
9912255,9912255,,19,9,28,19,9,28,0.000549,0.003357,0,9910,3,0.000044,12,0.196631,0.215976,15440.405081,0.116402,0.007422
9812153,9812153,,3,5,8,3,5,8,0.000003,0.000126,0,9908,2,0.000022,12,0.157728,0.177563,14344.978657,0.232143,0.000918
9202087,9202087,,5,0,5,5,0,5,0.000093,0,0,79,3,0.000052,0,0,0,0,0.1,0.002144
9607070,9607070,,53,7,60,53,7,60,0.002084,0.003077,0,3348,2,0.000126,11,0.206784,0.241712,38608.308745,0.071751,0.019192
9706223,9706223,,3,19,22,3,19,22,0.000113,0.000254,0,6716,28,0.000019,13,0.189052,0.222687,49519.327805,0.123377,0.001147
1085,1085,,8,12,20,8,12,20,0.000053,0.001776,0,10270,8,0.000035,11,0.227828,0.257684,94964.042121,0.123684,0.00234
9303103,9303103,,25,0,25,25,0,25,0.000102,0,0,381,5,0.000223,0,0,0,0,0.046667,0.007337
9506121,9506121,,13,1,14,13,1,14,0.000056,0.000001,0,8523,8,0.000097,1,1,1,13.299109,0.186813,0.004083
9601064,9601064,,5,11,16,5,11,16,0.000025,0.000411,0,10265,5,0.000033,7,0.287184,0.322204,15250.644749,0.091667,0.001308
9601073,9601073,,21,2,23,21,2,23,0.000165,0.000002,0,10261,8,0.000069,1,1,1,409.982986,0.166008,0.006406
9709166,9709166,,6,3,9,6,3,9,0.000047,0.000003,0,10266,8,0.000027,8,0.223837,0.241166,157.939047,0.333333,0.001519
9709206,9709206,,5,63,68,5,63,68,0.000916,0.011401,0,5104,13,0.000016,13,0.203416,0.248042,8692.873192,0.154083,0.002336
9710075,9710075,,10,5,15,10,5,15,0.000116,0.000004,0,10267,8,0.000039,13,0.168223,0.190681,17518.792221,0.2,0.003521
9806203,9806203,,3,6,9,3,6,9,0.000022,0.000054,0,10269,8,0.000014,13,0.165382,0.185917,566.341964,0.222222,0.000783
9807063,9807063,,10,5,15,10,5,15,0.000069,0.000021,0,8524,15,0.000021,17,0.153816,0.170451,6386.738613,0.161905,0.002418
9908099,9908099,,4,6,10,4,6,10,0.000043,0.000171,0,10268,8,0.000027,13,0.198943,0.228236,31050.437918,0.211111,0.000963
9307168,9307168,,67,0,67,67,0,67,0.00576,0,0,374,5,0.000301,0,0,0,0,0.021257,0.024151
9408039,9408039,,13,23,36,13,23,36,0.000559,0.000344,0,996,5,0.000037,6,0.40708,0.500242,106506.982593,0.084921,0.003765
9502074,9502074,,27,7,34,27,7,34,0.00143,0.000337,0,1013,5,0.000078,7,0.325397,0.38223,91498.449876,0.053476,0.012533
9507035,9507035,,3,8,11,3,8,11,0.000287,0.000278,0,7432,5,0.000014,7,0.293073,0.351025,2200.266797,0.209091,0.000937
9509104,9509104,,3,8,11,3,8,11,0.000005,0.000054,0,10264,5,0.000023,6,0.30285,0.350131,4496.190716,0.090909,0.000693
9510026,9510026,,4,2,6,4,2,6,0.000489,0.000002,0,10262,5,0.000016,1,1,1,745.454464,0.1,0.001249
9510156,9510156,,8,8,16,8,8,16,0.000037,0.00021,0,4591,5,0.00002,7,0.293497,0.350556,2232.536002,0.1875,0.002384
9409104,9409104,,8,5,13,8,5,13,0.000004,0.000014,0,2564,23,0.000049,5,0.375,0.459829,10304.63862,0.192308,0.002672
9505173,9505173,,37,9,46,37,9,46,0.000367,0.000014,0,2569,23,0.000092,5,0.401575,0.500327,37269.246602,0.096618,0.010719
9609053,9609053,,14,33,47,14,33,47,0.001742,0.007229,0,2726,13,0.000032,11,0.233196,0.276101,66763.495408,0.153099,0.007379
9611189,9611189,,15,27,42,15,27,42,0.001329,0.0058,0,3738,13,0.000024,11,0.221846,0.263207,4280.011987,0.20151,0.005228
9612234,9612234,,8,8,16,8,8,16,0.000552,0.006407,0,3312,2,0.000047,12,0.202019,0.234253,5839.405842,0.158333,0.004309
9704134,9704134,,26,27,53,26,27,53,0.004289,0.008094,0,4512,2,0.000034,14,0.201058,0.238541,17190.804377,0.130261,0.012214
9705165,9705165,,9,27,36,9,27,36,0.001354,0.005589,0,4986,13,0.00002,14,0.200562,0.237757,27381.212686,0.238889,0.00382
9707157,9707157,,6,23,29,6,23,29,0.000859,0.003381,0,5102,13,0.000012,12,0.19694,0.22625,3268.111979,0.32266,0.002178
9707170,9707170,,36,10,46,36,10,46,0.005465,0.001923,0,5101,13,0.000044,13,0.191189,0.221006,19330.477192,0.096618,0.013031
9709160,9709160,,13,60,73,13,60,73,0.001877,0.016162,0,5012,13,0.000016,12,0.215871,0.259013,27584.369694,0.135084,0.004734
9705017,9705017,,5,11,16,5,11,16,0.000024,0.002358,0,5264,13,0.000025,12,0.191555,0.223995,10402.85868,0.116667,0.001276
9506138,9506138,,34,13,47,34,13,47,0.004178,0.001368,0,1020,5,0.000105,8,0.275806,0.348719,68859.430618,0.065217,0.017199
9706213,9706213,,6,9,15,6,9,15,0.000162,0.000024,0,7715,15,0.000021,17,0.154761,0.173892,17997.111242,0.252381,0.001745
1086,1086,,3,2,5,3,2,5,0,0.000001,0,10271,5,0.000015,17,0.122048,0.134683,1,0.3,0.000658
9709182,9709182,,7,2,9,7,2,9,0.000017,0.00002,0,9222,5,0.000035,1,1,1,2872.108286,0.027778,0.001969
1087,1087,,0,2,2,0,2,2,0,0.000001,0,10275,23,0.00001,2,0.75,0.833333,0,0,0
9906072,9906072,,8,0,8,8,0,8,0.000042,0,0,10274,23,0.000025,0,0,0,0,0.107143,0.001852
9907217,9907217,,8,1,9,8,1,9,0.000009,0,0,10273,23,0.000034,1,1,1,14.25,0.083333,0.001899
9401083,9401083,,5,0,5,5,0,5,0.000001,0,0,10272,23,0.000053,0,0,0,0,0.2,0.001211
1088,1088,,2,1,3,2,1,3,0.000051,0.000068,0,10276,9,0.000012,14,0.176386,0.194324,2666.870086,0,0.000514
9601043,9601043,,6,6,12,6,6,12,0.000477,0.000036,0,3018,17,0.000023,8,0.240047,0.296556,146548.762663,0.068182,0.003203
1089,1089,,16,27,43,16,27,43,0.00098,0.006782,0,10280,30,0.000021,12,0.214972,0.239748,39206.293134,0.110188,0.006331
9709054,9709054,,33,22,55,33,22,55,0.001993,0.006945,0,5618,2,0.000069,16,0.207095,0.243561,36839.659683,0.075421,0.016788
9712199,9712199,,25,16,41,25,16,41,0.001904,0.003749,0,5619,30,0.000056,14,0.199044,0.23117,16307.478206,0.110976,0.013857
9903166,9903166,,10,37,47,10,37,47,0.000845,0.017842,0,10279,41,0.000021,13,0.199894,0.230928,81021.239967,0.101295,0.0033
9309143,9309143,,26,2,28,26,2,28,0.001769,0.000103,0,1021,2,0.000121,2,0.75,0.833333,263.596576,0.095238,0.016217
9703204,9703204,,23,41,64,23,41,64,0.003751,0.01364,0,3509,13,0.000028,12,0.218801,0.259084,19327.364873,0.162946,0.010516
9707184,9707184,,22,3,25,22,3,25,0.000895,0.000054,0,4953,2,0.000033,14,0.160386,0.177468,9492.445246,0.095,0.007226
9702205,9702205,,27,17,44,27,17,44,0.003791,0.002595,0,3430,13,0.000032,13,0.202507,0.235835,10963.109376,0.179175,0.011716
9703041,9703041,,35,23,58,35,23,58,0.004658,0.007559,0,3508,13,0.000038,11,0.222807,0.260974,51853.907906,0.132486,0.014423
9704143,9704143,,45,30,75,45,30,75,0.005311,0.007673,0,3531,13,0.000044,11,0.21524,0.257483,27651.787661,0.100721,0.016101
9701188,9701188,,5,20,25,5,20,25,0.000327,0.007132,0,4299,2,0.000022,11,0.226618,0.260656,4165.698857,0.165,0.002404
9203040,9203040,,4,0,4,4,0,4,0.00021,0,0,6045,41,0.000024,0,0,0,0,0.083333,0.001071
9211103,9211103,,16,0,16,16,0,16,0.001468,0,0,6897,41,0.000026,0,0,0,0,0.2625,0.004487
9211104,9211104,,17,0,17,17,0,17,0.001526,0,0,6043,41,0.000029,0,0,0,0,0.283088,0.004834
9301061,9301061,,7,1,8,7,1,8,0.001157,0,0,5479,41,0.000013,1,1,1,2438.416308,0.196429,0.001858
9508036,9508036,,15,5,20,15,5,20,0.00115,0.00002,0,6046,41,0.000028,2,0.857143,0.916667,29321.555615,0.178947,0.004044
9511047,9511047,,18,6,24,18,6,24,0.001547,0.00005,0,6898,41,0.00003,4,0.487179,0.600877,19418.442887,0.17029,0.004825
9607122,9607122,,5,3,8,5,3,8,0.000717,0,0,10278,41,0.000021,5,0.277628,0.31699,11508.083809,0.107143,0.001441
9609010,9609010,,10,0,10,10,0,10,0.001093,0,0,6901,41,0.000016,0,0,0,0,0.244444,0.002634
9703149,9703149,,12,2,14,12,2,14,0.001149,0.000001,0,6900,41,0.000017,6,0.276316,0.349206,9828.217993,0.208791,0.003216
9805108,9805108,,26,10,36,26,10,36,0.001495,0.000039,0,9365,17,0.000058,5,0.411111,0.546396,12070.006657,0.12619,0.006865
9806241,9806241,,14,6,20,14,6,20,0.001227,0.000022,0,9366,17,0.000024,6,0.336134,0.44,4090.950843,0.15,0.003823
9808191,9808191,,14,16,30,14,16,30,0.00132,0.020991,0,9369,41,0.000024,14,0.194129,0.221296,39657.179659,0.122989,0.004352
9909059,9909059,,20,21,41,20,21,41,0.002816,0.020041,0,9525,30,0.000023,13,0.201626,0.225465,6327.509721,0.182317,0.008781
9909085,9909085,,32,20,52,32,20,52,0.005057,0.020217,0,9524,30,0.000031,13,0.20116,0.224722,42985.680664,0.149321,0.01371
1090,1090,,4,10,14,4,10,14,0.000031,0.000043,0,10286,5,0.000012,8,0.251377,0.308118,30.432184,0.258242,0.000896
9206070,9206070,,125,1,126,125,1,126,0.001407,0.00001,0,64,5,0.000366,1,1,1,474.142889,0.024889,0.036308
9209012,9209012,,88,4,92,88,4,92,0.000599,0.000029,0,377,5,0.000215,1,1,1,1429.254201,0.033923,0.026084
9211011,9211011,,27,4,31,27,4,31,0.000352,0.000021,0,425,5,0.000094,1,1,1,521.116573,0.05914,0.008582
9409179,9409179,,12,23,35,12,23,35,0.000125,0.000114,0,1960,5,0.000023,4,0.520833,0.68,3548.597601,0.084874,0.003115
9502084,9502084,,1,13,14,1,13,14,0.000001,0.00007,0,10285,5,0.000011,6,0.392157,0.485625,38.278608,0.115385,0.000245
9506206,9506206,,21,32,53,21,32,53,0.000349,0.000469,0,4599,5,0.000032,6,0.34609,0.451202,12202.131314,0.089623,0.005546
9804089,9804089,,9,9,18,9,9,18,0.000276,0.000076,0,10282,5,0.000016,7,0.279302,0.339233,663.035903,0.238562,0.002267
9904184,9904184,,7,9,16,7,9,16,0.000263,0.000044,0,10283,5,0.000014,7,0.273282,0.323943,1521.083876,0.266667,0.001767
9911077,9911077,,1,9,10,1,9,10,0.000001,0.000057,0,10284,5,0.000011,8,0.250698,0.307445,23.152381,0.311111,0.000245
9201061,9201061,,112,0,112,112,0,112,0.000861,0,0,63,5,0.001448,0,0,0,0,0.032336,0.037447
9203042,9203042,,41,0,41,41,0,41,0.000208,0,0,100,5,0.000185,0,0,0,0,0.04939,0.014212
9203052,9203052,,51,0,51,51,0,51,0.00063,0,0,99,5,0.000264,0,0,0,0,0.037255,0.016872
9203054,9203054,,46,0,46,46,0,46,0.000105,0,0,98,5,0.000212,0,0,0,0,0.027536,0.014566
9204090,9204090,,29,0,29,29,0,29,0.00151,0,0,68,5,0.000636,0,0,0,0,0.052956,0.009206
9308034,9308034,,11,3,14,11,3,14,0.000015,0.00002,0,1649,5,0.000029,1,1,1,33340.686515,0.049451,0.002946
9312194,9312194,,11,11,22,11,11,22,0.000181,0.000234,0,387,5,0.00003,4,0.507246,0.616667,19051.729785,0.145022,0.003451
9401076,9401076,,4,0,4,4,0,4,0.000007,0,0,1634,5,0.000023,0,0,0,0,0,0.001275
9401159,9401159,,30,0,30,30,0,30,0.000232,0,0,371,5,0.000113,0,0,0,0,0.090805,0.009119
9403108,9403108,,31,7,38,31,7,38,0.000802,0.000245,0,390,5,0.000072,4,0.413793,0.484375,11404.320763,0.085349,0.009938
9403137,9403137,,30,32,62,30,32,62,0.00158,0.000824,0,432,5,0.000055,6,0.392157,0.526944,104555.35842,0.069011,0.010451
9405162,9405162,,17,16,33,17,16,33,0.000233,0.000278,0,1645,5,0.000033,5,0.373938,0.456944,19284.805638,0.090909,0.005212
9201074,9201074,,79,0,79,79,0,79,0.000926,0,0,66,5,0.000334,0,0,0,0,0.035054,0.024971
9205028,9205028,,33,0,33,33,0,33,0.000053,0,0,93,5,0.000108,0,0,0,0,0.03125,0.010355
9205069,9205069,,72,0,72,72,0,72,0.000812,0,0,92,5,0.000178,0,0,0,0,0.035603,0.022604
9205089,9205089,,88,0,88,88,0,88,0.001022,0,0,91,5,0.000179,0,0,0,0,0.033438,0.027085
9206020,9206020,,43,0,43,43,0,43,0.00039,0,0,90,5,0.00011,0,0,0,0,0.047619,0.014333
9206071,9206071,,21,0,21,21,0,21,0.000028,0,0,89,5,0.000041,0,0,0,0,0.064286,0.005334
9207006,9207006,,24,0,24,24,0,24,0.000276,0,0,87,5,0.000055,0,0,0,0,0.018116,0.006336
9207034,9207034,,25,1,26,25,1,26,0.000302,0.00001,0,86,5,0.000086,1,1,1,85.335785,0.066154,0.009244
9207095,9207095,,54,0,54,54,0,54,0.000198,0,0,84,5,0.000178,0,0,0,0,0.027952,0.016423
9209008,9209008,,37,2,39,37,2,39,0.000169,0.000018,0,378,5,0.000117,1,1,1,50.204631,0.079622,0.012279
9211135,9211135,,16,8,24,16,8,24,0.000034,0.000051,0,422,5,0.00002,1,1,1,134.280185,0.112319,0.003974
9302022,9302022,,31,1,32,31,1,32,0.000251,0.000001,0,386,5,0.000072,1,1,1,1854.527394,0.045363,0.009575
9303014,9303014,,15,8,23,15,8,23,0.000019,0.000058,0,992,5,0.00003,1,1,1,6476.077676,0.094862,0.003985
9304148,9304148,,20,14,34,20,14,34,0.000085,0.00009,0,383,5,0.000033,1,1,1,340.311331,0.158645,0.006055
9310155,9310155,,6,7,13,6,7,13,0.000015,0.000053,0,993,5,0.000014,2,0.705882,0.791667,153.022312,0.185897,0.001593
9211095,9211095,,11,1,12,11,1,12,0.000423,0.00001,0,2609,5,0.00002,1,1,1,11.475329,0.181818,0.003151
9212136,9212136,,12,15,27,12,15,27,0.00009,0.000078,0,419,5,0.000021,3,0.659091,0.752874,361.879704,0.126781,0.003214
9305125,9305125,,15,14,29,15,14,29,0.00027,0.000036,0,1010,5,0.000023,3,0.603175,0.679825,5873.528114,0.097291,0.003857
9311007,9311007,,22,7,29,22,7,29,0.000606,0.000034,0,389,5,0.000052,2,0.62069,0.694444,7326.125745,0.064039,0.007082
9405084,9405084,,10,13,23,10,13,23,0.000034,0.000115,0,987,5,0.000022,4,0.43662,0.530914,4785.827284,0.144269,0.003257
9407039,9407039,,5,7,12,5,7,12,0.000033,0.000057,0,2638,5,0.000016,5,0.444444,0.639583,655.170307,0.090909,0.00152
9204026,9204026,,21,0,21,21,0,21,0.000449,0,0,95,5,0.000088,0,0,0,0,0.016667,0.005718
9209055,9209055,,36,21,57,36,21,57,0.000165,0.000113,0,102,5,0.000214,1,1,1,108008.524483,0.036967,0.010745
9209113,9209113,,13,17,30,13,17,30,0.000038,0.000106,0,408,5,0.000031,2,0.904762,0.947368,1350.992967,0.12069,0.004085
9310150,9310150,,10,7,17,10,7,17,0.000499,0.000028,0,4598,5,0.000017,3,0.539683,0.593137,592.721093,0.128676,0.002805
9408066,9408066,,21,7,28,21,7,28,0.000127,0.000013,0,1663,5,0.000047,2,0.733333,0.818182,31857.679897,0.175926,0.006465
9408068,9408068,,18,6,24,18,6,24,0.000116,0.000061,0,1635,5,0.000032,5,0.3125,0.387,7064.576532,0.173913,0.005336
9412020,9412020,,26,4,30,26,4,30,0.000178,0.000156,0,1668,5,0.000043,4,0.390805,0.448529,2613.373838,0.187356,0.007779
9412027,9412027,,12,10,22,12,10,22,0.000073,0.000198,0,1651,5,0.000027,7,0.27116,0.325351,1458.07708,0.201299,0.003564
9502006,9502006,,14,8,22,14,8,22,0.000119,0.000184,0,1670,5,0.000024,7,0.275116,0.326512,5557.129605,0.179654,0.003889
9502155,9502155,,11,9,20,11,9,20,0.000063,0.000214,0,4052,5,0.000023,7,0.31291,0.373959,2935.55005,0.160526,0.003038
9503016,9503016,,35,16,51,35,16,51,0.00124,0.000403,0,1664,5,0.000066,7,0.290226,0.361066,150741.233039,0.109804,0.011145
9504022,9504022,,14,13,27,14,13,27,0.000103,0.000205,0,1671,5,0.000029,7,0.272603,0.33703,20465.181079,0.235043,0.004254
9506066,9506066,,14,11,25,14,11,25,0.000173,0.000212,0,4053,5,0.000025,8,0.26615,0.321746,31695.666524,0.213333,0.004372
9501127,9501127,,25,15,40,25,15,40,0.000549,0.000393,0,1667,5,0.000051,6,0.331096,0.411486,25906.411456,0.087179,0.006971
9602105,9602105,,26,21,47,26,21,47,0.00097,0.000299,0,4613,5,0.000038,7,0.327893,0.415966,39879.651348,0.069843,0.007121
9802117,9802117,,5,4,9,5,4,9,0.000008,0.00008,0,10281,5,0.000014,7,0.261519,0.307256,48.418934,0.236111,0.001258
9502098,9502098,,26,19,45,26,19,45,0.000693,0.000396,0,6242,5,0.000034,5,0.40113,0.535681,11778.710309,0.090909,0.007166
9607155,9607155,,6,9,15,6,9,15,0.000028,0.000082,0,6520,5,0.000017,6,0.319908,0.371343,3547.954144,0.17619,0.001626
9512187,9512187,,10,14,24,10,14,24,0.000242,0.000078,0,6247,5,0.000017,7,0.25514,0.313841,11658.549572,0.128623,0.002452
1091,1091,,1,4,5,1,4,5,0.000023,0.000004,0,10288,6,0.000011,8,0.20073,0.235554,26.135592,0.2,0.000219
9201067,9201067,,73,0,73,73,0,73,0.0002,0,0,1457,6,0.000284,0,0,0,0,0.05156,0.020744
9202069,9202069,,14,0,14,14,0,14,0.000063,0,0,2381,6,0.00011,0,0,0,0,0.098901,0.00474
9503079,9503079,,13,13,26,13,13,26,0.000025,0.00084,0,2389,6,0.000024,7,0.238691,0.299741,25661.369479,0.126154,0.003373
9909042,9909042,,2,3,5,2,3,5,0.000055,0.000002,0,10287,6,0.000012,4,0.388889,0.449405,64.576923,0.05,0.000451
9203076,9203076,,42,0,42,42,0,42,0.000045,0,0,2341,6,0.000153,0,0,0,0,0.106852,0.012372
9207015,9207015,,8,0,8,8,0,8,0.00001,0,0,2344,6,0.000068,0,0,0,0,0.160714,0.002399
9209024,9209024,,18,0,18,18,0,18,0.000019,0,0,2363,6,0.000039,0,0,0,0,0.199346,0.005556
9304065,9304065,,51,3,54,51,3,54,0.000105,0.000003,0,2357,6,0.000169,1,1,1,10961.26288,0.083508,0.015415
9305042,9305042,,12,3,15,12,3,15,0.000012,0.000003,0,2388,6,0.000031,1,1,1,1064.984506,0.128571,0.003329
9403162,9403162,,3,1,4,3,1,4,0.00001,0.000002,0,2387,6,0.000019,2,0.571429,0.625,15.5,0,0.000789
9405030,9405030,,18,4,22,18,4,22,0.00002,0.000001,0,2375,6,0.000064,3,0.533333,0.6875,15005.135549,0.093074,0.004789
9406197,9406197,,4,1,5,4,1,5,0.00001,0.000002,0,2384,6,0.000015,1,1,1,0,0.45,0.001324
9411176,9411176,,17,20,37,17,20,37,0.000035,0.000621,0,2382,6,0.00003,6,0.322148,0.419213,67750.51806,0.125375,0.00498
9501136,9501136,,20,14,34,20,14,34,0.000022,0.000009,0,2386,6,0.000028,7,0.259649,0.341409,17857.156672,0.130125,0.005668
9401066,9401066,,10,0,10,10,0,10,0.000077,0,0,2483,6,0.000033,0,0,0,0,0.077778,0.002635
9404013,9404013,,27,1,28,27,1,28,0.00005,0,0,1877,6,0.000142,1,1,1,14521.050574,0.035714,0.006786
9506023,9506023,,16,9,25,16,9,25,0.000001,0.000009,0,2482,6,0.000042,3,0.565217,0.653846,82211.322255,0.05,0.003789
1092,1092,,43,11,54,43,11,54,0.002297,0.002528,0,10289,25,0.000048,11,0.192057,0.210756,2989.440609,0.113557,0.013566
1093,1093,,2,30,32,2,30,32,0.000075,0.007364,0,10290,0,0.000011,12,0.226764,0.258307,3091.212968,0.134073,0.000482
9910090,9910090,,11,24,35,11,24,35,0.000769,0.003367,0,10151,0,0.000014,12,0.210898,0.240857,24706.753294,0.108403,0.003444
9204012,9204012,,51,0,51,51,0,51,0.00104,0,0,326,0,0.000142,0,0,0,0,0.052549,0.017081
9306048,9306048,,13,1,14,13,1,14,0.000327,0.000094,0,858,3,0.000058,1,1,1,76.851943,0.192308,0.006064
9401069,9401069,,40,1,41,40,1,41,0.001482,0.000062,0,1148,0,0.000129,1,1,1,190.266581,0.037805,0.014418
9203025,9203025,,23,0,23,23,0,23,0.000681,0,0,1701,0,0.000053,0,0,0,0,0.110672,0.007742
9205094,9205094,,15,1,16,15,1,16,0.000365,0.000062,0,613,0,0.000083,1,1,1,4.209268,0.341667,0.006461
9208024,9208024,,28,0,28,28,0,28,0.000752,0,0,1622,0,0.000072,0,0,0,0,0.132275,0.00896
9209020,9209020,,6,1,7,6,1,7,0.000091,0.000062,0,1722,0,0.000022,1,1,1,0.1,0.285714,0.002491
9307002,9307002,,3,3,6,3,3,6,0.000078,0.000081,0,1741,0,0.000013,1,1,1,0.540909,0.333333,0.001567
9410206,9410206,,34,6,40,34,6,40,0.000647,0.000103,0,973,0,0.000082,6,0.261411,0.316005,12148.059128,0.138462,0.011955
9412196,9412196,,8,9,17,8,9,17,0.000216,0.000176,0,1322,0,0.000021,6,0.27383,0.333755,717.901858,0.169118,0.003569
9506006,9506006,,15,2,17,15,2,17,0.00028,0.00001,0,1716,0,0.000046,1,1,1,2967.985602,0.139706,0.005102
9506178,9506178,,12,13,25,12,13,25,0.000515,0.000191,0,1712,0,0.00002,9,0.21989,0.260676,13528.04034,0.251667,0.005303
9508073,9508073,,14,6,20,14,6,20,0.000206,0.00009,0,1719,0,0.000029,10,0.214037,0.247282,1321.78629,0.231579,0.004633
9508178,9508178,,2,2,4,2,2,4,0.000025,0.000066,0,1739,0,0.000013,1,1,1,0,0.5,0.001116
9510094,9510094,,8,8,16,8,8,16,0.000197,0.000108,0,1720,0,0.000021,10,0.20512,0.24161,1270.596371,0.2625,0.003728
9510241,9510241,,26,19,45,26,19,45,0.000828,0.000281,0,1735,0,0.000034,14,0.212944,0.258177,69804.239182,0.095455,0.008039
9512156,9512156,,6,9,15,6,9,15,0.000244,0.000102,0,1736,0,0.000015,15,0.185353,0.218126,3794.039072,0.17619,0.002566
9602032,9602032,,17,11,28,17,11,28,0.000317,0.00033,0,1721,0,0.000033,10,0.199817,0.229714,8447.097048,0.169312,0.006189
9601175,9601175,,8,8,16,8,8,16,0.000528,0.002443,0,2457,0,0.000043,11,0.211423,0.242292,1681.362814,0.125,0.00571
9506169,9506169,,21,29,50,21,29,50,0.000085,0.000014,0,2428,6,0.000034,8,0.247699,0.338125,726179.759612,0.112653,0.006218
9307122,9307122,,7,2,9,7,2,9,0.000383,0.000023,0,898,2,0.000191,1,1,1,15753.980024,0.152778,0.004432
9605174,9605174,,5,20,25,5,20,25,0.000303,0.006563,0,3621,13,0.000016,10,0.226003,0.260981,2377.584409,0.17,0.001596
9606196,9606196,,3,18,21,3,18,21,0.000317,0.009862,0,3268,0,0.000013,12,0.217391,0.257107,7560.240767,0.188095,0.001299
9610250,9610250,,18,20,38,18,20,38,0.002282,0.006609,0,3264,2,0.000072,12,0.216276,0.25502,48158.493637,0.133713,0.011375
9512042,9512042,,24,10,34,24,10,34,0.00312,0.004139,0,1532,2,0.000128,10,0.212956,0.245044,3856.264048,0.106952,0.015751
9612192,9612192,,12,90,102,12,90,102,0.002772,0.020792,0,3620,0,0.000019,11,0.258714,0.315869,133997.636717,0.104834,0.005178
9512223,9512223,,17,4,21,17,4,21,0.001018,0.000103,0,3640,4,0.000094,7,0.227343,0.27101,79794.341897,0.078571,0.006269
9705054,9705054,,25,16,41,25,16,41,0.003114,0.006815,0,4510,13,0.000028,12,0.21489,0.252274,10819.105607,0.142073,0.010213
9711031,9711031,,7,28,35,7,28,35,0.001689,0.005153,0,5290,2,0.000016,13,0.200025,0.232222,1728.101931,0.239496,0.004521
9711046,9711046,,10,16,26,10,16,26,0.001532,0.004242,0,5310,2,0.000016,13,0.196188,0.226186,1826.148272,0.227692,0.004823
9711078,9711078,,88,41,129,88,41,129,0.011324,0.007282,0,5309,2,0.000082,13,0.207503,0.243768,93073.948725,0.067648,0.036593
9712012,9712012,,3,40,43,3,40,43,0.001353,0.009742,0,5226,2,0.000012,15,0.195846,0.234643,10596.515242,0.173865,0.003193
9712105,9712105,,41,16,57,41,16,57,0.004194,0.005761,0,5331,2,0.000035,14,0.189673,0.218582,8436.452281,0.097431,0.014797
9712159,9712159,,15,27,42,15,27,42,0.003071,0.005736,0,5311,2,0.000021,13,0.201358,0.233449,3360.564907,0.237515,0.010422
9712238,9712238,,14,16,30,14,16,30,0.002114,0.008989,0,5611,2,0.000022,14,0.189961,0.216716,8795.20523,0.217241,0.006115
9801120,9801120,,14,38,52,14,38,52,0.003342,0.013919,0,5609,2,0.000016,13,0.209246,0.244486,14587.760016,0.165535,0.006227
9603156,9603156,,26,7,33,26,7,33,0.002326,0.003788,0,3762,9,0.000027,10,0.206879,0.234004,4813.805718,0.174242,0.009768
9605168,9605168,,22,10,32,22,10,32,0.001717,0.001793,0,2749,9,0.000027,10,0.216975,0.244918,57146.770815,0.167339,0.009358
9703136,9703136,,24,71,95,24,71,95,0.002739,0.019482,0,5865,0,0.000037,10,0.253989,0.305205,302309.951515,0.052632,0.008337
9704021,9704021,,30,12,42,30,12,42,0.002418,0.002728,0,3406,2,0.000038,12,0.193562,0.220158,7137.264919,0.139954,0.009967
9704165,9704165,,20,21,41,20,21,41,0.003073,0.006771,0,5594,2,0.000022,11,0.214546,0.247328,24900.89389,0.134756,0.007191
9707135,9707135,,6,5,11,6,5,11,0.00132,0.003354,0,6886,2,0.000014,12,0.201005,0.22756,722.568672,0.2,0.002398
9707139,9707139,,29,10,39,29,10,39,0.002599,0.002441,0,4334,2,0.000047,13,0.188678,0.216298,61510.737496,0.10054,0.011385
9707246,9707246,,20,29,49,20,29,49,0.002797,0.006116,0,5693,2,0.000022,13,0.208706,0.246465,15172.992225,0.133503,0.007247
9709012,9709012,,11,10,21,11,10,21,0.001582,0.002654,0,6885,0,0.000016,12,0.20025,0.229266,9787.944936,0.119048,0.003819
9711014,9711014,,11,11,22,11,11,22,0.000858,0.002458,0,6883,0,0.000021,12,0.192859,0.222055,2147.662111,0.227273,0.004198
9712020,9712020,,2,52,54,2,52,54,0.000906,0.014911,0,6882,0,0.000011,12,0.209784,0.251749,29041.084135,0.080014,0.001428
9802073,9802073,,5,50,55,5,50,55,0.001246,0.015882,0,6722,2,0.000014,15,0.198958,0.237669,32943.320857,0.165993,0.002745
9803026,9803026,,14,15,29,14,15,29,0.002728,0.002728,0,6878,4,0.000028,13,0.191887,0.224424,53875.840712,0.093596,0.004449
9803106,9803106,,8,7,15,8,7,15,0.000803,0.000237,0,6873,2,0.000018,15,0.1858,0.214269,7734.372795,0.180952,0.002815
9805007,9805007,,16,22,38,16,22,38,0.002639,0.005906,0,6394,2,0.000026,13,0.197509,0.228772,11560.96293,0.214794,0.007376
9805055,9805055,,9,4,13,9,4,13,0.001307,0.000101,0,6868,1,0.00002,15,0.141116,0.159642,5248.157935,0.141026,0.003656
9807079,9807079,,6,18,24,6,18,24,0.000433,0.002652,0,7678,0,0.000014,16,0.169696,0.19838,23750.91396,0.195652,0.00258
9904151,9904151,,6,36,42,6,36,42,0.000344,0.004537,0,8605,0,0.000012,14,0.185311,0.219085,15634.729676,0.163182,0.001672
9905121,9905121,,2,25,27,2,25,27,0.000087,0.001161,0,8590,0,0.000011,14,0.19077,0.217084,4947.394635,0.156695,0.000756
9805181,9805181,,26,32,58,26,32,58,0.001242,0.004383,0,8097,0,0.000029,12,0.220031,0.255335,53511.672561,0.082577,0.009166
9901017,9901017,,28,45,73,28,45,73,0.000974,0.003164,0,8712,0,0.000028,14,0.208866,0.244925,54713.305898,0.142314,0.008454
9909219,9909219,,5,32,37,5,32,37,0.00037,0.009537,0,10150,0,0.000012,14,0.197044,0.226685,7490.715556,0.122372,0.001287
9702115,9702115,,4,9,13,4,9,13,0.000204,0.002622,0,9686,0,0.000014,12,0.192401,0.221798,687.770161,0.224359,0.002143
9904213,9904213,,8,6,14,8,6,14,0.000128,0.00018,0,9685,2,0.000016,11,0.177412,0.19578,690.794481,0.153846,0.002077
9907038,9907038,,16,32,48,16,32,48,0.00137,0.004054,0,9684,0,0.000023,13,0.204754,0.234963,46310.840149,0.068262,0.006739
1094,1094,,0,13,13,0,13,13,0,0.000025,0,10327,22,0.00001,15,0.135942,0.156569,0,0.224359,0
9303005,9303005,,27,0,27,27,0,27,0.000054,0,0,4277,22,0.000078,0,0,0,0,0.141026,0.006838
9512083,9512083,,3,7,10,3,7,10,0.000001,0.000006,0,10324,9,0.000012,5,0.359155,0.44183,1743.561223,0.177778,0.000815
9705043,9705043,,3,10,13,3,10,13,0.000002,0.000007,0,10299,22,0.000013,8,0.24115,0.332711,1641.490745,0.301282,0.000859
9710092,9710092,,9,5,14,9,5,14,0.000188,0.000035,0,8228,6,0.000021,9,0.214735,0.263861,51510.714634,0.087912,0.002176
9808062,9808062,,6,15,21,6,15,21,0.000022,0.00006,0,10301,22,0.000018,15,0.136104,0.166255,9167.420398,0.152381,0.001721
9903130,9903130,,23,28,51,23,28,51,0.000085,0.00007,0,10325,22,0.000034,14,0.15251,0.178004,77698.811619,0.061961,0.005638
9905149,9905149,,15,6,21,15,6,21,0.000056,0.000022,0,10326,22,0.000024,15,0.134567,0.15162,9358.758618,0.169048,0.003722
9211109,9211109,,26,1,27,26,1,27,0.000007,0,0,623,9,0.000088,1,1,1,1538.851086,0.064103,0.006669
9410114,9410114,,13,3,16,13,3,16,0.000101,0,0,5376,9,0.000053,1,1,1,5864.755005,0.133333,0.003407
9503161,9503161,,26,15,41,26,15,41,0.000371,0.000012,0,5381,9,0.000061,4,0.484848,0.597222,92612.34819,0.040854,0.006769
9510158,9510158,,4,3,7,4,3,7,0,0.000001,0,10323,9,0.000026,2,0.8,0.875,13.230769,0.190476,0.000912
9301100,9301100,,20,0,20,20,0,20,0.000001,0,0,5897,22,0.000099,0,0,0,0,0.023684,0.00481
9310018,9310018,,8,2,10,8,2,10,0.000002,0.000008,0,2776,22,0.000028,1,1,1,0,0.222222,0.002007
9404039,9404039,,11,2,13,11,2,13,0.000247,0.000008,0,621,22,0.000035,2,0.666667,0.75,19600.361089,0.089744,0.003201
9404081,9404081,,1,1,2,1,1,2,0,0.000003,0,10298,22,0.000011,2,0.571429,0.625,0,0.5,0.000241
9501098,9501098,,49,9,58,49,9,58,0.000037,0.000007,0,3549,6,0.000068,4,0.547619,0.666667,21219.42801,0.098911,0.013162
9503065,9503065,,1,8,9,1,8,9,0,0.00005,0,8227,3,0.000014,3,0.705882,0.819444,8446.78629,0.125,0.00028
9607085,9607085,,12,13,25,12,13,25,0.000189,0.000012,0,8225,6,0.000036,8,0.257206,0.327596,40358.944228,0.08,0.002881
9304139,9304139,,3,0,3,3,0,3,0.000002,0,0,10300,22,0.00004,0,0,0,0,0,0.000728
9803034,9803034,,10,2,12,10,2,12,0.000073,0.000001,0,8419,22,0.000027,14,0.137417,0.155469,10180.191758,0.151515,0.002371
9210109,9210109,,21,1,22,21,1,22,0.00036,0.000004,0,2661,22,0.000054,1,1,1,72.026118,0.095238,0.005498
9304047,9304047,,47,2,49,47,2,49,0.001327,0.000023,0,658,4,0.00013,2,0.666667,0.75,5318.25464,0.035714,0.016114
9308115,9308115,,15,2,17,15,2,17,0.000074,0.000003,0,4434,26,0.00004,1,1,1,698.927589,0.0625,0.004194
9309044,9309044,,40,7,47,40,7,47,0.000743,0.00019,0,684,26,0.000122,2,0.888889,0.9375,11739.788475,0.039778,0.011888
9310095,9310095,,12,1,13,12,1,13,0.000072,0.000004,0,4008,22,0.000023,2,0.666667,0.75,4.15,0.147436,0.003148
9402099,9402099,,2,1,3,2,1,3,0.000001,0.000005,0,5379,9,0.000015,2,0.666667,0.75,730.377469,0.166667,0.000779
9410180,9410180,,9,1,10,9,1,10,0.000002,0,0,10321,22,0.000038,1,1,1,32.333333,0.188889,0.002271
9603163,9603163,,7,2,9,7,2,9,0.000002,0,0,10322,22,0.000019,1,1,1,1330.5,0.25,0.001768
9603179,9603179,,6,2,8,6,2,8,0.000001,0,0,10311,22,0.00002,1,1,1,937.478154,0.107143,0.001527
9701084,9701084,,1,5,6,1,5,6,0.000001,0,0,10319,22,0.000011,6,0.325843,0.458046,12348.596219,0.166667,0.000376
9702017,9702017,,4,16,20,4,16,20,0.000002,0.000006,0,10309,22,0.000013,6,0.386364,0.55817,9808.991165,0.131579,0.001047
9805214,9805214,,3,0,3,3,0,3,0.000001,0,0,10302,22,0.000029,0,0,0,0,0,0.000815
9808130,9808130,,4,6,10,4,6,10,0.000023,0.000001,0,10297,22,0.000017,13,0.166868,0.183925,29207.017253,0.122222,0.001198
1096,1096,,1,2,3,1,2,3,0,0,0,10330,5,0.000014,2,0.75,0.833333,3,0,0.000219
9709157,9709157,,1,0,1,1,0,1,0,0,0,10329,5,0.000016,0,0,0,0,0,0.000226
9709158,9709158,,1,1,2,1,1,2,0,0.000001,0,10328,5,0.000016,1,1,1,2,0,0.000226
1097,1097,,4,9,13,4,9,13,0,0.000002,0,10333,6,0.000029,13,0.166206,0.209145,6588.777959,0.057692,0.000996
9206003,9206003,,21,0,21,21,0,21,0.000003,0,0,2397,6,0.000118,0,0,0,0,0.071429,0.005966
9403084,9403084,,9,0,9,9,0,9,0.000055,0,0,2072,6,0.000056,0,0,0,0,0.027778,0.002695
9604161,9604161,,7,1,8,7,1,8,0.000001,0,0,6784,6,0.000026,2,0.6,0.666667,3381.433525,0.125,0.001852
9612039,9612039,,12,13,25,12,13,25,0.000003,0.000001,0,6785,6,0.00008,10,0.194574,0.280657,102993.237735,0.063333,0.002857
9701156,9701156,,7,1,8,7,1,8,0.000001,0,0,7702,6,0.000035,11,0.163537,0.204757,418,0.089286,0.001627
9710019,9710019,,13,6,19,13,6,19,0,0.000002,0,10332,6,0.000028,9,0.215674,0.255197,745.218222,0.178363,0.00319
9711146,9711146,,8,16,24,8,16,24,0.000002,0.000003,0,9051,6,0.000023,12,0.162002,0.208531,34255.749323,0.052536,0.002159
9909170,9909170,,1,2,3,1,2,3,0,0.000042,0,10331,6,0.000013,7,0.214671,0.238035,1127.578244,0,0.000247
9406155,9406155,,9,2,11,9,2,11,0.000001,0,0,3850,6,0.000047,1,1,1,89.701029,0.145455,0.002474
9205064,9205064,,22,0,22,22,0,22,0.000026,0,0,847,6,0.000134,0,0,0,0,0.019481,0.006523
9211053,9211053,,45,0,45,45,0,45,0.000006,0,0,2404,6,0.00029,0,0,0,0,0.067677,0.012787
9303052,9303052,,5,2,7,5,2,7,0.000022,0,0,2070,6,0.000056,1,1,1,759.143356,0.02381,0.001512
9306028,9306028,,30,0,30,30,0,30,0.000003,0,0,3856,6,0.000072,0,0,0,0,0.07931,0.008076
9310130,9310130,,24,0,24,24,0,24,0.000003,0,0,2422,6,0.000082,0,0,0,0,0.083333,0.007009
9412166,9412166,,8,9,17,8,9,17,0.000001,0.000001,0,5067,6,0.000026,2,0.68,0.764706,43152.905005,0.088235,0.002254
9507010,9507010,,42,11,53,42,11,53,0.000002,0.000001,0,6774,6,0.000093,5,0.37931,0.468939,10492.985994,0.099057,0.011437
9601113,9601113,,10,22,32,10,22,32,0.000001,0.000003,0,6779,6,0.00003,5,0.396396,0.519508,24151.423886,0.085685,0.002682
9607046,9607046,,33,8,41,33,8,41,0.000005,0.000001,0,6781,6,0.000056,9,0.21238,0.277644,23855.892128,0.09878,0.008483
9609080,9609080,,9,7,16,9,7,16,0.000001,0.000002,0,6783,6,0.000024,10,0.188366,0.256065,3503.107967,0.2625,0.002424
9605065,9605065,,17,9,26,17,9,26,0,0.000001,0,6780,6,0.000044,8,0.232122,0.287753,26262.20903,0.184615,0.004664
9709034,9709034,,35,7,42,35,7,42,0.000044,0.000025,0,6796,6,0.000051,10,0.214912,0.268064,92653.432579,0.077236,0.00872
9210052,9210052,,13,0,13,13,0,13,0.000004,0,0,2420,6,0.000071,0,0,0,0,0.019231,0.003476
9307196,9307196,,41,1,42,41,1,42,0.000035,0,0,2396,6,0.000147,1,1,1,2421.959111,0.041812,0.010814
9312121,9312121,,10,2,12,10,2,12,0.000002,0,0,3853,6,0.000032,2,0.666667,0.75,233.531551,0.090909,0.002677
9312141,9312141,,1,4,5,1,4,5,0,0,0,9050,6,0.000011,1,1,1,171.105379,0,0.000277
9406060,9406060,,1,0,1,1,0,1,0,0,0,9049,6,0.000011,0,0,0,0,0,0.000277
9501059,9501059,,20,4,24,20,4,24,0.000002,0,0,4072,6,0.000088,2,0.642857,0.722222,28323.73159,0.099638,0.005977
9505091,9505091,,15,18,33,15,18,33,0.000082,0.000088,0,2805,4,0.000029,8,0.249187,0.337143,155250.35314,0.05303,0.00395
9606068,9606068,,14,2,16,14,2,16,0.000026,0,0,9048,6,0.000035,5,0.3625,0.418966,2113.388492,0.104167,0.003525
9608092,9608092,,7,2,9,7,2,9,0.000006,0,0,8788,6,0.000024,11,0.14776,0.167423,6582.008229,0.111111,0.00179
9704148,9704148,,2,6,8,2,6,8,0,0.000002,0,6757,6,0.000013,7,0.242574,0.309305,26951.389658,0.178571,0.000574
9706172,9706172,,6,2,8,6,2,8,0.000001,0,0,9046,6,0.000023,7,0.256604,0.295868,5197.140345,0.160714,0.001463
9707091,9707091,,17,14,31,17,14,31,0.000003,0.000003,0,6788,6,0.000033,10,0.202355,0.273853,41410.141,0.107527,0.004474
9711085,9711085,,5,2,7,5,2,7,0.000062,0,0,9047,6,0.000018,8,0.207831,0.24127,5180.86863,0.119048,0.001296
9303108,9303108,,18,0,18,18,0,18,0.000003,0,0,2423,6,0.000045,0,0,0,0,0.104575,0.004986
9306146,9306146,,19,4,23,19,4,23,0.000004,0.000007,0,7804,6,0.00004,1,1,1,1181.578711,0.094862,0.00491
9307062,9307062,,12,0,12,12,0,12,0.000003,0,0,3886,6,0.000056,0,0,0,0,0.090909,0.003153
9310110,9310110,,9,0,9,9,0,9,0.000008,0,0,6305,6,0.000028,0,0,0,0,0.055556,0.002306
9312039,9312039,,5,2,7,5,2,7,0.000001,0,0,2421,6,0.000015,1,1,1,3479.880096,0.047619,0.001492
9405014,9405014,,21,2,23,21,2,23,0.000002,0,0,2419,6,0.000072,1,1,1,3792.895701,0.211462,0.006442
9407122,9407122,,3,5,8,3,5,8,0.000001,0,0,9308,6,0.000011,1,1,1,737.3732,0.035714,0.000841
9509007,9509007,,20,7,27,20,7,27,0.000013,0.000005,0,6547,6,0.00003,9,0.204804,0.26127,7448.07158,0.123932,0.005207
9510171,9510171,,13,10,23,13,10,23,0.000002,0,0,6778,6,0.000023,5,0.375691,0.458824,15654.681023,0.16996,0.003385
9605187,9605187,,21,3,24,21,3,24,0.000629,0.000001,0,6501,6,0.000068,5,0.310345,0.424074,30717.599185,0.036232,0.005282
9609068,9609068,,8,2,10,8,2,10,0.000001,0,0,7134,6,0.000021,3,0.44,0.515152,1998.408512,0.066667,0.001995
9612099,9612099,,3,3,6,3,3,6,0.000001,0.000001,0,9307,6,0.000011,5,0.37037,0.438333,335.682154,0.266667,0.000841
9701034,9701034,,6,5,11,6,5,11,0.000002,0.000002,0,4995,6,0.000014,8,0.209979,0.279974,9969.128924,0.109091,0.00154
9701062,9701062,,7,14,21,7,14,21,0.000001,0.000002,0,6787,6,0.000022,9,0.203931,0.27722,21912.688468,0.192857,0.002157
9702145,9702145,,6,2,8,6,2,8,0.000006,0.000003,0,8787,6,0.000031,6,0.308725,0.358696,2857.573372,0.160714,0.001709
9703190,9703190,,22,5,27,22,5,27,0.000004,0.000002,0,6753,6,0.000039,7,0.251381,0.311303,944.040178,0.116809,0.005698
9704213,9704213,,11,10,21,11,10,21,0.000015,0.000003,0,6782,6,0.000019,10,0.195956,0.259736,43201.741034,0.166667,0.002932
9708148,9708148,,3,6,9,3,6,9,0.000001,0.000001,0,9306,6,0.000011,5,0.392405,0.494086,2373.494779,0.166667,0.000841
9712124,9712124,,12,9,21,12,9,21,0.000007,0.000007,0,9053,6,0.000031,12,0.166817,0.201846,33564.423401,0.104762,0.003188
9801046,9801046,,10,12,22,10,12,22,0.000072,0.000002,0,7786,6,0.000019,11,0.190122,0.267496,131498.488867,0.145022,0.002814
9802003,9802003,,5,11,16,5,11,16,0.000001,0.000002,0,9301,6,0.000013,11,0.190829,0.267372,538.73235,0.175,0.001316
9802132,9802132,,9,5,14,9,5,14,0.000027,0.000003,0,9304,6,0.000026,6,0.282282,0.341844,1718.825588,0.076923,0.002318
9804050,9804050,,5,20,25,5,20,25,0.000001,0.000004,0,9303,6,0.000013,10,0.217226,0.313551,4350.969594,0.173333,0.001375
1098,1098,,3,22,25,3,22,25,0.000232,0.008712,0,10347,2,0.000012,12,0.212569,0.243757,25721.586328,0.128333,0.000756
9902023,9902023,,16,6,22,16,6,22,0.002443,0.00303,0,8484,2,0.000017,16,0.167607,0.190787,63.657775,0.207792,0.004434
9906075,9906075,,5,43,48,5,43,48,0.000432,0.027454,0,10346,1,0.000012,13,0.206766,0.237383,3865.71233,0.119238,0.001123
9906153,9906153,,4,28,32,4,28,32,0.001004,0.020921,0,10345,1,0.000011,12,0.207511,0.236405,2484.813887,0.183468,0.001126
9907126,9907126,,11,11,22,11,11,22,0.002488,0.01855,0,10338,1,0.000016,14,0.187635,0.211478,3006.781758,0.24026,0.002724
9907177,9907177,,12,21,33,12,21,33,0.002647,0.021832,0,10343,1,0.000016,11,0.227993,0.258736,23720.10986,0.172348,0.003055
9909148,9909148,,3,31,34,3,31,34,0.000128,0.022858,0,10336,2,0.000011,15,0.209858,0.241524,2546.489399,0.095365,0.000691
9909171,9909171,,2,11,13,2,11,13,0.000135,0.003256,0,10335,2,0.000011,14,0.186065,0.210999,1315.878412,0.173077,0.000492
9602001,9602001,,2,5,7,2,5,7,0.000493,0.000012,0,2533,6,0.000013,2,0.857143,0.916667,50643.203919,0.047619,0.002386
9606173,9606173,,14,11,25,14,11,25,0.001596,0.007069,0,2961,2,0.000043,10,0.216368,0.249522,572.5881,0.211667,0.009128
9307036,9307036,,26,1,27,26,1,27,0.000696,0.000001,0,2949,23,0.000144,1,1,1,6728.895747,0.096866,0.00973
9309025,9309025,,18,2,20,18,2,20,0.000523,0.000001,0,2948,23,0.000089,2,0.75,0.833333,30337.11758,0.060526,0.007013
9402112,9402112,,11,1,12,11,1,12,0.00003,0.000008,0,3176,23,0.000057,2,0.666667,0.75,2.5,0.19697,0.004256
9503069,9503069,,7,3,10,7,3,10,0.000068,0.000007,0,3177,23,0.000035,3,0.583333,0.690476,13597.76437,0.155556,0.003294
9511035,9511035,,1,0,1,1,0,1,0.000019,0,0,5234,2,0.000022,0,0,0,0,0,0.001705
9203057,9203057,,10,0,10,10,0,10,0.000592,0,0,1121,1,0.000057,0,0,0,0,0.066667,0.003131
9208078,9208078,,36,0,36,36,0,36,0.001152,0,0,12,13,0.001197,0,0,0,0,0.069048,0.025491
9209125,9209125,,26,0,26,26,0,26,0.002863,0,0,11,13,0.000675,0,0,0,0,0.095385,0.022001
9303029,9303029,,9,3,12,9,3,12,0.000797,0.000061,0,1122,13,0.000042,1,1,1,4917.483388,0.05303,0.003197
9308100,9308100,,40,0,40,40,0,40,0.003836,0,0,392,5,0.000233,0,0,0,0,0.044872,0.021495
9310101,9310101,,17,23,40,17,23,40,0.00096,0.00031,0,865,5,0.000108,6,0.396296,0.509657,160630.298445,0.094231,0.013864
9402125,9402125,,14,3,17,14,3,17,0.000838,0.000261,0,913,5,0.000371,3,0.525,0.563492,3688.275824,0.158088,0.009895
9402136,9402136,,20,2,22,20,2,22,0.001543,0.00008,0,1008,5,0.000046,1,1,1,1222.433792,0.077922,0.007005
9404035,9404035,,18,14,32,18,14,32,0.001965,0.000994,0,354,13,0.000041,3,0.571429,0.6875,15663.702362,0.099798,0.007495
9406059,9406059,,40,15,55,40,15,55,0.0014,0.000504,0,356,13,0.000106,4,0.429907,0.502717,35470.866491,0.071044,0.017726
9406069,9406069,,20,7,27,20,7,27,0.000986,0.000263,0,357,13,0.000071,5,0.359621,0.408041,9242.185215,0.092593,0.009769
9407155,9407155,,41,7,48,41,7,48,0.001245,0.000548,0,500,13,0.000094,4,0.447368,0.536765,1247.615491,0.071809,0.013916
9409158,9409158,,16,5,21,16,5,21,0.000924,0.0002,0,380,5,0.000091,3,0.543478,0.593333,17940.919814,0.107143,0.007086
9410230,9410230,,40,15,55,40,15,55,0.002295,0.00163,0,519,13,0.000168,7,0.284717,0.331361,53321.304006,0.064646,0.020015
9412162,9412162,,14,16,30,14,16,30,0.000977,0.000633,0,862,13,0.000061,7,0.303246,0.357814,10573.168156,0.167816,0.008936
9503029,9503029,,14,8,22,14,8,22,0.001311,0.00078,0,868,13,0.000056,7,0.243944,0.283839,11800.18251,0.175325,0.008758
9503057,9503057,,43,32,75,43,32,75,0.003371,0.006364,0,976,13,0.000079,7,0.296081,0.376196,57141.339711,0.077658,0.014956
9503082,9503082,,22,9,31,22,9,31,0.001621,0.000381,0,1128,13,0.000065,6,0.285924,0.326581,3626.058498,0.104301,0.011809
9506182,9506182,,9,19,28,9,19,28,0.000653,0.00043,0,1673,5,0.000022,7,0.306003,0.384495,108144.199048,0.179894,0.003219
9509102,9509102,,12,16,28,12,16,28,0.001283,0.00122,0,1436,13,0.000026,11,0.206431,0.257489,3332.062757,0.160053,0.005794
9510080,9510080,,3,12,15,3,12,15,0.000723,0.001003,0,2106,13,0.000013,10,0.211313,0.257569,347.745554,0.185714,0.001773
9510178,9510178,,4,13,17,4,13,17,0.000722,0.001461,0,1810,13,0.000017,9,0.242818,0.28804,125.438931,0.242647,0.003322
9511116,9511116,,7,6,13,7,6,13,0.001391,0.003063,0,1545,13,0.000024,10,0.192636,0.226713,805.704069,0.141026,0.004442
9512152,9512152,,10,26,36,10,26,36,0.001478,0.005429,0,1811,13,0.000041,9,0.243084,0.290516,21521.869982,0.134921,0.009765
9601118,9601118,,6,9,15,6,9,15,0.000837,0.000774,0,2089,13,0.000017,11,0.199039,0.233868,36530.804488,0.219048,0.003015
9601164,9601164,,6,28,34,6,28,34,0.001096,0.010736,0,1919,0,0.00003,11,0.226904,0.278348,798.61913,0.208556,0.004425
9603099,9603099,,8,28,36,8,28,36,0.001386,0.005555,0,2095,13,0.000024,10,0.240989,0.291284,12793.97013,0.12619,0.00501
9604058,9604058,,28,4,32,28,4,32,0.002279,0.000829,0,2097,13,0.000046,11,0.179406,0.206626,3484.45756,0.123992,0.010993
9604200,9604200,,30,17,47,30,17,47,0.002761,0.00818,0,1922,0,0.000051,10,0.21546,0.253911,4180.90654,0.176226,0.01257
9605058,9605058,,2,14,16,2,14,16,0.000564,0.003181,0,5182,13,0.00002,10,0.219577,0.255763,1624.505817,0.2125,0.001178
9605059,9605059,,41,21,62,41,21,62,0.002873,0.00227,0,2158,13,0.00004,11,0.206522,0.248905,61493.91611,0.07853,0.012816
9605112,9605112,,33,8,41,33,8,41,0.003434,0.002496,0,2203,13,0.000045,10,0.209044,0.238728,1091.313733,0.135976,0.01271
9606047,9606047,,5,16,21,5,16,21,0.001136,0.001793,0,4564,13,0.000012,10,0.212204,0.24538,422.549628,0.207143,0.002319
9606093,9606093,,9,15,24,9,15,24,0.001155,0.00266,0,2162,13,0.00002,11,0.19889,0.234242,14882.788448,0.186594,0.003685
9607107,9607107,,24,30,54,24,30,54,0.003436,0.006374,0,2201,13,0.000069,9,0.232805,0.271897,10393.373062,0.121593,0.015635
9608106,9608106,,5,11,16,5,11,16,0.000699,0.001597,0,4572,0,0.000014,11,0.201812,0.23618,24999.843385,0.204167,0.002753
9609006,9609006,,18,4,22,18,4,22,0.002067,0.001542,0,5181,13,0.000053,10,0.209675,0.234819,14191.247131,0.056277,0.005152
9609075,9609075,,41,10,51,41,10,51,0.005454,0.002991,0,3158,13,0.000047,12,0.201494,0.232953,26665.004287,0.13451,0.016424
9609126,9609126,,12,8,20,12,8,20,0.002052,0.00068,0,3511,13,0.000022,11,0.206146,0.231406,6562.492352,0.128947,0.005577
9610005,9610005,,2,45,47,2,45,47,0.000808,0.013608,0,5180,13,0.00001,10,0.234317,0.284959,453.246646,0.165125,0.001101
9610068,9610068,,17,25,42,17,25,42,0.002558,0.005431,0,3574,13,0.000026,13,0.209282,0.254556,9581.819552,0.204413,0.007474
9611094,9611094,,12,12,24,12,12,24,0.001279,0.001427,0,4580,13,0.000026,13,0.192911,0.225837,2151.474936,0.110507,0.004326
9611161,9611161,,8,19,27,8,19,27,0.001402,0.001572,0,2494,13,0.000014,11,0.212853,0.248423,16527.824821,0.150997,0.003231
9611175,9611175,,14,21,35,14,21,35,0.001929,0.003209,0,3575,13,0.000022,11,0.208169,0.244342,5757.531287,0.189076,0.006026
9611182,9611182,,1,17,18,1,17,18,0.000563,0.001407,0,5179,0,0.00001,13,0.208153,0.243402,3130.67048,0.160131,0.000882
9611210,9611210,,6,12,18,6,12,18,0.000751,0.001195,0,4573,13,0.000015,11,0.209937,0.241732,203.606072,0.379085,0.003273
9612004,9612004,,5,14,19,5,14,19,0.00105,0.001812,0,4710,13,0.000015,11,0.207904,0.240036,23137.97568,0.125731,0.002178
9612224,9612224,,25,25,50,25,25,50,0.001837,0.001303,0,2682,0,0.000027,11,0.215301,0.248587,123922.756397,0.122449,0.009351
9701053,9701053,,6,38,44,6,38,44,0.001577,0.008324,0,4579,13,0.000012,10,0.230441,0.277681,1604.102113,0.157505,0.00233
9701177,9701177,,8,6,14,8,6,14,0.000929,0.001538,0,5178,13,0.000023,12,0.189263,0.216886,416.879199,0.192308,0.003977
9703101,9703101,,30,17,47,30,17,47,0.003773,0.001028,0,4575,13,0.000027,11,0.208087,0.24322,9930.862535,0.164662,0.010957
9703134,9703134,,16,23,39,16,23,39,0.002153,0.003602,0,4589,13,0.000022,11,0.215745,0.256596,18539.009672,0.188259,0.006693
9312127,9312127,,7,3,10,7,3,10,0.000142,0.00019,0,5236,41,0.000037,3,0.48,0.569444,648.73769,0.033333,0.002087
9711106,9711106,,50,11,61,50,11,61,0.003749,0.003146,0,5781,2,0.000059,14,0.189857,0.22117,33287.594261,0.077322,0.019168
9806162,9806162,,16,10,26,16,10,26,0.003869,0.017501,0,7175,1,0.000019,13,0.195232,0.218114,1431.266996,0.272308,0.005588
9902081,9902081,,14,4,18,14,4,18,0.000672,0.000406,0,7273,2,0.00002,15,0.17119,0.1888,530.295024,0.179739,0.003431
9804141,9804141,,6,43,49,6,43,49,0.001479,0.019479,0,6506,1,0.000015,13,0.211663,0.245041,2708.355859,0.183673,0.002564
9812109,9812109,,4,27,31,4,27,31,0.00135,0.021852,0,10344,1,0.000011,12,0.198775,0.226594,422.424238,0.245161,0.001092
9311115,9311115,,10,2,12,10,2,12,0.000222,0.000019,0,10337,1,0.000047,1,1,1,125.936435,0.128788,0.002493
9506043,9506043,,9,3,12,9,3,12,0.00121,0.000029,0,10339,1,0.000021,2,0.8,0.875,618.63005,0.25,0.00228
9602104,9602104,,8,4,12,8,4,12,0.001426,0.000035,0,10341,1,0.000017,2,0.75,0.833333,2808.246489,0.287879,0.002005
9702186,9702186,,6,5,11,6,5,11,0.001193,0.000052,0,10342,1,0.000014,2,0.777778,0.857143,2805.629822,0.318182,0.001525
9604014,9604014,,18,8,26,18,8,26,0.001483,0.003001,0,2730,2,0.000026,10,0.204867,0.230059,743.397971,0.135385,0.006715
9905087,9905087,,12,16,28,12,16,28,0.001651,0.004218,0,10334,2,0.000015,14,0.180457,0.205559,7993.840158,0.263228,0.003663
1100,1100,,2,3,5,2,3,5,0.000005,0.000018,0,10348,2,0.00002,17,0.137481,0.152918,9945.248017,0.2,0.000492
9211007,9211007,,13,2,15,13,2,15,0.00015,0.000092,0,2970,23,0.000066,1,1,1,61.499294,0.1,0.003454
9202077,9202077,,3,0,3,3,0,3,0.00001,0,0,7250,23,0.000018,0,0,0,0,0.166667,0.00097
9207070,9207070,,5,0,5,5,0,5,0.00005,0,0,301,23,0.000438,0,0,0,0,0.25,0.002149
9212153,9212153,,25,0,25,25,0,25,0.000166,0,0,2965,23,0.000102,0,0,0,0,0.11,0.006698
9305112,9305112,,6,4,10,6,4,10,0.000034,0.000143,0,2977,23,0.000026,3,0.521739,0.625,854.660552,0.155556,0.001965
9308068,9308068,,3,8,11,3,8,11,0.000053,0.000083,0,2964,5,0.000049,4,0.41958,0.491667,8707.822251,0.054545,0.000996
9311022,9311022,,11,11,22,11,11,22,0.000021,0.000135,0,2976,23,0.000036,3,0.450704,0.578125,18624.31533,0.099567,0.003093
9311098,9311098,,5,0,5,5,0,5,0.000017,0,0,2962,23,0.00009,0,0,0,0,0.2,0.001505
9312005,9312005,,9,3,12,9,3,12,0.000018,0.000001,0,2967,23,0.000124,5,0.309524,0.354103,29905.969017,0.181818,0.002677
9401071,9401071,,1,1,2,1,1,2,0.000009,0.00003,0,7270,23,0.000012,4,0.293233,0.324786,78.419699,0,0.000474
9406017,9406017,,9,2,11,9,2,11,0.00001,0,0,2968,23,0.000078,6,0.24,0.271465,4619.903394,0.209091,0.002562
9406021,9406021,,8,0,8,8,0,8,0.000014,0,0,2085,23,0.000037,0,0,0,0,0.035714,0.002046
9409013,9409013,,3,2,5,3,2,5,0.000021,0,0,2087,25,0.000014,1,1,1,22582.943264,0.1,0.001005
9409041,9409041,,14,2,16,14,2,16,0.000013,0,0,2969,23,0.000081,6,0.241877,0.274876,21936.326893,0.2,0.003966
9409185,9409185,,11,3,14,11,3,14,0.000013,0.000002,0,2971,23,0.00006,6,0.25,0.295894,818.860311,0.192308,0.003079
9502045,9502045,,16,4,20,16,4,20,0.000286,0.000001,0,2973,23,0.000057,6,0.250896,0.30119,26115.586055,0.147368,0.004303
9503034,9503034,,9,4,13,9,4,13,0.000016,0.000007,0,5272,23,0.000031,7,0.208824,0.264688,5460.44765,0.173077,0.002506
9503087,9503087,,3,1,4,3,1,4,0.000012,0,0,2972,23,0.000017,7,0.202312,0.229184,11.815532,0.333333,0.000985
9503092,9503092,,3,6,9,3,6,9,0.00001,0.000006,0,5359,23,0.000015,6,0.308943,0.373904,4679.918799,0.208333,0.001065
9504053,9504053,,6,5,11,6,5,11,0.000013,0.000004,0,2974,23,0.000025,7,0.209302,0.269114,18720.19641,0.254545,0.001795
9506131,9506131,,16,4,20,16,4,20,0.000326,0.000392,0,1410,13,0.000071,4,0.403226,0.483333,244.463633,0.089474,0.006534
9510007,9510007,,11,11,22,11,11,22,0.000468,0.000176,0,5356,23,0.000039,8,0.249707,0.308255,15295.638984,0.08658,0.003008
9510069,9510069,,9,7,16,9,7,16,0.000192,0.000006,0,2978,23,0.000035,7,0.260135,0.354236,152548.721118,0.183333,0.004051
9511071,9511071,,16,13,29,16,13,29,0.000437,0.00004,0,5362,23,0.000035,10,0.190295,0.230944,46902.556235,0.083744,0.004387
9604054,9604054,,4,6,10,4,6,10,0.00001,0.000045,0,7265,23,0.000027,9,0.219036,0.246033,14254.468415,0.088889,0.001149
9605089,9605089,,6,1,7,6,1,7,0.000291,0.000006,0,7268,23,0.00002,9,0.200562,0.226971,315.277487,0.190476,0.001687
9605106,9605106,,8,3,11,8,3,11,0.000386,0.00003,0,7260,23,0.000016,11,0.166566,0.195092,523.893643,0.127273,0.00243
9605109,9605109,,11,8,19,11,8,19,0.00002,0.000009,0,7252,23,0.000036,7,0.262626,0.362515,632.650165,0.157895,0.002957
9605166,9605166,,3,4,7,3,4,7,0.000156,0.000007,0,7269,23,0.000014,10,0.18,0.209673,731.091573,0.190476,0.000992
9609003,9609003,,4,16,20,4,16,20,0.000012,0.000081,0,7262,23,0.000017,10,0.210251,0.257275,18758.107331,0.081579,0.001195
9609180,9609180,,8,5,13,8,5,13,0.00001,0.000005,0,7255,23,0.000034,8,0.229651,0.31314,7764.569739,0.230769,0.002213
9609201,9609201,,1,5,6,1,5,6,0.000009,0.000004,0,7267,23,0.000012,6,0.253571,0.311033,0,0.466667,0.000474
9612101,9612101,,13,4,17,13,4,17,0.000014,0.000002,0,7256,23,0.000048,8,0.215426,0.282569,261.080727,0.147059,0.003413
9702119,9702119,,1,3,4,1,3,4,0.000009,0.000004,0,7266,23,0.000012,10,0.180155,0.195999,0,0.416667,0.000474
9703192,9703192,,5,10,15,5,10,15,0.00023,0.000038,0,7263,23,0.000014,11,0.182037,0.217987,502.285117,0.171429,0.001385
9704026,9704026,,4,1,5,4,1,5,0.000013,0,0,7257,23,0.000016,9,0.179039,0.216081,0.625,0.25,0.001176
9705179,9705179,,2,5,7,2,5,7,0.000009,0.000006,0,7253,23,0.000013,7,0.239394,0.311935,4.083333,0.380952,0.000711
9707176,9707176,,45,4,49,45,4,49,0.005842,0.000653,0,5907,1,0.000059,6,0.286391,0.323209,1473.361023,0.083333,0.015295
9709181,9709181,,1,2,3,1,2,3,0.000009,0.000002,0,7259,23,0.000012,7,0.202941,0.239752,63.456489,0.166667,0.000474
9802143,9802143,,2,7,9,2,7,9,0.000015,0.000003,0,7258,23,0.000012,8,0.228261,0.322279,9.611937,0.263889,0.000721
9804204,9804204,,2,3,5,2,3,5,0.000009,0,0,7251,23,0.000014,1,1,1,598.221195,0.1,0.000727
9704058,9704058,,8,16,24,8,16,24,0.00068,0.005528,0,5097,13,0.000031,13,0.206047,0.242942,23607.875671,0.112319,0.003114
9709050,9709050,,7,5,12,7,5,12,0.000064,0.000496,0,5265,13,0.00003,13,0.185642,0.215899,21549.643175,0.090909,0.001742
1101,1101,,2,16,18,2,16,18,0.00022,0.003158,0,10350,0,0.000011,12,0.20184,0.225719,898.675577,0.261438,0.001256
9811168,9811168,,43,12,55,43,12,55,0.002157,0.003085,0,8100,0,0.000036,14,0.185861,0.212127,16485.098215,0.146801,0.015388
9811240,9811240,,19,23,42,19,23,42,0.001182,0.002256,0,8564,0,0.000019,15,0.180165,0.209815,7272.75296,0.170151,0.005711
9901009,9901009,,45,41,86,45,41,86,0.001826,0.003988,0,8714,0,0.000036,14,0.195449,0.230118,42423.52593,0.126676,0.014599
9904054,9904054,,25,30,55,25,30,55,0.001179,0.005527,0,8823,0,0.000023,13,0.194288,0.229369,33746.72583,0.144444,0.008245
9912208,9912208,,34,25,59,34,25,59,0.001323,0.004168,0,10349,0,0.000031,12,0.204466,0.231281,44452.461726,0.139392,0.010358
9706093,9706093,,14,8,22,14,8,22,0.000923,0.00097,0,5853,0,0.000018,14,0.185308,0.216286,751.93685,0.294372,0.004436
9709209,9709209,,3,19,22,3,19,22,0.000175,0.006359,0,5504,0,0.00002,11,0.205578,0.237936,23783.224535,0.103896,0.001067
9501131,9501131,,13,6,19,13,6,19,0.000374,0.000035,0,975,0,0.000026,7,0.226415,0.284325,27939.666255,0.114035,0.00436
9811129,9811129,,4,14,18,4,14,18,0.00016,0.001449,0,8713,0,0.000012,15,0.168793,0.199539,8578.0417,0.29085,0.001368
9903052,9903052,,6,15,21,6,15,21,0.000309,0.000911,0,8822,0,0.000014,15,0.181666,0.209053,3881.990644,0.178571,0.002496
9903104,9903104,,9,48,57,9,48,57,0.000665,0.006032,0,8821,0,0.000014,12,0.214085,0.254124,42472.251626,0.104323,0.0028
9904114,9904114,,8,16,24,8,16,24,0.000536,0.002621,0,8566,0,0.000014,16,0.174046,0.204654,860.066367,0.20471,0.002285
1102,1102,,1,1,2,1,1,2,0.000006,0,0,10352,4,0.000011,1,1,1,1157,0,0.000301
9905013,9905013,,1,0,1,1,0,1,0,0,0,10351,4,0.000019,0,0,0,0,0,0.000227
1103,1103,,30,33,63,30,33,63,0.004751,0.022854,0,10371,1,0.000033,11,0.233176,0.266378,175498.961175,0.108551,0.014095
9702107,9702107,,43,24,67,43,24,67,0.002235,0.007188,0,3668,4,0.000065,11,0.215636,0.250133,81757.767159,0.068295,0.014957
9905015,9905015,,31,26,57,31,26,57,0.002546,0.010442,0,9606,4,0.000027,16,0.201624,0.233653,124042.588396,0.079261,0.009046
9906011,9906011,,47,30,77,47,30,77,0.005312,0.004418,0,9607,4,0.00004,16,0.194762,0.226076,64507.648866,0.080144,0.017888
9908020,9908020,,9,20,29,9,20,29,0.002426,0.019171,0,10370,1,0.000014,14,0.197641,0.226635,1670.242681,0.195813,0.003154
9912035,9912035,,3,11,14,3,11,14,0.00027,0.000099,0,10369,4,0.000012,18,0.157441,0.175139,126514.170957,0.247253,0.000985
9208046,9208046,,26,1,27,26,1,27,0.001589,0.000017,0,660,4,0.000058,1,1,1,402.811178,0.14245,0.010686
9303100,9303100,,13,1,14,13,1,14,0.000452,0.000017,0,659,4,0.000051,1,1,1,414.72954,0.203297,0.008171
9312103,9312103,,4,0,4,4,0,4,0.000134,0,0,657,4,0.000035,0,0,0,0,0.083333,0.002963
9401017,9401017,,27,0,27,27,0,27,0.000949,0,0,559,4,0.000073,0,0,0,0,0.092593,0.011588
9402021,9402021,,9,0,9,9,0,9,0.00048,0,0,656,4,0.000042,0,0,0,0,0.180556,0.004337
9504141,9504141,,7,5,12,7,5,12,0.000658,0.001395,0,655,4,0.00003,7,0.219485,0.25639,151.661294,0.113636,0.003561
9201003,9201003,,19,0,19,19,0,19,0.000218,0,0,959,4,0.00005,0,0,0,0,0.035088,0.008297
9205110,9205110,,37,0,37,37,0,37,0.001262,0,0,1224,4,0.000056,0,0,0,0,0.103604,0.015858
9306153,9306153,,99,18,117,99,18,117,0.002095,0.000148,0,1223,4,0.000207,4,0.39759,0.532828,190186.517877,0.014589,0.030614
9306102,9306102,,11,1,12,11,1,12,0.000048,0,0,1871,4,0.00004,1,1,1,652.51388,0.151515,0.003622
9411004,9411004,,23,3,26,23,3,26,0.000178,0.000007,0,1869,4,0.00006,3,0.55,0.621212,30297.920014,0.044615,0.007301
9411160,9411160,,16,2,18,16,2,18,0.000839,0.000028,0,1862,4,0.000035,1,1,1,5615.109357,0.173203,0.006848
9510143,9510143,,13,8,21,13,8,21,0.000599,0.000079,0,1870,4,0.000032,3,0.52,0.615385,34494.042301,0.102381,0.006565
9609104,9609104,,30,24,54,30,24,54,0.001947,0.003282,0,3491,4,0.000025,12,0.191737,0.225134,8677.316424,0.238994,0.009358
9407007,9407007,,14,1,15,14,1,15,0.000044,0,0,3987,26,0.000074,1,1,1,3155.893718,0.080952,0.004607
9511104,9511104,,64,10,74,64,10,74,0.000984,0.001153,0,3919,26,0.00016,7,0.270615,0.311779,202430.88977,0.054609,0.01821
9703191,9703191,,19,10,29,19,10,29,0.00185,0.001089,0,5566,1,0.000049,14,0.158446,0.18391,5546.64873,0.157635,0.009333
9804099,9804099,,7,12,19,7,12,19,0.001501,0.017855,0,6150,1,0.000033,12,0.196672,0.220614,2076.464445,0.251462,0.005267
9802012,9802012,,22,5,27,22,5,27,0.000675,0.00027,0,6474,4,0.000049,13,0.183902,0.208611,31033.673657,0.146724,0.007194
9802108,9802108,,33,7,40,33,7,40,0.000923,0.000135,0,6476,4,0.000053,16,0.167035,0.190115,7344.984906,0.110897,0.009633
9805168,9805168,,40,11,51,40,11,51,0.00091,0.000204,0,9603,4,0.00006,14,0.168074,0.188906,65827.468543,0.085098,0.010444
9806034,9806034,,24,7,31,24,7,31,0.000579,0.000109,0,9605,4,0.000033,14,0.167407,0.186875,81639.730668,0.139785,0.006244
9902018,9902018,,25,45,70,25,45,70,0.002231,0.003692,0,9601,4,0.000026,15,0.194441,0.225489,111697.20828,0.064596,0.006881
9904116,9904116,,18,16,34,18,16,34,0.002172,0.001996,0,9602,4,0.000022,16,0.188054,0.213743,81958.712915,0.129234,0.005339
9710098,9710098,,9,25,34,9,25,34,0.000275,0.003313,0,8448,4,0.000015,12,0.191866,0.222154,20200.513854,0.114082,0.002801
9804069,9804069,,19,14,33,19,14,33,0.001949,0.004005,0,7915,4,0.000019,13,0.191207,0.219031,9210.955628,0.167614,0.005741
9811172,9811172,,41,14,55,41,14,55,0.008104,0.017175,0,7555,1,0.000035,16,0.180594,0.204625,5490.482922,0.217508,0.016592
9802049,9802049,,30,9,39,30,9,39,0.000858,0.001029,0,6475,4,0.000056,15,0.179533,0.205721,42689.15759,0.093792,0.009196
9905016,9905016,,4,7,11,4,7,11,0.000003,0.000098,0,10360,4,0.000015,17,0.166327,0.185598,46763.759875,0.309091,0.001007
9905138,9905138,,4,13,17,4,13,17,0.000003,0.000086,0,10368,4,0.000014,14,0.162716,0.179859,31500.573584,0.235294,0.00092
9908095,9908095,,4,11,15,4,11,15,0.000205,0.00042,0,10362,4,0.000012,15,0.136203,0.153296,183.806991,0.204762,0.000933
9909004,9909004,,13,11,24,13,11,24,0.000003,0.000046,0,10361,23,0.000025,18,0.151966,0.169643,133421.165379,0.125,0.003071
1105,1105,,7,8,15,7,8,15,0.000581,0.002171,0,10373,30,0.000014,13,0.191914,0.21017,11096.926532,0.2,0.002301
9911085,9911085,,17,13,30,17,13,30,0.000559,0.004025,0,10372,30,0.000024,13,0.193733,0.213001,5343.416215,0.175862,0.004107
9511111,9511111,,6,5,11,6,5,11,0.000061,0.000073,0,4486,3,0.00003,7,0.265781,0.323988,5642.940543,0.136364,0.002015
9910258,9910258,,2,15,17,2,15,17,0.000057,0.003549,0,9584,30,0.000015,13,0.196613,0.216256,1550.697419,0.242647,0.000582
9907055,9907055,,20,6,26,20,6,26,0.000807,0.000545,0,9583,30,0.000029,14,0.183038,0.201156,3979.794194,0.124615,0.005847
9806198,9806198,,7,9,16,7,9,16,0.000558,0.003311,0,9359,30,0.000015,16,0.174493,0.199253,10514.0816,0.145833,0.001716
9911140,9911140,,23,37,60,23,37,60,0.001196,0.024714,0,9577,30,0.000025,12,0.220736,0.24731,39911.137961,0.111299,0.006342
1106,1106,,8,18,26,8,18,26,0.00123,0.004216,0,10377,2,0.000013,14,0.178443,0.204493,1686.967646,0.286154,0.002343
9806108,9806108,,58,17,75,58,17,75,0.009082,0.006437,0,6415,2,0.000049,14,0.188157,0.214458,15191.191,0.109189,0.020428
9903022,9903022,,18,25,43,18,25,43,0.002688,0.005198,0,7763,2,0.000018,12,0.193836,0.219508,22938.43942,0.192691,0.005976
9903049,9903049,,20,23,43,20,23,43,0.003565,0.003757,0,7764,2,0.00002,13,0.189899,0.216309,26439.013224,0.154485,0.007561
9905183,9905183,,11,33,44,11,33,44,0.001659,0.006613,0,10376,2,0.00002,14,0.183477,0.212886,23320.754332,0.167019,0.00572
9312104,9312104,,37,3,40,37,3,40,0.001104,0.000215,0,689,4,0.000083,2,0.8,0.875,20510.311697,0.035897,0.017203
9708097,9708097,,7,0,7,7,0,7,0.00028,0,0,6400,26,0.000022,0,0,0,0,0.047619,0.001915
9801072,9801072,,5,16,21,5,16,21,0.000357,0.006684,0,6401,13,0.000014,13,0.178616,0.213372,2066.676182,0.12619,0.001582
9706059,9706059,,16,9,25,16,9,25,0.001122,0.00441,0,3897,2,0.00003,11,0.20928,0.23902,3622.170932,0.085,0.007086
9707039,9707039,,2,1,3,2,1,3,0.000087,0.000003,0,6405,26,0.000013,1,1,1,1398.227284,0.166667,0.001008
9712133,9712133,,30,11,41,30,11,41,0.003302,0.004501,0,6404,2,0.000035,13,0.178461,0.205176,6697.748927,0.155488,0.010544
9801093,9801093,,5,17,22,5,17,22,0.001,0.007003,0,6664,2,0.000013,15,0.186764,0.217904,764.140615,0.264069,0.00166
9705200,9705200,,17,7,24,17,7,24,0.000393,0.001949,0,4905,4,0.000022,12,0.154266,0.187903,3042.254078,0.108696,0.00463
9808183,9808183,,11,26,37,11,26,37,0.002455,0.020183,0,6672,2,0.000014,13,0.202219,0.232517,6367.464127,0.180931,0.004093
9812039,9812039,,6,14,20,6,14,20,0.000703,0.004597,0,6666,2,0.000013,16,0.180944,0.211034,871.618875,0.247368,0.001682
9901105,9901105,,8,36,44,8,36,44,0.001543,0.020806,0,6682,2,0.000013,13,0.201353,0.23384,6231.05062,0.153277,0.002792
9901152,9901152,,8,21,29,8,21,29,0.001357,0.003079,0,7762,2,0.000013,13,0.190206,0.217304,1254.929783,0.243842,0.0026
9810021,9810021,,18,29,47,18,29,47,0.003479,0.005823,0,6685,2,0.00002,13,0.20234,0.2314,10471.084855,0.199352,0.007328
9903025,9903025,,7,21,28,7,21,28,0.001262,0.008515,0,7761,2,0.000013,13,0.187899,0.214373,2422.509456,0.275132,0.002312
9903099,9903099,,1,15,16,1,15,16,0.000078,0.001237,0,10375,2,0.00001,14,0.175153,0.198705,55.146493,0.25,0.000335
9904182,9904182,,20,16,36,20,16,36,0.001704,0.003413,0,10161,2,0.000027,16,0.1751,0.198177,46759.104649,0.165873,0.006472
9905091,9905091,,3,15,18,3,15,18,0.00097,0.006498,0,10374,2,0.000011,13,0.192306,0.215213,290.802224,0.352941,0.0013
1107,1107,,20,8,28,20,8,28,0.000787,0.001294,0,10378,25,0.000027,12,0.191738,0.209081,2280.739407,0.191799,0.006587
1108,1108,,1,6,7,1,6,7,0,0,0,10401,22,0.000011,6,0.318584,0.390046,67,0.142857,0.000219
9709133,9709133,,3,1,4,3,1,4,0,0,0,10394,22,0.000014,2,0.6,0.666667,7.833333,0.166667,0.000671
9709134,9709134,,2,0,2,2,0,2,0,0,0,10392,22,0.000012,0,0,0,0,0.5,0.000451
9710025,9710025,,8,4,12,8,4,12,0.000001,0.000002,0,10383,22,0.000018,5,0.358491,0.477193,2883.348901,0.257576,0.001847
9801192,9801192,,6,14,20,6,14,20,0.000034,0.000005,0,10391,22,0.000016,4,0.513158,0.632479,37029.526611,0.139474,0.001415
9810182,9810182,,4,1,5,4,1,5,0,0,0,10400,22,0.000027,3,0.5,0.583333,5227,0,0.000906
9906170,9906170,,1,12,13,1,12,13,0,0.000005,0,10399,22,0.000012,5,0.380435,0.473571,60.633333,0.141026,0.000226
9410225,9410225,,1,2,3,1,2,3,0,0,0,10393,22,0.000022,1,1,1,6.833333,0.166667,0.000239
9302116,9302116,,45,1,46,45,1,46,0.000157,0,0,2656,22,0.000192,1,1,1,10853.76484,0.046377,0.011506
9610247,9610247,,6,2,8,6,2,8,0,0.000002,0,10380,22,0.000027,3,0.555556,0.666667,513.488087,0.285714,0.001489
9703090,9703090,,7,3,10,7,3,10,0,0.000002,0,10382,22,0.000022,5,0.384615,0.496667,153.553446,0.2,0.001641
9703200,9703200,,7,2,9,7,2,9,0,0.000002,0,10381,22,0.00002,4,0.461538,0.597222,512.712818,0.333333,0.001674
9306117,9306117,,21,0,21,21,0,21,0.000003,0,0,2654,22,0.000086,0,0,0,0,0.057143,0.005467
9307034,9307034,,4,2,6,4,2,6,0,0,0,10379,22,0.000027,2,0.75,0.833333,167.14551,0.066667,0.000958
9309013,9309013,,33,1,34,33,1,34,0.000065,0,0,2658,8,0.000134,2,0.666667,0.75,6682.228232,0.044563,0.008253
9402020,9402020,,16,2,18,16,2,18,0.000047,0.000003,0,2649,22,0.000061,2,0.75,0.833333,6252.487333,0.107843,0.004204
9404094,9404094,,13,4,17,13,4,17,0.000047,0.000001,0,3744,22,0.000031,2,0.75,0.833333,5606.079569,0.077206,0.003119
9406212,9406212,,14,5,19,14,5,19,0.000047,0.000002,0,3747,22,0.000031,2,0.692308,0.777778,1776.267767,0.105263,0.003425
9503032,9503032,,10,1,11,10,1,11,0.000001,0.000002,0,3741,22,0.000038,2,0.666667,0.75,4,0.127273,0.002469
9509003,9509003,,10,1,11,10,1,11,0.000024,0,0,3118,22,0.000024,1,1,1,13140,0.090909,0.002597
9606054,9606054,,9,14,23,9,14,23,0.000047,0.000009,0,7148,22,0.000021,3,0.592593,0.697917,16482.527533,0.136364,0.002162
9611027,9611027,,5,9,14,5,9,14,0,0.000005,0,10389,22,0.000015,3,0.612903,0.719298,1135.886309,0.175824,0.00117
9603185,9603185,,5,2,7,5,2,7,0,0,0,10398,22,0.000052,2,0.75,0.833333,3932,0.142857,0.001135
9411175,9411175,,6,0,6,6,0,6,0,0,0,10395,22,0.000083,0,0,0,0,0.2,0.001381
9809062,9809062,,4,11,15,4,11,15,0.000243,0.000008,0,10390,22,0.000013,4,0.42963,0.517241,37487.986411,0.142857,0.000985
1109,1109,,3,24,27,3,24,27,0.000253,0.003633,0,10416,4,0.000012,11,0.228254,0.259749,20003.907572,0.105413,0.000843
9512075,9512075,,17,1,18,17,1,18,0.000693,0.000029,0,3281,4,0.00004,8,0.195089,0.217458,649.629004,0.101307,0.004811
9702161,9702161,,8,6,14,8,6,14,0.000144,0.000815,0,5321,4,0.000021,13,0.174168,0.195427,1517.851545,0.153846,0.002301
9709082,9709082,,7,5,12,7,5,12,0.000184,0.000446,0,6162,4,0.000018,14,0.158114,0.176477,2267.814349,0.166667,0.001775
9710185,9710185,,8,3,11,8,3,11,0.000774,0.000609,0,7215,4,0.000013,13,0.168301,0.190877,277.407274,0.136364,0.001939
9803112,9803112,,8,7,15,8,7,15,0.000231,0.000912,0,10413,4,0.000017,16,0.179215,0.20309,2525.501865,0.190476,0.002301
9803160,9803160,,4,6,10,4,6,10,0.000157,0.000106,0,10415,4,0.000012,16,0.177923,0.200145,2397.715611,0.166667,0.001118
9808160,9808160,,11,2,13,11,2,13,0.000793,0.005695,0,7657,0,0.000024,14,0.182932,0.206048,6608.220466,0.211538,0.003019
9810250,9810250,,17,8,25,17,8,25,0.002118,0.011613,0,7987,1,0.000027,13,0.19309,0.217473,5206.451647,0.145,0.00599
9812212,9812212,,3,10,13,3,10,13,0.000133,0.000947,0,10414,4,0.000011,16,0.179783,0.204525,349.681945,0.224359,0.000811
9904196,9904196,,5,11,16,5,11,16,0.000379,0.002903,0,10408,4,0.000012,18,0.161981,0.191495,9979.153957,0.2,0.001235
9909177,9909177,,2,33,35,2,33,35,0.000278,0.005064,0,10412,4,0.000011,14,0.184364,0.216323,6648.612119,0.121849,0.000468
9909228,9909228,,21,11,32,21,11,32,0.00141,0.002181,0,10402,0,0.000023,11,0.227448,0.25842,53098.269827,0.102823,0.005799
9605192,9605192,,11,5,16,11,5,16,0.00093,0.000864,0,3376,4,0.000034,14,0.167388,0.198765,52061.644685,0.1375,0.003719
9603082,9603082,,5,20,25,5,20,25,0.000467,0.003978,0,2752,4,0.000017,14,0.18688,0.230499,12359.874915,0.24,0.002564
9310017,9310017,,1,2,3,1,2,3,0.00011,0.000001,0,4292,5,0.000012,1,1,1,3222.481689,0.166667,0.000775
9607054,9607054,,1,18,19,1,18,19,0.00011,0.005124,0,4291,0,0.000012,9,0.225669,0.259428,10768.819911,0.157895,0.000775
9710085,9710085,,11,53,64,11,53,64,0.00063,0.009503,0,4908,4,0.000018,12,0.19922,0.23993,33641.552559,0.098958,0.004014
9707262,9707262,,17,36,53,17,36,53,0.000426,0.005971,0,6061,0,0.000036,14,0.204429,0.241579,17696.201927,0.105951,0.004517
9710243,9710243,,39,17,56,39,17,56,0.003144,0.002144,0,5692,13,0.000041,16,0.183571,0.212502,11678.906264,0.083442,0.012809
9611209,9611209,,25,20,45,25,20,45,0.001662,0.007203,0,4888,4,0.000034,12,0.210573,0.258465,13331.754625,0.09697,0.006665
9902211,9902211,,2,13,15,2,13,15,0.000094,0.002286,0,10407,4,0.000011,17,0.151787,0.173548,12933.105224,0.114286,0.000486
9903256,9903256,,3,6,9,3,6,9,0.000135,0.003057,0,10403,4,0.000012,14,0.177173,0.204562,365.232946,0.194444,0.000727
9812133,9812133,,7,8,15,7,8,15,0.000881,0.0067,0,10411,1,0.000013,13,0.184172,0.208828,3139.41439,0.185714,0.001861
9903183,9903183,,8,2,10,8,2,10,0.000171,0.000002,0,10410,23,0.000025,17,0.114918,0.129505,5642.498841,0.1,0.001862
1110,1110,,1,22,23,1,22,23,0,0.000005,0,10486,17,0.00001,12,0.17496,0.221056,94.809318,0.278656,0.000219
9212088,9212088,,65,0,65,65,0,65,0.000017,0,0,10425,17,0.000186,0,0,0,0,0.151442,0.019737
9401059,9401059,,61,1,62,61,1,62,0.000155,0,0,6265,17,0.000102,1,1,1,8335.79241,0.140666,0.017769
9401092,9401092,,37,1,38,37,1,38,0.000017,0,0,10428,17,0.000079,1,1,1,0.948465,0.236131,0.012149
9402008,9402008,,29,2,31,29,2,31,0.000005,0,0,10435,17,0.000061,1,1,1,2.19152,0.26129,0.009523
9609174,9609174,,57,7,64,57,7,64,0.000099,0.000002,0,10432,17,0.000074,2,0.888889,0.9375,4467.302856,0.155258,0.016289
9704055,9704055,,22,12,34,22,12,34,0.000002,0.000007,0,10441,17,0.000036,6,0.270701,0.376078,152.511655,0.190731,0.006266
9704056,9704056,,16,14,30,16,14,30,0.000002,0.000009,0,10438,17,0.000028,11,0.229491,0.309343,7924.400524,0.182759,0.004761
9710103,9710103,,3,14,17,3,14,17,0,0.000047,0,10457,17,0.000013,12,0.196294,0.244161,9137.480352,0.095588,0.000798
9711047,9711047,,14,11,25,14,11,25,0.000001,0.000007,0,10452,17,0.000027,12,0.160907,0.192594,789.101793,0.35,0.004672
9711110,9711110,,30,14,44,30,14,44,0.000012,0.000007,0,10461,17,0.000037,13,0.141989,0.173655,415.35573,0.254757,0.008588
9801133,9801133,,28,18,46,28,18,46,0.000012,0.000008,0,10463,17,0.000034,12,0.166001,0.20223,3901.583375,0.225121,0.007655
9802174,9802174,,28,19,47,28,19,47,0.000011,0.000008,0,10464,17,0.000033,12,0.166167,0.203189,3934.385449,0.240981,0.007657
9806110,9806110,,29,15,44,29,15,44,0.000004,0.000003,0,10466,17,0.000034,12,0.163369,0.199679,4827.527401,0.196617,0.007521
9811212,9811212,,25,24,49,25,24,49,0.000004,0.000007,0,10480,17,0.000031,12,0.165921,0.209172,14015.17647,0.213861,0.006403
9902117,9902117,,11,10,21,11,10,21,0.000002,0.000004,0,10481,17,0.000017,12,0.148573,0.179558,71.070962,0.335714,0.002819
9903096,9903096,,8,24,32,8,24,32,0.000002,0.000008,0,10482,17,0.000016,12,0.154082,0.196959,332.980033,0.265121,0.002013
9903119,9903119,,5,5,10,5,5,10,0.000002,0.000002,0,10474,17,0.000013,12,0.189873,0.23853,3.811251,0.311111,0.00128
9904199,9904199,,19,22,41,19,22,41,0.000033,0.000008,0,10483,17,0.000023,12,0.14959,0.189061,6712.596361,0.225,0.004745
9907096,9907096,,8,16,24,8,16,24,0.000001,0.000006,0,10472,17,0.000017,12,0.151259,0.186822,1234.308172,0.221014,0.001949
9910107,9910107,,5,3,8,5,3,8,0.000002,0,0,10485,17,0.000012,13,0.142642,0.166284,2.716626,0.25,0.001149
9910190,9910190,,15,26,41,15,26,41,0.000041,0.000029,0,10484,17,0.00002,12,0.169893,0.216157,2126.852164,0.196951,0.003643
9912207,9912207,,7,16,23,7,16,23,0,0.000007,0,10473,17,0.000016,13,0.144674,0.176687,759.819068,0.249012,0.001683
9303012,9303012,,56,0,56,56,0,56,0.000017,0,0,6264,17,0.000364,0,0,0,0,0.180844,0.018114
9310049,9310049,,7,1,8,7,1,8,0.000001,0,0,10429,17,0.000038,1,1,1,2.333333,0.232143,0.002514
9404031,9404031,,33,2,35,33,2,35,0.000148,0,0,10431,17,0.000055,1,1,1,4.088294,0.184034,0.009858
9405005,9405005,,29,2,31,29,2,31,0.000003,0,0,10427,17,0.000061,1,1,1,3.686905,0.204301,0.008929
9606099,9606099,,8,4,12,8,4,12,0.000001,0,0,10430,17,0.000029,2,0.75,0.833333,380.341682,0.242424,0.002765
9502096,9502096,,28,7,35,28,7,35,0.000136,0.000002,0,10440,17,0.000043,1,1,1,1923.669917,0.218487,0.008568
9605110,9605110,,14,5,19,14,5,19,0.000002,0.000011,0,10434,17,0.000039,2,0.619048,0.692308,345.965564,0.195906,0.004416
9605183,9605183,,29,4,33,29,4,33,0.000003,0.000027,0,10436,17,0.000055,5,0.309917,0.376444,1517.78067,0.192235,0.008735
9304063,9304063,,13,0,13,13,0,13,0.000002,0,0,10418,17,0.00003,0,0,0,0,0.128205,0.003582
9412230,9412230,,1,0,1,1,0,1,0,0,0,10437,17,0.000012,0,0,0,0,0,0.00034
9606004,9606004,,20,7,27,20,7,27,0.000402,0.000011,0,10424,4,0.00003,5,0.404762,0.516667,8995.209018,0.102564,0.007304
9612237,9612237,,8,6,14,8,6,14,0.000036,0.000016,0,10426,17,0.000019,10,0.250927,0.314428,13093.87681,0.164835,0.002341
9612242,9612242,,2,5,7,2,5,7,0.000002,0.000004,0,10420,17,0.000012,3,0.485714,0.588235,3219.975167,0.047619,0.000572
9207020,9207020,,14,2,16,14,2,16,0.000161,0.000001,0,1210,4,0.000055,1,1,1,709.381568,0.108333,0.004764
9302014,9302014,,52,6,58,52,6,58,0.000595,0.000012,0,1212,4,0.00013,1,1,1,31328.765358,0.047489,0.015079
9307116,9307116,,10,7,17,10,7,17,0.000003,0.00001,0,3007,17,0.000023,1,1,1,5112.864804,0.147059,0.002487
9604012,9604012,,2,6,8,2,6,8,0.000002,0.00005,0,10456,26,0.000011,7,0.275762,0.336404,5622.708653,0.107143,0.00046
9607243,9607243,,4,18,22,4,18,22,0.000036,0.000068,0,10448,6,0.000014,9,0.203973,0.250314,48177.7713,0.051948,0.001141
9702005,9702005,,4,9,13,4,9,13,0.000024,0.000015,0,10455,4,0.000014,11,0.2125,0.275072,556.304519,0.173077,0.001038
9710114,9710114,,17,18,35,17,18,35,0.000026,0.000036,0,10451,17,0.000028,11,0.190403,0.23884,25350.033297,0.156303,0.004844
9711023,9711023,,30,10,40,30,10,40,0.000004,0.000007,0,10450,17,0.00004,12,0.161136,0.192574,1865.219318,0.262179,0.008948
9711057,9711057,,22,12,34,22,12,34,0.00001,0.000004,0,10453,17,0.000032,12,0.145646,0.179834,2240.524234,0.270053,0.006754
9711096,9711096,,24,14,38,24,14,38,0.000011,0.000007,0,10454,17,0.000034,12,0.161863,0.196897,1583.03646,0.243954,0.006966
9709032,9709032,,8,19,27,8,19,27,0.000001,0.000041,0,10449,17,0.000024,11,0.191188,0.241827,10682.171532,0.172365,0.002819
9712006,9712006,,17,15,32,17,15,32,0.000003,0.000009,0,10458,17,0.000027,12,0.170944,0.209307,11444.682157,0.208669,0.004879
9801042,9801042,,24,18,42,24,18,42,0.000004,0.000013,0,10462,17,0.00003,12,0.155431,0.197547,11740.407486,0.223577,0.006825
9412012,9412012,,6,1,7,6,1,7,0,0.000001,0,10433,17,0.000023,1,1,1,68.820654,0.190476,0.001824
9803007,9803007,,12,18,30,12,18,30,0.000001,0.000004,0,10465,17,0.000019,12,0.162823,0.198958,2594.971245,0.287356,0.003272
9807026,9807026,,10,21,31,10,21,31,0.000011,0.000006,0,10470,17,0.000016,12,0.166833,0.206104,2219.92315,0.273118,0.002653
9810130,9810130,,2,1,3,2,1,3,0,0,0,10479,17,0.000012,6,0.252809,0.301296,3929.208817,0.166667,0.000634
9811044,9811044,,4,14,18,4,14,18,0.000002,0.000003,0,10476,17,0.000012,12,0.163867,0.200177,145.60294,0.297386,0.001126
9809194,9809194,,11,9,20,11,9,20,0.000001,0.000002,0,10468,17,0.000019,12,0.166335,0.198092,2926.667664,0.260526,0.003021
9810248,9810248,,6,10,16,6,10,16,0.000001,0.000004,0,10475,17,0.000014,13,0.147795,0.176488,169.462317,0.291667,0.001617
9405006,9405006,,2,2,4,2,2,4,0,0,0,10471,17,0.000012,1,1,1,0,0.416667,0.00054
9201013,9201013,,49,0,49,49,0,49,0.001481,0,0,160,4,0.000382,0,0,0,0,0.045068,0.016024
9404005,9404005,,12,8,20,12,8,20,0.00016,0.000076,0,5463,4,0.000019,2,0.833333,0.9,1276.940299,0.097368,0.003305
1111,1111,,17,20,37,17,20,37,0.000857,0.003647,0,10490,30,0.000023,13,0.19839,0.218569,21650.553473,0.168919,0.005524
9909132,9909132,,18,5,23,18,5,23,0.00115,0.001667,0,10487,30,0.000025,12,0.207018,0.226725,13950.138139,0.16996,0.006028
9911245,9911245,,24,17,41,24,17,41,0.00132,0.005089,0,10489,30,0.000028,12,0.209286,0.23155,10585.310177,0.157317,0.009611
9912293,9912293,,21,6,27,21,6,27,0.001173,0.001785,0,10488,30,0.000025,12,0.205003,0.224128,5297.01829,0.168091,0.0069
9612120,9612120,,25,19,44,25,19,44,0.003266,0.007939,0,3323,2,0.000059,11,0.219024,0.25494,127031.88628,0.129493,0.012463
9904133,9904133,,24,39,63,24,39,63,0.002142,0.021603,0,8510,30,0.00004,14,0.232283,0.263624,305121.895929,0.080389,0.010275
9707118,9707118,,33,12,45,33,12,45,0.00209,0.002071,0,5150,10,0.000043,14,0.193341,0.22791,56247.06177,0.089394,0.011227
1112,1112,,16,8,24,16,8,24,0.0009,0.001062,0,10491,0,0.000018,13,0.175,0.196398,402.98402,0.137681,0.004202
9212049,9212049,,58,0,58,58,0,58,0.001469,0,0,325,0,0.000254,0,0,0,0,0.041742,0.020351
9805005,9805005,,13,6,19,13,6,19,0.000461,0.000057,0,8719,0,0.000021,13,0.176455,0.195103,5015.613784,0.108187,0.003974
9307121,9307121,,5,13,18,5,13,18,0.000583,0.000985,0,324,13,0.000042,2,0.724138,0.809524,330.063591,0.133987,0.003549
9402115,9402115,,10,1,11,10,1,11,0.000133,0.000056,0,1177,0,0.000068,1,1,1,29.005874,0,0.002903
9611149,9611149,,16,22,38,16,22,38,0.000247,0.000205,0,4940,0,0.000028,11,0.19687,0.228846,42712.235744,0.123044,0.004353
9702105,9702105,,17,17,34,17,17,34,0.000198,0.001573,0,7631,0,0.00005,12,0.21188,0.242717,28561.016691,0.09893,0.004676
1114,1114,,3,19,22,3,19,22,0.000049,0.001346,0,10497,13,0.000011,12,0.190865,0.217673,23546.273102,0.108225,0.000755
9402031,9402031,,50,28,78,50,28,78,0.001154,0.000357,0,241,13,0.000133,2,0.71875,0.804348,46487.298603,0.070263,0.019593
9411242,9411242,,19,5,24,19,5,24,0.000359,0.000548,0,2222,13,0.000029,5,0.323308,0.376873,171.039202,0.231884,0.005966
9510092,9510092,,8,12,20,8,12,20,0.000197,0.000579,0,2263,13,0.000016,8,0.244114,0.290627,118563.402828,0.160526,0.003073
9603015,9603015,,8,7,15,8,7,15,0.000886,0.000539,0,3272,13,0.000014,8,0.231129,0.280512,2532.705682,0.157143,0.002109
9709071,9709071,,4,33,37,4,33,37,0.000066,0.00151,0,5842,13,0.000012,13,0.182884,0.220616,32433.027869,0.123874,0.001047
9811033,9811033,,12,22,34,12,22,34,0.000823,0.013756,0,8393,1,0.000022,12,0.188932,0.214047,198132.990072,0.111408,0.002926
9906123,9906123,,3,7,10,3,7,10,0.000054,0.011269,0,10496,1,0.000012,13,0.186497,0.208498,2857.26028,0.088889,0.000678
9201039,9201039,,16,0,16,16,0,16,0.000132,0,0,52,13,0.000079,0,0,0,0,0.075,0.005708
9202002,9202002,,11,0,11,11,0,11,0.000036,0,0,240,13,0.000063,0,0,0,0,0.081818,0.004223
9203059,9203059,,20,0,20,20,0,20,0.000199,0,0,97,5,0.000083,0,0,0,0,0.086842,0.006045
9204011,9204011,,14,0,14,14,0,14,0.000026,0,0,43,13,0.000284,0,0,0,0,0.098901,0.004818
9209023,9209023,,46,3,49,46,3,49,0.001283,0.000017,0,232,41,0.000159,1,1,1,14937.092839,0.077806,0.021399
9211061,9211061,,31,5,36,31,5,36,0.000661,0.000022,0,231,41,0.000106,2,0.857143,0.916667,7034.198113,0.104762,0.012419
9310112,9310112,,97,1,98,97,1,98,0.004397,0.000006,0,235,41,0.000161,1,1,1,5125.461572,0.049758,0.036977
9305055,9305055,,10,1,11,10,1,11,0.000067,0.000021,0,2226,13,0.000026,1,1,1,13.041808,0.090909,0.002953
9409011,9409011,,27,6,33,27,6,33,0.001563,0.000584,0,841,13,0.000052,5,0.323782,0.387758,1852.762378,0.174242,0.00942
9409177,9409177,,2,5,7,2,5,7,0.000016,0.000148,0,501,13,0.000014,5,0.32133,0.366954,495.001452,0.238095,0.000598
9509013,9509013,,2,19,21,2,19,21,0.000017,0.000777,0,2233,41,0.000012,7,0.313627,0.383014,28143.919954,0.207143,0.000728
9407113,9407113,,6,4,10,6,4,10,0.00003,0.000001,0,2814,13,0.000016,2,0.625,0.7,7957.695465,0.1,0.001535
9601016,9601016,,4,9,13,4,9,13,0.000025,0.003018,0,3838,13,0.000025,8,0.237624,0.275587,70173.252767,0.089744,0.001457
9601096,9601096,,12,20,32,12,20,32,0.001005,0.000757,0,2815,13,0.000035,9,0.228268,0.287051,57101.689797,0.152218,0.003711
9602162,9602162,,11,27,38,11,27,38,0.000176,0.000898,0,3317,13,0.000018,13,0.180797,0.235588,12284.909342,0.233997,0.003431
9311081,9311081,,44,0,44,44,0,44,0.001724,0,0,243,41,0.000092,0,0,0,0,0.103066,0.01908
9311093,9311093,,23,4,27,23,4,27,0.000385,0.000032,0,242,41,0.000049,4,0.484848,0.583333,400.209371,0.150997,0.008335
9311187,9311187,,22,1,23,22,1,23,0.001928,0.000108,0,266,41,0.00003,4,0.312169,0.338983,132.72392,0.146245,0.012251
9403041,9403041,,23,8,31,23,8,31,0.001136,0.000145,0,255,41,0.000041,6,0.303571,0.383987,892.668992,0.184946,0.009053
9404063,9404063,,46,48,94,46,48,94,0.002381,0.00121,0,275,41,0.000083,4,0.469613,0.583824,100014.352778,0.073896,0.023946
9511024,9511024,,13,11,24,13,11,24,0.000173,0.000683,0,2809,13,0.00002,8,0.236299,0.292293,354.109296,0.233696,0.003704
9512126,9512126,,7,16,23,7,16,23,0.000833,0.00079,0,3276,13,0.000014,8,0.242388,0.307207,16126.437154,0.250988,0.001804
9608023,9608023,,4,26,30,4,26,30,0.000112,0.001342,0,5841,13,0.000012,10,0.20795,0.247418,15852.845042,0.13908,0.000984
9407181,9407181,,4,4,8,4,4,8,0.00036,0.000641,0,5301,1,0.000043,4,0.328042,0.377688,6208.542287,0.196429,0.004851
9603135,9603135,,7,3,10,7,3,10,0.000473,0,0,5352,5,0.000026,3,0.448276,0.538462,37807.45975,0.088889,0.002207
9706032,9706032,,10,23,33,10,23,33,0.001166,0.002056,0,5348,13,0.000021,11,0.194776,0.233408,89844.541058,0.073864,0.003267
9305155,9305155,,2,0,2,2,0,2,0.000016,0,0,5295,5,0.000021,0,0,0,0,0,0.00101
9709143,9709143,,6,2,8,6,2,8,0.000096,0.000006,0,6089,52,0.000027,3,0.533333,0.604167,24523.047879,0.053571,0.002074
9206059,9206059,,2,0,2,2,0,2,0.000234,0,0,6590,8,0.000021,0,0,0,0,0,0.000813
9804129,9804129,,6,29,35,6,29,35,0.001036,0.00386,0,6589,13,0.000019,14,0.192221,0.226797,24233.095082,0.136134,0.003542
9602060,9602060,,24,18,42,24,18,42,0.001745,0.004008,0,1849,0,0.000027,14,0.19884,0.247427,6338.311117,0.160279,0.009193
9705150,9705150,,4,36,40,4,36,40,0.000422,0.003658,0,4623,13,0.000012,13,0.202628,0.249847,4430.93471,0.147436,0.001554
9805182,9805182,,5,26,31,5,26,31,0.001338,0.023554,0,7159,1,0.000012,12,0.204187,0.233926,9767.55103,0.172043,0.001742
9806049,9806049,,6,6,12,6,6,12,0.000779,0.006203,0,7158,1,0.000014,13,0.182336,0.204456,516.127316,0.143939,0.002225
9412144,9412144,,14,9,23,14,9,23,0.001756,0.000656,0,4617,5,0.000027,5,0.294944,0.360952,32629.89359,0.088933,0.004877
9803220,9803220,,9,45,54,9,45,54,0.002877,0.026179,0,5902,1,0.000021,12,0.216313,0.248261,33143.298953,0.302586,0.007237
9803227,9803227,,16,27,43,16,27,43,0.003072,0.01421,0,6585,1,0.000017,14,0.192561,0.223682,27205.045501,0.134551,0.00599
9804095,9804095,,27,32,59,27,32,59,0.005204,0.019952,0,6603,1,0.000025,14,0.202179,0.236676,56941.795768,0.131794,0.009675
9808002,9808002,,8,20,28,8,20,28,0.001904,0.017781,0,7173,1,0.000013,12,0.199399,0.227345,2048.33649,0.252645,0.002614
9205077,9205077,,6,0,6,6,0,6,0.000175,0,0,2872,23,0.000024,0,0,0,0,0.066667,0.001654
9402057,9402057,,28,6,34,28,6,34,0.000228,0.000003,0,2657,22,0.000126,3,0.631579,0.736111,69922.934047,0.044563,0.007189
9411164,9411164,,7,6,13,7,6,13,0.000294,0.000002,0,1658,23,0.000021,2,0.8,0.875,92533.29634,0.089744,0.002487
9803208,9803208,,3,7,10,3,7,10,0.000162,0.000001,0,8392,26,0.000016,10,0.162162,0.227128,149639.329639,0.077778,0.000752
9806119,9806119,,33,10,43,33,10,43,0.003488,0.00093,0,8376,8,0.000033,13,0.172836,0.190978,8905.109593,0.111296,0.012126
9807216,9807216,,27,7,34,27,7,34,0.003545,0.000841,0,8377,8,0.000033,13,0.170806,0.189467,22591.075811,0.182709,0.013591
9901112,9901112,,7,4,11,7,4,11,0.000235,0.000018,0,10495,8,0.000022,13,0.159092,0.173202,14135.458283,0.163636,0.001708
1115,1115,,1,1,2,1,1,2,0.000243,0.000001,0,10498,5,0.00001,4,0.4,0.46875,15.951852,0,0.000226
9210036,9210036,,18,1,19,18,1,19,0.000229,0.000006,0,238,5,0.000161,1,1,1,6,0.114035,0.004953
9301119,9301119,,17,3,20,17,3,20,0.00002,0.000027,0,415,5,0.000075,2,0.8,0.875,1657.914077,0.065789,0.004466
1116,1116,,0,1,1,0,1,1,0,0,1,10500,7,0.00001,1,1,1,0,0,0
9812221,9812221,,1,0,1,1,0,1,0,0,1,10499,7,0.000019,0,0,0,0,0,0.000219
1117,1117,,0,4,4,0,4,4,0,0.000005,0,10509,30,0.00001,12,0.140452,0.159739,0,0,0
9403067,9403067,,17,0,17,17,0,17,0.000346,0,0,5406,30,0.000076,0,0,0,0,0.051471,0.005363
9506041,9506041,,5,6,11,5,6,11,0.000027,0.000014,0,5395,30,0.000019,2,0.75,0.833333,1868.192609,0.081818,0.001259
9606114,9606114,,2,6,8,2,6,8,0.000001,0.000001,0,10508,30,0.000013,11,0.159336,0.179441,1213.597311,0.160714,0.000445
9209044,9209044,,51,0,51,51,0,51,0.000893,0,0,875,30,0.000348,0,0,0,0,0.025098,0.015097
9304157,9304157,,4,0,4,4,0,4,0.000001,0,0,877,30,0.000023,0,0,0,0,0.083333,0.000965
9401145,9401145,,14,2,16,14,2,16,0.000063,0.000011,0,876,30,0.000041,1,1,1,9829.265358,0.083333,0.003402
9402046,9402046,,18,1,19,18,1,19,0.000213,0,0,874,30,0.000067,1,1,1,8449.853298,0.026316,0.00473
9406166,9406166,,4,0,4,4,0,4,0.000002,0,0,5393,30,0.000023,0,0,0,0,0.25,0.001262
9410201,9410201,,5,5,10,5,5,10,0.000002,0.000014,0,5394,30,0.000021,2,0.857143,0.916667,1777.336438,0.177778,0.001517
9212108,9212108,,12,0,12,12,0,12,0.00006,0,0,3144,26,0.000069,0,0,0,0,0.159091,0.003416
9303006,9303006,,22,0,22,22,0,22,0.000017,0,0,1326,5,0.000071,0,0,0,0,0.032468,0.005608
9307074,9307074,,5,13,18,5,13,18,0.000007,0.000067,0,3870,5,0.000032,3,0.714286,0.816667,38019.421048,0.026144,0.001281
9304023,9304023,,20,1,21,20,1,21,0.000086,0.000003,0,2698,30,0.000099,1,1,1,346.367329,0.059524,0.005062
9402048,9402048,,12,2,14,12,2,14,0.000017,0.000003,0,10501,30,0.000034,1,1,1,8.625,0.120879,0.002816
9510038,9510038,,3,5,8,3,5,8,0,0.000002,0,10506,30,0.000015,2,0.857143,0.916667,7.666667,0.178571,0.000704
9512171,9512171,,5,4,9,5,4,9,0.000001,0.000001,0,10504,30,0.000017,2,0.833333,0.9,6.583333,0.25,0.001175
9512215,9512215,,13,1,14,13,1,14,0.00001,0.00001,0,6609,30,0.000051,1,1,1,134.089278,0.043956,0.003155
9603045,9603045,,5,11,16,5,11,16,0.000001,0.000005,0,10507,30,0.000017,10,0.188963,0.220655,6908.524387,0.1875,0.001155
1118,1118,,10,3,13,10,3,13,0.000683,0.0012,0,10510,30,0.000026,12,0.201273,0.2204,5249.841722,0.147436,0.005417
1119,1119,,1,1,2,1,1,2,0.000011,0.000026,0,10511,25,0.000012,3,0.373832,0.395833,35.291478,0,0.000226
9206055,9206055,,15,1,16,15,1,16,0.000198,0.00001,0,103,5,0.000111,1,1,1,143.869276,0.1125,0.006085
9210012,9210012,,18,4,22,18,4,22,0.000061,0.000038,0,104,13,0.000208,2,0.543478,0.58,10101.72334,0.060606,0.006515
9210050,9210050,,13,6,19,13,6,19,0.000267,0.000092,0,81,13,0.000188,1,1,1,22021.304074,0.070175,0.008787
1121,1121,,1,16,17,1,16,17,0,0.000077,0,10515,4,0.000012,16,0.155112,0.173511,5115.998229,0.110294,0.000219
9308090,9308090,,16,1,17,16,1,17,0.00027,0.000005,0,2431,0,0.000056,1,1,1,30.040868,0.172794,0.004738
9408149,9408149,,12,3,15,12,3,15,0.000024,0.000016,0,2470,0,0.000025,3,0.583333,0.690476,21.881574,0.22381,0.003145
9412125,9412125,,7,1,8,7,1,8,0.000009,0.000003,0,2469,0,0.000023,2,0.666667,0.75,115.852975,0.232143,0.001841
9606052,9606052,,10,10,20,10,10,20,0.000247,0.000112,0,2471,0,0.00002,8,0.209691,0.242234,10271.646035,0.184211,0.002806
9606135,9606135,,12,11,23,12,11,23,0.00025,0.000107,0,2472,0,0.000023,8,0.210572,0.245481,11182.487809,0.162055,0.003279
9608084,9608084,,13,14,27,13,14,27,0.000238,0.003106,0,4018,4,0.00005,15,0.150759,0.186249,9454.600923,0.141026,0.004137
9608157,9608157,,5,13,18,5,13,18,0.000224,0.000084,0,3618,4,0.000013,12,0.171891,0.211827,95755.2013,0.137255,0.001752
9701134,9701134,,6,1,7,6,1,7,0.000044,0.000003,0,8586,10,0.000017,16,0.131098,0.151175,235.902419,0.142857,0.001429
9803099,9803099,,4,1,5,4,1,5,0.000082,0,0,8594,22,0.000013,17,0.144109,0.155057,19001.063372,0,0.001179
9903243,9903243,,7,3,10,7,3,10,0.000106,0.000017,0,10512,4,0.000017,15,0.166523,0.182723,12426.594762,0.188889,0.001738
9905062,9905062,,6,7,13,6,7,13,0.000036,0.000068,0,10513,4,0.000016,16,0.149376,0.164493,1123.11549,0.211538,0.001503
9906141,9906141,,6,8,14,6,8,14,0.000111,0.000037,0,10514,4,0.000014,15,0.169902,0.188275,8516.928352,0.181319,0.001476
9508043,9508043,,7,14,21,7,14,21,0.000246,0.003409,0,2485,4,0.000072,10,0.197271,0.238859,109654.128729,0.183333,0.002673
9602021,9602021,,12,9,21,12,9,21,0.000626,0.002805,0,4017,4,0.000019,15,0.152233,0.187708,25331.004639,0.2,0.003358
9505113,9505113,,14,7,21,14,7,21,0.000002,0.000003,0,3617,28,0.00005,3,0.714286,0.833333,43024.853138,0.116667,0.003465
9506184,9506184,,3,9,12,3,9,12,0.000001,0.000031,0,3609,26,0.000015,7,0.234188,0.272211,68400.267871,0.189394,0.000731
9602031,9602031,,33,13,46,33,13,46,0.000764,0.002409,0,3052,4,0.000042,10,0.183403,0.234884,1254.417073,0.189372,0.010584
9602035,9602035,,12,12,24,12,12,24,0.000186,0.000791,0,3596,4,0.000018,10,0.178402,0.225918,1335.090801,0.242754,0.003417
9602180,9602180,,24,4,28,24,4,28,0.000479,0.000355,0,3051,4,0.000053,10,0.179153,0.215895,24119.430548,0.130952,0.007666
9607210,9607210,,34,19,53,34,19,53,0.000913,0.000855,0,3598,4,0.000033,11,0.174481,0.218124,4106.475239,0.157837,0.010451
9801062,9801062,,7,11,18,7,11,18,0.000013,0.000219,0,8593,22,0.00004,16,0.168333,0.186954,36339.133903,0.117647,0.001789
9608197,9608197,,15,8,23,15,8,23,0.000792,0.001803,0,2674,0,0.000029,10,0.203426,0.229406,3475.691372,0.150198,0.005433
9711178,9711178,,10,7,17,10,7,17,0.000156,0.000066,0,8596,0,0.000025,12,0.181024,0.207787,3899.425862,0.113971,0.00262
9805133,9805133,,9,14,23,9,14,23,0.000256,0.000182,0,8598,0,0.000019,16,0.169775,0.198384,14588.43488,0.106719,0.002533
1122,1122,,24,30,54,24,30,54,0.005408,0.019074,0,10521,1,0.000019,12,0.213657,0.240406,33546.407982,0.139413,0.008094
9810008,9810008,,43,18,61,43,18,61,0.00885,0.017122,0,7861,1,0.000043,13,0.185911,0.209849,54549.089364,0.121038,0.016703
9905180,9905180,,16,34,50,16,34,50,0.003083,0.022749,0,9628,1,0.000015,14,0.212885,0.245206,16188.50366,0.102857,0.005095
9905200,9905200,,17,32,49,17,32,49,0.003574,0.017145,0,9629,1,0.000018,11,0.23337,0.265523,18535.924935,0.165816,0.005461
9906127,9906127,,56,19,75,56,19,75,0.009724,0.008479,0,9594,1,0.000047,11,0.227021,0.256694,43699.37126,0.098198,0.019384
9906216,9906216,,7,38,45,7,38,45,0.001594,0.018673,0,9633,1,0.000013,11,0.234923,0.268838,29759.298623,0.178788,0.002063
9908066,9908066,,9,13,22,9,13,22,0.001829,0.00847,0,10518,1,0.000014,11,0.228533,0.257606,18430.177831,0.209957,0.002478
9911060,9911060,,10,12,22,10,12,22,0.001628,0.007342,0,9654,1,0.000017,12,0.198526,0.218201,22213.115303,0.222944,0.003139
9911152,9911152,,18,15,33,18,15,33,0.003965,0.003897,0,10516,1,0.000016,11,0.229486,0.259376,11346.844062,0.147727,0.005842
9912013,9912013,,11,27,38,11,27,38,0.002606,0.019117,0,10517,1,0.000014,12,0.21162,0.235869,14869.681089,0.162873,0.003571
9912191,9912191,,8,19,27,8,19,27,0.00204,0.017809,0,10520,1,0.000013,12,0.208394,0.231494,11539.16568,0.235043,0.002335
2125,2125,,12,28,40,12,28,40,0.002867,0.020875,0,10528,1,0.000014,13,0.225422,0.25949,35333.594084,0.153846,0.003499
1131,1131,,18,29,47,18,29,47,0.002695,0.02003,0,10527,1,0.00002,11,0.229066,0.26181,17925.941004,0.156337,0.006239
1177,1177,,9,29,38,9,29,38,0.002294,0.017819,0,10523,1,0.000013,11,0.228984,0.260172,9151.188078,0.150782,0.002793
3147,3147,,25,47,72,25,47,72,0.005635,0.026095,0,10571,1,0.00002,13,0.214321,0.243231,83302.9145,0.129304,0.008448
1193,1193,,14,21,35,14,21,35,0.003266,0.017961,0,10570,1,0.000016,12,0.212116,0.235566,170584.087545,0.211765,0.004165
2111,2111,,10,21,31,10,21,31,0.001906,0.017215,0,10562,1,0.000015,12,0.207863,0.232902,7398.792752,0.180645,0.00287
2230,2230,,65,35,100,65,35,100,0.013778,0.022556,0,10541,1,0.00004,14,0.205755,0.233481,105120.979591,0.086869,0.021655
9905177,9905177,,92,6,98,92,6,98,0.011463,0.001268,0,9060,8,0.000145,13,0.165981,0.181133,10622.898532,0.08279,0.036145
9905227,9905227,,17,34,51,17,34,51,0.003268,0.025125,0,8676,1,0.000021,11,0.231084,0.264287,23270.307131,0.141569,0.004891
9906022,9906022,,98,16,114,98,16,114,0.01311,0.018394,0,9065,8,0.000132,13,0.183616,0.209072,83524.218509,0.085623,0.039274
9911002,9911002,,41,15,56,41,15,56,0.006236,0.017455,0,10537,8,0.000064,13,0.1822,0.202126,17449.988804,0.149675,0.016802
9912209,9912209,,9,34,43,9,34,43,0.00181,0.023039,0,10535,1,0.000015,11,0.230399,0.262522,14877.521417,0.166667,0.002562
9305123,9305123,,2,1,3,2,1,3,0.000277,0.00001,0,1425,5,0.000039,1,1,1,654.98631,0,0.001922
9510029,9510029,,17,6,23,17,6,23,0.000688,0.000058,0,1424,5,0.000103,8,0.25,0.296401,47183.92716,0.039526,0.006285
9511227,9511227,,12,11,23,12,11,23,0.00228,0.001504,0,1674,5,0.000073,8,0.264768,0.323539,138776.941721,0.090909,0.007589
9308020,9308020,,31,7,38,31,7,38,0.001088,0.000046,0,6510,5,0.000079,2,0.733333,0.818182,8743.1775,0.125889,0.010287
9705236,9705236,,51,3,54,51,3,54,0.001932,0.000023,0,6508,5,0.00011,4,0.410256,0.505208,694.197954,0.132075,0.016191
9706009,9706009,,44,3,47,44,3,47,0.001779,0.000046,0,6511,5,0.000078,5,0.35443,0.432143,280.36051,0.174376,0.014082
9706143,9706143,,34,28,62,34,28,62,0.001963,0.000623,0,6527,5,0.00006,17,0.170681,0.220601,161628.787845,0.105764,0.011008
9707025,9707025,,22,7,29,22,7,29,0.001255,0.000095,0,6532,5,0.000045,18,0.148184,0.179628,26534.635723,0.23399,0.007566
9707041,9707041,,38,6,44,38,6,44,0.001653,0.000104,0,6533,5,0.00005,18,0.151613,0.183646,37756.19282,0.176004,0.011623
9801052,9801052,,7,8,15,7,8,15,0.000849,0.000299,0,7859,5,0.000018,18,0.147193,0.177551,655.73602,0.22381,0.002228
9802029,9802029,,20,7,27,20,7,27,0.00154,0.00009,0,7482,5,0.000028,19,0.133122,0.156871,21199.328038,0.198006,0.006496
9802043,9802043,,11,14,25,11,14,25,0.001275,0.000284,0,7860,5,0.000019,13,0.191476,0.218564,20799.208968,0.176667,0.003359
9804031,9804031,,16,21,37,16,21,37,0.003255,0.019968,0,6555,1,0.000031,13,0.205222,0.236557,24573.221182,0.163664,0.007825
9808085,9808085,,20,4,24,20,4,24,0.001375,0.011501,0,7892,1,0.000051,15,0.1791,0.204062,4697.88197,0.148551,0.007142
9809035,9809035,,29,3,32,29,3,32,0.003565,0.00106,0,7893,1,0.000055,14,0.164198,0.181742,15388.664847,0.123992,0.010325
9812202,9812202,,7,3,10,7,3,10,0.001207,0.000095,0,7897,1,0.000019,14,0.160527,0.174723,19980.866083,0.244444,0.002711
9310069,9310069,,4,0,4,4,0,4,0.000413,0,0,933,13,0.000015,0,0,0,0,0,0.001723
9809174,9809174,,4,8,12,4,8,12,0.000851,0.017107,0,8140,1,0.000014,13,0.188673,0.215587,26422.77564,0.234848,0.001266
9904197,9904197,,26,24,50,26,24,50,0.005595,0.021708,0,7966,1,0.000029,13,0.217179,0.25272,54596.531981,0.119184,0.007931
9902156,9902156,,1,30,31,1,30,31,0.000267,0.018291,0,9627,1,0.00001,12,0.205598,0.236971,1042.867487,0.172043,0.000344
9809040,9809040,,1,3,4,1,3,4,0.0001,0.000088,0,9593,3,0.000012,11,0.167605,0.192798,86.610857,0.25,0.000679
9903229,9903229,,29,6,35,29,6,35,0.003844,0.000531,0,9591,1,0.000032,14,0.170152,0.18763,638.598735,0.151261,0.008926
9904148,9904148,,21,7,28,21,7,28,0.002733,0.000705,0,9592,1,0.000022,14,0.172643,0.18975,232.486332,0.218254,0.006385
9810014,9810014,,11,21,32,11,21,32,0.000462,0.000583,0,9632,4,0.000015,16,0.146234,0.168609,16853.901976,0.210685,0.002779
9812014,9812014,,16,34,50,16,34,50,0.003124,0.005733,0,6713,2,0.000016,13,0.196928,0.231043,17099.326782,0.099184,0.004943
9906054,9906054,,15,18,33,15,18,33,0.002845,0.01159,0,9641,1,0.000023,14,0.190085,0.212618,121183.294173,0.107008,0.005182
9602093,9602093,,3,1,4,3,1,4,0.000223,0,0,3826,23,0.000021,1,1,1,1003.976082,0.083333,0.000993
9910040,9910040,,21,23,44,21,23,44,0.003365,0.018933,0,9653,1,0.000021,12,0.206556,0.229972,77534.10896,0.163848,0.005659
9910113,9910113,,13,8,21,13,8,21,0.002794,0.007387,0,9643,1,0.000017,11,0.228613,0.257973,32081.859527,0.209524,0.005007
9910124,9910124,,17,13,30,17,13,30,0.003752,0.008142,0,9597,1,0.000019,12,0.193926,0.214332,1772.0501,0.158621,0.006017
9908065,9908065,,14,45,59,14,45,59,0.002519,0.018534,0,9642,1,0.000017,11,0.237748,0.270429,53051.577564,0.107832,0.004364
9908022,9908022,,16,29,45,16,29,45,0.002279,0.020233,0,9645,1,0.00002,11,0.229054,0.260799,26877.737619,0.158586,0.004872
9909197,9909197,,13,9,22,13,9,22,0.002089,0.001917,0,9595,1,0.000019,12,0.19043,0.208683,489.114694,0.166667,0.004032
9902184,9902184,,10,8,18,10,8,18,0.001262,0.012062,0,10519,1,0.000017,13,0.185998,0.209269,104179.849535,0.150327,0.002976
1123,1123,,9,22,31,9,22,31,0.000721,0.002863,0,10585,3,0.000015,13,0.201973,0.22782,60633.4672,0.17957,0.003186
9904157,9904157,,6,1,7,6,1,7,0.000149,0.000005,0,10584,13,0.000016,12,0.178585,0.194957,1623.851467,0.095238,0.001519
9905185,9905185,,1,1,2,1,1,2,0.000034,0,0,10583,23,0.00001,1,1,1,2853.547427,0,0.000293
9910241,9910241,,4,10,14,4,10,14,0.000177,0.001142,0,10581,3,0.000013,14,0.192636,0.217559,475.010873,0.21978,0.001508
9911173,9911173,,6,30,36,6,30,36,0.000225,0.003873,0,10580,3,0.000012,13,0.20151,0.232124,3930.145599,0.188889,0.001543
11116,11116,,6,4,10,6,4,10,0.000241,0.001331,0,10607,2,0.000014,14,0.175129,0.194301,2601.975171,0.266667,0.001666
5165,5165,,8,21,29,8,21,29,0.000475,0.002252,0,10606,2,0.000019,13,0.202416,0.228508,31494.885516,0.084975,0.002022
9406202,9406202,,13,0,13,13,0,13,0.000325,0,0,5532,2,0.000076,0,0,0,0,0.173077,0.003912
9710213,9710213,,5,38,43,5,38,43,0.000151,0.001449,0,5531,4,0.000026,16,0.168661,0.193365,54720.474399,0.215947,0.001618
9709219,9709219,,18,18,36,18,18,36,0.001527,0.003278,0,7652,0,0.000032,15,0.184634,0.21454,5416.904503,0.14127,0.009555
9802199,9802199,,21,12,33,21,12,33,0.001294,0.000565,0,6712,2,0.000019,14,0.195721,0.225264,2992.317226,0.152462,0.006182
9804208,9804208,,29,42,71,29,42,71,0.003909,0.014062,0,7438,0,0.000023,11,0.212706,0.249635,31421.586486,0.108048,0.009301
9806120,9806120,,54,37,91,54,37,91,0.004738,0.005962,0,6890,13,0.00004,14,0.207171,0.244457,126706.035063,0.06337,0.018652
9812210,9812210,,8,20,28,8,20,28,0.000329,0.007123,0,8258,0,0.000014,12,0.186616,0.21595,3174.37698,0.152116,0.002311
9903118,9903118,,7,15,22,7,15,22,0.000448,0.004881,0,8067,1,0.00003,11,0.217382,0.249443,19842.763598,0.132035,0.002169
9808074,9808074,,30,14,44,30,14,44,0.003823,0.002075,0,7731,2,0.000032,11,0.218471,0.247757,18780.334516,0.112579,0.013449
9812071,9812071,,59,18,77,59,18,77,0.005831,0.005133,0,7732,0,0.000048,11,0.219001,0.24898,43440.090278,0.085099,0.023884
9812088,9812088,,48,21,69,48,21,69,0.005119,0.005933,0,7733,2,0.00004,11,0.221867,0.252073,35878.108631,0.091858,0.019786
9812149,9812149,,23,8,31,23,8,31,0.002443,0.000969,0,7734,2,0.000029,12,0.189997,0.211254,916.374697,0.197849,0.010543
9812101,9812101,,14,0,14,14,0,14,0,0,0,10582,23,0.000084,0,0,0,0,0.208791,0.003431
9710004,9710004,,6,25,31,6,25,31,0.000822,0.008241,0,4920,0,0.000015,13,0.193286,0.224847,9662.130622,0.119355,0.002948
9812084,9812084,,6,4,10,6,4,10,0.000523,0.001274,0,8617,3,0.000013,14,0.190403,0.208743,730.230918,0.2,0.002131
9903140,9903140,,9,44,53,9,44,53,0.001225,0.00851,0,8621,2,0.000013,13,0.224639,0.262415,30174.102298,0.095428,0.0027
9905034,9905034,,5,36,41,5,36,41,0.000472,0.006394,0,9970,3,0.000013,14,0.20609,0.240028,14258.277656,0.140244,0.002454
9905044,9905044,,2,12,14,2,12,14,0.000224,0.002053,0,9968,3,0.000011,13,0.196689,0.219909,999.218989,0.252747,0.000707
9905055,9905055,,3,32,35,3,32,35,0.000422,0.008401,0,8503,2,0.000013,13,0.202352,0.231912,9493.706838,0.217647,0.001827
9907128,9907128,,3,21,24,3,21,24,0.000873,0.004943,0,9967,2,0.000011,15,0.188647,0.216734,1644.632109,0.257246,0.001518
9901055,9901055,,9,22,31,9,22,31,0.000651,0.004495,0,10572,2,0.000014,14,0.196469,0.22683,7968.396941,0.127957,0.002623
9908094,9908094,,12,39,51,12,39,51,0.000581,0.003408,0,10578,2,0.000015,13,0.213454,0.250213,35630.869229,0.111765,0.003098
9910266,9910266,,10,19,29,10,19,29,0.000505,0.001738,0,10579,3,0.000014,14,0.193166,0.220156,21389.832746,0.229064,0.003318
1124,1124,,6,26,32,6,26,32,0.000026,0.001953,0,10629,17,0.000021,11,0.190013,0.218689,24160.175797,0.08871,0.001606
9208032,9208032,,18,0,18,18,0,18,0.000026,0,0,3607,5,0.000156,0,0,0,0,0.039216,0.004515
9301002,9301002,,18,1,19,18,1,19,0.000448,0,0,3608,5,0.000047,1,1,1,1902.246755,0.096491,0.004827
9302133,9302133,,53,0,53,53,0,53,0.000156,0,0,1562,17,0.000371,0,0,0,0,0.085631,0.014927
9303041,9303041,,10,1,11,10,1,11,0.000427,0,0,4183,5,0.000047,1,1,1,289.319557,0.081818,0.002902
9303149,9303149,,11,2,13,11,2,13,0.000026,0,0,4239,17,0.000034,1,1,1,269.182053,0.083333,0.002875
9307045,9307045,,40,1,41,40,1,41,0.001437,0.000002,0,1564,17,0.00014,1,1,1,5293.037599,0.115854,0.011949
9312047,9312047,,36,4,40,36,4,40,0.000996,0.00002,0,1570,17,0.000069,1,1,1,2292.572627,0.102564,0.009301
9312158,9312158,,22,2,24,22,2,24,0.000094,0.000019,0,1568,17,0.000053,1,1,1,28.856469,0.117754,0.005956
9401096,9401096,,24,2,26,24,2,26,0.00014,0.000019,0,1565,17,0.000043,1,1,1,3.703968,0.135385,0.006165
9401137,9401137,,14,8,22,14,8,22,0.000031,0.000009,0,4244,17,0.000033,3,0.566667,0.696078,12321.855565,0.103896,0.003755
9612069,9612069,,3,5,8,3,5,8,0.000025,0.00004,0,10628,17,0.000017,7,0.209073,0.257165,3136.556298,0.089286,0.000849
9712058,9712058,,5,0,5,5,0,5,0.000026,0,0,7207,17,0.00002,0,0,0,0,0.2,0.001278
9802020,9802020,,2,6,8,2,6,8,0.000024,0.000025,0,10613,17,0.000012,10,0.238251,0.296305,581.759584,0.214286,0.000537
9904012,9904012,,11,3,14,11,3,14,0.00003,0.000019,0,10611,17,0.000032,6,0.335484,0.400962,267.243729,0.247253,0.002882
9907084,9907084,,8,14,22,8,14,22,0.000029,0.00006,0,10614,17,0.000019,10,0.237844,0.315605,1333.104535,0.170996,0.002006
9910232,9910232,,1,2,3,1,2,3,0.000023,0.000018,0,10623,17,0.000011,6,0.294444,0.346541,0,0.5,0.000262
9912246,9912246,,6,8,14,6,8,14,0.000025,0.000004,0,10622,17,0.000019,5,0.414894,0.513675,4604.721106,0.054945,0.001608
9912267,9912267,,8,6,14,8,6,14,0.000029,0.000035,0,10615,17,0.000022,11,0.188026,0.215677,3409.477635,0.269231,0.002045
9204017,9204017,,17,0,17,17,0,17,0.000008,0,0,1208,17,0.000075,0,0,0,0,0.036765,0.004415
9204018,9204018,,28,0,28,28,0,28,0.000023,0,0,1205,17,0.00022,0,0,0,0,0.079365,0.007432
9203030,9203030,,28,0,28,28,0,28,0.000055,0,0,707,4,0.000134,0,0,0,0,0.070106,0.009437
9204082,9204082,,11,0,11,11,0,11,0.000047,0,0,1218,4,0.000077,0,0,0,0,0.063636,0.003686
9206088,9206088,,19,0,19,19,0,19,0.000208,0,0,3013,17,0.000045,0,0,0,0,0.140351,0.005296
9208030,9208030,,22,1,23,22,1,23,0.000007,0,0,2997,17,0.000052,1,1,1,48.129587,0.075099,0.005418
9303105,9303105,,16,2,18,16,2,18,0.000006,0.000001,0,2996,17,0.000046,2,0.75,0.833333,426.032887,0.120915,0.004067
9303146,9303146,,9,5,14,9,5,14,0.000054,0.000013,0,3001,17,0.000035,2,0.692308,0.777778,1683.982512,0.087912,0.002471
9307120,9307120,,9,0,9,9,0,9,0.000001,0,0,2999,17,0.000024,0,0,0,0,0.222222,0.002241
9310098,9310098,,10,1,11,10,1,11,0.000008,0.000002,0,2789,17,0.000042,1,1,1,0,0.190909,0.002863
9412097,9412097,,1,0,1,1,0,1,0,0,0,10627,17,0.000013,0,0,0,0,0,0.000241
9602002,9602002,,5,4,9,5,4,9,0.000008,0,0,10625,17,0.000022,6,0.25062,0.293399,1305.535062,0.208333,0.001157
9607071,9607071,,5,3,8,5,3,8,0.000123,0.000006,0,10626,17,0.000016,7,0.20396,0.237957,92.960248,0.107143,0.001118
9503134,9503134,,13,11,24,13,11,24,0.000717,0.000072,0,2788,17,0.000022,5,0.483333,0.63046,13804.238319,0.181159,0.003227
9506193,9506193,,20,6,26,20,6,26,0.00005,0.000009,0,4237,4,0.000042,4,0.461538,0.5625,13643.109365,0.078462,0.005066
9605167,9605167,,3,5,8,3,5,8,0.000208,0.000026,0,10612,17,0.000013,5,0.337278,0.394591,13099.541436,0.089286,0.001108
9705202,9705202,,4,13,17,4,13,17,0.000003,0.000038,0,8074,17,0.000015,9,0.263852,0.346954,30910.307488,0.154412,0.000961
9511117,9511117,,6,10,16,6,10,16,0.000004,0.000058,0,8071,5,0.000021,4,0.450704,0.578125,2174.881105,0.116667,0.0016
9206081,9206081,,37,0,37,37,0,37,0.000311,0,0,2280,5,0.000102,0,0,0,0,0.046547,0.009397
9303123,9303123,,37,0,37,37,0,37,0.000024,0,0,1566,5,0.000103,0,0,0,0,0.04955,0.009807
9308099,9308099,,2,2,4,2,2,4,0,0,0,10619,5,0.000015,1,1,1,18.548352,0.25,0.000502
9311078,9311078,,8,4,12,8,4,12,0.000001,0,0,4188,17,0.000036,2,0.75,0.833333,17465.499433,0.128788,0.002184
9408103,9408103,,8,3,11,8,3,11,0.000001,0.000001,0,4189,17,0.000031,4,0.441176,0.527778,6262.175894,0.090909,0.002082
9607153,9607153,,3,7,10,3,7,10,0,0.000002,0,10620,17,0.000022,5,0.439394,0.55,630.401927,0.088889,0.000714
9708019,9708019,,2,2,4,2,2,4,0.000002,0,0,10621,17,0.000012,6,0.32967,0.395,418.322261,0.166667,0.000481
9810193,9810193,,1,3,4,1,3,4,0,0,0,10616,20,0.000012,2,0.714286,0.8,201.262313,0.25,0.000262
9911189,9911189,,1,10,11,1,10,11,0,0.000042,0,10610,17,0.000013,10,0.219167,0.253534,2837.002038,0.227273,0.000275
1125,1125,,2,28,30,2,28,30,0.000254,0.001727,0,10639,2,0.000011,12,0.219152,0.245665,8237.291249,0.08046,0.000452
9607038,9607038,,4,11,15,4,11,15,0.000394,0.005731,0,8493,2,0.000012,10,0.21095,0.242512,88.120795,0.204762,0.000936
9704161,9704161,,10,13,23,10,13,23,0.001063,0.004931,0,7196,2,0.000019,11,0.213993,0.245445,21176.587122,0.081028,0.002976
9710223,9710223,,22,16,38,22,16,38,0.002659,0.004237,0,5694,2,0.000021,13,0.192177,0.221475,10467.585269,0.140825,0.007812
9801202,9801202,,20,11,31,20,11,31,0.001957,0.001836,0,7190,2,0.000021,14,0.174388,0.201025,1965.537804,0.174194,0.006374
9802133,9802133,,13,32,45,13,32,45,0.001387,0.009369,0,6425,2,0.000018,13,0.217104,0.254567,31427.026509,0.09697,0.003993
9803040,9803040,,10,14,24,10,14,24,0.001753,0.008157,0,5808,2,0.000015,14,0.194574,0.22287,2702.109842,0.173913,0.00366
9803041,9803041,,13,27,40,13,27,40,0.00154,0.003451,0,7197,2,0.000015,14,0.19717,0.231104,28701.905401,0.119231,0.00406
9804202,9804202,,12,27,39,12,27,39,0.00182,0.005527,0,6709,2,0.000015,13,0.19819,0.231017,23625.071602,0.139676,0.00381
9805209,9805209,,8,26,34,8,26,34,0.001134,0.006245,0,6710,2,0.000013,13,0.194183,0.229054,8263.262619,0.160428,0.002262
9809204,9809204,,9,60,69,9,60,69,0.000979,0.030079,0,7415,2,0.000019,12,0.223155,0.265205,119779.902317,0.071824,0.002946
9905144,9905144,,7,60,67,7,60,67,0.000557,0.022584,0,10633,2,0.000013,13,0.20842,0.248816,9331.703287,0.08209,0.001698
9906041,9906041,,6,75,81,6,75,81,0.000261,0.02518,0,10638,2,0.000013,13,0.216927,0.255222,13146.57076,0.088889,0.001438
9604182,9604182,,10,5,15,10,5,15,0.000001,0,0,9238,5,0.00008,3,0.424242,0.5,5023.408238,0.114286,0.002483
9608076,9608076,,4,3,7,4,3,7,0,0.000001,0,9729,5,0.000047,4,0.315789,0.380556,1815.902383,0.261905,0.001117
9610209,9610209,,1,1,2,1,1,2,0.000058,0,0,7195,2,0.000011,1,1,1,8885,0,0.000294
9409107,9409107,,6,2,8,6,2,8,0.000174,0.000021,0,1022,2,0.000033,3,0.545455,0.638889,12734.091089,0.125,0.001849
9603093,9603093,,4,2,6,4,2,6,0.000472,0.000003,0,5593,2,0.000014,4,0.421053,0.53125,551.418356,0.133333,0.001316
9612153,9612153,,9,19,28,9,19,28,0.000486,0.009979,0,3405,2,0.000025,13,0.196005,0.232428,569.194359,0.230159,0.003463
9703179,9703179,,12,29,41,12,29,41,0.001868,0.007896,0,3525,13,0.00002,11,0.216166,0.253518,41088.822474,0.181707,0.00522
9602089,9602089,,28,7,35,28,7,35,0.000148,0.000003,0,5637,5,0.000074,3,0.509804,0.596154,26927.204363,0.063866,0.007206
9707200,9707200,,21,31,52,21,31,52,0.002872,0.009349,0,5595,2,0.000022,12,0.207211,0.243607,11780.196184,0.121418,0.007124
9710214,9710214,,13,4,17,13,4,17,0.001549,0.000296,0,5909,1,0.000021,10,0.186706,0.203906,299.470323,0.143382,0.004755
9801038,9801038,,9,28,37,9,28,37,0.000903,0.010746,0,5914,13,0.000021,14,0.211202,0.251561,79709.498704,0.122372,0.00346
9404106,9404106,,5,1,6,5,1,6,0.00011,0,0,6424,28,0.000053,1,1,1,1895.273703,0.066667,0.001262
9303156,9303156,,27,7,34,27,7,34,0.001267,0.000106,0,2939,2,0.000057,1,1,1,1357.555221,0.164884,0.010311
9312168,9312168,,23,5,28,23,5,28,0.000977,0.000065,0,2937,2,0.000045,2,0.777778,0.857143,1032.679381,0.193122,0.009407
9710215,9710215,,15,41,56,15,41,56,0.002184,0.014753,0,5596,2,0.000019,13,0.207059,0.246225,9740.295823,0.153571,0.00557
9710034,9710034,,31,23,54,31,23,54,0.003874,0.004374,0,4899,4,0.000025,15,0.177916,0.215924,32061.664709,0.105171,0.009845
9711009,9711009,,17,6,23,17,6,23,0.001112,0.000739,0,6692,2,0.00002,14,0.182533,0.206886,1713.985864,0.136364,0.004883
9803209,9803209,,54,31,85,54,31,85,0.005824,0.020713,0,6135,2,0.00005,13,0.207026,0.241479,95420.333461,0.064706,0.018407
9804087,9804087,,11,25,36,11,25,36,0.001068,0.008595,0,6708,2,0.000017,15,0.188286,0.220138,47182.565206,0.176984,0.005794
9708081,9708081,,12,5,17,12,5,17,0.000093,0.000005,0,9742,5,0.000034,4,0.382022,0.460784,16592.049703,0.147059,0.00359
9708152,9708152,,15,6,21,15,6,21,0.000401,0.000002,0,9749,5,0.000042,12,0.155304,0.192365,20955.116042,0.042857,0.003682
9803094,9803094,,4,6,10,4,6,10,0.000001,0.00001,0,9750,5,0.000018,17,0.126147,0.144558,27551.210829,0.222222,0.001084
9412163,9412163,,4,3,7,4,3,7,0.000465,0.000487,0,7414,1,0.000012,4,0.427184,0.471591,16267.602395,0.047619,0.001108
9705093,9705093,,23,21,44,23,21,44,0.002135,0.002504,0,5664,2,0.000025,12,0.204007,0.234735,1838.756013,0.156448,0.007719
9203051,9203051,,53,0,53,53,0,53,0.001205,0,0,1344,2,0.000323,0,0,0,0,0.108853,0.018296
9204071,9204071,,35,1,36,35,1,36,0.000965,0.000027,0,1347,2,0.000122,1,1,1,1641.526763,0.139683,0.012752
9601109,9601109,,9,5,14,9,5,14,0.000609,0.003502,0,2667,2,0.000019,14,0.167502,0.204473,1902.302348,0.142857,0.003157
9608094,9608094,,4,8,12,4,8,12,0.000281,0.000599,0,5680,2,0.000012,11,0.195683,0.219763,10364.56459,0.219697,0.001355
9705064,9705064,,14,34,48,14,34,48,0.001584,0.005404,0,5665,2,0.000019,11,0.220253,0.255478,8920.594758,0.171543,0.005019
9712040,9712040,,19,14,33,19,14,33,0.002236,0.002618,0,4915,4,0.000017,17,0.186256,0.218556,18948.980009,0.157197,0.005908
9703099,9703099,,6,52,58,6,52,58,0.001031,0.008145,0,5679,2,0.000013,11,0.233978,0.277596,69294.400845,0.095584,0.002459
9707110,9707110,,6,49,55,6,49,55,0.000768,0.007852,0,5685,2,0.000013,12,0.222578,0.262256,91041.994103,0.145791,0.001987
9807133,9807133,,1,14,15,1,14,15,0.000265,0.000927,0,10632,2,0.00001,15,0.172785,0.199655,43.183542,0.280952,0.000267
9901003,9901003,,38,14,52,38,14,52,0.002172,0.000432,0,8908,2,0.000036,14,0.15852,0.179987,15349.479913,0.146305,0.010403
9904041,9904041,,13,30,43,13,30,43,0.002017,0.005003,0,10631,2,0.000014,13,0.198647,0.230691,20195.016337,0.091362,0.003634
9905031,9905031,,14,7,21,14,7,21,0.001421,0.004399,0,10630,41,0.000018,13,0.183001,0.211536,1254.656915,0.088095,0.004838
9507060,9507060,,22,23,45,22,23,45,0.002331,0.005576,0,2198,26,0.000035,8,0.251347,0.314133,43895.695322,0.067677,0.007673
9904003,9904003,,9,4,13,9,4,13,0.000509,0.000089,0,10637,23,0.000021,14,0.165397,0.184705,12917.585689,0.147436,0.002357
1126,1126,,16,18,34,16,18,34,0.000967,0.00398,0,10640,25,0.000021,11,0.203496,0.226944,7147.011674,0.177362,0.005261
9611204,9611204,,30,35,65,30,35,65,0.001394,0.008543,0,2681,0,0.000031,11,0.229695,0.272754,53481.088213,0.089423,0.009605
9202003,9202003,,9,0,9,9,0,9,0.000165,0,0,1180,0,0.00007,0,0,0,0,0.027778,0.003448
9509077,9509077,,2,1,3,2,1,3,0.000077,0,0,2527,5,0.000021,1,1,1,4458.407673,0,0.001512
9601083,9601083,,3,2,5,3,2,5,0.000092,0.000009,0,2526,0,0.000021,5,0.305882,0.364744,35233.415824,0.15,0.001769
9403179,9403179,,44,11,55,44,11,55,0.003148,0.000284,0,2300,0,0.000108,3,0.538462,0.598639,48752.331159,0.100673,0.017377
9406216,9406216,,77,5,82,77,5,82,0.001733,0.000135,0,2301,0,0.00015,4,0.378788,0.43,10784.178486,0.107347,0.027529
9509074,9509074,,60,7,67,60,7,67,0.001625,0.000153,0,2539,0,0.000106,7,0.252234,0.287973,7724.779971,0.13953,0.023525
9608195,9608195,,55,14,69,55,14,69,0.003037,0.004834,0,2540,0,0.000065,11,0.218198,0.253631,28123.716508,0.112958,0.020961
9609048,9609048,,11,10,21,11,10,21,0.000428,0.000739,0,2663,0,0.000023,10,0.205186,0.231135,32506.099814,0.2,0.004677
9609087,9609087,,32,30,62,32,30,62,0.001572,0.000392,0,2642,0,0.000039,11,0.198268,0.233822,169453.495425,0.142517,0.01354
9610107,9610107,,55,19,74,55,19,74,0.003311,0.001543,0,2664,0,0.000053,11,0.2104,0.243315,75174.83843,0.108293,0.019656
9610166,9610166,,31,23,54,31,23,54,0.001632,0.005021,0,2671,0,0.00004,11,0.213382,0.251532,53214.3931,0.168064,0.013304
9610238,9610238,,64,32,96,64,32,96,0.002859,0.00853,0,2675,0,0.000075,11,0.220256,0.262736,51178.256064,0.083991,0.022531
9610252,9610252,,32,16,48,32,16,48,0.001868,0.005672,0,2672,0,0.000038,11,0.214743,0.251551,21166.956762,0.120124,0.01314
9802190,9802190,,7,10,17,7,10,17,0.000305,0.001777,0,8256,0,0.000017,16,0.178885,0.211982,3082.378045,0.224265,0.001952
9807100,9807100,,7,9,16,7,9,16,0.000322,0.000067,0,7874,0,0.000019,14,0.165152,0.184126,25197.663871,0.158333,0.002386
9701082,9701082,,40,26,66,40,26,66,0.00146,0.00177,0,4555,0,0.000043,11,0.211786,0.248161,64542.657666,0.119114,0.012955
9701154,9701154,,19,32,51,19,32,51,0.000773,0.009735,0,4535,0,0.000028,11,0.229211,0.270524,83524.658645,0.136471,0.007014
9704013,9704013,,13,40,53,13,40,53,0.00145,0.002199,0,4558,0,0.00002,13,0.215469,0.26053,126807.182133,0.114659,0.005066
9705050,9705050,,21,34,55,21,34,55,0.000989,0.000769,0,4559,0,0.000027,14,0.187412,0.224051,57277.209529,0.16633,0.007389
9707003,9707003,,6,18,24,6,18,24,0.000267,0.004203,0,8342,0,0.000023,11,0.211208,0.244196,22317.477454,0.148551,0.002635
9707182,9707182,,21,16,37,21,16,37,0.001398,0.000492,0,4560,0,0.000025,15,0.175041,0.21068,82383.973994,0.150901,0.007269
9708154,9708154,,9,23,32,9,23,32,0.000577,0.005299,0,6113,0,0.000018,13,0.207247,0.243372,11319.068732,0.203629,0.003773
9802057,9802057,,12,27,39,12,27,39,0.000714,0.000436,0,8107,0,0.000021,13,0.194265,0.225274,38180.679184,0.170715,0.004102
9802197,9802197,,3,30,33,3,30,33,0.000252,0.00071,0,8723,0,0.000014,12,0.20988,0.240336,29537.426629,0.232955,0.00175
9809105,9809105,,6,29,35,6,29,35,0.000431,0.001762,0,8717,0,0.000015,13,0.200576,0.233312,7731.63146,0.209244,0.002732
9812052,9812052,,11,32,43,11,32,43,0.000795,0.003936,0,8715,0,0.000017,14,0.208737,0.24507,9440.211081,0.1268,0.004299
9906246,9906246,,17,25,42,17,25,42,0.000645,0.000642,0,9672,0,0.00002,14,0.189348,0.216281,29992.139738,0.080139,0.004635
9908085,9908085,,7,25,32,7,25,32,0.000401,0.003116,0,9667,4,0.000019,14,0.181471,0.206662,59229.178424,0.184476,0.00226
1127,1127,,5,25,30,5,25,30,0.000514,0.021205,0,10641,2,0.000013,11,0.214001,0.242001,19502.1004,0.122989,0.001541
9802179,9802179,,6,21,27,6,21,27,0.000711,0.00446,0,8487,2,0.000018,15,0.198955,0.236897,12904.225435,0.230769,0.001999
9803049,9803049,,10,5,15,10,5,15,0.000477,0.000076,0,8489,2,0.000025,13,0.172669,0.194533,16722.965047,0.052381,0.002627
9501003,9501003,,3,3,6,3,3,6,0.000104,0,0,2982,23,0.000029,1,1,1,36541.866747,0.2,0.002215
9609102,9609102,,28,1,29,28,1,29,0.000811,0.000022,0,3343,2,0.000064,11,0.17669,0.190809,5279.13986,0.099754,0.010847
9610134,9610134,,33,10,43,33,10,43,0.001282,0.004767,0,3352,2,0.000088,12,0.183851,0.213807,71321.954596,0.103544,0.014364
9610226,9610226,,20,7,27,20,7,27,0.001247,0.00114,0,3355,2,0.000051,12,0.174716,0.199898,32951.057381,0.109687,0.009305
9701186,9701186,,14,41,55,14,41,55,0.00112,0.01336,0,3421,2,0.000019,11,0.229494,0.272238,54497.564954,0.121212,0.004922
9712163,9712163,,1,17,18,1,17,18,0.000052,0.004837,0,8486,2,0.000011,11,0.203594,0.23267,0.341292,0.382353,0.000267
9708048,9708048,,3,11,14,3,11,14,0.000012,0.002031,0,5127,0,0.000028,12,0.192298,0.219455,14300.128734,0.104396,0.000884
9709196,9709196,,2,3,5,2,3,5,0.000018,0.001458,0,8488,2,0.000016,16,0.175785,0.202134,1153.134851,0.3,0.000509
9810153,9810153,,5,10,15,5,10,15,0.000244,0.00276,0,7754,0,0.000013,15,0.171295,0.199103,321.446573,0.195238,0.001775
1128,1128,,10,14,24,10,14,24,0.000003,0.000005,0,10705,6,0.000016,16,0.14872,0.167459,3585.14656,0.146739,0.002405
9206034,9206034,,32,0,32,32,0,32,0.000003,0,0,1971,6,0.000297,0,0,0,0,0.083669,0.009446
9301018,9301018,,24,2,26,24,2,26,0.000002,0,0,1983,6,0.000077,1,1,1,1141.044949,0.087692,0.00699
9309137,9309137,,29,6,35,29,6,35,0.000003,0.000004,0,5886,6,0.000071,2,0.75,0.833333,10692.091865,0.045378,0.007139
9310060,9310060,,13,4,17,13,4,17,0.000002,0.000001,0,5889,6,0.000033,4,0.5,0.583333,10035.762333,0.084559,0.003244
9810006,9810006,,18,30,48,18,30,48,0.000178,0.000015,0,10670,6,0.00002,12,0.161068,0.18665,21475.692758,0.082447,0.004435
9902011,9902011,,12,24,36,12,24,36,0.000004,0.000007,0,10698,6,0.000023,13,0.130393,0.153487,26905.55921,0.083333,0.003102
9903072,9903072,,3,12,15,3,12,15,0,0.000002,0,10704,6,0.000013,9,0.209843,0.257363,1438.660884,0.142857,0.000745
9904159,9904159,,12,2,14,12,2,14,0.000003,0,0,10700,6,0.000032,5,0.377358,0.451667,979.351142,0.065934,0.002853
9907125,9907125,,9,11,20,9,11,20,0.000003,0.000005,0,10699,6,0.000016,14,0.117201,0.13523,2810.850774,0.176316,0.002209
9910218,9910218,,17,17,34,17,17,34,0.000028,0.000015,0,10689,6,0.000024,15,0.169797,0.191325,73395.905666,0.120321,0.004357
9912196,9912196,,13,25,38,13,25,38,0.000057,0.00002,0,10701,6,0.000019,16,0.150841,0.172123,5474.030583,0.119488,0.003257
9202020,9202020,,26,0,26,26,0,26,0.000001,0,0,1968,6,0.000459,0,0,0,0,0.095385,0.00841
9207040,9207040,,38,2,40,38,2,40,0.000028,0,0,1970,6,0.000188,1,1,1,6661.587156,0.072436,0.01053
9207069,9207069,,6,1,7,6,1,7,0.000001,0,0,2044,6,0.00003,1,1,1,14.253669,0.142857,0.001734
9210025,9210025,,3,0,3,3,0,3,0.000001,0,0,5885,26,0.000023,0,0,0,0,0,0.000904
9211111,9211111,,15,0,15,15,0,15,0.000317,0,0,2478,4,0.00015,0,0,0,0,0.061905,0.0041
9305024,9305024,,7,1,8,7,1,8,0,0,0,2033,6,0.000027,1,1,1,4754.761178,0.196429,0.002049
9303013,9303013,,27,4,31,27,4,31,0.000003,0.000002,0,1979,6,0.000099,3,0.615385,0.729167,26324.913128,0.11828,0.008348
9303111,9303111,,5,12,17,5,12,17,0.000051,0.000002,0,5888,6,0.000022,3,0.761905,0.864583,2833.37679,0.113971,0.001309
9207061,9207061,,15,0,15,15,0,15,0.000061,0,0,2340,6,0.000099,0,0,0,0,0.157143,0.004514
9208057,9208057,,21,0,21,21,0,21,0.000035,0,0,2352,6,0.000103,0,0,0,0,0.180952,0.006423
9305160,9305160,,41,3,44,41,3,44,0.000153,0.000002,0,2343,6,0.000105,1,1,1,5828.371318,0.084038,0.011573
9307035,9307035,,17,2,19,17,2,19,0.00001,0.000001,0,2353,6,0.000042,1,1,1,500.105691,0.216374,0.004849
9307175,9307175,,12,4,16,12,4,16,0.00001,0.000003,0,2355,6,0.000028,2,0.833333,0.9,530.835122,0.2,0.003517
9310183,9310183,,5,1,6,5,1,6,0,0,0,2374,6,0.00003,2,0.555556,0.6,31004.657863,0.1,0.001563
9404097,9404097,,2,5,7,2,5,7,0.000033,0.000003,0,2385,6,0.000012,2,0.857143,0.916667,2.991209,0.261905,0.000592
9409035,9409035,,12,10,22,12,10,22,0.000029,0.00001,0,2383,6,0.000024,4,0.575758,0.72807,6764.520392,0.179654,0.003475
9202070,9202070,,22,0,22,22,0,22,0.000058,0,0,2342,6,0.000135,0,0,0,0,0.099567,0.006663
9212086,9212086,,32,2,34,32,2,34,0.000162,0.000001,0,2354,6,0.000075,1,1,1,3700.965389,0.107843,0.009199
9304149,9304149,,18,5,23,18,5,23,0.000003,0.000003,0,2361,6,0.000042,3,0.6,0.740741,27626.792679,0.136364,0.005528
9404065,9404065,,10,8,18,10,8,18,0.000023,0.000006,0,2364,6,0.00002,4,0.545455,0.685185,8482.88501,0.22549,0.002959
9405034,9405034,,21,7,28,21,7,28,0.000068,0.000006,0,2379,6,0.000042,4,0.5,0.638889,18092.618101,0.142857,0.005825
9408092,9408092,,11,10,21,11,10,21,0.000034,0.000006,0,2368,6,0.000019,5,0.44,0.575253,36400.595388,0.17381,0.003236
9411103,9411103,,1,3,4,1,3,4,0,0.00001,0,2427,6,0.000011,2,0.714286,0.8,8844.925213,0.166667,0.000377
9412213,9412213,,30,25,55,30,25,55,0.000059,0.000015,0,2425,6,0.000051,7,0.278523,0.391437,105448.409493,0.069697,0.007895
9501078,9501078,,3,9,12,3,9,12,0.000005,0.000011,0,2413,6,0.000013,7,0.266234,0.335438,70577.36027,0.128788,0.000867
9503019,9503019,,7,7,14,7,7,14,0.000006,0.000005,0,2406,6,0.000046,5,0.417476,0.507364,43968.20718,0.043956,0.001905
9504085,9504085,,4,5,9,4,5,9,0,0.000002,0,2351,6,0.000017,3,0.555556,0.644444,49373.498604,0.222222,0.001263
9505085,9505085,,10,2,12,10,2,12,0.000002,0.000002,0,2345,6,0.000028,2,0.625,0.7,126.865292,0.128788,0.002704
9202034,9202034,,7,0,7,7,0,7,0.000003,0,0,2062,6,0.000028,0,0,0,0,0.071429,0.0018
9211134,9211134,,8,2,10,8,2,10,0.000001,0,0,5878,6,0.000023,1,1,1,4967.042117,0.177778,0.002165
9302112,9302112,,6,1,7,6,1,7,0,0,0,10669,2,0.00003,1,1,1,130.588558,0,0.001459
9404030,9404030,,10,8,18,10,8,18,0.000038,0.000009,0,2378,6,0.000023,3,0.615385,0.729167,3729.493828,0.189542,0.002968
9507001,9507001,,10,23,33,10,23,33,0.000123,0.000015,0,10659,6,0.000016,9,0.221116,0.300602,2415.281489,0.125947,0.00252
9604098,9604098,,12,0,12,12,0,12,0.000002,0,0,6786,6,0.000023,0,0,0,0,0.106061,0.003142
9605104,9605104,,10,4,14,10,4,14,0.000024,0.000003,0,6795,6,0.000026,5,0.309417,0.357488,21028.074703,0.10989,0.003011
9607099,9607099,,41,5,46,41,5,46,0.000025,0.000004,0,5893,6,0.000121,6,0.298319,0.343075,62746.795161,0.07971,0.011621
9607167,9607167,,28,2,30,28,2,30,0.000006,0.000002,0,6789,6,0.000057,7,0.240336,0.272061,2577.322637,0.118391,0.007769
9608055,9608055,,3,7,10,3,7,10,0.000038,0.000003,0,6548,6,0.000012,9,0.212696,0.264976,11106.629519,0.277778,0.000885
9608091,9608091,,30,4,34,30,4,34,0.000004,0.000001,0,6790,6,0.000051,7,0.242475,0.282562,2317.813276,0.14795,0.007763
9701118,9701118,,7,15,22,7,15,22,0.000003,0.000008,0,10652,6,0.000016,8,0.233524,0.297232,7792.630039,0.212121,0.00191
9702196,9702196,,5,17,22,5,17,22,0.000087,0.00001,0,10660,6,0.000013,8,0.242742,0.2943,49093.357642,0.214286,0.001314
9703158,9703158,,6,26,32,6,26,32,0.000002,0.000128,0,10668,6,0.000014,11,0.182935,0.209183,133321.682779,0.114919,0.001748
9803248,9803248,,2,4,6,2,4,6,0.000004,0.000004,0,10651,6,0.000011,5,0.396552,0.499275,2.092952,0.333333,0.00059
9805117,9805117,,13,9,22,13,9,22,0.000002,0.000001,0,10650,6,0.00002,10,0.193778,0.234776,2909.328877,0.222944,0.003257
9201032,9201032,,13,0,13,13,0,13,0.000001,0,0,1969,6,0.000179,0,0,0,0,0.166667,0.004019
9204094,9204094,,24,0,24,24,0,24,0.000013,0,0,311,6,0.000181,0,0,0,0,0.030797,0.006657
9206052,9206052,,14,2,16,14,2,16,0.000004,0,0,2358,6,0.000027,1,1,1,936.576204,0.1375,0.003703
9206112,9206112,,10,0,10,10,0,10,0.000002,0,0,2356,6,0.000082,0,0,0,0,0.255556,0.003224
9208011,9208011,,18,1,19,18,1,19,0.000006,0,0,5880,6,0.000028,1,1,1,1479.630853,0.134503,0.004773
9308147,9308147,,8,4,12,8,4,12,0.000002,0.000001,0,4319,6,0.000025,2,0.75,0.833333,5183.310026,0.106061,0.002151
9407117,9407117,,34,3,37,34,3,37,0.00001,0.000001,0,2071,6,0.000116,2,0.666667,0.75,11358.964916,0.102853,0.009682
9408113,9408113,,38,7,45,38,7,45,0.000131,0.000012,0,1986,6,0.000111,3,0.482143,0.574074,25844.018028,0.064141,0.010499
9505102,9505102,,7,6,13,7,6,13,0.000001,0.000003,0,8689,6,0.000018,5,0.383721,0.497475,3436.192068,0.217949,0.001828
9511008,9511008,,11,3,14,11,3,14,0.000003,0.000006,0,7805,6,0.000028,5,0.348485,0.402899,10728.292146,0.126374,0.002966
9601123,9601123,,10,18,28,10,18,28,0.000003,0.000014,0,8686,6,0.000021,7,0.295844,0.410153,23468.876282,0.095238,0.002534
9610150,9610150,,6,0,6,6,0,6,0.000001,0,0,8682,28,0.000034,0,0,0,0,0.033333,0.001497
9706140,9706140,,18,7,25,18,7,25,0.000004,0.000001,0,7829,6,0.000034,9,0.219442,0.263784,75220.460086,0.165,0.005003
9711185,9711185,,4,2,6,4,2,6,0,0.000002,0,10697,6,0.000014,7,0.243612,0.270346,64.916725,0.2,0.001027
9803005,9803005,,14,12,26,14,12,26,0.000004,0.000003,0,8690,6,0.00002,12,0.142579,0.161627,86665.297719,0.089231,0.003595
9807160,9807160,,8,12,20,8,12,20,0.000002,0.000001,0,10696,6,0.000015,10,0.190781,0.243699,3851.859236,0.234211,0.002013
9812211,9812211,,15,8,23,15,8,23,0.000003,0.000002,0,10691,6,0.000036,10,0.202756,0.253047,3544.3268,0.164032,0.004084
9812247,9812247,,13,5,18,13,5,18,0.000023,0.000002,0,10694,6,0.000031,11,0.183296,0.227879,3571.527927,0.205882,0.003648
9410117,9410117,,11,6,17,11,6,17,0.000001,0.000001,0,6775,6,0.000034,2,0.714286,0.8,867.526688,0.125,0.003062
9603011,9603011,,15,17,32,15,17,32,0.000016,0.000002,0,6776,6,0.000034,7,0.285714,0.361455,48174.051965,0.063508,0.003676
9804144,9804144,,1,0,1,1,0,1,0,0,0,10703,6,0.000011,0,0,0,0,0,0.00024
9810026,9810026,,12,9,21,12,9,21,0.000118,0.000005,0,10647,6,0.000019,8,0.229249,0.300855,957.046625,0.095238,0.00286
9902075,9902075,,10,4,14,10,4,14,0.000001,0,0,10702,6,0.000031,7,0.228029,0.275645,381.477186,0.137363,0.002413
9410065,9410065,,9,7,16,9,7,16,0.000039,0.000011,0,4395,22,0.000043,4,0.517241,0.672222,13478.156946,0.0375,0.002275
9512054,9512054,,5,2,7,5,2,7,0,0,0,10105,6,0.000033,2,0.75,0.833333,941.993774,0.071429,0.00127
9702170,9702170,,5,5,10,5,5,10,0.000002,0.000006,0,10645,6,0.000016,8,0.221053,0.276779,546.423877,0.211111,0.001252
9706054,9706054,,11,5,16,11,5,16,0.000002,0.000004,0,10646,6,0.000019,9,0.187019,0.234748,1096.553477,0.183333,0.002639
9205024,9205024,,12,1,13,12,1,13,0.000004,0,0,10688,6,0.000017,1,1,1,6.894981,0.153846,0.00305
9211115,9211115,,14,1,15,14,1,15,0.000005,0,0,5879,6,0.00002,1,1,1,265.540723,0.133333,0.003706
9410140,9410140,,20,5,25,20,5,25,0.000386,0.000012,0,5670,6,0.000039,2,0.647059,0.727273,24207.101678,0.128333,0.005631
9606032,9606032,,30,12,42,30,12,42,0.000141,0.000097,0,6912,6,0.000038,11,0.184317,0.218116,28233.298239,0.106852,0.007739
9612040,9612040,,8,1,9,8,1,9,0.000099,0.000004,0,10672,6,0.000017,1,1,1,45.859617,0.111111,0.002038
9701109,9701109,,15,10,25,15,10,25,0.000065,0.000041,0,10671,6,0.00002,12,0.159283,0.190216,791.493882,0.14,0.003827
9706203,9706203,,14,24,38,14,24,38,0.000087,0.000142,0,10673,6,0.000019,15,0.169697,0.201075,15696.177776,0.104552,0.003551
9711113,9711113,,12,15,27,12,15,27,0.00024,0.000008,0,5900,6,0.000022,12,0.162897,0.185413,274970.962752,0.103989,0.003282
9809052,9809052,,4,33,37,4,33,37,0.000001,0.000315,0,10687,6,0.000013,14,0.195178,0.223626,83552.907625,0.063063,0.001022
9901145,9901145,,5,12,17,5,12,17,0.000058,0.000011,0,10674,6,0.000013,14,0.158955,0.181424,2628.18062,0.121324,0.001288
9904072,9904072,,1,0,1,1,0,1,0,0,0,10644,6,0.000011,0,0,0,0,0,0.000338
9905213,9905213,,1,0,1,1,0,1,0,0,0,10643,6,0.000011,0,0,0,0,0,0.000338
9907039,9907039,,6,5,11,6,5,11,0.000003,0,0,10642,6,0.000015,10,0.180458,0.228962,201.805191,0.181818,0.001547
9211102,9211102,,56,2,58,56,2,58,0.000005,0.000002,0,1975,6,0.000189,3,0.545455,0.638889,2007.226341,0.087417,0.015705
9301046,9301046,,63,6,69,63,6,69,0.000006,0.000002,0,1976,6,0.000202,3,0.666667,0.783333,31182.891503,0.078218,0.017845
9310122,9310122,,28,4,32,28,4,32,0.000278,0.000012,0,5667,6,0.000067,2,0.7,0.785714,3149.214038,0.091734,0.007497
9402038,9402038,,30,0,30,30,0,30,0.000011,0,0,5666,6,0.000099,0,0,0,0,0.145977,0.008131
9412062,9412062,,23,4,27,23,4,27,0.000026,0.000006,0,5674,6,0.000041,3,0.52381,0.636364,3278.520351,0.12963,0.006145
9412127,9412127,,18,14,32,18,14,32,0.000214,0.000012,0,6907,6,0.000028,7,0.273438,0.350639,5709.674823,0.114919,0.004942
9506087,9506087,,18,5,23,18,5,23,0.000028,0.000008,0,5673,6,0.000032,3,0.538462,0.642857,15123.817917,0.177866,0.004628
1129,1129,,9,5,14,9,5,14,0.00019,0.000001,0,10711,23,0.000027,6,0.35,0.466667,1737.316479,0.087912,0.002132
9911063,9911063,,8,5,13,8,5,13,0.000035,0,0,10710,23,0.000023,4,0.390244,0.536458,2495.262791,0.070513,0.001962
9404080,9404080,,3,2,5,3,2,5,0.000001,0.000003,0,4349,22,0.000031,2,0.625,0.7,1822.106194,0.2,0.000821
9502157,9502157,,5,0,5,5,0,5,0,0,0,10709,23,0.000042,0,0,0,0,0,0.001181
9809069,9809069,,2,1,3,2,1,3,0,0,0,10708,23,0.000015,3,0.5,0.583333,106.430303,0.166667,0.0005
1130,1130,,4,10,14,4,10,14,0.000278,0.001437,0,10712,3,0.000012,13,0.187459,0.209429,2196.676716,0.318681,0.001463
9909109,9909109,,9,17,26,9,17,26,0.001532,0.019146,0,8843,1,0.000015,13,0.193333,0.219844,4892.452217,0.196923,0.003633
9805151,9805151,,38,1,39,38,1,39,0.005714,0.000085,0,6676,1,0.000073,10,0.182397,0.195923,1340.688535,0.050607,0.016298
9810142,9810142,,2,49,51,2,49,51,0.000546,0.015413,0,7838,13,0.000011,13,0.198511,0.235363,2207.554878,0.168627,0.000714
9810205,9810205,,2,15,17,2,15,17,0.000515,0.018205,0,10526,1,0.000013,13,0.197532,0.224084,4342.920692,0.191176,0.001909
9903046,9903046,,12,20,32,12,20,32,0.00167,0.001966,0,10524,13,0.000017,11,0.217899,0.25746,14151.768379,0.16129,0.0036
9911195,9911195,,20,13,33,20,13,33,0.002914,0.015767,0,10525,1,0.000021,13,0.18675,0.213221,2775.513342,0.208333,0.006736
9702153,9702153,,18,31,49,18,31,49,0.002464,0.007003,0,4987,13,0.000025,10,0.229595,0.267914,14319.227499,0.166667,0.007087
9308077,9308077,,10,7,17,10,7,17,0.001308,0.00091,0,5261,13,0.000033,4,0.353535,0.421429,7388.59189,0.102941,0.005666
9310011,9310011,,3,5,8,3,5,8,0.00042,0.000666,0,3370,13,0.000011,4,0.340314,0.398718,933.228805,0.25,0.000993
9801064,9801064,,3,22,25,3,22,25,0.000345,0.003534,0,6576,13,0.000012,14,0.184103,0.215256,31987.479158,0.111667,0.000954
9801125,9801125,,7,55,62,7,55,62,0.000992,0.006812,0,6278,13,0.000014,15,0.206876,0.255103,14562.788729,0.129561,0.002354
9801145,9801145,,8,16,24,8,16,24,0.001261,0.011991,0,5388,1,0.000023,14,0.188033,0.218928,15205.474098,0.172101,0.003818
9803064,9803064,,11,25,36,11,25,36,0.00169,0.005758,0,6569,13,0.000019,13,0.203956,0.240308,23435.1733,0.168254,0.003979
9803080,9803080,,13,19,32,13,19,32,0.002507,0.009224,0,6582,13,0.000016,14,0.190855,0.220628,14333.898414,0.216734,0.00503
9804019,9804019,,21,23,44,21,23,44,0.005735,0.020227,0,5901,1,0.00003,13,0.211463,0.254512,274996.252371,0.131078,0.01213
9206103,9206103,,9,0,9,9,0,9,0.000389,0,0,5584,22,0.00005,0,0,0,0,0.027778,0.002862
9511188,9511188,,25,3,28,25,3,28,0.001861,0.000474,0,4729,1,0.000038,4,0.285714,0.329365,10813.487652,0.071429,0.007317
9410132,9410132,,11,6,17,11,6,17,0.000421,0.000579,0,7870,41,0.000035,4,0.331633,0.392308,16847.361297,0.069853,0.002869
9806181,9806181,,3,3,6,3,3,6,0.000419,0.000722,0,7866,1,0.000017,7,0.276331,0.311944,108.776797,0.166667,0.001205
9808181,9808181,,4,8,12,4,8,12,0.000256,0.006098,0,7864,1,0.000014,12,0.195569,0.220048,650.470219,0.272727,0.001153
9805208,9805208,,24,39,63,24,39,63,0.004676,0.021035,0,6637,13,0.000025,12,0.204925,0.240037,8796.89949,0.113159,0.009398
9806141,9806141,,4,37,41,4,37,41,0.000444,0.008067,0,7400,13,0.000013,12,0.19779,0.231288,10298.510625,0.156707,0.001057
9705090,9705090,,8,23,31,8,23,31,0.000714,0.001944,0,4581,13,0.000016,12,0.199966,0.237869,4605.149018,0.155914,0.002958
9809167,9809167,,6,5,11,6,5,11,0.00036,0.000268,0,7869,13,0.000026,14,0.166761,0.186153,27382.060957,0.045455,0.001818
1132,1132,,32,30,62,32,30,62,0.001603,0.002618,0,10714,52,0.000023,15,0.196447,0.225636,24427.535381,0.150449,0.011647
9506104,9506104,,19,6,25,19,6,25,0.000448,0.000651,0,1726,0,0.000023,9,0.211999,0.243124,21426.34057,0.185,0.006022
9911229,9911229,,18,9,27,18,9,27,0.000438,0.000262,0,10713,52,0.000019,16,0.160133,0.175422,1160.576055,0.190883,0.005186
9210062,9210062,,13,0,13,13,0,13,0.000262,0,0,791,0,0.000037,0,0,0,0,0.070513,0.004075
9211047,9211047,,18,6,24,18,6,24,0.000344,0.000043,0,779,0,0.000058,1,1,1,15272.971355,0.139493,0.005549
9303015,9303015,,3,4,7,3,4,7,0.000016,0.000023,0,789,0,0.000016,1,1,1,3720.143037,0.119048,0.001166
9501072,9501072,,2,5,7,2,5,7,0.000008,0.000012,0,1725,0,0.000015,3,0.534884,0.594203,2828.505253,0.095238,0.000593
1133,1133,,24,25,49,24,25,49,0.000949,0.00443,0,10716,0,0.000025,12,0.20734,0.23476,33542.759768,0.134779,0.008967
9908193,9908193,,4,40,44,4,40,44,0.000164,0.003928,0,10715,0,0.000012,13,0.201005,0.23818,5518.342911,0.183404,0.001135
9702030,9702030,,7,16,23,7,16,23,0.000232,0.001065,0,4342,0,0.000014,13,0.199757,0.233017,5196.631888,0.16996,0.00209
9612077,9612077,,10,8,18,10,8,18,0.000998,0.001539,0,3544,0,0.000016,14,0.19549,0.224676,12376.862275,0.147059,0.003296
9806059,9806059,,8,36,44,8,36,44,0.000576,0.005788,0,8820,0,0.000013,16,0.185403,0.2232,12910.840234,0.133721,0.002255
9812097,9812097,,13,42,55,13,42,55,0.001727,0.005117,0,8037,4,0.000017,11,0.214202,0.251371,269525.603813,0.101684,0.006276
9507011,9507011,,6,17,23,6,17,23,0.000359,0.007131,0,2750,4,0.000017,9,0.2327,0.281602,4973.997113,0.171937,0.002298
9808159,9808159,,6,60,66,6,60,66,0.000316,0.012789,0,10575,0,0.000012,12,0.206139,0.246371,7440.368399,0.131235,0.001438
1134,1134,,5,11,16,5,11,16,0.000019,0.000226,0,10726,15,0.000017,13,0.196211,0.213791,7614.288537,0.120833,0.001243
9506097,9506097,,2,0,2,2,0,2,0.000004,0,0,10725,15,0.000013,0,0,0,0,0,0.000486
9903249,9903249,,17,11,28,17,11,28,0.000025,0.000014,0,10722,22,0.000045,9,0.165937,0.211152,19978.961417,0.179894,0.004815
9904044,9904044,,16,9,25,16,9,25,0.000245,0.00073,0,10724,22,0.00004,16,0.163364,0.182357,92089.826644,0.136667,0.004109
9912037,9912037,,18,6,24,18,6,24,0.000626,0.006921,0,10719,25,0.000028,12,0.197771,0.219232,18590.682277,0.083333,0.004845
9201070,9201070,,8,0,8,8,0,8,0.000203,0,0,534,22,0.00003,0,0,0,0,0.053571,0.001896
9309067,9309067,,5,12,17,5,12,17,0.000169,0.000203,0,770,26,0.000015,4,0.518987,0.613821,164427.352694,0.040441,0.001744
9401027,9401027,,9,5,14,9,5,14,0.000449,0.000007,0,1136,26,0.000045,1,1,1,17868.25238,0.098901,0.005664
9603024,9603024,,6,3,9,6,3,9,0.000268,0.000012,0,2766,22,0.000026,1,1,1,860.308579,0.069444,0.001523
9612160,9612160,,2,15,17,2,15,17,0.000143,0.00004,0,6988,9,0.000012,11,0.20316,0.236856,20198.434335,0.044118,0.000573
9703094,9703094,,6,8,14,6,8,14,0.000247,0.000666,0,6994,15,0.000018,13,0.198903,0.226093,50499.775425,0.071429,0.001639
9705010,9705010,,7,2,9,7,2,9,0.000219,0.000002,0,6191,15,0.000017,3,0.466667,0.571429,4593.841934,0.236111,0.001795
9705205,9705205,,32,25,57,32,25,57,0.002209,0.001772,0,4694,0,0.000041,14,0.207493,0.243204,68473.96882,0.164474,0.009606
9707171,9707171,,5,23,28,5,23,28,0.000214,0.003645,0,6205,15,0.000016,14,0.217424,0.254519,187467.740338,0.033069,0.001291
9807107,9807107,,1,10,11,1,10,11,0.000125,0.002892,0,9370,0,0.00001,13,0.188451,0.222603,475.432152,0.209091,0.000288
9808019,9808019,,3,31,34,3,31,34,0.000433,0.018645,0,7645,0,0.000011,13,0.212138,0.239853,11167.662778,0.213012,0.001064
9605107,9605107,,13,1,14,13,1,14,0.000002,0,0,6694,22,0.000079,1,1,1,954.757889,0.230769,0.003868
9611150,9611150,,12,2,14,12,2,14,0.0001,0,0,6695,22,0.000038,1,1,1,13769.614614,0.164835,0.003357
9808113,9808113,,4,0,4,4,0,4,0.000001,0,0,10721,8,0.000031,0,0,0,0,0,0.001102
9811173,9811173,,3,12,15,3,12,15,0,0.000004,0,10720,22,0.00002,8,0.194253,0.242991,956.148215,0.22381,0.00083
9803091,9803091,,15,7,22,15,7,22,0.000011,0,0,9024,22,0.000049,8,0.188668,0.224864,2767.249635,0.170996,0.003752
9904014,9904014,,8,5,13,8,5,13,0.000011,0.000013,0,10723,22,0.000036,9,0.165217,0.199813,171.851445,0.25,0.002096
9711103,9711103,,1,3,4,1,3,4,0.000081,0,0,10718,6,0.000014,8,0.185996,0.235336,6615.275274,0.083333,0.000348
9909077,9909077,,11,30,41,11,30,41,0.001667,0.011301,0,10220,1,0.000017,12,0.2136,0.241921,15039.785157,0.129268,0.003315
1135,1135,,9,18,27,9,18,27,0.000415,0.003078,0,10732,30,0.000017,13,0.197369,0.219844,25431.538097,0.193732,0.002822
9911186,9911186,,24,34,58,24,34,58,0.001038,0.005427,0,10731,30,0.000023,13,0.200756,0.22465,91322.800323,0.092559,0.007324
9607082,9607082,,7,14,21,7,14,21,0.001366,0.005536,0,2463,0,0.000046,10,0.214003,0.247097,26289.482488,0.159524,0.005119
9612022,9612022,,3,15,18,3,15,18,0.000138,0.005231,0,5775,2,0.000014,11,0.220672,0.256067,3143.267567,0.183007,0.001277
9705025,9705025,,6,22,28,6,22,28,0.001182,0.0015,0,5786,4,0.000017,14,0.169519,0.198807,21030.703667,0.165344,0.002248
9601011,9601011,,16,22,38,16,22,38,0.000663,0.004334,0,2146,4,0.000025,15,0.160127,0.206548,13688.335051,0.124467,0.005724
9801106,9801106,,9,10,19,9,10,19,0.000823,0.000821,0,6493,2,0.000018,17,0.179635,0.206747,58866.401499,0.146199,0.003104
9803203,9803203,,8,6,14,8,6,14,0.000794,0.000533,0,6485,2,0.000016,16,0.155787,0.174437,58713.739694,0.076923,0.002576
9804114,9804114,,7,42,49,7,42,49,0.000287,0.007192,0,6478,4,0.000013,12,0.203138,0.240355,12255.288221,0.119898,0.002125
9510138,9510138,,12,5,17,12,5,17,0.000476,0.00196,0,2145,4,0.000025,6,0.26694,0.312692,374.500739,0.169118,0.004693
9803164,9803164,,13,6,19,13,6,19,0.00022,0.000094,0,6472,4,0.000028,14,0.15074,0.166895,30178.159577,0.157895,0.00391
9707142,9707142,,3,20,23,3,20,23,0.000229,0.011642,0,8495,2,0.000012,11,0.208675,0.242748,8714.834366,0.1917,0.000853
9710010,9710010,,2,27,29,2,27,29,0.000107,0.010355,0,8496,2,0.000011,13,0.201731,0.239347,6742.610126,0.176108,0.000618
9710137,9710137,,1,21,22,1,21,22,0.000076,0.009839,0,8494,2,0.00001,13,0.195329,0.230348,12979.598408,0.162338,0.000399
9806149,9806149,,19,21,40,19,21,40,0.002387,0.002242,0,8490,2,0.000022,13,0.197547,0.225809,75781.489348,0.103846,0.00779
9810110,9810110,,2,9,11,2,9,11,0.00022,0.002027,0,8485,2,0.000011,15,0.180954,0.206222,1262.003992,0.054545,0.000774
9812159,9812159,,21,21,42,21,21,42,0.002886,0.010222,0,8298,13,0.000021,13,0.216782,0.252017,10343.457905,0.11266,0.006029
9811179,9811179,,4,17,21,4,17,21,0.000104,0.00034,0,10730,4,0.000012,14,0.172939,0.195632,8438.488984,0.192857,0.001128
9906119,9906119,,23,24,47,23,24,47,0.000697,0.003619,0,9985,4,0.000025,17,0.188226,0.214312,47314.469737,0.157262,0.006437
9907090,9907090,,15,17,32,15,17,32,0.000574,0.000531,0,10728,4,0.000018,17,0.181686,0.20463,13315.952542,0.231855,0.004226
1136,1136,,2,9,11,2,9,11,0.000041,0.000005,0,10736,41,0.000013,18,0.11911,0.128641,4814.453445,0.163636,0.000494
9507059,9507059,,2,0,2,2,0,2,0,0,0,6480,41,0.000026,0,0,0,0,0.5,0.00048
9611054,9611054,,4,1,5,4,1,5,0.000001,0.000001,0,10735,41,0.000023,1,1,1,167.817593,0,0.000924
9705172,9705172,,10,6,16,10,6,16,0.000271,0.000002,0,5656,41,0.000034,2,0.875,0.928571,29537.423514,0.033333,0.002378
9802019,9802019,,4,2,6,4,2,6,0,0,0,6481,41,0.000034,1,1,1,9038.06898,0.333333,0.001025
9803012,9803012,,9,3,12,9,3,12,0.000048,0,0,6482,41,0.000037,2,0.8,0.875,13240.496737,0.189394,0.00221
9803025,9803025,,9,3,12,9,3,12,0.000069,0.000001,0,6483,41,0.000033,2,0.714286,0.8,22034.977352,0.128788,0.002578
9806206,9806206,,2,5,7,2,5,7,0,0.000011,0,10733,41,0.000013,17,0.134852,0.146879,8235.431083,0.309524,0.000459
9810178,9810178,,1,5,6,1,5,6,0,0.000001,0,10734,41,0.000011,18,0.118877,0.127356,0.25,0.366667,0.000233
9303001,9303001,,23,0,23,23,0,23,0.000116,0,0,741,41,0.000137,0,0,0,0,0.037549,0.006379
9304086,9304086,,6,0,6,6,0,6,0.000008,0,0,3098,41,0.000075,0,0,0,0,0.133333,0.00166
9410095,9410095,,8,0,8,8,0,8,0.000033,0,0,2502,41,0.000047,0,0,0,0,0.125,0.001995
9411231,9411231,,8,0,8,8,0,8,0,0,0,5655,41,0.000099,0,0,0,0,0.071429,0.001956
9604135,9604135,,1,2,3,1,2,3,0,0,0,5654,41,0.000015,1,1,1,3492.988518,0.333333,0.000286
9611082,9611082,,2,0,2,2,0,2,0,0,0,5653,41,0.000018,0,0,0,0,0.5,0.000519
1137,1137,,9,19,28,9,19,28,0.000009,0.000008,0,10737,17,0.000015,12,0.151665,0.192525,112.323642,0.296296,0.002194
9412234,9412234,,1,0,1,1,0,1,0,0,0,10439,17,0.000015,0,0,0,0,0,0.000434
9206035,9206035,,33,0,33,33,0,33,0.000292,0,0,1204,17,0.000139,0,0,0,0,0.059659,0.009892
9712051,9712051,,2,10,12,2,10,12,0,0.000026,0,10460,17,0.000012,12,0.16734,0.20258,1666.186065,0.257576,0.000702
9306042,9306042,,9,0,9,9,0,9,0.000001,0,0,7785,17,0.000022,0,0,0,0,0.055556,0.00235
1138,1138,,24,36,60,24,36,60,0.004699,0.019849,0,10749,1,0.000018,13,0.204331,0.229504,4372.588819,0.204802,0.008034
9811155,9811155,,23,2,25,23,2,25,0.004903,0.000556,0,7554,1,0.000029,15,0.172417,0.189176,1673.238791,0.265,0.010397
9906051,9906051,,32,11,43,32,11,43,0.006279,0.016591,0,9762,1,0.000025,16,0.187259,0.210376,2310.413627,0.251938,0.012385
9910011,9910011,,28,27,55,28,27,55,0.006261,0.018755,0,10744,1,0.000023,12,0.205719,0.230013,4828.691907,0.22963,0.009869
9910016,9910016,,38,26,64,38,26,64,0.008299,0.011318,0,10743,1,0.000027,11,0.229599,0.261009,46390.870805,0.197669,0.013253
9910197,9910197,,26,13,39,26,13,39,0.005612,0.017031,0,10745,1,0.000023,12,0.1984,0.219949,1178.934169,0.254386,0.00968
9912210,9912210,,28,43,71,28,43,71,0.005942,0.020744,0,10748,1,0.000022,12,0.206049,0.231195,22506.508327,0.196982,0.010132
9610026,9610026,,29,54,83,29,54,83,0.001209,0.004599,0,3458,4,0.000032,12,0.210109,0.257068,87761.343414,0.125771,0.009535
9507003,9507003,,7,15,22,7,15,22,0.000709,0.003082,0,1791,4,0.000024,8,0.262288,0.312379,13017.258001,0.090909,0.002868
9804182,9804182,,20,43,63,20,43,63,0.004543,0.026028,0,6553,1,0.000033,11,0.215032,0.24629,95428.883636,0.196621,0.009779
9701064,9701064,,1,2,3,1,2,3,0.000016,0.000128,0,7385,1,0.000012,16,0.142752,0.164036,76.413949,0.166667,0.000523
9804053,9804053,,11,7,18,11,7,18,0.000475,0.000735,0,7384,1,0.000029,13,0.161948,0.181574,54182.973712,0.143791,0.003515
9807206,9807206,,37,13,50,37,13,50,0.007512,0.001684,0,6680,41,0.000066,13,0.190478,0.215955,12245.870578,0.156735,0.016263
9808146,9808146,,33,8,41,33,8,41,0.00608,0.001247,0,7330,41,0.000043,13,0.170795,0.189059,4141.057355,0.190244,0.014714
9807034,9807034,,30,21,51,30,21,51,0.003161,0.011595,0,7695,9,0.000022,13,0.190814,0.215797,152710.765747,0.203922,0.009409
9903162,9903162,,26,60,86,26,60,86,0.002635,0.027621,0,7725,9,0.00002,14,0.216297,0.25241,181578.438548,0.109302,0.008379
9809090,9809090,,6,2,8,6,2,8,0.000713,0.000059,0,7544,1,0.000016,14,0.140873,0.153897,10182.912294,0.267857,0.002217
9811209,9811209,,7,13,20,7,13,20,0.000429,0.001369,0,8696,1,0.000017,12,0.184948,0.207966,77182.373045,0.123684,0.002188
9904076,9904076,,5,9,14,5,9,14,0.000573,0.00075,0,8680,1,0.000013,16,0.164517,0.181918,183.417725,0.258242,0.001919
9812197,9812197,,7,3,10,7,3,10,0.000238,0,0,9817,20,0.00003,2,0.666667,0.75,14408.609044,0.066667,0.001862
9906099,9906099,,13,27,40,13,27,40,0.002585,0.021134,0,9761,1,0.000017,11,0.234736,0.266406,27863.773295,0.283333,0.005663
9906188,9906188,,56,36,92,56,36,92,0.010348,0.020798,0,9812,1,0.000034,11,0.232066,0.264511,70167.139861,0.147635,0.019798
9907088,9907088,,37,23,60,37,23,60,0.007959,0.020296,0,9813,1,0.000029,11,0.227352,0.258048,42062.745096,0.203107,0.013961
9902047,9902047,,11,22,33,11,22,33,0.002283,0.014266,0,9811,1,0.000016,17,0.195625,0.222175,83888.699019,0.195076,0.004629
9907106,9907106,,19,16,35,19,16,35,0.004245,0.01974,0,10742,1,0.000022,11,0.22778,0.25829,28366.710207,0.168908,0.006585
9908163,9908163,,32,41,73,32,41,73,0.006292,0.021968,0,10741,1,0.000024,11,0.212726,0.240982,42520.836868,0.135464,0.011479
9908171,9908171,,9,100,109,9,100,109,0.001797,0.039371,0,10740,1,0.000014,12,0.227866,0.268371,68433.236239,0.067703,0.003292
9911222,9911222,,38,47,85,38,47,85,0.008461,0.02243,0,10747,1,0.000028,11,0.234496,0.267322,108224.026368,0.167647,0.013334
1140,1140,,4,6,10,4,6,10,0.000026,0.00004,0,10754,2,0.000013,14,0.150809,0.164682,4233.083937,0.133333,0.000896
9911148,9911148,,11,3,14,11,3,14,0.00004,0.000008,0,10750,2,0.000039,17,0.136055,0.148424,10370.526764,0.131868,0.002609
9912023,9912023,,2,9,11,2,9,11,0.000005,0.000319,0,10753,2,0.000012,13,0.170349,0.185197,10052.814097,0.245455,0.000484
9805059,9805059,,7,2,9,7,2,9,0.000004,0.000003,0,7225,23,0.00011,20,0.085696,0.093432,31786.199663,0.111111,0.001775
9911065,9911065,,5,21,26,5,21,26,0.000054,0.00219,0,10752,2,0.000013,12,0.201375,0.225265,21067.580552,0.195385,0.001156
1141,1141,,1,3,4,1,3,4,0.000003,0.000342,0,10755,52,0.000011,16,0.176964,0.194071,276.12239,0.333333,0.000226
9505012,9505012,,24,9,33,24,9,33,0.000702,0.000037,0,2261,5,0.000068,4,0.40625,0.49359,65419.82553,0.090909,0.007424
1142,1142,,0,39,39,0,39,39,0,0.002711,0,10763,4,0.00001,13,0.189836,0.215795,0,0.136977,0
9803154,9803154,,8,11,19,8,11,19,0.000203,0.002072,0,10759,4,0.000013,17,0.176333,0.2038,9369.378928,0.245614,0.001841
9806043,9806043,,2,15,17,2,15,17,0.000059,0.001586,0,10757,4,0.000011,13,0.179255,0.209172,403.510133,0.279412,0.000526
9807059,9807059,,5,10,15,5,10,15,0.000194,0.002209,0,10762,4,0.000011,14,0.165768,0.194959,417.772337,0.180952,0.001208
9810040,9810040,,5,8,13,5,8,13,0.0001,0.0003,0,10761,4,0.000012,15,0.182614,0.206445,139.156218,0.365385,0.001245
9902188,9902188,,5,17,22,5,17,22,0.000418,0.00282,0,8816,4,0.000012,13,0.181652,0.210505,10742.425509,0.132035,0.00139
9906145,9906145,,1,11,12,1,11,12,0.000032,0.002052,0,10760,4,0.00001,17,0.176293,0.203684,105.96146,0.348485,0.000219
9908054,9908054,,14,14,28,14,14,28,0.000308,0.00244,0,10756,4,0.000016,17,0.18228,0.208964,15108.082659,0.215608,0.003393
9909183,9909183,,13,14,27,13,14,27,0.000323,0.002309,0,10758,4,0.000014,18,0.157202,0.177449,2308.402651,0.18661,0.003133
9502149,9502149,,5,2,7,5,2,7,0.000379,0.000028,0,3058,9,0.000017,3,0.481481,0.538462,3045.916004,0.119048,0.001819
9508140,9508140,,7,5,12,7,5,12,0.000254,0.002226,0,3416,4,0.000017,11,0.16509,0.20903,563.141049,0.212121,0.002241
9705107,9705107,,7,52,59,7,52,59,0.000768,0.015836,0,4715,2,0.000016,14,0.208031,0.251818,4508.483083,0.153127,0.003071
9705181,9705181,,9,30,39,9,30,39,0.000644,0.003992,0,4901,4,0.000015,13,0.177524,0.209422,27968.880684,0.189609,0.002948
9703036,9703036,,4,9,13,4,9,13,0.000196,0.002401,0,4309,4,0.000014,13,0.194917,0.222153,4804.110899,0.185897,0.001364
9704002,9704002,,10,2,12,10,2,12,0.000179,0.000105,0,4887,4,0.000023,13,0.168115,0.185574,1849.000882,0.227273,0.00314
9704163,9704163,,5,8,13,5,8,13,0.000393,0.002135,0,4886,4,0.000019,12,0.186405,0.213512,7928.810247,0.173077,0.001553
9603129,9603129,,2,10,12,2,10,12,0.000063,0.00234,0,4906,4,0.000011,14,0.188892,0.227815,358.809273,0.30303,0.000705
9705027,9705027,,7,12,19,7,12,19,0.000062,0.001436,0,4891,4,0.000021,12,0.202046,0.235037,17085.081263,0.225146,0.002249
9612195,9612195,,14,19,33,14,19,33,0.001376,0.002323,0,6397,4,0.000021,12,0.187289,0.216996,11263.82704,0.088068,0.003994
9704027,9704027,,6,31,37,6,31,37,0.000181,0.003924,0,4898,4,0.000014,13,0.18218,0.217669,4589.010835,0.18018,0.001647
9510045,9510045,,2,3,5,2,3,5,0.000043,0.001302,0,7971,4,0.000013,10,0.176292,0.21282,6.386573,0.35,0.000623
9803130,9803130,,1,4,5,1,4,5,0.000033,0.002301,0,8815,4,0.00001,13,0.169591,0.188568,56.171889,0.4,0.000256
9610122,9610122,,2,4,6,2,4,6,0.00006,0.000018,0,4451,23,0.000017,8,0.221818,0.267852,15386.82966,0.1,0.001229
9410112,9410112,,2,0,2,2,0,2,0.000168,0,0,1427,13,0.000092,0,0,0,0,0,0.006722
9511112,9511112,,11,3,14,11,3,14,0.000588,0.000053,0,4450,4,0.000028,7,0.249446,0.28819,7750.290337,0.104396,0.002841
1144,1144,,12,20,32,12,20,32,0.000757,0.005453,0,10765,30,0.000021,12,0.217723,0.24141,32087.070454,0.16129,0.005729
9907100,9907100,,30,27,57,30,27,57,0.004007,0.013788,0,8545,2,0.000032,13,0.206296,0.237204,43240.787113,0.08302,0.011038
9907145,9907145,,28,14,42,28,14,42,0.003135,0.018427,0,10559,2,0.000032,11,0.228795,0.259279,153529.763903,0.127758,0.010078
9911153,9911153,,14,16,30,14,16,30,0.001062,0.005991,0,10764,30,0.000019,13,0.196603,0.218665,3054.998229,0.154023,0.005063
9601067,9601067,,5,22,27,5,22,27,0.000454,0.004773,0,1548,0,0.000019,9,0.227513,0.268212,25011.434752,0.182336,0.002526
9611169,9611169,,9,7,16,9,7,16,0.000302,0.000665,0,4948,1,0.000017,4,0.338542,0.40641,20031.854997,0.175,0.002602
9407108,9407108,,14,0,14,14,0,14,0.000246,0,0,7854,9,0.000054,0,0,0,0,0.181319,0.004064
9601058,9601058,,6,3,9,6,3,9,0.000922,0.000018,0,7853,22,0.000015,4,0.303571,0.367647,7293.614123,0.069444,0.002193
9611181,9611181,,2,9,11,2,9,11,0.000243,0.000074,0,7852,22,0.000014,5,0.34359,0.43209,60880.522452,0.118182,0.000936
9811116,9811116,,1,19,20,1,19,20,0.000254,0.001936,0,8509,2,0.000011,12,0.21438,0.242096,25625.253358,0.147368,0.000442
9903146,9903146,,9,14,23,9,14,23,0.000697,0.003589,0,8508,8,0.000021,13,0.194575,0.226337,69970.502539,0.13834,0.002806
9404009,9404009,,12,2,14,12,2,14,0.000698,0.000083,0,739,4,0.000036,1,1,1,115.065622,0.148352,0.00443
9804027,9804027,,44,29,73,44,29,73,0.004901,0.008927,0,6945,2,0.000037,12,0.206762,0.237476,75777.038538,0.064307,0.015023
9208007,9208007,,41,0,41,41,0,41,0.000292,0,0,3799,15,0.000155,0,0,0,0,0.016463,0.009993
9404023,9404023,,2,1,3,2,1,3,0.000249,0.000003,0,10556,15,0.000013,1,1,1,0,0.5,0.000697
9705211,9705211,,3,17,20,3,17,20,0.000323,0.002743,0,10558,15,0.000015,13,0.182674,0.210665,111771.744834,0.044737,0.001015
1145,1145,,15,10,25,15,10,25,0.001619,0.001535,0,10767,8,0.000024,12,0.203837,0.225166,20455.022543,0.15,0.006334
9803132,9803132,,17,5,22,17,5,22,0.001245,0.002001,0,8344,8,0.000036,13,0.177904,0.200697,5292.198471,0.103896,0.005731
9912156,9912156,,23,18,41,23,18,41,0.003103,0.023429,0,10766,25,0.000044,11,0.22843,0.259244,42132.922134,0.153659,0.010162
9311037,9311037,,22,0,22,22,0,22,0.001205,0,0,914,4,0.000373,0,0,0,0,0.075758,0.010194
9902126,9902126,,49,22,71,49,22,71,0.005104,0.000618,0,8341,8,0.000087,12,0.192217,0.215152,105986.170836,0.130382,0.0184
9902183,9902183,,9,21,30,9,21,30,0.001592,0.013605,0,9064,5,0.000022,14,0.188067,0.214768,56785.331711,0.133333,0.004556
9907062,9907062,,7,9,16,7,9,16,0.001305,0.001477,0,9164,8,0.000019,13,0.175189,0.192137,2736.185734,0.308333,0.002403
9908070,9908070,,38,5,43,38,5,43,0.00518,0.001236,0,9170,8,0.000065,12,0.186712,0.202806,84782.537095,0.129014,0.01534
9908093,9908093,,13,11,24,13,11,24,0.002647,0.001616,0,10536,8,0.000028,13,0.170077,0.186526,3177.695158,0.29529,0.005183
1146,1146,,0,2,2,0,2,2,0,0,0,10770,5,0.00001,3,0.428571,0.518519,0,0.5,0
9812233,9812233,,2,2,4,2,2,4,0,0.000005,0,10768,5,0.000027,2,0.583333,0.642857,19.178788,0.083333,0.000451
9906241,9906241,,2,1,3,2,1,3,0.000014,0,0,10769,5,0.000015,3,0.4,0.458333,1612.178788,0.166667,0.000452
9504028,9504028,,9,0,9,9,0,9,0.000159,0,0,1407,13,0.000072,0,0,0,0,0.013889,0.002734
1147,1147,,0,1,1,0,1,1,0,0.000058,0,10771,4,0.00001,7,0.215088,0.239623,0,0,0
1148,1148,,0,4,4,0,4,4,0,0.000054,0,10772,30,0.00001,11,0.163002,0.177155,0,0.166667,0
9401149,9401149,,11,1,12,11,1,12,0.000037,0,0,5409,15,0.000042,1,1,1,63.141714,0.030303,0.002492
9605001,9605001,,53,16,69,53,16,69,0.000689,0.000051,0,2710,30,0.000118,2,0.807692,0.880952,163434.157859,0.053495,0.016325
9606001,9606001,,67,5,72,67,5,72,0.001259,0.000359,0,6816,30,0.000124,10,0.19258,0.212112,100826.620035,0.040689,0.018768
9304005,9304005,,28,0,28,28,0,28,0.00002,0,0,873,30,0.000232,0,0,0,0,0.054233,0.006901
9302008,9302008,,28,0,28,28,0,28,0.000223,0,0,2689,30,0.000568,0,0,0,0,0.071429,0.007993
9311121,9311121,,5,0,5,5,0,5,0.000001,0,0,2709,30,0.000025,0,0,0,0,0.25,0.001573
9312186,9312186,,19,1,20,19,1,20,0.000056,0.000003,0,2702,30,0.00005,1,1,1,135.410171,0.102632,0.005397
9401099,9401099,,20,1,21,20,1,21,0.000037,0.000003,0,2690,30,0.000196,1,1,1,76.56421,0.116667,0.005722
9404075,9404075,,4,2,6,4,2,6,0.000001,0.000003,0,2695,30,0.000035,1,1,1,2,0.3,0.001392
9501077,9501077,,26,1,27,26,1,27,0.000143,0,0,2692,30,0.000117,2,0.6,0.666667,4486.128435,0.116809,0.007527
9501142,9501142,,27,3,30,27,3,30,0.000038,0.000002,0,2694,30,0.000111,2,0.714286,0.8,3843.630812,0.134483,0.007783
9502120,9502120,,12,6,18,12,6,18,0.000026,0.000005,0,2696,30,0.000069,2,0.875,0.928571,1210.343391,0.179739,0.003539
9503093,9503093,,27,0,27,27,0,27,0.000787,0,0,2708,30,0.000087,0,0,0,0,0.054131,0.00918
9505192,9505192,,7,4,11,7,4,11,0.000025,0.000003,0,2700,30,0.000041,2,0.666667,0.75,366.205433,0.163636,0.002139
9506115,9506115,,20,4,24,20,4,24,0.000065,0.000005,0,2697,30,0.000061,3,0.615385,0.729167,1383.012976,0.130435,0.005506
9509163,9509163,,11,4,15,11,4,15,0.000008,0.000002,0,2703,30,0.000044,3,0.56,0.630952,2057.692088,0.195238,0.003244
9603095,9603095,,14,12,26,14,12,26,0.000252,0.000008,0,2707,30,0.000044,2,0.833333,0.9,21500.87692,0.147692,0.004768
9604115,9604115,,9,6,15,9,6,15,0.000008,0.000033,0,2706,30,0.000041,3,0.583333,0.690476,11201.163044,0.180952,0.002529
9604169,9604169,,9,4,13,9,4,13,0.000032,0.000001,0,2704,30,0.000028,3,0.535714,0.611111,2316.217052,0.211538,0.002716
9404138,9404138,,13,1,14,13,1,14,0.000293,0.00001,0,3313,30,0.000067,1,1,1,71.074693,0.054945,0.004291
1149,1149,,1,18,19,1,18,19,0.000068,0.008084,0,10773,2,0.00001,12,0.214377,0.238866,625.148605,0.245614,0.00024
9403181,9403181,,11,11,22,11,11,22,0.000609,0.000126,0,2943,2,0.00003,4,0.62963,0.789216,20943.120275,0.19697,0.003802
9606142,9606142,,8,24,32,8,24,32,0.00031,0.002808,0,2904,28,0.000023,10,0.224256,0.265986,186209.815805,0.083669,0.003697
9209115,9209115,,17,1,18,17,1,18,0.000519,0.000027,0,1746,2,0.000043,1,1,1,504.384824,0.189542,0.006067
9304046,9304046,,30,5,35,30,5,35,0.001184,0.000078,0,2938,2,0.000053,2,0.857143,0.916667,255.843114,0.184034,0.010644
9403177,9403177,,9,6,15,9,6,15,0.000764,0.000077,0,2945,2,0.000019,1,1,1,206.367796,0.242857,0.00367
9411055,9411055,,8,10,18,8,10,18,0.000119,0.000099,0,2941,2,0.000025,2,0.727273,0.8125,14404.712922,0.254902,0.003361
9510213,9510213,,8,18,26,8,18,26,0.000335,0.000407,0,3230,2,0.000015,7,0.307692,0.376436,2109.079221,0.169231,0.002287
9512103,9512103,,5,10,15,5,10,15,0.00014,0.000181,0,3224,2,0.000013,6,0.4375,0.575714,702.61641,0.27619,0.001528
9609092,9609092,,9,13,22,9,13,22,0.000784,0.002722,0,3400,2,0.000015,11,0.205928,0.240594,10061.702999,0.140693,0.002937
1150,1150,,1,12,13,1,12,13,0.000068,0.000735,0,10774,2,0.00001,13,0.19616,0.219783,0.143478,0.384615,0.00024
9906142,9906142,,50,157,207,50,157,207,0.003911,0.027706,0,8926,2,0.000039,12,0.235818,0.282037,1349803.089338,0.041579,0.015805
9410024,9410024,,5,0,5,5,0,5,0.000009,0,0,2955,2,0.000033,0,0,0,0,0.1,0.00156
9307195,9307195,,9,6,15,9,6,15,0.000718,0.000066,0,2942,2,0.000016,2,0.875,0.928571,62.563548,0.233333,0.002881
9511042,9511042,,2,0,2,2,0,2,0.000188,0,0,5684,2,0.00001,0,0,0,0,0.5,0.000644
9705092,9705092,,4,17,21,4,17,21,0.000315,0.003315,0,4205,2,0.000013,11,0.20788,0.239366,4568.640509,0.154762,0.002349
9706197,9706197,,3,27,30,3,27,30,0.0002,0.009404,0,7192,2,0.000012,11,0.228369,0.26798,2189.586852,0.109195,0.000828
9707119,9707119,,3,30,33,3,30,33,0.000327,0.009705,0,5166,2,0.000012,14,0.21136,0.255296,36935.206325,0.150568,0.001334
9709202,9709202,,8,17,25,8,17,25,0.000581,0.002301,0,5369,2,0.000078,15,0.182506,0.215676,10019.577826,0.21,0.004896
9712007,9712007,,4,9,13,4,9,13,0.000169,0.000314,0,7191,2,0.000013,13,0.180127,0.202344,2727.797149,0.089744,0.001048
9301055,9301055,,4,3,7,4,3,7,0.000336,0.000042,0,8925,2,0.000013,2,0.8,0.875,3.583333,0.261905,0.001425
9308018,9308018,,11,15,26,11,15,26,0.00038,0.000094,0,249,13,0.000026,3,0.75,0.849206,21444.672413,0.112308,0.0042
9406071,9406071,,4,8,12,4,8,12,0.000408,0.000083,0,8924,2,0.000011,2,0.722222,0.807692,74.446411,0.272727,0.001363
9502124,9502124,,6,3,9,6,3,9,0.000565,0.000032,0,3399,2,0.000014,2,0.8,0.875,55.444866,0.222222,0.001806
9502143,9502143,,6,8,14,6,8,14,0.000397,0.00014,0,8918,2,0.000014,6,0.4125,0.539899,333.278682,0.274725,0.001834
9510220,9510220,,18,6,24,18,6,24,0.000653,0.000077,0,3187,2,0.000032,6,0.320717,0.370807,71066.40636,0.083333,0.004803
9511049,9511049,,9,11,20,9,11,20,0.00034,0.000112,0,3174,9,0.000023,7,0.294977,0.330934,65386.066617,0.126316,0.002651
9603049,9603049,,11,7,18,11,7,18,0.000362,0.000587,0,5682,41,0.000024,5,0.340081,0.399206,27172.014575,0.117647,0.00292
9603187,9603187,,12,28,40,12,28,40,0.000542,0.000425,0,3223,2,0.000021,9,0.253455,0.30392,367359.570471,0.055769,0.003231
9604195,9604195,,11,6,17,11,6,17,0.000447,0.000017,0,5678,6,0.000019,4,0.458333,0.568182,68843.811787,0.080882,0.003
9608093,9608093,,6,33,39,6,33,39,0.000762,0.00576,0,3231,0,0.000015,10,0.245932,0.286586,271569.010844,0.099865,0.002454
9610038,9610038,,4,14,18,4,14,18,0.000338,0.000214,0,8923,2,0.000014,11,0.200963,0.233648,55173.652246,0.084967,0.00128
9610098,9610098,,4,31,35,4,31,35,0.00039,0.001451,0,8921,2,0.000012,9,0.233864,0.270181,23913.874616,0.130252,0.001287
9704051,9704051,,34,16,50,34,16,50,0.001954,0.005241,0,4633,3,0.00005,12,0.207791,0.240148,63471.711025,0.062041,0.01365
9711007,9711007,,4,29,33,4,29,33,0.000542,0.001874,0,8919,2,0.000011,11,0.217495,0.249735,557.964659,0.196023,0.001293
9801104,9801104,,10,14,24,10,14,24,0.001195,0.00242,0,8116,4,0.000014,18,0.166995,0.196857,4378.426816,0.182971,0.002844
9804115,9804115,,13,30,43,13,30,43,0.00107,0.003509,0,6841,2,0.000017,14,0.185672,0.220309,16767.05895,0.151717,0.004616
9804157,9804157,,10,31,41,10,31,41,0.000767,0.003071,0,6842,2,0.000016,13,0.196718,0.233429,34662.665053,0.127439,0.003308
9810038,9810038,,4,8,12,4,8,12,0.000507,0.000107,0,8916,2,0.000015,15,0.155534,0.18065,77859.558769,0.136364,0.001273
9810081,9810081,,10,9,19,10,9,19,0.00078,0.000677,0,7199,2,0.000017,12,0.187518,0.211945,28038.701805,0.137427,0.003099
9811025,9811025,,11,21,32,11,21,32,0.001287,0.003043,0,8570,4,0.000015,13,0.194601,0.22598,7619.025503,0.15121,0.003235
9811145,9811145,,9,28,37,9,28,37,0.000606,0.005981,0,7952,2,0.000021,12,0.200918,0.235601,20237.086731,0.144895,0.003944
9903149,9903149,,5,22,27,5,22,27,0.000375,0.000224,0,8907,28,0.000012,14,0.163439,0.188785,238299.132408,0.084046,0.001519
9904137,9904137,,24,26,50,24,26,50,0.001953,0.006264,0,8878,2,0.000025,13,0.184348,0.216318,53662.846159,0.077959,0.006699
9905112,9905112,,19,15,34,19,15,34,0.003597,0.018065,0,8870,41,0.00002,12,0.196784,0.224185,16796.895617,0.145276,0.005961
9905117,9905117,,4,21,25,4,21,25,0.000431,0.002037,0,8853,2,0.000011,17,0.177448,0.207155,29565.370534,0.15,0.001299
1151,1151,,6,5,11,6,5,11,0.000002,0.000003,0,10776,6,0.000015,13,0.175887,0.192912,37401.568615,0.1,0.001454
9411051,9411051,,10,5,15,10,5,15,0.000033,0.000004,0,2039,6,0.000023,5,0.349398,0.407184,11129.103347,0.095238,0.002746
9412229,9412229,,61,6,67,61,6,67,0.000111,0.000004,0,2073,6,0.000198,5,0.30198,0.383607,59580.827667,0.041384,0.016596
9807085,9807085,,3,25,28,3,25,28,0.000074,0.005217,0,10775,2,0.000016,12,0.210325,0.240726,95186.401275,0.060847,0.001179
9206046,9206046,,27,0,27,27,0,27,0.000153,0,0,683,22,0.000076,0,0,0,0,0.05698,0.007165
9404050,9404050,,37,4,41,37,4,41,0.000004,0.000004,0,2015,6,0.00009,4,0.430769,0.497024,12009.993288,0.068293,0.009459
9404192,9404192,,19,5,24,19,5,24,0.000052,0.000034,0,2038,22,0.000141,2,0.6,0.666667,7112.531895,0.074275,0.005273
9406020,9406020,,38,4,42,38,4,42,0.000003,0,0,2021,6,0.000072,4,0.41573,0.472973,10666.805499,0.073751,0.009615
9310058,9310058,,8,1,9,8,1,9,0.000002,0,0,2065,6,0.000081,1,1,1,2166.12886,0.055556,0.003279
9409176,9409176,,8,3,11,8,3,11,0.000035,0.000019,0,2069,6,0.000069,5,0.327485,0.375595,21898.680921,0.136364,0.003028
9603010,9603010,,13,7,20,13,7,20,0.000033,0.000012,0,7932,6,0.000045,4,0.459016,0.559524,33755.252051,0.076316,0.003388
9510047,9510047,,9,10,19,9,10,19,0.000001,0.000003,0,5892,6,0.000038,5,0.373297,0.43455,117426.412159,0.108187,0.00249
9411053,9411053,,11,15,26,11,15,26,0.000109,0.000018,0,2781,22,0.000025,3,0.49,0.595238,61624.475361,0.116923,0.002869
9503043,9503043,,15,9,24,15,9,24,0.000113,0.00005,0,2782,22,0.000025,4,0.429688,0.510606,14743.087465,0.068841,0.00385
9605225,9605225,,15,10,25,15,10,25,0.000714,0.000084,0,4317,4,0.000024,8,0.223792,0.262014,35681.846252,0.108333,0.004678
9703086,9703086,,7,7,14,7,7,14,0.000171,0.00007,0,5171,4,0.00002,9,0.198227,0.23241,27512.882292,0.197802,0.001989
9704117,9704117,,4,9,13,4,9,13,0.000291,0.00574,0,5187,2,0.000014,11,0.206164,0.237769,1274.848701,0.217949,0.001877
9709152,9709152,,4,6,10,4,6,10,0.000137,0.000365,0,5172,4,0.000014,9,0.196493,0.227449,5337.134419,0.211111,0.001268
1152,1152,,1,1,2,1,1,2,0,0,0,10779,23,0.000013,15,0.134967,0.149411,1504.626428,0,0.000226
9911107,9911107,,4,7,11,4,7,11,0.000001,0.00001,0,10778,23,0.000026,14,0.15592,0.180604,4932.962837,0.154545,0.000969
9301060,9301060,,14,0,14,14,0,14,0.00001,0,0,4846,23,0.000037,0,0,0,0,0.115385,0.003488
9512216,9512216,,30,0,30,30,0,30,0.000037,0,0,4845,23,0.000066,0,0,0,0,0.058621,0.007272
9601076,9601076,,10,3,13,10,3,13,0.000011,0.000001,0,9101,23,0.000034,2,0.8,0.875,1876.802574,0.108974,0.002414
9705123,9705123,,22,11,33,22,11,33,0.000661,0.000009,0,6039,23,0.000068,13,0.170776,0.200958,144054.759332,0.075758,0.006407
9707129,9707129,,14,12,26,14,12,26,0.000007,0.000022,0,9455,23,0.000047,12,0.188313,0.222389,34254.133616,0.093846,0.003498
9806077,9806077,,4,0,4,4,0,4,0.00007,0,0,10777,23,0.000034,0,0,0,0,0.083333,0.000917
1153,1153,,0,1,1,0,1,1,0,0,0,10780,23,0.00001,1,1,1,0,0,0
1154,1154,,0,1,1,0,1,1,0,0,0,10781,6,0.00001,1,1,1,0,0,0
9807099,9807099,,7,0,7,7,0,7,0.00001,0,0,10177,6,0.000043,0,0,0,0,0,0.001584
1155,1155,,1,1,2,1,1,2,0,0.000001,0,10782,23,0.000015,1,1,1,0,0.5,0.000226
1156,1156,,1,3,4,1,3,4,0,0.000001,0,10785,20,0.000014,4,0.4,0.490741,6.583333,0,0.000219
9605048,9605048,,7,5,12,7,5,12,0.000014,0.000003,0,7778,20,0.000032,3,0.521739,0.652778,36187.240118,0.022727,0.001582
9608181,9608181,,3,0,3,3,0,3,0.000108,0,0,10784,20,0.000019,0,0,0,0,0,0.00067
9811043,9811043,,1,2,3,1,2,3,0,0,0,10783,20,0.000014,2,0.75,0.833333,4.25,0.166667,0.000226
2113,2113,,0,3,3,0,3,3,0,0.000026,0,10789,25,0.00001,3,0.529412,0.62963,0,0.166667,0
9508149,9508149,,1,2,3,1,2,3,0,0,0,10788,25,0.000013,1,1,1,2,0,0.000219
9706139,9706139,,16,0,16,16,0,16,0.000786,0,0,6009,25,0.000045,0,0,0,0,0.241667,0.00432
9707016,9707016,,25,3,28,25,3,28,0.001386,0.000022,0,6010,25,0.000042,2,0.714286,0.8,12364.082277,0.116402,0.00673
9405187,9405187,,25,0,25,25,0,25,0.000198,0,0,2523,0,0.000144,0,0,0,0,0.03,0.006963
9501124,9501124,,22,1,23,22,1,23,0.000003,0.000001,0,4163,20,0.000039,2,0.6,0.666667,42.240873,0.189723,0.005821
9501137,9501137,,16,1,17,16,1,17,0.000027,0.000001,0,4162,20,0.000036,1,1,1,1286.597373,0.117647,0.004511
9504123,9504123,,6,1,7,6,1,7,0.000001,0,0,7777,26,0.000033,2,0.6,0.666667,8743.432692,0.047619,0.001374
9508052,9508052,,4,0,4,4,0,4,0.000002,0,0,7775,20,0.000018,0,0,0,0,0.333333,0.000977
9211044,9211044,,8,0,8,8,0,8,0.000001,0,0,7772,20,0.000042,0,0,0,0,0.035714,0.001903
9610175,9610175,,2,2,4,2,2,4,0,0.000001,0,7773,20,0.000035,1,1,1,7197.154932,0.083333,0.000458
1157,1157,,3,18,21,3,18,21,0.000286,0.002571,0,10792,0,0.000011,12,0.204319,0.22761,2930.571332,0.166667,0.000728
9806124,9806124,,10,10,20,10,10,20,0.000587,0.000573,0,8588,0,0.000021,13,0.191371,0.218536,16041.503476,0.157895,0.003681
9903212,9903212,,8,23,31,8,23,31,0.000271,0.00253,0,8589,0,0.000015,14,0.201015,0.228745,22482.839539,0.101075,0.002354
9906126,9906126,,16,15,31,16,15,31,0.000817,0.001508,0,9670,0,0.000023,15,0.17792,0.201636,10346.626684,0.112903,0.00512
9910164,9910164,,8,14,22,8,14,22,0.000881,0.005934,0,10791,2,0.000019,14,0.185854,0.209429,38851.710517,0.134199,0.003226
9208056,9208056,,3,0,3,3,0,3,0.000006,0,0,603,5,0.000077,0,0,0,0,0,0.001533
9502069,9502069,,12,4,16,12,4,16,0.000157,0.000055,0,1181,0,0.000054,7,0.230174,0.27407,10926.196286,0.0375,0.004175
9602062,9602062,,11,2,13,11,2,13,0.000304,0.000075,0,2821,52,0.000104,11,0.189921,0.212487,15083.174089,0.160256,0.003636
9606091,9606091,,4,18,22,4,18,22,0.000262,0.003628,0,2315,0,0.000013,9,0.226533,0.257853,658.889696,0.192641,0.001577
9608010,9608010,,5,9,14,5,9,14,0.000104,0.000094,0,4937,0,0.000013,9,0.195205,0.23095,3073.503577,0.159341,0.001567
9803107,9803107,,9,31,40,9,31,40,0.0002,0.001419,0,8089,4,0.000021,12,0.211811,0.244929,95847.518166,0.145513,0.002318
9508173,9508173,,4,5,9,4,5,9,0.000061,0.001079,0,2604,0,0.000021,7,0.251549,0.294382,407.321518,0.125,0.001852
9512004,9512004,,1,12,13,1,12,13,0.000008,0.001022,0,9671,4,0.000011,10,0.177469,0.224045,129.833581,0.282051,0.000342
9906148,9906148,,13,20,33,13,20,33,0.000406,0.002438,0,9669,0,0.000016,14,0.189262,0.217368,6429.00516,0.234848,0.003508
9907083,9907083,,1,12,13,1,12,13,0.00007,0.003616,0,10790,2,0.000011,14,0.187372,0.210131,4594.122839,0.205128,0.000291
1158,1158,,2,8,10,2,8,10,0.00005,0.000016,0,10793,52,0.000011,14,0.165012,0.184544,1303.253841,0.011111,0.00054
9202047,9202047,,15,0,15,15,0,15,0,0,0,2054,15,0.000169,0,0,0,0,0.014286,0.003585
9203047,9203047,,19,0,19,19,0,19,0.000005,0,0,4399,22,0.000081,0,0,0,0,0.090643,0.004599
9303009,9303009,,5,0,5,5,0,5,0.000005,0,0,4657,52,0.000031,0,0,0,0,0.1,0.001301
9405153,9405153,,8,4,12,8,4,12,0.000003,0.000006,0,4032,52,0.000044,1,1,1,2642.242407,0.090909,0.00207
9608063,9608063,,12,6,18,12,6,18,0.000158,0.000007,0,6321,52,0.000019,11,0.202843,0.232157,52931.4162,0.03268,0.003135
9205072,9205072,,19,0,19,19,0,19,0.000151,0,0,1624,52,0.000118,0,0,0,0,0.038012,0.005038
9210040,9210040,,7,0,7,7,0,7,0,0,0,1040,9,0.000049,0,0,0,0,0.119048,0.002023
9212048,9212048,,12,0,12,12,0,12,0.000001,0,0,1729,52,0.000066,0,0,0,0,0.083333,0.003058
9402074,9402074,,6,4,10,6,4,10,0.000009,0,0,4663,52,0.000025,1,1,1,4281.043034,0.088889,0.001713
9407055,9407055,,6,4,10,6,4,10,0.000007,0.000008,0,2917,52,0.000034,1,1,1,5972.573033,0.044444,0.001819
9509170,9509170,,14,22,36,14,22,36,0.000143,0.000364,0,1732,0,0.000027,10,0.236107,0.280755,112995.393176,0.083333,0.004112
9601163,9601163,,9,9,18,9,9,18,0.000101,0.000019,0,6301,9,0.000024,5,0.346821,0.404306,46227.407687,0.071895,0.002674
9605127,9605127,,12,12,24,12,12,24,0.000081,0.000022,0,6315,22,0.00003,4,0.5,0.616667,17372.254452,0.126812,0.003002
9207019,9207019,,15,0,15,15,0,15,0.000032,0,0,1480,9,0.000058,0,0,0,0,0.17619,0.005707
9209034,9209034,,7,1,8,7,1,8,0.000006,0.000021,0,1036,9,0.000025,1,1,1,27.229472,0.107143,0.001864
9308144,9308144,,4,0,4,4,0,4,0.000001,0,0,6308,52,0.000025,0,0,0,0,0,0.001061
9308153,9308153,,49,0,49,49,0,49,0.000208,0,0,1460,22,0.000182,0,0,0,0,0.059949,0.012775
9405121,9405121,,27,10,37,27,10,37,0.000016,0.000022,0,1474,22,0.000069,3,0.621622,0.710145,37319.728762,0.09009,0.006917
9408158,9408158,,24,10,34,24,10,34,0.000243,0.000088,0,2778,22,0.000042,3,0.625,0.733333,7635.721716,0.071301,0.006081
9411077,9411077,,11,2,13,11,2,13,0.000142,0.000001,0,6316,52,0.000054,1,1,1,959.578616,0.070513,0.003217
9502021,9502021,,20,10,30,20,10,30,0.000089,0.000019,0,3765,22,0.000035,4,0.492308,0.601562,19068.378462,0.135632,0.005193
1159,1159,,68,24,92,68,24,92,0.007872,0.004021,0,10795,25,0.000086,15,0.207836,0.234357,96222.78669,0.085404,0.024296
9908089,9908089,,12,10,22,12,10,22,0.000759,0.016419,0,10794,1,0.000022,13,0.191442,0.216208,3714.195816,0.138528,0.00361
1161,1161,,3,10,13,3,10,13,0.00029,0.00113,0,10800,8,0.000014,13,0.194514,0.212047,25875.979146,0.147436,0.001059
9912055,9912055,,21,16,37,21,16,37,0.00224,0.001792,0,10799,8,0.000034,13,0.181219,0.199431,28732.967848,0.20045,0.007277
9201002,9201002,,7,0,7,7,0,7,0.000013,0,0,1002,15,0.000069,0,0,0,0,0.119048,0.001775
9201016,9201016,,12,0,12,12,0,12,0.000001,0,0,1001,15,0.000315,0,0,0,0,0.113636,0.003346
9206029,9206029,,38,0,38,38,0,38,0.000392,0,0,1000,15,0.000204,0,0,0,0,0.019915,0.009118
9309023,9309023,,91,3,94,91,3,94,0.002171,0.000084,0,2293,0,0.000284,3,0.571429,0.666667,1501.093823,0.078586,0.032134
9506027,9506027,,68,10,78,68,10,78,0.001922,0.000159,0,2538,0,0.000123,6,0.305825,0.348677,21718.578381,0.114386,0.024661
9510117,9510117,,46,11,57,46,11,57,0.001074,0.000195,0,2612,0,0.000082,6,0.302133,0.347843,7013.619136,0.150063,0.01806
9702043,9702043,,44,32,76,44,32,76,0.001101,0.000399,0,4548,0,0.000064,11,0.213126,0.249935,172457.893158,0.120877,0.016423
9705035,9705035,,45,8,53,45,8,53,0.001587,0.000171,0,4557,0,0.000058,12,0.17717,0.197464,16167.121273,0.164369,0.015018
9706221,9706221,,35,32,67,35,32,67,0.00104,0.000575,0,6127,0,0.000046,13,0.188232,0.221675,51376.132634,0.149932,0.012029
9708046,9708046,,41,32,73,41,32,73,0.000951,0.000433,0,6271,0,0.000041,14,0.181998,0.21936,189446.831461,0.13946,0.012806
9801073,9801073,,36,12,48,36,12,48,0.001479,0.000498,0,8101,0,0.000059,14,0.170334,0.197598,18080.814967,0.152039,0.012303
9806233,9806233,,8,8,16,8,8,16,0.000332,0.000174,0,8340,0,0.00002,14,0.161489,0.182647,413.896215,0.2875,0.003199
9811051,9811051,,14,17,31,14,17,31,0.001147,0.011298,0,8108,0,0.00005,15,0.177229,0.203471,30887.49857,0.170968,0.005995
9902097,9902097,,8,35,43,8,35,43,0.000104,0.003156,0,8335,0,0.000026,12,0.19702,0.224363,30783.852801,0.182171,0.003148
9411179,9411179,,9,21,30,9,21,30,0.00005,0.000035,0,4249,17,0.000022,6,0.284024,0.432639,40417.415694,0.041379,0.00219
9907115,9907115,,5,20,25,5,20,25,0.000735,0.020485,0,9169,8,0.000024,11,0.228074,0.25881,97923.724489,0.248333,0.001591
9803018,9803018,,11,10,21,11,10,21,0.000781,0.000908,0,6556,0,0.000017,13,0.173786,0.207292,34742.787279,0.171429,0.003882
9907012,9907012,,23,26,49,23,26,49,0.002986,0.001914,0,9165,8,0.000029,13,0.188871,0.212539,14760.512686,0.178571,0.008514
9907032,9907032,,17,25,42,17,25,42,0.002274,0.001894,0,10798,8,0.000025,13,0.19626,0.22202,42333.104113,0.16899,0.007407
1162,1162,,2,5,7,2,5,7,0.000013,0.000013,0,10801,26,0.000016,6,0.248804,0.295726,205.833333,0.261905,0.000491
9303153,9303153,,43,2,45,43,2,45,0.000508,0.000051,0,180,26,0.000272,1,1,1,12231.643151,0.047475,0.013469
9407026,9407026,,7,12,19,7,12,19,0.000014,0.000257,0,6846,26,0.000023,5,0.308642,0.398,1533.791757,0.070175,0.001667
9410105,9410105,,9,6,15,9,6,15,0.000014,0.000149,0,3903,26,0.000026,6,0.229412,0.358547,389.844292,0.071429,0.002151
9412113,9412113,,30,5,35,30,5,35,0.000569,0.000047,0,3916,26,0.000087,6,0.233945,0.327124,6500.293061,0.078151,0.008702
9503155,9503155,,4,6,10,4,6,10,0.000013,0.000021,0,7111,26,0.000019,6,0.270035,0.327742,3942.841898,0.133333,0.000959
9203019,9203019,,9,0,9,9,0,9,0.000002,0,0,134,26,0.000491,0,0,0,0,0.097222,0.003339
9204028,9204028,,15,0,15,15,0,15,0.000036,0,0,405,5,0.000058,0,0,0,0,0.090476,0.004012
9212038,9212038,,28,0,28,28,0,28,0.000063,0,0,2252,26,0.000317,0,0,0,0,0.034392,0.00797
9209049,9209049,,68,2,70,68,2,70,0.001852,0.000004,0,136,26,0.000275,1,1,1,9060.794313,0.058178,0.019918
9307111,9307111,,61,5,66,61,5,66,0.001935,0.0002,0,734,26,0.000268,5,0.267857,0.351481,7627.31035,0.078089,0.018124
9402066,9402066,,19,1,20,19,1,20,0.00012,0.000001,0,3915,26,0.000079,1,1,1,1056.851813,0.102632,0.005588
9405028,9405028,,24,1,25,24,1,25,0.000016,0,0,3294,26,0.00017,1,1,1,3807.665062,0.055,0.0063
9412143,9412143,,14,1,15,14,1,15,0.000001,0,0,7110,23,0.000069,2,0.666667,0.75,257.416904,0.052381,0.003792
1163,1163,,2,12,14,2,12,14,0,0.000011,0,10836,23,0.000013,14,0.141159,0.154968,7448.256534,0.148352,0.000451
9903040,9903040,,9,3,12,9,3,12,0,0.000002,0,10826,23,0.000029,11,0.160343,0.173898,2645.013367,0.25,0.002201
9903116,9903116,,3,1,4,3,1,4,0,0,0,10823,23,0.000014,3,0.5,0.611111,474,0.166667,0.000725
9905079,9905079,,10,7,17,10,7,17,0.000028,0.000011,0,10819,23,0.000023,14,0.157336,0.171591,76836.519216,0.128676,0.002313
9909189,9909189,,4,11,15,4,11,15,0,0.000012,0,10827,23,0.00002,14,0.140743,0.154085,47082.876926,0.171429,0.001037
9911072,9911072,,12,7,19,12,7,19,0.000002,0,0,10835,23,0.000041,15,0.127982,0.139752,30289.10616,0.061404,0.002808
9601146,9601146,,20,0,20,20,0,20,0.000051,0,0,4963,23,0.000185,0,0,0,0,0.076316,0.005478
9704012,9704012,,10,2,12,10,2,12,0.000004,0.000001,0,5317,23,0.000109,17,0.114304,0.127035,11694.792829,0.257576,0.002736
9704028,9704028,,9,1,10,9,1,10,0.000004,0,0,5318,23,0.00006,18,0.102655,0.111667,8920.598061,0.166667,0.00242
9606037,9606037,,11,5,16,11,5,16,0,0,0,10825,23,0.000036,4,0.396825,0.493333,777.477833,0.116667,0.002626
9611055,9611055,,8,2,10,8,2,10,0,0.000104,0,10824,23,0.000032,10,0.187454,0.206258,20008.481546,0.166667,0.001929
9805161,9805161,,1,1,2,1,1,2,0,0,0,10822,22,0.000022,2,0.666667,0.75,318,0,0.00024
9810067,9810067,,6,11,17,6,11,17,0.000001,0.00227,0,10818,23,0.000018,13,0.181999,0.202884,106026.128896,0.180147,0.00148
9902142,9902142,,11,2,13,11,2,13,0.000599,0.000101,0,10802,4,0.000018,13,0.160394,0.17668,3302.372296,0.25,0.003383
9501043,9501043,,8,4,12,8,4,12,0.000025,0.000005,0,4376,22,0.000029,1,1,1,354.313996,0.113636,0.002146
9704022,9704022,,3,3,6,3,3,6,0.000001,0.000008,0,10834,23,0.000025,7,0.215434,0.247086,539.349644,0.066667,0.000777
9712087,9712087,,14,5,19,14,5,19,0.000002,0.000007,0,9180,23,0.000049,13,0.149548,0.162059,48717.431716,0.184211,0.003598
9712132,9712132,,16,1,17,16,1,17,0.000005,0,0,10833,23,0.00003,13,0.149459,0.161143,8938.265262,0.102941,0.003882
9907176,9907176,,7,2,9,7,2,9,0,0,0,10832,26,0.000028,11,0.139344,0.152323,1576.878668,0.180556,0.001627
9910139,9910139,,6,7,13,6,7,13,0,0.000001,0,10828,23,0.000023,15,0.130003,0.143675,11245.880099,0.237179,0.001462
1164,1164,,4,11,15,4,11,15,0,0.000004,0,10837,23,0.000016,15,0.13049,0.145178,6310.796063,0.190476,0.00093
9301013,9301013,,12,0,12,12,0,12,0,0,0,7925,26,0.000092,0,0,0,0,0.113636,0.003165
9410126,9410126,,11,1,12,11,1,12,0.000002,0,0,9276,5,0.000058,1,1,1,4416.222436,0.128788,0.002809
9504020,9504020,,10,2,12,10,2,12,0,0.000003,0,3613,28,0.000083,3,0.545455,0.638889,12709.060896,0.128788,0.002529
9506085,9506085,,17,4,21,17,4,21,0.000001,0.000021,0,4360,28,0.000102,3,0.533333,0.604167,5960.656573,0.092857,0.004557
1165,1165,,6,11,17,6,11,17,0.000391,0.001311,0,10840,0,0.000014,12,0.197579,0.220757,11399.220612,0.088235,0.001604
9212155,9212155,,18,0,18,18,0,18,0.000399,0,0,3680,28,0.000047,0,0,0,0,0.065359,0.004602
9809108,9809108,,6,3,9,6,3,9,0.000161,0.000159,0,8553,10,0.000018,14,0.161849,0.184329,5512.64079,0.194444,0.001659
9812024,9812024,,5,39,44,5,39,44,0.000154,0.007426,0,8554,0,0.000013,13,0.19122,0.224962,27207.575229,0.063953,0.001382
9908048,9908048,,1,6,7,1,6,7,0.000015,0.000923,0,10839,13,0.000011,11,0.189201,0.220019,2460.45073,0.142857,0.000262
9601089,9601089,,5,16,21,5,16,21,0.000585,0.002137,0,1827,13,0.000023,10,0.205195,0.245935,1921.709251,0.147619,0.004631
9803066,9803066,,8,19,27,8,19,27,0.000576,0.000972,0,6130,13,0.000014,15,0.191456,0.222587,70723.202905,0.15812,0.002837
9205012,9205012,,9,0,9,9,0,9,0.00013,0,0,228,0,0.000202,0,0,0,0,0.055556,0.003209
9511021,9511021,,1,8,9,1,8,9,0.000011,0.000686,0,10838,13,0.000011,7,0.254392,0.305767,156.903253,0.180556,0.000226
1166,1166,,10,17,27,10,17,27,0.000582,0.001912,0,10842,25,0.000018,13,0.191832,0.212124,2537.58786,0.156695,0.003086
1113,1113,,144,0,144,144,0,144,0.008985,0,0,10841,25,0.000139,0,0,0,0,0.022679,0.044873
9802107,9802107,,10,14,24,10,14,24,0.000234,0.000101,0,8784,10,0.000023,13,0.184809,0.211655,32432.319774,0.128623,0.002918
9810042,9810042,,15,4,19,15,4,19,0.00047,0.00003,0,8785,10,0.000026,14,0.164329,0.183676,2744.012678,0.154971,0.004452
9901078,9901078,,16,15,31,16,15,31,0.00171,0.003955,0,8780,2,0.000019,14,0.196661,0.224624,12330.292435,0.12043,0.004773
9902010,9902010,,6,3,9,6,3,9,0.001323,0.000735,0,8779,13,0.000013,17,0.173053,0.201,383.925379,0.25,0.001755
1167,1167,,37,10,47,37,10,47,0.000984,0.001456,0,10843,30,0.000054,13,0.193505,0.211579,34002.850869,0.132285,0.013009
1168,1168,,8,41,49,8,41,49,0.000519,0.004606,0,10922,4,0.000012,19,0.187039,0.227949,8314.306447,0.161565,0.002174
9309144,9309144,,2,4,6,2,4,6,0.000054,0,0,5066,6,0.000013,1,1,1,23957.476085,0.133333,0.000555
9309154,9309154,,30,4,34,30,4,34,0.000601,0.000011,0,1878,4,0.000066,1,1,1,6407.798202,0.055258,0.008087
9312212,9312212,,15,8,23,15,8,23,0.000693,0.000064,0,1888,4,0.000023,2,0.722222,0.807692,9033.001365,0.092885,0.004583
9403094,9403094,,16,4,20,16,4,20,0.000089,0,0,2394,6,0.000047,2,0.833333,0.9,17965.801905,0.086842,0.004261
9405011,9405011,,17,9,26,17,9,26,0.000797,0.000138,0,1899,4,0.000036,4,0.383929,0.456395,105522.654937,0.107692,0.005671
9410228,9410228,,4,24,28,4,24,28,0.000056,0.00021,0,2800,4,0.000015,7,0.289665,0.392402,39643.36255,0.037037,0.001095
9505039,9505039,,20,6,26,20,6,26,0.000803,0.000063,0,1881,4,0.000031,3,0.481481,0.564103,61129.595677,0.089231,0.006944
9510224,9510224,,49,24,73,49,24,73,0.002509,0.003145,0,1883,4,0.000046,14,0.195793,0.243954,61167.916615,0.159247,0.019133
9511125,9511125,,9,15,24,9,15,24,0.000521,0.000194,0,6014,4,0.000013,6,0.296039,0.344327,13091.316815,0.086957,0.002858
9603140,9603140,,44,33,77,44,33,77,0.003061,0.00495,0,3096,4,0.000031,13,0.21711,0.271248,64664.65398,0.179255,0.015995
9604078,9604078,,28,28,56,28,28,56,0.001813,0.003573,0,3466,4,0.000022,14,0.201342,0.25056,13487.503804,0.243831,0.010372
9701014,9701014,,49,17,66,49,17,66,0.002842,0.003337,0,4064,4,0.000034,12,0.190944,0.221386,9096.510827,0.179254,0.0153
9701123,9701123,,62,37,99,62,37,99,0.00368,0.004068,0,4065,4,0.000035,12,0.201529,0.244567,24303.455076,0.135745,0.01985
9707111,9707111,,8,5,13,8,5,13,0.000317,0.000077,0,10917,4,0.000015,3,0.533333,0.625,1014.520526,0.147436,0.002372
9711156,9711156,,21,53,74,21,53,74,0.001663,0.005237,0,5803,4,0.000016,13,0.216516,0.258551,59226.443684,0.176231,0.00659
9802007,9802007,,57,71,128,57,71,128,0.004485,0.007595,0,6057,4,0.00003,16,0.215957,0.266832,407840.789826,0.115096,0.017104
9902205,9902205,,27,39,66,27,39,66,0.00183,0.003657,0,10854,4,0.000023,14,0.198986,0.242676,140383.405677,0.175058,0.007523
9903087,9903087,,7,25,32,7,25,32,0.000572,0.018177,0,10916,4,0.000012,16,0.207981,0.24005,5626.109798,0.194556,0.002033
9903088,9903088,,11,57,68,11,57,68,0.00066,0.005172,0,10877,4,0.000013,13,0.217898,0.258476,42251.048057,0.179324,0.002885
9906235,9906235,,22,41,63,22,41,63,0.001437,0.009613,0,10921,4,0.000022,14,0.189353,0.227545,31505.7965,0.073733,0.005855
9906240,9906240,,15,49,64,15,49,64,0.000572,0.006176,0,10918,4,0.000027,18,0.193885,0.23338,46134.877904,0.130208,0.003803
9909224,9909224,,8,36,44,8,36,44,0.000873,0.005751,0,10857,4,0.000011,14,0.18438,0.220971,14426.296913,0.240486,0.002353
9912092,9912092,,44,8,52,44,8,52,0.000948,0.00002,0,10845,22,0.000069,17,0.141235,0.154305,52838.13587,0.087481,0.01085
9202073,9202073,,5,0,5,5,0,5,0,0,0,434,6,0.00005,0,0,0,0,0.15,0.001168
9204064,9204064,,85,0,85,85,0,85,0.000005,0,0,433,6,0.000519,0,0,0,0,0.015126,0.021612
9208063,9208063,,2,1,3,2,1,3,0,0,0,5064,6,0.000017,1,1,1,0,0.5,0.00046
9305091,9305091,,1,3,4,1,3,4,0,0,0,5065,6,0.000013,1,1,1,0,0.333333,0.000234
9206002,9206002,,22,0,22,22,0,22,0.000218,0,0,1472,6,0.00011,0,0,0,0,0.073593,0.00643
9210128,9210128,,26,0,26,26,0,26,0.000011,0,0,1861,4,0.000165,0,0,0,0,0.083077,0.006948
9201010,9201010,,17,0,17,17,0,17,0.000324,0,0,1213,4,0.000127,0,0,0,0,0.0625,0.005906
9201011,9201011,,21,0,21,21,0,21,0.000456,0,0,435,4,0.000213,0,0,0,0,0.064286,0.006289
9203043,9203043,,23,1,24,23,1,24,0.000488,0.000005,0,709,4,0.000064,1,1,1,3327.671421,0.050725,0.008084
9208044,9208044,,16,1,17,16,1,17,0.000319,0.000004,0,1887,4,0.000025,1,1,1,272.971251,0.106618,0.005787
9211066,9211066,,21,0,21,21,0,21,0,0,0,2390,6,0.000085,0,0,0,0,0.061905,0.005355
9302139,9302139,,1,0,1,1,0,1,0,0,0,2393,6,0.00002,0,0,0,0,0,0.000333
9305100,9305100,,21,2,23,21,2,23,0.000035,0,0,2392,6,0.000062,1,1,1,1161.07184,0.110672,0.005318
9303101,9303101,,13,4,17,13,4,17,0.000452,0.000034,0,1214,4,0.000047,2,0.642857,0.722222,9486.271125,0.069853,0.004377
9306010,9306010,,3,7,10,3,7,10,0.000002,0.000006,0,1898,6,0.000018,2,0.888889,0.9375,53803.096084,0.044444,0.000875
9312213,9312213,,10,2,12,10,2,12,0.00042,0.000005,0,1886,4,0.000024,3,0.448276,0.512821,1012.289248,0.227273,0.003158
9303026,9303026,,4,0,4,4,0,4,0.000008,0,0,1880,4,0.000018,0,0,0,0,0.166667,0.001102
9303038,9303038,,37,0,37,37,0,37,0.000229,0,0,2223,13,0.000101,0,0,0,0,0.123874,0.011428
9305090,9305090,,15,0,15,15,0,15,0.00015,0,0,693,4,0.000053,0,0,0,0,0.061905,0.005268
9308060,9308060,,22,4,26,22,4,26,0.000278,0.000001,0,2796,4,0.000047,2,0.833333,0.9,24997.549774,0.1,0.006345
9311074,9311074,,12,1,13,12,1,13,0.000007,0.000001,0,2799,6,0.000027,2,0.666667,0.75,1838.06281,0.064103,0.002825
9311132,9311132,,9,0,9,9,0,9,0.00034,0,0,560,4,0.000039,0,0,0,0,0.083333,0.002871
9312031,9312031,,2,5,7,2,5,7,0.000003,0.000005,0,2798,4,0.000011,3,0.7,0.833333,3.857765,0.333333,0.000467
9403168,9403168,,7,2,9,7,2,9,0.000392,0,0,555,4,0.000035,1,1,1,17125.659072,0.111111,0.002219
9407047,9407047,,7,7,14,7,7,14,0.000231,0.000049,0,561,4,0.000038,2,0.818182,0.888889,64210.918403,0.082418,0.002413
9412170,9412170,,7,3,10,7,3,10,0.000003,0.000012,0,1879,4,0.000026,2,0.615385,0.6875,5831.684484,0.133333,0.001884
9502041,9502041,,3,1,4,3,1,4,0.000001,0,0,1875,22,0.000017,1,1,1,11076.025282,0,0.000834
9312210,9312210,,9,10,19,9,10,19,0.000279,0.000055,0,1882,4,0.000017,3,0.575758,0.719298,26446.598014,0.105263,0.002979
9510165,9510165,,2,1,3,2,1,3,0.000091,0.000027,0,1873,4,0.000014,1,1,1,98.748534,0.333333,0.001694
9208031,9208031,,39,2,41,39,2,41,0.000217,0.000021,0,681,4,0.000075,1,1,1,495.174763,0.07378,0.010828
9211090,9211090,,20,0,20,20,0,20,0.000229,0,0,928,4,0.000044,0,0,0,0,0.044737,0.005928
9403190,9403190,,15,11,26,15,11,26,0.000014,0.000043,0,952,4,0.000037,5,0.31068,0.426823,1916.921599,0.158462,0.004432
9404056,9404056,,22,10,32,22,10,32,0.000348,0.000037,0,953,4,0.000036,5,0.318627,0.433077,1601.934981,0.122984,0.005736
9405096,9405096,,35,10,45,35,10,45,0.000286,0.00004,0,1259,4,0.000059,6,0.272031,0.39108,5327.803777,0.051515,0.009429
9407018,9407018,,61,9,70,61,9,70,0.002358,0.000225,0,1278,4,0.000105,3,0.666667,0.770833,42691.79203,0.048447,0.018617
9407134,9407134,,21,2,23,21,2,23,0.000423,0.000057,0,1275,4,0.00004,2,0.75,0.833333,565.809864,0.094862,0.005377
9502029,9502029,,8,22,30,8,22,30,0.000013,0.0002,0,1281,4,0.000017,6,0.328407,0.407083,51419.723604,0.118391,0.00204
9511052,9511052,,36,14,50,36,14,50,0.002034,0.002797,0,1884,4,0.000039,14,0.185385,0.228448,18900.51687,0.198776,0.017433
9404173,9404173,,31,2,33,31,2,33,0.001209,0.000004,0,3095,4,0.000073,2,0.75,0.833333,19581.734905,0.063447,0.008208
9503133,9503133,,11,5,16,11,5,16,0.000178,0.000007,0,1758,26,0.000037,2,0.777778,0.857143,41365.163205,0.1,0.00335
9511070,9511070,,9,5,14,9,5,14,0.00027,0.000058,0,3094,4,0.000021,3,0.541667,0.653846,1000.612435,0.17033,0.003184
9602005,9602005,,28,19,47,28,19,47,0.001575,0.003633,0,3075,4,0.000026,14,0.199435,0.246202,20976.419082,0.221092,0.011526
9309033,9309033,,14,4,18,14,4,18,0.000093,0.000004,0,2797,4,0.00003,3,0.666667,0.805556,2057.313539,0.130719,0.003635
9611158,9611158,,6,0,6,6,0,6,0.000206,0,0,4063,4,0.000014,0,0,0,0,0.266667,0.002206
9211089,9211089,,4,0,4,4,0,4,0.000054,0,0,929,4,0.000023,0,0,0,0,0.083333,0.001677
9505074,9505074,,16,21,37,16,21,37,0.001588,0.001304,0,1019,5,0.000024,7,0.325048,0.411289,36475.3902,0.061562,0.005868
9606063,9606063,,18,4,22,18,4,22,0.000398,0.001158,0,4207,4,0.000044,13,0.180654,0.211054,4361.804017,0.264069,0.005089
9612238,9612238,,23,26,49,23,26,49,0.002328,0.006163,0,4260,4,0.000017,12,0.210135,0.249652,5579.568722,0.193878,0.008231
9701148,9701148,,4,10,14,4,10,14,0.000148,0.000056,0,4259,26,0.000012,10,0.271291,0.328465,202965.681236,0.153846,0.001373
9702138,9702138,,11,14,25,11,14,25,0.000323,0.000633,0,4219,4,0.000031,11,0.18907,0.219228,45326.795535,0.231667,0.003306
9705229,9705229,,12,15,27,12,15,27,0.000424,0.000638,0,4221,4,0.000022,11,0.187986,0.217665,36885.631673,0.213675,0.003386
9403001,9403001,,4,0,4,4,0,4,0.000336,0,0,5798,4,0.000012,0,0,0,0,0.25,0.001478
9606071,9606071,,8,5,13,8,5,13,0.000065,0.000127,0,4797,26,0.000018,10,0.188686,0.230476,18861.921234,0.198718,0.002171
9610198,9610198,,7,6,13,7,6,13,0.000142,0.000478,0,5797,13,0.000013,14,0.167109,0.211893,5425.94946,0.24359,0.002176
9701004,9701004,,3,2,5,3,2,5,0.000168,0,0,5796,4,0.000011,7,0.21129,0.235823,19901.415986,0.15,0.001112
9707120,9707120,,38,43,81,38,43,81,0.003113,0.006507,0,4827,4,0.000025,15,0.2174,0.258246,232301.343474,0.095988,0.012505
9704205,9704205,,11,27,38,11,27,38,0.000686,0.003018,0,4066,4,0.000015,12,0.198034,0.236935,3777.661758,0.280228,0.004775
9709001,9709001,,12,27,39,12,27,39,0.000954,0.004927,0,5800,4,0.000014,11,0.214464,0.248564,4653.767662,0.196356,0.003818
9710248,9710248,,16,27,43,16,27,43,0.000788,0.003395,0,5794,4,0.000014,11,0.200916,0.234582,43201.240064,0.115172,0.005236
9707017,9707017,,32,19,51,32,19,51,0.001375,0.002672,0,4866,4,0.000029,11,0.189754,0.21968,110453.801343,0.138824,0.010082
9710146,9710146,,21,32,53,21,32,53,0.001792,0.004703,0,5946,4,0.000016,12,0.203552,0.244012,11719.192162,0.142961,0.007048
9711108,9711108,,47,35,82,47,35,82,0.003501,0.003372,0,5965,4,0.00003,13,0.198643,0.240961,62636.037897,0.093044,0.014832
9711194,9711194,,16,23,39,16,23,39,0.001275,0.002901,0,5977,4,0.000014,13,0.176366,0.2114,31283.335027,0.195007,0.0054
9712039,9712039,,14,22,36,14,22,36,0.000885,0.003078,0,5971,4,0.000013,14,0.161832,0.191101,6684.497194,0.246032,0.004654
9712062,9712062,,30,20,50,30,20,50,0.002145,0.003076,0,6056,4,0.000023,13,0.187685,0.226155,178476.972928,0.170612,0.009675
9712109,9712109,,17,23,40,17,23,40,0.001234,0.002904,0,6017,4,0.000014,14,0.174166,0.202982,20718.077925,0.205128,0.005536
9712110,9712110,,13,79,92,13,79,92,0.000772,0.003635,0,6005,4,0.000015,14,0.211501,0.261004,321005.502886,0.108337,0.0044
9712177,9712177,,15,33,48,15,33,48,0.001223,0.003962,0,6015,4,0.000014,16,0.208392,0.251655,17328.575868,0.252216,0.005096
9801036,9801036,,12,35,47,12,35,47,0.000623,0.003882,0,5959,4,0.000013,14,0.198521,0.236282,18387.511819,0.150324,0.003592
9603178,9603178,,7,8,15,7,8,15,0.000314,0.00042,0,10680,4,0.000013,14,0.174212,0.211087,20752.401182,0.142857,0.001992
9606144,9606144,,8,5,13,8,5,13,0.000412,0.000018,0,4826,4,0.000022,5,0.291785,0.339159,25310.312792,0.076923,0.002481
9702182,9702182,,8,23,31,8,23,31,0.000407,0.000105,0,10853,4,0.000015,15,0.180407,0.218997,56104.47596,0.054839,0.002269
9801149,9801149,,6,29,35,6,29,35,0.000374,0.003768,0,5942,4,0.000012,14,0.195073,0.229177,16922.32645,0.272269,0.002161
9812078,9812078,,19,57,76,19,57,76,0.001745,0.007249,0,10846,4,0.000015,13,0.205312,0.250192,23944.055921,0.191579,0.005715
9502091,9502091,,22,23,45,22,23,45,0.001456,0.000131,0,5976,4,0.000025,5,0.334375,0.459657,46560.23819,0.053535,0.006928
9810031,9810031,,7,10,17,7,10,17,0.001009,0.016577,0,10915,4,0.000012,15,0.198427,0.22698,7374.073005,0.150735,0.002035
9801061,9801061,,29,18,47,29,18,47,0.002406,0.00299,0,6503,4,0.000022,15,0.176966,0.203697,53207.992544,0.145698,0.008796
9803126,9803126,,23,28,51,23,28,51,0.001742,0.00348,0,10678,4,0.000017,14,0.194699,0.226192,26100.509966,0.15451,0.006454
9805051,9805051,,13,78,91,13,78,91,0.00133,0.008137,0,10876,4,0.000012,13,0.240411,0.287413,43055.080886,0.140537,0.004059
9902030,9902030,,9,40,49,9,40,49,0.000877,0.004698,0,10875,4,0.000012,12,0.202405,0.234769,43416.587447,0.171344,0.002525
9303047,9303047,,8,0,8,8,0,8,0.000161,0,0,531,4,0.000052,0,0,0,0,0.071429,0.003006
9410188,9410188,,3,0,3,3,0,3,0.000114,0,0,1863,4,0.000022,0,0,0,0,0,0.001303
9607213,9607213,,1,0,1,1,0,1,0.000113,0,0,10920,4,0.00001,0,0,0,0,0,0.000376
9608013,9608013,,10,4,14,10,4,14,0.000374,0.000033,0,10919,4,0.000017,10,0.164394,0.19675,742.729995,0.115385,0.002658
9610207,9610207,,3,5,8,3,5,8,0.000118,0.000027,0,5980,4,0.000012,4,0.41573,0.488739,16578.651715,0.178571,0.000883
9901089,9901089,,17,12,29,17,12,29,0.001449,0.002424,0,10878,4,0.000021,13,0.181464,0.204522,13139.463561,0.098522,0.005214
9903252,9903252,,5,35,40,5,35,40,0.000319,0.00444,0,10858,4,0.000011,13,0.190927,0.225209,2388.778828,0.235897,0.001434
9904121,9904121,,3,31,34,3,31,34,0.000212,0.002927,0,10914,4,0.000011,14,0.181075,0.210843,3927.929284,0.184492,0.00084
9905010,9905010,,3,0,3,3,0,3,0.000176,0,0,10912,4,0.000011,0,0,0,0,0.166667,0.000926
9905053,9905053,,15,43,58,15,43,58,0.001063,0.004367,0,10892,4,0.000014,13,0.200854,0.237393,34026.380293,0.197822,0.004272
9905224,9905224,,14,69,83,14,69,83,0.001156,0.005345,0,10898,4,0.000014,13,0.211271,0.250248,24952.757803,0.165883,0.00403
9906027,9906027,,6,64,70,6,64,70,0.000422,0.0058,0,10911,4,0.000012,12,0.230147,0.272478,136537.216609,0.144306,0.001637
9906029,9906029,,4,39,43,4,39,43,0.000215,0.005442,0,10883,4,0.000011,17,0.19815,0.234778,15593.670976,0.132337,0.001059
9604080,9604080,,13,9,22,13,9,22,0.00007,0.000013,0,10856,6,0.000038,6,0.308123,0.38697,13538.404062,0.054113,0.003112
9805098,9805098,,8,0,8,8,0,8,0.000003,0,0,6810,22,0.000176,0,0,0,0,0.285714,0.00266
9909126,9909126,,15,3,18,15,3,18,0.000362,0.00001,0,10844,22,0.000038,9,0.164351,0.192428,5163.003505,0.153595,0.004211
1169,1169,,6,17,23,6,17,23,0.000142,0.001506,0,10923,2,0.000012,13,0.197466,0.22411,1515.707047,0.213439,0.001508
9712059,9712059,,27,22,49,27,22,49,0.00167,0.006268,0,5689,2,0.00003,14,0.19088,0.224022,72084.700121,0.10119,0.008642
9510216,9510216,,8,6,14,8,6,14,0.000263,0.000095,0,3229,2,0.000018,6,0.415094,0.497727,16995.756325,0.131868,0.002138
9604196,9604196,,34,22,56,34,22,56,0.0013,0.006945,0,2842,23,0.000058,11,0.217021,0.264047,118446.78172,0.040584,0.009941
9608171,9608171,,3,7,10,3,7,10,0.000129,0.001025,0,5696,4,0.000012,12,0.195623,0.227413,10502.651487,0.111111,0.001054
9706094,9706094,,9,14,23,9,14,23,0.000525,0.002258,0,4331,2,0.000021,12,0.195294,0.224873,2693.944914,0.167984,0.003516
9706210,9706210,,9,40,49,9,40,49,0.000428,0.005355,0,4327,13,0.000018,12,0.22071,0.265281,122241.627087,0.067177,0.002683
9709171,9709171,,6,20,26,6,20,26,0.000399,0.007492,0,4982,2,0.000013,13,0.198196,0.230125,1513.627355,0.229231,0.00203
1170,1170,,8,31,39,8,31,39,0.000385,0.004082,0,10926,3,0.000014,13,0.204353,0.232464,15279.141345,0.17139,0.002665
9812225,9812225,,10,22,32,10,22,32,0.00052,0.003485,0,9969,2,0.000014,12,0.215202,0.246883,5011.54964,0.16129,0.002561
9909194,9909194,,5,10,15,5,10,15,0.000253,0.001142,0,10925,3,0.000014,14,0.192636,0.217559,910.677005,0.219048,0.002382
9912030,9912030,,8,24,32,8,24,32,0.000465,0.005677,0,10924,2,0.000013,15,0.184216,0.214929,2251.546152,0.190524,0.002045
9609192,9609192,,24,17,41,24,17,41,0.000354,0.001066,0,4122,23,0.000047,10,0.213659,0.24729,168173.221501,0.09939,0.00701
9607238,9607238,,5,5,10,5,5,10,0.000453,0.002013,0,3422,2,0.000017,10,0.194167,0.218952,57.649589,0.144444,0.00215
9609234,9609234,,4,18,22,4,18,22,0.000274,0.005193,0,3425,13,0.000022,11,0.206268,0.246844,17661.817533,0.082251,0.001719
9702044,9702044,,1,0,1,1,0,1,0.00012,0,0,3414,2,0.000012,0,0,0,0,0,0.000939
1171,1171,,1,4,5,1,4,5,0.000005,0.000002,0,10927,28,0.00001,11,0.16848,0.200879,0,0.45,0.0003
9512142,9512142,,13,2,15,13,2,15,0.000011,0.000001,0,4782,28,0.00003,2,0.625,0.7,2.826923,0.242857,0.003742
9605035,9605035,,19,2,21,19,2,21,0.00001,0.000001,0,4781,28,0.000053,2,0.625,0.7,33.926923,0.142857,0.005158
9610191,9610191,,41,28,69,41,28,69,0.000117,0.000123,0,4786,28,0.000094,10,0.201893,0.268312,330194.525079,0.073103,0.010513
9310074,9310074,,2,1,3,2,1,3,0.000001,0,0,4785,28,0.000014,1,1,1,984.828623,0,0.000725
9401132,9401132,,8,0,8,8,0,8,0.000002,0,0,3720,22,0.00003,0,0,0,0,0.160714,0.00222
9409023,9409023,,12,0,12,12,0,12,0.000143,0,0,3262,3,0.000038,0,0,0,0,0.121212,0.003637
9411177,9411177,,15,1,16,15,1,16,0.000034,0.000001,0,1366,28,0.000096,2,0.666667,0.75,57.414992,0.208333,0.004673
9502125,9502125,,26,3,29,26,3,29,0.000038,0.000001,0,4148,28,0.000128,2,0.8,0.875,12926.208208,0.213054,0.008068
9504087,9504087,,2,0,2,2,0,2,0.000002,0,0,2111,28,0.000016,0,0,0,0,0,0.000747
9505077,9505077,,8,2,10,8,2,10,0.000019,0.000001,0,1367,28,0.000031,2,0.75,0.833333,16424.246271,0.188889,0.002731
9508131,9508131,,30,1,31,30,1,31,0.000365,0,0,4152,28,0.00006,3,0.5,0.566667,177.988641,0.132258,0.00835
9508136,9508136,,24,4,28,24,4,28,0.000011,0.000001,0,4151,28,0.000073,2,0.7,0.785714,12533.330933,0.130952,0.00702
9509005,9509005,,5,5,10,5,5,10,0.000007,0.00001,0,4784,28,0.000019,2,0.857143,0.916667,5041.234137,0.188889,0.001505
9510036,9510036,,21,6,27,21,6,27,0.000037,0.000011,0,4153,28,0.000045,2,0.6875,0.772727,869.52311,0.230769,0.006251
9511158,9511158,,14,8,22,14,8,22,0.000067,0.000018,0,4778,28,0.000029,3,0.64,0.739583,1915.934752,0.279221,0.004388
9512080,9512080,,18,7,25,18,7,25,0.00008,0.000007,0,4160,28,0.000031,4,0.522727,0.619565,33768.685589,0.198333,0.005351
9604152,9604152,,32,11,43,32,11,43,0.000263,0.00003,0,4779,28,0.000057,6,0.271493,0.401944,29639.365244,0.148948,0.009023
9608179,9608179,,6,2,8,6,2,8,0.000006,0,0,4775,28,0.000028,1,1,1,8641.604673,0.089286,0.001735
9609166,9609166,,9,23,32,9,23,32,0.000252,0.000031,0,4773,23,0.000037,9,0.231996,0.293843,243810.871554,0.047379,0.002528
1172,1172,,1,17,18,1,17,18,0,0.00001,0,10954,6,0.00001,20,0.123637,0.158261,83.306966,0.254902,0.000226
9206114,9206114,,22,0,22,22,0,22,0.000056,0,0,3827,6,0.000109,0,0,0,0,0.0671,0.00557
9409108,9409108,,17,4,21,17,4,21,0.000003,0.000033,0,3848,6,0.000052,2,0.75,0.833333,6755.803591,0.104762,0.004968
9701107,9701107,,15,7,22,15,7,22,0.000001,0.000003,0,7826,6,0.000035,7,0.266904,0.321063,1017.149859,0.205628,0.003883
9712222,9712222,,12,8,20,12,8,20,0.000002,0.000002,0,10649,6,0.000019,10,0.206667,0.253546,2771.608465,0.192105,0.003011
9803104,9803104,,11,4,15,11,4,15,0.000001,0.000001,0,10648,6,0.000022,8,0.215297,0.254112,58.018995,0.233333,0.00271
9902192,9902192,,3,4,7,3,4,7,0,0.000001,0,10942,6,0.000012,11,0.140625,0.163769,17942.160012,0.214286,0.000738
9909031,9909031,,11,13,24,11,13,24,0.000056,0.000001,0,10943,6,0.000016,12,0.162819,0.208462,22270.774097,0.228261,0.0026
9910102,9910102,,12,22,34,12,22,34,0.000002,0.00001,0,10953,6,0.000021,19,0.134637,0.172893,33042.84226,0.127451,0.002974
9304050,9304050,,13,3,16,13,3,16,0.000005,0.000034,0,3847,6,0.000041,1,1,1,521.363531,0.1125,0.003333
9304051,9304051,,17,2,19,17,2,19,0.000018,0,0,3846,6,0.000058,1,1,1,10855.881888,0.052632,0.00437
9405087,9405087,,12,1,13,12,1,13,0.000001,0,0,6499,6,0.000081,1,1,1,1003.384437,0.057692,0.003183
9509024,9509024,,8,3,11,8,3,11,0,0.000001,0,6500,6,0.000058,4,0.365854,0.466667,16018.96213,0.1,0.002081
9311189,9311189,,16,3,19,16,3,19,0.000001,0,0,2400,6,0.00008,2,0.666667,0.75,11894.64726,0.119883,0.004552
9601135,9601135,,20,7,27,20,7,27,0.000005,0.000002,0,4073,6,0.000111,7,0.227147,0.314779,17445.036512,0.04416,0.005145
9203065,9203065,,15,0,15,15,0,15,0,0,0,1186,6,0.00014,0,0,0,0,0.028571,0.004099
9503227,9503227,,51,8,59,51,8,59,0.000128,0.000023,0,3849,6,0.000089,6,0.3125,0.411905,26469.85955,0.050263,0.013018
9610003,9610003,,8,12,20,8,12,20,0,0.000002,0,7828,6,0.000024,8,0.251131,0.31783,53087.327474,0.147368,0.002133
9506120,9506120,,3,0,3,3,0,3,0.000001,0,0,10695,6,0.000014,0,0,0,0,0,0.000713
9706017,9706017,,12,13,25,12,13,25,0.000002,0.000006,0,6794,6,0.00003,9,0.229902,0.294074,39104.234071,0.125,0.003297
9607115,9607115,,6,0,6,6,0,6,0,0,0,10934,6,0.000039,0,0,0,0,0.1,0.00137
9709039,9709039,,10,3,13,10,3,13,0.000001,0.000001,0,10941,23,0.000038,10,0.154908,0.176577,15168.885012,0.089744,0.002315
9212143,9212143,,6,4,10,6,4,10,0,0.000002,0,2360,6,0.00003,2,0.75,0.833333,9274.558109,0.088889,0.001775
9305134,9305134,,2,1,3,2,1,3,0,0.000001,0,10952,6,0.000011,1,1,1,49.995879,0,0.00054
9312169,9312169,,21,1,22,21,1,22,0.000001,0.000001,0,2025,6,0.000062,2,0.666667,0.75,10142.393715,0.108225,0.005926
9411085,9411085,,14,10,24,14,10,24,0.000002,0.000002,0,5881,6,0.000023,2,0.708333,0.794118,32297.181518,0.108696,0.00357
9703026,9703026,,6,11,17,6,11,17,0.000059,0.000003,0,6791,6,0.000015,6,0.309322,0.373858,37890.608096,0.132353,0.001688
9902053,9902053,,6,5,11,6,5,11,0.000001,0.000003,0,10947,6,0.00002,11,0.176915,0.219707,92.262475,0.372727,0.0017
9902085,9902085,,2,2,4,2,2,4,0,0.000001,0,10951,6,0.000011,9,0.210407,0.246021,3423.471397,0.25,0.000554
9906114,9906114,,5,5,10,5,5,10,0.000549,0.000034,0,10944,6,0.000013,11,0.176439,0.217167,8253.538823,0.177778,0.001257
9906219,9906219,,9,15,24,9,15,24,0.000002,0.000012,0,10948,6,0.000023,10,0.213616,0.278518,5077.291201,0.161232,0.002387
9909104,9909104,,4,13,17,4,13,17,0,0.000001,0,10933,6,0.000013,18,0.14311,0.175408,21229.294453,0.106618,0.000988
1173,1173,,5,13,18,5,13,18,0.000091,0.000218,0,10955,52,0.000012,17,0.162482,0.182427,5186.994938,0.202614,0.001263
9808023,9808023,,5,4,9,5,4,9,0.000158,0.000704,0,8960,52,0.000015,15,0.172811,0.196441,1907.18607,0.333333,0.001301
9904105,9904105,,13,8,21,13,8,21,0.000296,0.000215,0,8958,52,0.000026,16,0.162935,0.188871,9679.413359,0.22619,0.00334
9908187,9908187,,12,8,20,12,8,20,0.000293,0.000235,0,8959,52,0.000023,13,0.164429,0.184305,9014.233639,0.252632,0.003038
1174,1174,,3,5,8,3,5,8,0,0.000007,0,10957,23,0.000015,7,0.332226,0.374048,5034.878639,0.160714,0.000697
9807191,9807191,,8,3,11,8,3,11,0.000002,0.000003,0,9776,23,0.000029,2,0.8,0.875,10718.815176,0.081818,0.002327
9905192,9905192,,5,2,7,5,2,7,0,0,0,10956,23,0.000019,2,0.625,0.7,255.338928,0.166667,0.001162
9206106,9206106,,37,0,37,37,0,37,0.000078,0,0,816,23,0.000326,0,0,0,0,0.06982,0.011034
9302122,9302122,,14,0,14,14,0,14,0.000135,0,0,3821,23,0.000058,0,0,0,0,0.043956,0.003847
9302136,9302136,,35,0,35,35,0,35,0.000103,0,0,2563,23,0.000109,0,0,0,0,0.048739,0.009059
9503140,9503140,,9,1,10,9,1,10,0,0,0,9775,23,0.000102,1,1,1,6350.023103,0.111111,0.002283
1175,1175,,4,9,13,4,9,13,0.000001,0.000007,0,10967,23,0.000014,19,0.135825,0.151181,4806.132032,0.211538,0.000949
9707185,9707185,,25,8,33,25,8,33,0.00008,0.001874,0,7115,23,0.000072,12,0.187213,0.220168,72144.106635,0.095644,0.007344
9801169,9801169,,5,11,16,5,11,16,0.00004,0.000008,0,10966,26,0.000022,11,0.160896,0.195312,6892.209214,0.045833,0.001277
9802191,9802191,,19,5,24,19,5,24,0.000032,0.000016,0,10357,23,0.000044,10,0.17771,0.202569,8643.529179,0.110507,0.004872
9803177,9803177,,16,6,22,16,6,22,0.000034,0.000007,0,10356,23,0.000043,10,0.16977,0.193745,1505.146102,0.123377,0.003997
9809209,9809209,,10,6,16,10,6,16,0.000016,0.000002,0,10959,23,0.000024,10,0.184117,0.213115,2835.670548,0.141667,0.002424
9811248,9811248,,11,10,21,11,10,21,0.000016,0.000011,0,10960,23,0.000021,15,0.146539,0.162114,54967.434733,0.12619,0.002659
9512141,9512141,,2,0,2,2,0,2,0.000039,0,0,3999,23,0.000045,0,0,0,0,0.5,0.000686
9512173,9512173,,22,31,53,22,31,53,0.000299,0.003803,0,3418,4,0.000084,11,0.213881,0.265063,56358.250913,0.066038,0.005516
9608191,9608191,,5,7,12,5,7,12,0.000024,0.002183,0,6029,23,0.000033,9,0.194553,0.224505,14249.093164,0.113636,0.001653
9702035,9702035,,14,8,22,14,8,22,0.000119,0.000006,0,6031,23,0.000064,13,0.158441,0.180847,29525.055254,0.158009,0.004675
9702049,9702049,,26,13,39,26,13,39,0.00004,0.000017,0,7114,23,0.000094,9,0.195396,0.227368,38965.859833,0.066127,0.006794
9702117,9702117,,6,1,7,6,1,7,0.00005,0.000004,0,7108,4,0.000027,12,0.176316,0.200674,0,0.190476,0.001582
9309065,9309065,,8,3,11,8,3,11,0.000005,0.000008,0,2254,26,0.000033,2,0.666667,0.75,19424.588488,0.072727,0.00209
9404059,9404059,,11,1,12,11,1,12,0.000039,0,0,2631,26,0.000034,2,0.666667,0.75,986.013219,0.045455,0.002729
9408164,9408164,,32,2,34,32,2,34,0.000175,0.000001,0,1756,26,0.000153,1,1,1,7176.122334,0.061497,0.008125
9511119,9511119,,7,8,15,7,8,15,0.000016,0.000005,0,3638,26,0.000037,3,0.684211,0.794872,56071.650507,0.047619,0.001739
9602155,9602155,,19,1,20,19,1,20,0.000211,0.000002,0,7374,26,0.000047,10,0.159608,0.17327,5102.548029,0.176316,0.004655
9609055,9609055,,1,2,3,1,2,3,0,0.000003,0,10965,26,0.000012,10,0.167521,0.188722,1865.541258,0,0.000254
9610056,9610056,,2,4,6,2,4,6,0,0.000007,0,7112,26,0.000018,7,0.230563,0.277685,13469.036528,0.066667,0.000657
9508142,9508142,,22,4,26,22,4,26,0.000005,0.000006,0,7370,26,0.000075,7,0.261905,0.293189,24424.901204,0.016923,0.005479
9710205,9710205,,33,4,37,33,4,37,0.000245,0.000018,0,7107,23,0.00008,7,0.219436,0.257568,2190.339349,0.09009,0.009083
9802066,9802066,,7,5,12,7,5,12,0.000034,0.000007,0,8125,23,0.000038,9,0.179061,0.217695,25230.165349,0.037879,0.001827
9610213,9610213,,5,2,7,5,2,7,0.000023,0.00186,0,7109,23,0.000043,6,0.263804,0.29832,881.963777,0.190476,0.001951
9611105,9611105,,6,13,19,6,13,19,0.000008,0.000183,0,7371,26,0.000019,8,0.245431,0.296622,10512.489513,0.099415,0.001553
9709115,9709115,,3,3,6,3,3,6,0,0.000001,0,10958,23,0.00002,10,0.163776,0.181276,122.028928,0.1,0.000726
9807108,9807108,,11,1,12,11,1,12,0.000088,0.000012,0,10363,4,0.00003,8,0.18625,0.209652,107.502438,0.083333,0.002786
9602047,9602047,,7,2,9,7,2,9,0.000026,0.000002,0,6028,23,0.000043,2,0.666667,0.75,256.302214,0.138889,0.00195
9810088,9810088,,8,5,13,8,5,13,0.000014,0.000003,0,10358,23,0.000026,10,0.171281,0.191742,245.446322,0.205128,0.00203
9907139,9907139,,17,11,28,17,11,28,0.000003,0.000023,0,10359,23,0.00005,10,0.177732,0.207046,42583.70011,0.080688,0.003977
1176,1176,,3,11,14,3,11,14,0.000194,0.000204,0,10968,0,0.000013,14,0.166194,0.187538,965.057281,0.263736,0.000789
9501066,9501066,,39,7,46,39,7,46,0.00091,0.000131,0,2444,0,0.000057,6,0.312977,0.345833,13434.377402,0.103865,0.012602
9308023,9308023,,18,0,18,18,0,18,0.00035,0,0,2297,0,0.000103,0,0,0,0,0.248366,0.008833
9404191,9404191,,16,13,29,16,13,29,0.000183,0.000713,0,1081,0,0.000037,5,0.343458,0.423696,19149.432714,0.07266,0.005151
9407005,9407005,,7,39,46,7,39,46,0.000081,0.001211,0,1085,41,0.000039,6,0.388136,0.482897,47954.026211,0.081643,0.003673
9412074,9412074,,10,14,24,10,14,24,0.00011,0.002566,0,1033,0,0.000032,6,0.347333,0.396024,10745.634315,0.036232,0.003816
9504083,9504083,,38,2,40,38,2,40,0.000618,0.000081,0,3497,0,0.000069,4,0.409091,0.509259,269.718845,0.142949,0.012269
9507017,9507017,,36,9,45,36,9,45,0.000821,0.000734,0,3499,0,0.000053,6,0.288983,0.325904,31601.27702,0.147475,0.013453
9607146,9607146,,6,15,21,6,15,21,0.000048,0.000239,0,4553,0,0.00002,12,0.171457,0.203187,9544.310736,0.185714,0.002012
9701085,9701085,,22,10,32,22,10,32,0.000542,0.000711,0,4549,0,0.000037,12,0.180586,0.223339,4873.169829,0.155242,0.007412
9407101,9407101,,9,1,10,9,1,10,0.0003,0.000017,0,4547,0,0.000025,1,1,1,103.843626,0.133333,0.003624
9410136,9410136,,33,6,39,33,6,39,0.001007,0.000174,0,2536,0,0.000065,4,0.3875,0.44086,1710.744826,0.190283,0.013145
9604084,9604084,,17,8,25,17,8,25,0.000462,0.000143,0,4541,0,0.000029,7,0.248567,0.27851,12107.145364,0.25,0.005875
9608045,9608045,,18,6,24,18,6,24,0.000448,0.000055,0,2606,0,0.00003,8,0.211245,0.247252,849.525823,0.20471,0.006193
9608136,9608136,,14,8,22,14,8,22,0.000455,0.000117,0,2607,0,0.000024,11,0.199455,0.232365,6974.43659,0.229437,0.005272
9704173,9704173,,16,20,36,16,20,36,0.000531,0.003548,0,6112,0,0.000025,12,0.204983,0.235622,22613.198624,0.12619,0.005543
9503097,9503097,,10,2,12,10,2,12,0.000322,0,0,7478,0,0.000218,1,1,1,10202.814888,0.106061,0.003212
9709022,9709022,,13,21,34,13,21,34,0.000351,0.000268,0,6274,0,0.000019,13,0.173142,0.201247,52303.36011,0.253119,0.004231
9710018,9710018,,1,17,18,1,17,18,0.000005,0.000461,0,8106,0,0.000011,14,0.176542,0.204397,194.008988,0.173203,0.000316
9710070,9710070,,2,9,11,2,9,11,0.000063,0.000145,0,8105,0,0.000011,14,0.162313,0.185285,172.940861,0.236364,0.000872
9710188,9710188,,25,22,47,25,22,47,0.001484,0.000524,0,6275,0,0.000027,14,0.171336,0.20115,76042.735753,0.193802,0.008477
9711049,9711049,,4,14,18,4,14,18,0.000195,0.000139,0,8104,0,0.000012,13,0.181271,0.20568,2226.002815,0.215686,0.001453
9408023,9408023,,7,0,7,7,0,7,0.000006,0,0,7476,0,0.00022,0,0,0,0,0.047619,0.002024
9503149,9503149,,15,4,19,15,4,19,0.000502,0.000112,0,2535,0,0.000037,4,0.377778,0.438725,468.479517,0.093567,0.004511
9709066,9709066,,7,2,9,7,2,9,0.000936,0,0,8326,1,0.000019,1,1,1,12503.442181,0.069444,0.002266
9905211,9905211,,18,18,36,18,18,36,0.001707,0.020302,0,10522,1,0.000032,14,0.199115,0.22729,15730.990657,0.075397,0.007257
9207054,9207054,,4,0,4,4,0,4,0,0,0,8325,22,0.000032,0,0,0,0,0,0.000939
9209102,9209102,,5,0,5,5,0,5,0.000006,0,0,8324,22,0.00003,0,0,0,0,0.05,0.001199
9705147,9705147,,3,7,10,3,7,10,0.000217,0.00194,0,7890,13,0.000018,12,0.202541,0.234064,2866.704918,0.111111,0.000957
9807241,9807241,,3,10,13,3,10,13,0.000659,0.017873,0,7423,1,0.000016,13,0.196626,0.219677,9123.982888,0.288462,0.001389
9411214,9411214,,1,4,5,1,4,5,0.000001,0.000001,0,7896,5,0.000016,1,1,1,9653.807112,0,0.00028
9407064,9407064,,17,2,19,17,2,19,0.000318,0.000005,0,1642,5,0.000048,3,0.5,0.595238,1104.790995,0.152047,0.005063
9507139,9507139,,7,0,7,7,0,7,0.00024,0,0,4592,5,0.000019,0,0,0,0,0.02381,0.001831
9905030,9905030,,16,35,51,16,35,51,0.002633,0.021627,0,8803,1,0.000022,13,0.214888,0.246505,134288.889276,0.10549,0.005361
9905205,9905205,,14,13,27,14,13,27,0.002823,0.018393,0,8811,1,0.00002,14,0.193306,0.218267,39051.757406,0.190883,0.004648
1178,1178,,19,17,36,19,17,36,0.004108,0.003744,0,10973,1,0.000019,11,0.22771,0.258384,8549.442817,0.196825,0.005763
9912007,9912007,,39,36,75,39,36,75,0.006415,0.015748,0,10971,1,0.000032,10,0.229381,0.261984,132219.868394,0.140901,0.011602
9912168,9912168,,26,11,37,26,11,37,0.004849,0.010622,0,10972,1,0.000021,11,0.196055,0.217338,59845.189872,0.174174,0.00861
9710127,9710127,,24,24,48,24,24,48,0.001513,0.001517,0,5246,2,0.000052,11,0.202422,0.233352,35946.285386,0.136082,0.008347
9709118,9709118,,19,37,56,19,37,56,0.002771,0.010855,0,4415,2,0.000028,11,0.216131,0.252349,124703.02879,0.122078,0.007612
9712082,9712082,,10,28,38,10,28,38,0.002019,0.011825,0,5597,2,0.000017,15,0.185275,0.219876,18712.153506,0.183499,0.004162
9705033,9705033,,1,1,2,1,1,2,0.000309,0.000002,0,5814,6,0.000011,2,0.666667,0.75,15407.943772,0,0.000893
9902038,9902038,,3,19,22,3,19,22,0.000381,0.001848,0,10970,28,0.000013,15,0.193093,0.226428,22257.825857,0.071429,0.000998
9905226,9905226,,43,47,90,43,47,90,0.009713,0.025014,0,8832,1,0.000041,10,0.235584,0.270119,62438.111258,0.109613,0.019276
9910150,9910150,,36,23,59,36,23,59,0.006789,0.017728,0,10746,1,0.000025,12,0.199487,0.221722,4804.455711,0.216248,0.012126
1179,1179,,6,14,20,6,14,20,0.000957,0.009792,0,10605,1,0.000013,12,0.226545,0.258228,36572.88462,0.144737,0.001607
9905175,9905175,,20,21,41,20,21,41,0.000729,0.000296,0,10604,0,0.000024,15,0.170876,0.206098,56002.703412,0.121951,0.005859
9912073,9912073,,8,40,48,8,40,48,0.001748,0.023683,0,10601,1,0.000013,11,0.232109,0.266569,12470.539148,0.143174,0.002177
9610045,9610045,,20,25,45,20,25,45,0.002053,0.005274,0,3740,13,0.000059,11,0.210171,0.249482,28164.981993,0.168182,0.008229
9510123,9510123,,3,3,6,3,3,6,0.000515,0.000002,0,6579,5,0.000011,5,0.312057,0.372727,14036.081391,0.033333,0.000821
9704172,9704172,,9,22,31,9,22,31,0.001815,0.004499,0,5002,13,0.000016,13,0.209507,0.245281,129582.106664,0.213978,0.00328
9805014,9805014,,29,29,58,29,29,58,0.006841,0.021729,0,6279,1,0.000027,12,0.203268,0.233419,13270.88765,0.161222,0.011323
9305025,9305025,,52,3,55,52,3,55,0.001773,0.00007,0,2537,0,0.000088,3,0.571429,0.666667,1064.828122,0.091246,0.018794
9602096,9602096,,21,4,25,21,4,25,0.000678,0.000529,0,2635,0,0.000029,7,0.247668,0.296274,66908.947061,0.12,0.006294
9605173,9605173,,37,12,49,37,12,49,0.001223,0.000291,0,2614,0,0.000048,7,0.257,0.303937,11390.969968,0.138605,0.01321
9605176,9605176,,36,15,51,36,15,51,0.00084,0.004806,0,2611,0,0.000049,11,0.196253,0.232604,39678.620546,0.103529,0.012346
9607126,9607126,,26,17,43,26,17,43,0.000686,0.000254,0,2636,0,0.000036,12,0.171128,0.204682,27209.292475,0.144518,0.008933
9701035,9701035,,6,10,16,6,10,16,0.00034,0.000925,0,4543,0,0.000015,10,0.220506,0.249197,2966.712354,0.270833,0.002744
9704175,9704175,,3,12,15,3,12,15,0.000007,0.000121,0,6243,0,0.000012,12,0.189126,0.215654,5954.661954,0.180952,0.000886
9705061,9705061,,7,15,22,7,15,22,0.000022,0.000099,0,6254,0,0.000015,12,0.179325,0.205329,33893.058342,0.121212,0.002165
9805060,9805060,,2,1,3,2,1,3,0.000003,0,0,7771,23,0.000013,1,1,1,8322,0,0.000597
9806111,9806111,,2,3,5,2,3,5,0.000211,0.000006,0,10603,5,0.000011,7,0.235479,0.25444,10418.564065,0.1,0.001024
9908044,9908044,,45,19,64,45,19,64,0.004177,0.007637,0,10600,1,0.000047,13,0.19439,0.220312,136643.465454,0.08631,0.012069
9909082,9909082,,15,22,37,15,22,37,0.002578,0.02095,0,10591,1,0.000015,11,0.229633,0.261816,15127.531111,0.123874,0.004223
9910117,9910117,,20,26,46,20,26,46,0.004021,0.022002,0,8842,1,0.000025,11,0.228692,0.259757,68251.860762,0.163768,0.009499
9911160,9911160,,8,13,21,8,13,21,0.001875,0.018776,0,10590,1,0.000013,11,0.227244,0.257439,3091.127276,0.295238,0.002608
1180,1180,,13,14,27,13,14,27,0.000902,0.006164,0,10976,1,0.000018,13,0.181666,0.202564,13102.383792,0.148148,0.003227
9405026,9405026,,23,8,31,23,8,31,0.000149,0.000656,0,3368,41,0.000052,4,0.384181,0.443627,10705.782988,0.070968,0.00582
9410219,9410219,,18,3,21,18,3,21,0.000617,0.000002,0,5681,41,0.000042,5,0.367347,0.466667,3005.582352,0.107143,0.005011
9803038,9803038,,11,10,21,11,10,21,0.000254,0.001109,0,10974,41,0.000027,15,0.162697,0.183209,44714.190485,0.12619,0.003124
9805173,9805173,,6,5,11,6,5,11,0.000117,0.000478,0,10975,41,0.000014,16,0.140225,0.15328,2387.648117,0.2,0.001868
9304068,9304068,,30,4,34,30,4,34,0.001493,0.00047,0,259,5,0.000051,2,0.543478,0.58,30983.82743,0.060606,0.008119
9308152,9308152,,4,0,4,4,0,4,0.000015,0,0,740,41,0.000033,0,0,0,0,0.083333,0.001146
9309016,9309016,,22,0,22,22,0,22,0.00005,0,0,3100,41,0.000107,0,0,0,0,0.15368,0.006116
9310073,9310073,,19,2,21,19,2,21,0.000071,0.000001,0,3102,41,0.000059,1,1,1,13403.544463,0.109524,0.00495
9311085,9311085,,14,1,15,14,1,15,0.000041,0,0,3099,41,0.000033,1,1,1,5897.735154,0.12381,0.003554
9406029,9406029,,15,5,20,15,5,20,0.000032,0.000079,0,4551,41,0.000051,4,0.483871,0.611111,2920.177388,0.097368,0.003729
9408065,9408065,,16,5,21,16,5,21,0.000546,0.000012,0,6088,6,0.000065,2,0.857143,0.916667,17894.165523,0.052381,0.003913
9509125,9509125,,8,1,9,8,1,9,0.000001,0.00001,0,6084,52,0.000042,1,1,1,39.945087,0.055556,0.001922
9604048,9604048,,5,1,6,5,1,6,0.000026,0.000001,0,6704,41,0.000019,1,1,1,70.278881,0.066667,0.001281
9501101,9501101,,20,8,28,20,8,28,0.000126,0.000579,0,3104,41,0.000042,4,0.338384,0.410448,61122.236508,0.116402,0.005545
1182,1182,,42,7,49,42,7,49,0.001594,0.001352,0,10977,30,0.000069,13,0.188414,0.204669,43326.66054,0.207058,0.022193
1183,1183,,23,20,43,23,20,43,0.000962,0.003976,0,10980,25,0.000022,12,0.204482,0.228217,8227.677036,0.119601,0.006839
9302120,9302120,,11,5,16,11,5,16,0.000115,0.000092,0,2150,13,0.00009,3,0.6,0.740741,1392.504502,0.0375,0.003123
9304048,9304048,,11,2,13,11,2,13,0.000349,0.000034,0,2543,0,0.00004,1,1,1,379.955395,0.032051,0.003211
9406028,9406028,,6,9,15,6,9,15,0.000145,0.000034,0,7144,5,0.000014,4,0.371212,0.47449,10708.059486,0.047619,0.001785
9506059,9506059,,6,8,14,6,8,14,0.000134,0.00003,0,5277,5,0.000016,4,0.375,0.46732,47993.376031,0.054945,0.001839
9903045,9903045,,9,13,22,9,13,22,0.000296,0.000203,0,10979,9,0.000014,12,0.205906,0.229105,9539.12246,0.116883,0.002478
9210055,9210055,,2,0,2,2,0,2,0.000001,0,0,7143,5,0.000012,0,0,0,0,0,0.000484
9212120,9212120,,3,1,4,3,1,4,0.000001,0.000017,0,5276,5,0.000014,2,0.666667,0.75,1,0.166667,0.000749
9301105,9301105,,2,0,2,2,0,2,0.000001,0,0,5275,5,0.000013,0,0,0,0,0,0.00053
9303140,9303140,,6,4,10,6,4,10,0.000008,0.00001,0,937,5,0.00002,3,0.380282,0.444444,176.920128,0.055556,0.001469
9305003,9305003,,5,9,14,5,9,14,0.000008,0.000019,0,941,5,0.000015,4,0.355372,0.474806,8749.73329,0.049451,0.001279
9305030,9305030,,8,4,12,8,4,12,0.000066,0.000009,0,399,5,0.000022,3,0.380282,0.444444,292.795583,0.037879,0.001997
9311005,9311005,,4,3,7,4,3,7,0.000002,0.000025,0,5274,5,0.000015,2,0.714286,0.8,304.136195,0.095238,0.000944
9806227,9806227,,8,8,16,8,8,16,0.000048,0.000106,0,8094,0,0.000022,9,0.17492,0.199739,5660.189116,0.204167,0.002628
9304133,9304133,,16,0,16,16,0,16,0.000414,0,0,2910,9,0.000084,0,0,0,0,0.045833,0.004056
9309106,9309106,,45,0,45,45,0,45,0.00152,0,0,2268,9,0.000176,0,0,0,0,0.043939,0.01283
9503162,9503162,,23,13,36,23,13,36,0.00082,0.000169,0,3776,9,0.000027,5,0.327974,0.419118,50885.737049,0.130159,0.007339
9810134,9810134,,1,15,16,1,15,16,0.000002,0.00042,0,10978,0,0.000011,13,0.172372,0.203579,1017.488233,0.229167,0.000284
9708078,9708078,,9,21,30,9,21,30,0.001606,0.007727,0,5020,2,0.000018,16,0.185082,0.222837,3337.058863,0.134483,0.002774
9712112,9712112,,1,12,13,1,12,13,0.000035,0.003175,0,8790,2,0.000012,16,0.182065,0.212371,20754.224841,0.134615,0.000448
1184,1184,,19,23,42,19,23,42,0.001171,0.003314,0,10983,4,0.000023,14,0.198406,0.225979,24712.981979,0.142857,0.004787
9506147,9506147,,11,8,19,11,8,19,0.000119,0.000339,0,5340,13,0.000025,9,0.180389,0.204273,11939.214533,0.143275,0.002889
9605066,9605066,,3,3,6,3,3,6,0.000041,0.000015,0,5341,13,0.000013,10,0.153456,0.169049,10605,0.266667,0.000823
9801082,9801082,,6,2,8,6,2,8,0.000353,0.000026,0,10982,4,0.000015,12,0.185226,0.203682,91.132598,0.196429,0.00159
9802185,9802185,,36,33,69,36,33,69,0.002647,0.010056,0,10677,4,0.000025,13,0.224928,0.262152,150176.67924,0.130861,0.011107
9805172,9805172,,44,57,101,44,57,101,0.00296,0.004866,0,10869,4,0.000027,14,0.207601,0.245278,123082.785398,0.128614,0.013965
9807218,9807218,,10,4,14,10,4,14,0.00032,0.001127,0,9400,4,0.000018,13,0.174827,0.197842,1846.523548,0.225275,0.002766
9901006,9901006,,19,16,35,19,16,35,0.001575,0.00332,0,10887,4,0.000016,14,0.195912,0.223324,3469.93066,0.251261,0.005506
9906198,9906198,,13,9,22,13,9,22,0.000111,0.00002,0,10981,23,0.000036,14,0.149735,0.172555,13723.837592,0.188312,0.003405
9506050,9506050,,2,0,2,2,0,2,0.000005,0,0,5339,13,0.000013,0,0,0,0,0.5,0.000516
9505088,9505088,,46,19,65,46,19,65,0.001972,0.003788,0,887,4,0.000088,9,0.197331,0.246007,1549.003582,0.178606,0.022586
9503186,9503186,,34,4,38,34,4,38,0.001623,0.000544,0,889,4,0.000059,7,0.218994,0.252988,60.290909,0.172119,0.013223
9508002,9508002,,36,11,47,36,11,47,0.001649,0.002856,0,2170,4,0.000046,10,0.180328,0.228391,459.491143,0.160962,0.012256
9507082,9507082,,1,0,1,1,0,1,0,0,0,5338,13,0.000014,0,0,0,0,0,0.000241
9605178,9605178,,15,4,19,15,4,19,0.000569,0.001156,0,3443,4,0.000027,13,0.156332,0.176694,513.521657,0.119883,0.005028
9707197,9707197,,2,17,19,2,17,19,0.000236,0.001925,0,4853,4,0.000011,15,0.195574,0.223672,3869.743731,0.192982,0.001207
9203023,9203023,,9,0,9,9,0,9,0.000028,0,0,1766,13,0.000056,0,0,0,0,0.027778,0.00231
9612240,9612240,,8,32,40,8,32,40,0.000541,0.0042,0,10676,4,0.000012,12,0.201902,0.238805,5497.683913,0.223077,0.002497
9712054,9712054,,6,30,36,6,30,36,0.000332,0.003944,0,5970,4,0.000012,14,0.196236,0.232602,10045.633745,0.201587,0.002288
9608054,9608054,,52,34,86,52,34,86,0.003114,0.004415,0,3437,4,0.000032,11,0.195626,0.233286,7532.770749,0.179754,0.016867
9608135,9608135,,30,8,38,30,8,38,0.001361,0.002074,0,3445,4,0.000033,12,0.174319,0.199158,6163.472286,0.185633,0.010238
9701170,9701170,,21,24,45,21,24,45,0.001587,0.003248,0,3994,4,0.000017,14,0.174383,0.210344,5578.78125,0.263131,0.006887
9801159,9801159,,8,25,33,8,25,33,0.000431,0.003673,0,6076,4,0.000014,15,0.207938,0.241977,5534.316246,0.217803,0.002437
9803217,9803217,,15,25,40,15,25,40,0.000822,0.003377,0,10679,4,0.000015,14,0.197038,0.22751,15371.460029,0.237821,0.004455
9804029,9804029,,6,27,33,6,27,33,0.000253,0.002695,0,6905,4,0.000017,13,0.212503,0.246322,65644.119344,0.211174,0.002103
9804038,9804038,,9,43,52,9,43,52,0.000609,0.009589,0,8020,4,0.000014,14,0.212406,0.251385,139038.614648,0.128959,0.00275
9804086,9804086,,3,52,55,3,52,55,0.0002,0.004121,0,10868,4,0.000011,14,0.208329,0.248881,12938.984807,0.202357,0.001166
9804104,9804104,,14,11,25,14,11,25,0.001353,0.000447,0,10866,4,0.000016,14,0.194839,0.221593,4996.423006,0.213333,0.004355
9804105,9804105,,19,62,81,19,62,81,0.001525,0.00795,0,10864,4,0.000015,18,0.18405,0.232211,4182.011878,0.190895,0.005805
9804151,9804151,,20,56,76,20,56,76,0.001487,0.007893,0,10865,4,0.000016,14,0.19188,0.238762,6945.092235,0.192105,0.005914
9804197,9804197,,5,2,7,5,2,7,0.000064,0,0,10863,52,0.00002,2,0.666667,0.75,16087.886765,0.095238,0.001492
9404140,9404140,,46,0,46,46,0,46,0.000772,0,0,1159,23,0.000156,0,0,0,0,0.075845,0.013174
9406208,9406208,,33,0,33,33,0,33,0.000671,0,0,1158,23,0.000093,0,0,0,0,0.069129,0.008936
9505070,9505070,,45,6,51,45,6,51,0.000389,0.000022,0,4722,23,0.000177,2,0.8,0.875,17528.058622,0.078824,0.011733
1185,1185,,6,27,33,6,27,33,0.000001,0.000009,0,10984,6,0.000013,20,0.124137,0.165549,33777.387627,0.098485,0.00139
9202028,9202028,,5,0,5,5,0,5,0,0,0,8684,6,0.000015,0,0,0,0,0.15,0.001251
9307166,9307166,,3,7,10,3,7,10,0.000001,0.000083,0,2284,9,0.000027,2,0.666667,0.75,2387.846457,0.066667,0.000725
9405197,9405197,,7,6,13,7,6,13,0.000001,0.000001,0,8685,6,0.000015,2,0.75,0.833333,5881.767224,0.147436,0.001718
9412154,9412154,,17,12,29,17,12,29,0.000003,0.000007,0,2050,6,0.000032,4,0.482759,0.585317,52764.371084,0.109606,0.004243
9512104,9512104,,4,1,5,4,1,5,0,0,0,8683,6,0.000012,2,0.6,0.666667,2,0.25,0.000999
9201006,9201006,,5,0,5,5,0,5,0.000001,0,0,3845,6,0.000048,0,0,0,0,0.05,0.001324
9206041,9206041,,14,0,14,14,0,14,0.000374,0,0,310,6,0.000051,0,0,0,0,0.021978,0.003906
9207073,9207073,,14,1,15,14,1,15,0.000006,0.000006,0,2283,6,0.00005,1,1,1,98.007535,0.042857,0.003508
9211034,9211034,,40,3,43,40,3,43,0.000142,0,0,1972,6,0.000261,2,0.8,0.875,17641.142924,0.10299,0.012391
9211018,9211018,,1,0,1,1,0,1,0,0,0,2049,6,0.000012,0,0,0,0,0,0.000336
9301086,9301086,,17,1,18,17,1,18,0.000002,0,0,1980,6,0.000047,1,1,1,256.429907,0.160131,0.005022
9301131,9301131,,3,1,4,3,1,4,0,0,0,2048,6,0.000016,3,0.5,0.566667,2211.877044,0,0.000878
9305114,9305114,,30,9,39,30,9,39,0.000004,0.000002,0,1984,6,0.000084,3,0.589744,0.681159,35489.285937,0.161943,0.008632
9311116,9311116,,4,4,8,4,4,8,0,0.000002,0,2045,6,0.000017,2,0.75,0.833333,51.951477,0.160714,0.001095
9312043,9312043,,18,7,25,18,7,25,0.000001,0,0,1985,6,0.00008,4,0.533333,0.621528,6024.690374,0.196667,0.005705
9403073,9403073,,37,12,49,37,12,49,0.000005,0.000003,0,2020,6,0.000076,3,0.596154,0.682796,86862.938682,0.113095,0.010074
9411203,9411203,,6,7,13,6,7,13,0,0.000004,0,5876,6,0.000018,4,0.39726,0.514368,113.592795,0.211538,0.001586
9505022,9505022,,7,12,19,7,12,19,0.000001,0.000004,0,5882,6,0.000018,6,0.336634,0.43366,14362.615812,0.143275,0.00171
9507057,9507057,,13,4,17,13,4,17,0.00039,0.000002,0,4911,52,0.000046,3,0.56,0.630952,35140.702536,0.051471,0.003562
9501028,9501028,,8,5,13,8,5,13,0,0,0,6773,6,0.000031,4,0.396226,0.462302,2927.907859,0.115385,0.002412
1186,1186,,1,12,13,1,12,13,0.00003,0.008229,0,10989,1,0.000011,13,0.188921,0.212892,314.351194,0.230769,0.000239
9909155,9909155,,1,6,7,1,6,7,0.000097,0.000185,0,10988,4,0.000011,13,0.155077,0.17003,178.889193,0.214286,0.000226
9609183,9609183,,7,10,17,7,10,17,0.00032,0.000673,0,3675,4,0.000016,11,0.172525,0.20895,901.174101,0.272059,0.002828
9704067,9704067,,15,35,50,15,35,50,0.000854,0.003775,0,4860,4,0.000019,14,0.178516,0.212176,9225.368137,0.151429,0.004726
9706074,9706074,,5,6,11,5,6,11,0.00018,0.000742,0,6363,4,0.000015,12,0.181074,0.203891,7945.285903,0.2,0.001651
9709137,9709137,,27,7,34,27,7,34,0.000774,0.000306,0,6011,25,0.000052,16,0.159759,0.176174,33540.654663,0.122103,0.008705
9804068,9804068,,14,19,33,14,19,33,0.000531,0.002635,0,8000,4,0.00002,16,0.176638,0.204819,17713.500368,0.183712,0.003395
9805144,9805144,,3,7,10,3,7,10,0.000348,0.00038,0,10987,4,0.000012,17,0.134766,0.153086,8763.351287,0.188889,0.001038
9812128,9812128,,4,6,10,4,6,10,0.00014,0.00041,0,10985,4,0.000014,17,0.153086,0.172553,1045.905935,0.222222,0.001002
9903155,9903155,,2,9,11,2,9,11,0.000101,0.000567,0,10986,4,0.000012,12,0.176757,0.196612,6752.203321,0.254545,0.000527
1187,1187,,0,3,3,0,3,3,0,0,0,11000,26,0.00001,17,0.108267,0.126053,0,0.166667,0
9812245,9812245,,4,3,7,4,3,7,0,0.000001,0,10997,26,0.00002,16,0.118894,0.139105,5188.171364,0.142857,0.000903
9906026,9906026,,2,1,3,2,1,3,0,0.000001,0,10999,26,0.000016,7,0.212625,0.232391,197.00284,0,0.000438
9908123,9908123,,3,4,7,3,4,7,0,0.000012,0,10998,26,0.000015,17,0.110141,0.134766,413.470809,0.166667,0.000671
9704176,9704176,,14,4,18,14,4,18,0.000018,0.000012,0,8027,23,0.000032,15,0.127038,0.148627,18413.960611,0.107843,0.00345
9810089,9810089,,14,14,28,14,14,28,0.000001,0.00103,0,10996,26,0.000052,11,0.169945,0.21496,6429.688279,0.05291,0.003187
9603006,9603006,,4,3,7,4,3,7,0.000091,0.001634,0,2196,4,0.000037,6,0.268636,0.307243,670.904755,0.047619,0.001199
9604063,9604063,,14,7,21,14,7,21,0.000038,0.001041,0,5088,26,0.000034,8,0.254423,0.294108,38631.523324,0.111905,0.003533
1188,1188,,14,16,30,14,16,30,0.000011,0.000006,0,11001,17,0.000018,12,0.15319,0.190854,2060.132817,0.271264,0.003338
1189,1189,,6,16,22,6,16,22,0.001379,0.002096,0,11002,2,0.000014,14,0.184853,0.20984,18930.763119,0.19697,0.002475
9805080,9805080,,9,13,22,9,13,22,0.000927,0.00228,0,7788,2,0.00002,16,0.173794,0.195625,5224.08966,0.270563,0.003106
9908096,9908096,,31,16,47,31,16,47,0.002446,0.001953,0,10166,2,0.000038,16,0.184187,0.208518,51477.538844,0.104533,0.009656
9701119,9701119,,20,2,22,20,2,22,0.00237,0.001537,0,3585,2,0.000054,11,0.179003,0.196194,2502.120161,0.140693,0.008342
9701169,9701169,,16,20,36,16,20,36,0.001393,0.010304,0,3624,2,0.000036,11,0.217036,0.249391,78322.422843,0.138095,0.005913
9709132,9709132,,16,5,21,16,5,21,0.001461,0.001931,0,5228,2,0.00006,14,0.16662,0.18789,7506.887972,0.261905,0.00532
9709217,9709217,,11,1,12,11,1,12,0.001057,0.000017,0,5229,2,0.000038,15,0.142857,0.155436,3585,0.30303,0.00377
9711033,9711033,,9,1,10,9,1,10,0.000966,0.000012,0,6723,2,0.000018,16,0.125031,0.133296,10.571783,0.255556,0.003009
9711169,9711169,,5,8,13,5,8,13,0.000251,0.001972,0,6724,2,0.000015,14,0.166736,0.188569,518.753633,0.320513,0.0016
9305120,9305120,,10,0,10,10,0,10,0.000483,0,0,2863,26,0.000028,0,0,0,0,0.022222,0.002369
9805046,9805046,,10,11,21,10,11,21,0.001243,0.003254,0,9716,2,0.000019,16,0.170679,0.19261,11793.470119,0.261905,0.003513
9806152,9806152,,4,2,6,4,2,6,0.000146,0.000165,0,10160,2,0.000015,16,0.164837,0.184378,44526.355406,0.233333,0.001134
9706029,9706029,,1,2,3,1,2,3,0.000023,0,0,10165,22,0.000012,1,1,1,4921.798282,0,0.000459
9711032,9711032,,17,12,29,17,12,29,0.000564,0.00145,0,7977,25,0.000027,16,0.164908,0.186818,8851.398031,0.203202,0.005352
9805183,9805183,,17,1,18,17,1,18,0.000409,0.000108,0,7628,4,0.00005,13,0.170094,0.187715,0,0.20915,0.006243
9901154,9901154,,16,2,18,16,2,18,0.000376,0.000112,0,10162,4,0.000033,13,0.170125,0.187893,4.770241,0.248366,0.005307
9902186,9902186,,11,5,16,11,5,16,0.000328,0.000173,0,10164,4,0.00002,12,0.180426,0.203103,7562.499964,0.2625,0.003949
1190,1190,,7,25,32,7,25,32,0.000906,0.017036,0,11007,0,0.000016,13,0.197039,0.223809,7468.874183,0.149194,0.001659
9410152,9410152,,18,7,25,18,7,25,0.000748,0.000059,0,5763,28,0.000045,3,0.530612,0.608974,18994.621224,0.078333,0.005093
9712129,9712129,,3,3,6,3,3,6,0.00044,0.000069,0,11006,28,0.000012,9,0.240617,0.271475,230.412275,0.133333,0.000783
9802090,9802090,,9,17,26,9,17,26,0.001111,0.003566,0,11003,0,0.000015,15,0.184525,0.22064,2880.884219,0.156923,0.002196
9909087,9909087,,2,19,21,2,19,21,0.000468,0.003379,0,11005,0,0.000011,16,0.172368,0.200705,530.174229,0.188095,0.000523
9910056,9910056,,11,12,23,11,12,23,0.000944,0.001736,0,11004,0,0.00002,15,0.173878,0.201821,6771.619804,0.142292,0.003156
9205097,9205097,,1,0,1,1,0,1,0.000001,0,0,5762,28,0.000016,0,0,0,0,0,0.000351
9302003,9302003,,16,0,16,16,0,16,0.000293,0,0,5760,28,0.00007,0,0,0,0,0.183333,0.004713
9701009,9701009,,20,20,40,20,20,40,0.001261,0.003222,0,4013,4,0.000017,11,0.184828,0.211005,1146.62617,0.219231,0.006291
9703118,9703118,,7,35,42,7,35,42,0.000385,0.011487,0,4300,13,0.000017,13,0.221365,0.265561,15642.824354,0.114983,0.002254
1191,1191,,1,2,3,1,2,3,0,0,0,11008,52,0.000012,1,1,1,0,0.5,0.000226
1192,1192,,64,38,102,64,38,102,0.010406,0.018573,0,11012,25,0.000048,15,0.218778,0.246954,184239.383553,0.086197,0.022755
9901119,9901119,,11,17,28,11,17,28,0.001575,0.000235,0,8233,5,0.000016,15,0.160742,0.183079,310866.892416,0.171958,0.003689
9912028,9912028,,8,14,22,8,14,22,0.000837,0.008215,0,11011,1,0.000017,12,0.205241,0.2283,10333.533407,0.190476,0.002408
9912032,9912032,,4,8,12,4,8,12,0.00064,0.002555,0,11009,1,0.000014,11,0.226719,0.255783,18891.042813,0.121212,0.00183
9706066,9706066,,19,13,32,19,13,32,0.000858,0.000138,0,6522,5,0.000033,10,0.224738,0.266268,92030.786811,0.173387,0.005845
9709224,9709224,,26,4,30,26,4,30,0.001609,0.000071,0,7459,5,0.000045,5,0.32967,0.411667,310.501892,0.128736,0.007594
9801180,9801180,,15,23,38,15,23,38,0.001259,0.000251,0,6544,5,0.000018,18,0.152146,0.199309,91119.069011,0.117354,0.004086
9806055,9806055,,16,24,40,16,24,40,0.001016,0.00246,0,8230,5,0.000019,14,0.184691,0.215344,66548.702307,0.119872,0.004567
9807123,9807123,,24,13,37,24,13,37,0.000704,0.00029,0,8193,5,0.000038,18,0.152415,0.188947,7294.473147,0.159159,0.006627
9811092,9811092,,20,23,43,20,23,43,0.000313,0.000259,0,8232,5,0.000029,15,0.16376,0.187936,212835.77541,0.143965,0.005313
9410050,9410050,,16,2,18,16,2,18,0.001418,0.000178,0,2210,25,0.00003,2,0.75,0.833333,617.326796,0.078431,0.006414
9902080,9902080,,11,47,58,11,47,58,0.001065,0.004946,0,8733,0,0.000019,12,0.217459,0.250877,48528.863512,0.137024,0.003003
9907051,9907051,,8,7,15,8,7,15,0.000739,0.006566,0,11010,1,0.000016,12,0.184961,0.203993,984.902202,0.319048,0.001936
9505061,9505061,,57,11,68,57,11,68,0.001757,0.000037,0,4609,5,0.000088,2,0.789474,0.866667,76432.867764,0.025461,0.014111
9810104,9810104,,20,21,41,20,21,41,0.000662,0.000284,0,9808,20,0.000027,16,0.161179,0.189657,112752.939711,0.130488,0.005841
9906052,9906052,,8,15,23,8,15,23,0.001536,0.019046,0,10543,17,0.000014,11,0.227752,0.258429,27649.415975,0.167984,0.002254
9909152,9909152,,4,16,20,4,16,20,0.001022,0.016705,0,10560,17,0.000012,12,0.199339,0.22163,19866.130755,0.202632,0.001206
9910256,9910256,,7,31,38,7,31,38,0.000644,0.026846,0,10569,1,0.000016,11,0.231847,0.264387,491395.325309,0.114509,0.002272
9510111,9510111,,14,0,14,14,0,14,0.000049,0,0,3633,23,0.000101,0,0,0,0,0.043956,0.003872
9602156,9602156,,47,13,60,47,13,60,0.00009,0.000008,0,5206,20,0.000069,5,0.537313,0.651389,29335.698494,0.132203,0.013427
9607188,9607188,,19,0,19,19,0,19,0.000049,0,0,9764,20,0.000026,0,0,0,0,0.137427,0.005182
9709100,9709100,,16,38,54,16,38,54,0.000021,0.000031,0,9803,20,0.00003,18,0.14599,0.199382,90770.054146,0.084556,0.004524
9710145,9710145,,13,8,21,13,8,21,0.000037,0.000006,0,9793,20,0.000025,6,0.4,0.507456,1158.355181,0.245238,0.003983
9711070,9711070,,7,1,8,7,1,8,0.000013,0.000012,0,8123,20,0.000022,8,0.18625,0.209652,1327.710754,0.071429,0.002118
9802039,9802039,,28,18,46,28,18,46,0.000344,0.00001,0,9807,20,0.000032,19,0.129076,0.166006,20233.319418,0.103382,0.007442
9809004,9809004,,16,24,40,16,24,40,0.000035,0.000012,0,9806,20,0.000025,15,0.16923,0.190352,90093.660343,0.140385,0.004837
9809023,9809023,,7,2,9,7,2,9,0.000005,0,0,9773,20,0.000017,11,0.156028,0.181421,3963.541326,0.319444,0.002347
9312118,9312118,,29,3,32,29,3,32,0.001198,0.000012,0,1569,17,0.000068,3,0.55,0.621212,4901.135863,0.077621,0.007453
9312175,9312175,,16,3,19,16,3,19,0.000721,0.000019,0,1567,17,0.000038,1,1,1,3629.892718,0.166667,0.004147
9406207,9406207,,25,11,36,25,11,36,0.000871,0.00006,0,1571,17,0.00004,4,0.560976,0.699275,104073.145685,0.127778,0.006747
9703115,9703115,,2,12,14,2,12,14,0.000247,0.002946,0,10542,4,0.000013,14,0.198134,0.239973,988.550161,0.274725,0.000503
9908203,9908203,,2,10,12,2,10,12,0.000512,0.000778,0,10544,17,0.000011,12,0.188769,0.206274,1444.650626,0.242424,0.000524
9409101,9409101,,6,7,13,6,7,13,0.000599,0.000056,0,2787,17,0.000014,4,0.487179,0.618421,413.052647,0.269231,0.001516
9908113,9908113,,2,9,11,2,9,11,0.000545,0.018556,0,10568,1,0.000011,11,0.226008,0.255498,1155.790631,0.309091,0.000517
9910058,9910058,,30,24,54,30,24,54,0.000784,0.000424,0,10567,20,0.000034,14,0.183512,0.210635,151982.73892,0.103774,0.007857
1194,1194,,0,17,17,0,17,17,0,0.000756,0,11048,2,0.00001,13,0.188921,0.212842,0,0.069853,0
9809065,9809065,,24,21,45,24,21,45,0.00267,0.009907,0,7457,13,0.00005,12,0.202622,0.23482,34090.675939,0.093939,0.008841
9910160,9910160,,10,29,39,10,29,39,0.000284,0.006269,0,11047,1,0.000018,12,0.2123,0.240089,311714.136509,0.075574,0.00255
9705047,9705047,,7,6,13,7,6,13,0.000569,0.002521,0,5365,2,0.000019,10,0.207757,0.232295,6609.352242,0.115385,0.002524
9902040,9902040,,45,19,64,45,19,64,0.005099,0.013475,0,8323,1,0.00004,14,0.188007,0.218067,207946.698701,0.107639,0.012134
9907101,9907101,,6,31,37,6,31,37,0.000587,0.022097,0,10599,2,0.000016,12,0.20355,0.231228,68526.042414,0.081832,0.002075
9907191,9907191,,28,8,36,28,8,36,0.002488,0.006097,0,10592,1,0.000037,13,0.182468,0.204655,28067.701964,0.121429,0.007928
9506105,9506105,,14,1,15,14,1,15,0.000077,0,0,11022,22,0.000048,3,0.5,0.566667,1085.547398,0.128571,0.003468
9607203,9607203,,6,12,18,6,12,18,0.000257,0.000158,0,4283,1,0.000022,15,0.175767,0.229447,108717.339321,0.133987,0.002133
9612173,9612173,,3,6,9,3,6,9,0.000074,0.00001,0,11024,22,0.000015,4,0.43662,0.52957,21054.943347,0.083333,0.000837
9705219,9705219,,16,13,29,16,13,29,0.000083,0.000041,0,11027,22,0.000039,9,0.215155,0.27587,22772.901414,0.091133,0.003974
9807194,9807194,,2,3,5,2,3,5,0.000074,0.000002,0,11028,22,0.000015,10,0.178164,0.211508,735.594494,0.35,0.000529
9811011,9811011,,3,1,4,3,1,4,0.000075,0,0,11031,4,0.000013,11,0.1523,0.173033,9644.357179,0.25,0.000889
9905070,9905070,,6,7,13,6,7,13,0.000448,0.005969,0,10596,1,0.000015,15,0.169535,0.190972,1306.426045,0.141026,0.00146
9907224,9907224,,11,21,32,11,21,32,0.000146,0.000897,0,11046,1,0.000025,13,0.192751,0.2194,69063.257264,0.042339,0.002818
9910022,9910022,,13,15,28,13,15,28,0.000464,0.001528,0,11042,1,0.000021,14,0.179841,0.205558,9810.484357,0.133598,0.003557
9910028,9910028,,10,12,22,10,12,22,0.000309,0.000152,0,11041,1,0.000021,14,0.169704,0.190874,26461.076035,0.112554,0.002889
9910033,9910033,,14,12,26,14,12,26,0.000088,0.000069,0,11036,4,0.000022,13,0.174439,0.197192,29339.181812,0.156923,0.003397
9910067,9910067,,9,32,41,9,32,41,0.00123,0.017609,0,11018,41,0.000016,12,0.215335,0.242534,58751.763994,0.20061,0.003109
1195,1195,,5,2,7,5,2,7,0.000181,0.000006,0,11050,1,0.000018,2,0.75,0.833333,3.4,0.333333,0.001341
9803207,9803207,,9,1,10,9,1,10,0.000241,0.000003,0,11049,1,0.000033,2,0.666667,0.75,52.963359,0.233333,0.002402
9611022,9611022,,1,0,1,1,0,1,0,0,0,8864,1,0.000081,0,0,0,0,0,0.000322
1196,1196,,0,4,4,0,4,4,0,0,0,11060,28,0.00001,14,0.135089,0.141931,0,0.416667,0
9406083,9406083,,6,0,6,6,0,6,0,0,0,11057,28,0.000037,0,0,0,0,0.233333,0.001388
9408002,9408002,,9,0,9,9,0,9,0,0,0,11056,28,0.000067,0,0,0,0,0.166667,0.002078
9909169,9909169,,3,2,5,3,2,5,0,0,0,11058,28,0.000018,1,1,1,0,0.4,0.00069
9911032,9911032,,2,4,6,2,4,6,0,0,0,11059,28,0.000015,13,0.156149,0.166604,24005.735009,0.266667,0.000458
9910085,9910085,,2,6,8,2,6,8,0.000002,0.000025,0,11055,28,0.000016,12,0.184912,0.202491,31865.198133,0.089286,0.000458
1197,1197,,142,15,157,142,15,157,0.012608,0.002984,0,11061,25,0.000161,12,0.205345,0.227175,141411.315865,0.045648,0.048068
1198,1198,,7,27,34,7,27,34,0.000231,0.003287,0,11062,52,0.000013,15,0.17927,0.204849,29805.115516,0.143494,0.002138
9211092,9211092,,1,2,3,1,2,3,0.000002,0.00003,0,900,2,0.000181,1,1,1,9470.640803,0.166667,0.002499
9212085,9212085,,16,1,17,16,1,17,0.000198,0.000023,0,894,2,0.001471,1,1,1,323.234558,0.066176,0.008799
9402156,9402156,,20,11,31,20,11,31,0.000416,0.000249,0,896,5,0.000205,3,0.444444,0.541667,25783.414171,0.087097,0.007915
9406179,9406179,,5,2,7,5,2,7,0.000097,0.000001,0,892,5,0.000308,2,0.6,0.666667,12348.785209,0.214286,0.003986
9210122,9210122,,4,0,4,4,0,4,0.000004,0,0,2919,52,0.000024,0,0,0,0,0.25,0.001146
1199,1199,,22,11,33,22,11,33,0.000923,0.000796,0,11066,52,0.000025,15,0.191114,0.215566,11384.237737,0.175189,0.008608
9909164,9909164,,15,6,21,15,6,21,0.000768,0.000228,0,11065,52,0.000023,16,0.180315,0.199164,17086.145805,0.15,0.005903
9404184,9404184,,13,3,16,13,3,16,0.000248,0.000488,0,1572,13,0.00003,5,0.319767,0.374091,3997.957662,0.058333,0.004545
9605111,9605111,,2,8,10,2,8,10,0.000048,0.000069,0,5515,41,0.000013,8,0.264813,0.304702,36907.280317,0.088889,0.000772
9904124,9904124,,20,9,29,20,9,29,0.001534,0.000299,0,11064,13,0.000027,15,0.174337,0.197242,9358.128776,0.04064,0.006373
1200,1200,,26,40,66,26,40,66,0.001982,0.005894,0,11068,52,0.000024,12,0.208801,0.236701,31323.579627,0.115618,0.007868
9908166,9908166,,2,18,20,2,18,20,0.000135,0.003984,0,11067,3,0.000011,12,0.206286,0.229929,3283.366646,0.202632,0.00067
9909089,9909089,,39,10,49,39,10,49,0.002067,0.003037,0,9466,3,0.000046,13,0.194422,0.214052,19544.396584,0.11352,0.012474
9403192,9403192,,22,8,30,22,8,30,0.000606,0.000057,0,226,13,0.00007,4,0.354037,0.442982,69474.5652,0.065517,0.009862
9402148,9402148,,12,11,23,12,11,23,0.000289,0.000426,0,647,0,0.000031,3,0.606061,0.741667,20864.462303,0.112648,0.003878
9607157,9607157,,5,29,34,5,29,34,0.000269,0.008239,0,3142,0,0.000015,10,0.226309,0.266453,7581.980603,0.179144,0.001724
9607131,9607131,,6,10,16,6,10,16,0.000359,0.003615,0,3143,0,0.000016,10,0.218383,0.255408,566.328102,0.204167,0.002269
9703131,9703131,,5,1,6,5,1,6,0.000497,0,0,6081,22,0.000026,1,1,1,9379.74695,0.1,0.003202
9803197,9803197,,10,33,43,10,33,43,0.000855,0.004157,0,6079,4,0.00002,12,0.214409,0.248921,41916.658454,0.228682,0.005169
9803192,9803192,,5,19,24,5,19,24,0.000499,0.004348,0,6952,52,0.000014,15,0.190336,0.222848,7311.843736,0.179348,0.00174
9806012,9806012,,4,16,20,4,16,20,0.001038,0.009336,0,7626,0,0.000012,13,0.207368,0.2334,22592.436232,0.192105,0.001731
9806177,9806177,,12,42,54,12,42,54,0.001277,0.006279,0,7992,4,0.000017,14,0.218892,0.255358,13276.694976,0.104822,0.003518
1201,1201,,57,24,81,57,24,81,0.001779,0.003328,0,11095,3,0.00009,12,0.219588,0.244523,259782.810813,0.118519,0.033336
9909154,9909154,,25,10,35,25,10,35,0.003708,0.002888,0,8846,2,0.000029,12,0.221056,0.246256,15198.22004,0.180672,0.012397
9909187,9909187,,10,12,22,10,12,22,0.000307,0.000841,0,11094,2,0.000022,13,0.189285,0.217087,5352.274246,0.145022,0.004486
9910052,9910052,,83,61,144,83,61,144,0.008496,0.022204,0,11093,2,0.000052,11,0.248428,0.288036,357484.399153,0.058226,0.025515
9910053,9910053,,330,97,427,330,97,427,0.034135,0.021026,0,8934,2,0.000206,12,0.241963,0.280675,2180769.47686,0.021874,0.111514
9211116,9211116,,2,0,2,2,0,2,0.000001,0,0,9874,22,0.000085,0,0,0,0,0.5,0.00089
9212057,9212057,,9,3,12,9,3,12,0.000098,0.000028,0,421,9,0.000093,1,1,1,1332.462175,0.136364,0.003042
9408064,9408064,,2,0,2,2,0,2,0.000023,0,0,4448,52,0.000017,0,0,0,0,0,0.000913
9803003,9803003,,11,13,24,11,13,24,0.002074,0.00366,0,6423,2,0.000017,13,0.198019,0.226563,11616.641421,0.28442,0.007258
9712026,9712026,,9,37,46,9,37,46,0.001713,0.010451,0,5189,13,0.000016,13,0.210868,0.252002,2909.483478,0.1657,0.003581
9712160,9712160,,10,25,35,10,25,35,0.001599,0.0087,0,5190,13,0.000017,12,0.202274,0.23807,7091.69108,0.169748,0.003871
9907029,9907029,,10,34,44,10,34,44,0.001987,0.019702,0,11092,2,0.000014,12,0.213091,0.240736,168404.795838,0.147992,0.004011
9711012,9711012,,10,26,36,10,26,36,0.001023,0.006468,0,5736,2,0.00002,12,0.203295,0.236965,89422.034749,0.126984,0.006597
9711081,9711081,,28,24,52,28,24,52,0.003452,0.005352,0,5330,2,0.000038,14,0.196669,0.230007,169855.339343,0.06825,0.01352
9804065,9804065,,7,19,26,7,19,26,0.001755,0.005541,0,7717,2,0.000013,12,0.205254,0.237144,25203.555666,0.169231,0.00456
9806176,9806176,,7,9,16,7,9,16,0.001517,0.002171,0,7755,2,0.000014,14,0.180018,0.204412,3793.452674,0.225,0.005368
9809088,9809088,,2,22,24,2,22,24,0.00042,0.004883,0,8933,2,0.000012,15,0.184671,0.212351,40454.927058,0.251812,0.00314
9811134,9811134,,7,26,33,7,26,33,0.000734,0.007328,0,8927,2,0.000015,14,0.181602,0.209662,23915.964521,0.188447,0.004389
9812095,9812095,,4,14,18,4,14,18,0.000357,0.003093,0,8932,2,0.000014,14,0.18799,0.213868,26520.500128,0.130719,0.003806
9904019,9904019,,11,43,54,11,43,54,0.000595,0.0181,0,8928,2,0.000017,14,0.194291,0.228172,68839.106379,0.138714,0.005369
9904117,9904117,,5,40,45,5,40,45,0.000444,0.006501,0,8929,2,0.000014,14,0.195687,0.229311,31304.398385,0.133333,0.004007
9907132,9907132,,15,7,22,15,7,22,0.001666,0.001133,0,8847,13,0.000021,14,0.182656,0.205111,6058.65138,0.134199,0.007335
1202,1202,,8,11,19,8,11,19,0.000006,0.00003,0,11098,22,0.000016,18,0.124573,0.135258,652.295823,0.304094,0.001945
9912093,9912093,,12,9,21,12,9,21,0.000028,0.000019,0,11097,22,0.000027,9,0.166505,0.20931,365.425564,0.235714,0.003074
9912290,9912290,,5,12,17,5,12,17,0.000026,0.000032,0,11096,22,0.000015,17,0.141288,0.154917,5126.99964,0.268382,0.001265
9509091,9509091,,4,0,4,4,0,4,0,0,0,6693,22,0.000129,0,0,0,0,0.083333,0.00109
9610128,9610128,,12,4,16,12,4,16,0.000003,0,0,9019,22,0.000033,2,0.666667,0.75,15.90633,0.258333,0.00317
9612013,9612013,,5,10,15,5,10,15,0,0.000005,0,9020,22,0.000022,7,0.226704,0.294654,3909.463251,0.2,0.001401
9805025,9805025,,3,6,9,3,6,9,0,0,0,9025,22,0.000019,8,0.188921,0.22417,385.770779,0.458333,0.000866
9807125,9807125,,2,10,12,2,10,12,0.000191,0,0,9033,22,0.000014,9,0.163466,0.204376,13301.52294,0.234848,0.000637
1203,1203,,97,5,102,97,5,102,0.003208,0.00092,0,11100,30,0.000123,13,0.186177,0.202046,37335.621812,0.034362,0.03054
9707040,9707040,,4,1,5,4,1,5,0.000011,0,0,11099,5,0.000035,1,1,1,2551.715193,0.1,0.00165
1204,1204,,33,21,54,33,21,54,0.006457,0.018345,0,11102,1,0.00003,12,0.196915,0.219592,11031.304681,0.141509,0.009576
9906056,9906056,,9,18,27,9,18,27,0.001425,0.017948,0,10594,1,0.000017,11,0.228019,0.259324,33407.809142,0.173789,0.002416
9911123,9911123,,20,26,46,20,26,46,0.004748,0.012166,0,11101,1,0.000019,12,0.202521,0.227189,4817.954342,0.173913,0.005435
9506033,9506033,,2,2,4,2,2,4,0.000042,0.000023,0,1023,2,0.00002,3,0.5,0.595238,1129.50736,0.25,0.000753
9506095,9506095,,5,4,9,5,4,9,0.000208,0.000012,0,6732,26,0.00004,3,0.538462,0.619048,26199.697256,0.027778,0.002219
9402106,9402106,,7,4,11,7,4,11,0.000668,0.000059,0,2230,41,0.000023,2,0.833333,0.9,2145.710322,0.127273,0.00322
9810136,9810136,,7,33,40,7,33,40,0.00072,0.017232,0,7455,2,0.000014,13,0.196339,0.226016,80397.05592,0.138462,0.002239
9702178,9702178,,17,0,17,17,0,17,0.001688,0,0,8293,5,0.000052,0,0,0,0,0.047794,0.004947
9903231,9903231,,4,18,22,4,18,22,0.000615,0.012251,0,10593,1,0.000013,14,0.190761,0.218368,4592.580241,0.17316,0.001009
9805150,9805150,,21,4,25,21,4,25,0.000576,0.000011,0,9411,5,0.000069,7,0.214744,0.2492,11392.110789,0.141667,0.006281
9809133,9809133,,9,23,32,9,23,32,0.001605,0.005697,0,8050,1,0.000016,13,0.207742,0.24076,15074.48695,0.172379,0.003176
9906073,9906073,,7,15,22,7,15,22,0.001404,0.018867,0,8678,1,0.000014,11,0.226626,0.256699,11532.079678,0.257576,0.00246
1205,1205,,12,21,33,12,21,33,0.001018,0.00841,0,11107,2,0.000016,12,0.206532,0.231508,60546.236685,0.082386,0.002928
9911246,9911246,,2,44,46,2,44,46,0.000119,0.015263,0,11106,2,0.000011,12,0.227498,0.256951,40932.573735,0.091787,0.00052
9607092,9607092,,14,26,40,14,26,40,0.00118,0.006505,0,3030,0,0.000023,12,0.229179,0.26715,31868.173438,0.103846,0.005301
9801043,9801043,,3,6,9,3,6,9,0.000292,0.000893,0,6398,4,0.000012,13,0.159272,0.178359,4050.126637,0.180556,0.000764
9710126,9710126,,3,9,12,3,9,12,0.000128,0.002208,0,7286,2,0.000017,15,0.179772,0.208927,88.384124,0.348485,0.001145
9712205,9712205,,6,14,20,6,14,20,0.000191,0.001319,0,7285,2,0.000018,13,0.200473,0.230377,15730.010562,0.197368,0.001945
9710001,9710001,,17,14,31,17,14,31,0.000354,0.002679,0,6361,4,0.000021,14,0.149671,0.171265,964.278264,0.216129,0.004429
9712010,9712010,,15,7,22,15,7,22,0.000327,0.000912,0,6077,4,0.00002,13,0.169148,0.190376,3103.458421,0.225108,0.003744
9803139,9803139,,10,16,26,10,16,26,0.000213,0.002576,0,8284,4,0.000015,16,0.152098,0.17596,10578.962661,0.238462,0.002469
9710105,9710105,,25,35,60,25,35,60,0.000462,0.001072,0,6365,4,0.000042,13,0.170639,0.197475,56047.82275,0.141243,0.007151
9801146,9801146,,15,18,33,15,18,33,0.000699,0.002746,0,7447,4,0.000021,12,0.183133,0.208691,14350.975748,0.215909,0.003948
9808178,9808178,,3,16,19,3,16,19,0.000083,0.000717,0,9666,4,0.000012,12,0.188348,0.211703,19043.904707,0.184211,0.000733
9801083,9801083,,4,17,21,4,17,21,0.00031,0.002507,0,11105,4,0.000012,14,0.188983,0.223036,2434.436136,0.095238,0.000979
9806139,9806139,,6,20,26,6,20,26,0.000504,0.006749,0,9103,2,0.000013,15,0.189343,0.219007,25157.924909,0.210769,0.001469
9909075,9909075,,2,16,18,2,16,18,0.0002,0.003298,0,11104,2,0.000011,14,0.187194,0.211479,5214.397296,0.271242,0.000452
1206,1206,,149,26,175,149,26,175,0.012134,0.021338,0,11109,25,0.000151,12,0.212184,0.240467,321032.006661,0.037406,0.048767
9912058,9912058,,14,16,30,14,16,30,0.002541,0.019139,0,11108,1,0.000022,12,0.206294,0.230049,17306.02176,0.137931,0.005289
9902032,9902032,,20,33,53,20,33,53,0.00139,0.006109,0,9683,13,0.000025,13,0.200274,0.241287,22006.83109,0.087808,0.005479
9907007,9907007,,5,17,22,5,17,22,0.000309,0.004169,0,9682,3,0.000012,14,0.190263,0.217318,972.185412,0.15368,0.001525
1207,1207,,2,5,7,2,5,7,0.000159,0.001865,0,11110,25,0.00001,12,0.194366,0.214767,822.314836,0.119048,0.000583
9512137,9512137,,2,11,13,2,11,13,0.000268,0.001382,0,2131,13,0.000036,10,0.212033,0.247172,3306.53446,0.166667,0.002376
1208,1208,,2,16,18,2,16,18,0.000085,0.001297,0,11111,0,0.00001,13,0.183886,0.212279,1749.899796,0.163399,0.000493
9703003,9703003,,12,22,34,12,22,34,0.000752,0.00191,0,5849,0,0.000015,13,0.206451,0.242357,2553.015041,0.130125,0.003079
9502114,9502114,,8,4,12,8,4,12,0.000156,0.000019,0,1788,5,0.000022,3,0.383562,0.446429,9467.281965,0.022727,0.002499
9503003,9503003,,3,0,3,3,0,3,0.000069,0,0,1787,22,0.000031,0,0,0,0,0.166667,0.001306
9503150,9503150,,4,4,8,4,4,8,0.000082,0.000051,0,919,0,0.000031,3,0.5,0.578431,1147.593377,0.232143,0.002049
9511058,9511058,,18,23,41,18,23,41,0.001175,0.002892,0,1615,0,0.000025,13,0.208531,0.261503,16062.848584,0.173171,0.006783
9601050,9601050,,4,18,22,4,18,22,0.000185,0.003582,0,1786,0,0.000013,12,0.215042,0.257582,13586.457088,0.281385,0.001786
9410177,9410177,,2,0,2,2,0,2,0.000126,0,0,3135,0,0.000012,0,0,0,0,0,0.000882
9410184,9410184,,5,4,9,5,4,9,0.000438,0.000199,0,3134,0,0.000014,2,0.7,0.785714,20.950682,0.097222,0.001615
9412226,9412226,,5,2,7,5,2,7,0.000442,0.000048,0,1302,4,0.000017,4,0.428571,0.486111,1937.078552,0.190476,0.001735
9504114,9504114,,7,10,17,7,10,17,0.000556,0.000295,0,3133,0,0.000015,3,0.590909,0.679487,3529.940546,0.143382,0.002421
9504115,9504115,,6,16,22,6,16,22,0.000496,0.00058,0,3132,0,0.000015,4,0.446429,0.54,6445.137653,0.090909,0.002202
9508021,9508021,,29,12,41,29,12,41,0.001206,0.002314,0,3300,4,0.000046,10,0.221026,0.267537,49575.942272,0.102439,0.007865
9605047,9605047,,3,25,28,3,25,28,0.000198,0.007298,0,2334,0,0.000012,10,0.227534,0.265711,1009.131454,0.246032,0.001589
9610165,9610165,,1,1,2,1,1,2,0.000057,0,0,3709,0,0.000011,1,1,1,12384,0,0.000586
9512204,9512204,,11,12,23,11,12,23,0.000453,0.000334,0,3137,0,0.000018,8,0.232673,0.282282,1370.007236,0.162055,0.003074
9701150,9701150,,8,5,13,8,5,13,0.000338,0.001221,0,3689,4,0.000019,13,0.192214,0.216622,173.858281,0.237179,0.003041
9601147,9601147,,4,0,4,4,0,4,0.00015,0,0,10574,23,0.000016,0,0,0,0,0,0.00093
1209,1209,,20,17,37,20,17,37,0.001131,0.001424,0,11113,25,0.000023,12,0.198497,0.218338,12789.450564,0.126126,0.006348
9901081,9901081,,1,0,1,1,0,1,0.000017,0,0,11112,25,0.000011,0,0,0,0,0,0.000375
1210,1210,,3,3,6,3,3,6,0.000068,0.000002,0,11115,8,0.000012,2,0.8,0.875,9.5,0.066667,0.000658
9505166,9505166,,12,0,12,12,0,12,0.000067,0,0,6287,8,0.000067,0,0,0,0,0.143939,0.002831
9706056,9706056,,8,2,10,8,2,10,0.000118,0.000001,0,6288,8,0.000033,1,1,1,16367.015759,0.111111,0.002021
9810246,9810246,,3,0,3,3,0,3,0,0,0,11114,8,0.00002,0,0,0,0,0,0.00069
9602024,9602024,,9,0,9,9,0,9,0.000003,0,0,5214,8,0.000047,0,0,0,0,0.125,0.002164
1211,1211,,10,15,25,10,15,25,0.000603,0.001462,0,11125,25,0.000016,13,0.200121,0.220264,19387.066632,0.13,0.002795
9801152,9801152,,7,27,34,7,27,34,0.000928,0.004225,0,6581,13,0.000014,14,0.191892,0.224555,22250.670119,0.142602,0.002889
9912288,9912288,,5,29,34,5,29,34,0.000909,0.014809,0,11124,30,0.000012,12,0.209969,0.235009,36094.265275,0.16221,0.001619
2076,2076,,24,19,43,24,19,43,0.0018,0.002295,0,11127,25,0.000031,16,0.195954,0.216711,19915.983393,0.163898,0.009312
2040,2040,,26,48,74,26,48,74,0.001623,0.021306,0,11126,25,0.000033,15,0.21542,0.243387,52854.94933,0.117734,0.008796
4101,4101,,26,21,47,26,21,47,0.001678,0.00308,0,11132,25,0.000026,13,0.192294,0.212615,5582.944351,0.121184,0.007808
2072,2072,,108,3,111,108,3,111,0.006885,0.000266,0,11131,25,0.000178,13,0.161765,0.171731,1952.926706,0.062408,0.037276
2091,2091,,184,20,204,184,20,204,0.016998,0.01902,0,10540,25,0.000193,11,0.203399,0.226605,67698.593278,0.04588,0.061408
3300,3300,,48,5,53,48,5,53,0.001625,0.001137,0,11129,25,0.000051,11,0.195344,0.212227,4607.994802,0.12627,0.014948
4014,4014,,73,12,85,73,12,85,0.003434,0.003345,0,11130,25,0.000069,12,0.195475,0.214215,30692.146488,0.090056,0.020826
9136,9136,,2,10,12,2,10,12,0.000018,0.001654,0,11136,25,0.000011,11,0.191187,0.208973,4129.170817,0.204545,0.000453
3118,3118,,35,9,44,35,9,44,0.00196,0.001541,0,11135,25,0.000043,11,0.191072,0.208686,24877.102084,0.090381,0.009028
9906038,9906038,,15,3,18,15,3,18,0.000604,0.000135,0,11133,25,0.00003,16,0.146898,0.166855,3602.967183,0.055556,0.004742
9209070,9209070,,17,1,18,17,1,18,0.000087,0.000009,0,82,13,0.000181,1,1,1,108.010794,0.084967,0.005715
9510127,9510127,,4,4,8,4,4,8,0.000091,0.00008,0,5273,5,0.000019,8,0.186701,0.25561,17520.018798,0.160714,0.001587
9603044,9603044,,5,8,13,5,8,13,0.00009,0.000104,0,5278,5,0.00002,8,0.26046,0.3108,78094.366049,0.108974,0.001781
9702075,9702075,,4,19,23,4,19,23,0.00019,0.003738,0,3754,13,0.000017,11,0.211096,0.248209,105009.2542,0.237154,0.00193
9704199,9704199,,6,18,24,6,18,24,0.000887,0.003216,0,5281,13,0.000018,15,0.178983,0.210774,26708.976178,0.202899,0.003337
9607001,9607001,,5,13,18,5,13,18,0.000458,0.002934,0,6577,13,0.000012,11,0.204499,0.239187,136.735436,0.218954,0.001333
9610031,9610031,,2,19,21,2,19,21,0.000081,0.004578,0,6580,13,0.000011,14,0.203169,0.245487,3431.987484,0.169048,0.000542
9704050,9704050,,2,10,12,2,10,12,0.00047,0.000004,0,6597,9,0.000011,6,0.260684,0.327869,39670.961348,0.090909,0.000879
9801151,9801151,,8,25,33,8,25,33,0.000236,0.000022,0,6628,23,0.000017,17,0.154287,0.198729,496100.887881,0.117424,0.002045
9907024,9907024,,3,19,22,3,19,22,0.000264,0.002195,0,11121,1,0.000011,13,0.197179,0.222076,1564.658899,0.229437,0.000732
9908092,9908092,,1,26,27,1,26,27,0.000174,0.003531,0,11123,1,0.00001,13,0.20429,0.232684,5771.138233,0.17094,0.000259
9910083,9910083,,3,10,13,3,10,13,0.000376,0.002523,0,11118,30,0.000011,13,0.190591,0.209054,579.151321,0.269231,0.000757
9910092,9910092,,23,42,65,23,42,65,0.002582,0.023262,0,10229,30,0.000023,12,0.225235,0.254699,103327.956358,0.11851,0.008335
9911031,9911031,,3,13,16,3,13,16,0.00036,0.00267,0,11119,30,0.000012,13,0.195699,0.214897,808.18941,0.258333,0.000771
9911057,9911057,,26,29,55,26,29,55,0.003187,0.011698,0,10215,30,0.000028,13,0.203378,0.22764,16053.839665,0.120875,0.011656
9911183,9911183,,4,23,27,4,23,27,0.000742,0.00535,0,11117,30,0.000012,13,0.204336,0.228489,5835.112309,0.159544,0.001242
9911193,9911193,,5,23,28,5,23,28,0.001065,0.014513,0,11120,30,0.000012,13,0.206682,0.230599,8004.730257,0.220899,0.001586
1212,1212,,17,63,80,17,63,80,0.001308,0.007408,0,11145,0,0.000019,12,0.220994,0.252519,121813.405486,0.1375,0.007135
9805141,9805141,,28,43,71,28,43,71,0.002752,0.005835,0,7653,4,0.000023,11,0.219041,0.255439,38748.863345,0.082897,0.009393
9908016,9908016,,2,25,27,2,25,27,0.000176,0.001632,0,11143,0,0.00001,13,0.200696,0.22762,330.090031,0.390313,0.000603
9908130,9908130,,56,42,98,56,42,98,0.004153,0.00347,0,10131,0,0.000037,13,0.193776,0.223462,35437.204419,0.147801,0.024478
9909028,9909028,,12,14,26,12,14,26,0.002447,0.003407,0,10167,2,0.000015,12,0.19647,0.221927,18829.335024,0.126154,0.005
9910087,9910087,,1,44,45,1,44,45,0.000087,0.007578,0,11144,0,0.00001,12,0.226124,0.254972,5419.860089,0.181313,0.000375
9911021,9911021,,19,29,48,19,29,48,0.001884,0.002786,0,11142,0,0.000016,12,0.202075,0.228295,8467.599318,0.220745,0.008023
9912204,9912204,,61,39,100,61,39,100,0.004327,0.003303,0,11138,0,0.000037,13,0.196072,0.22393,22963.692793,0.157576,0.026085
9702031,9702031,,4,14,18,4,14,18,0.000872,0.00508,0,3707,0,0.000013,13,0.20144,0.232614,122.769131,0.27451,0.002296
9611119,9611119,,12,25,37,12,25,37,0.00105,0.007405,0,3127,0,0.000021,13,0.212766,0.250036,16964.514846,0.162913,0.005186
9605221,9605221,,16,4,20,16,4,20,0.000282,0.000015,0,4401,0,0.000036,11,0.167763,0.185792,2497.188287,0.213158,0.005272
9607137,9607137,,7,2,9,7,2,9,0.000119,0.000005,0,4410,0,0.000018,12,0.143756,0.154776,420.829443,0.333333,0.002599
9607138,9607138,,11,6,17,11,6,17,0.000383,0.000023,0,4404,0,0.000021,11,0.181043,0.205121,1644.052723,0.25,0.00413
9609027,9609027,,8,13,21,8,13,21,0.000203,0.000211,0,4405,0,0.000019,11,0.210304,0.248398,12045.206714,0.240476,0.003099
9610106,9610106,,8,22,30,8,22,30,0.000179,0.000256,0,4409,0,0.000022,11,0.209488,0.251356,348446.810301,0.162069,0.003478
9701057,9701057,,9,11,20,9,11,20,0.000242,0.000135,0,4411,0,0.000021,12,0.185703,0.215209,5957.766801,0.239474,0.003691
9604113,9604113,,3,5,8,3,5,8,0.000022,0,0,5048,23,0.000022,6,0.253731,0.303922,110823.396559,0.089286,0.001524
9801207,9801207,,10,71,81,10,71,81,0.000613,0.008254,0,6078,4,0.000015,13,0.217942,0.261265,51705.991812,0.167438,0.003565
9802005,9802005,,4,33,37,4,33,37,0.000869,0.00894,0,5716,2,0.000012,14,0.197497,0.233145,2229.337032,0.135886,0.001973
9607172,9607172,,18,1,19,18,1,19,0.000449,0.000145,0,4938,0,0.00003,1,1,1,39.249396,0.064327,0.005745
9610139,9610139,,28,27,55,28,27,55,0.001106,0.001031,0,3676,4,0.000027,11,0.182065,0.233969,29389.854625,0.173064,0.008318
9707198,9707198,,5,28,33,5,28,33,0.000056,0.001933,0,7313,0,0.000014,13,0.212359,0.250842,158720.50972,0.175189,0.001422
9808087,9808087,,5,25,30,5,25,30,0.000166,0.002593,0,8113,4,0.000013,13,0.196179,0.232622,22409.798574,0.094253,0.001466
9902070,9902070,,13,5,18,13,5,18,0.000183,0.000084,0,8732,25,0.000032,13,0.146339,0.165038,14620.002943,0.088235,0.003088
9703075,9703075,,29,9,38,29,9,38,0.002346,0.001278,0,4696,0,0.000032,12,0.201451,0.231097,4483.821671,0.125178,0.009746
9812042,9812042,,10,35,45,10,35,45,0.001427,0.002716,0,10125,0,0.000013,13,0.182655,0.216224,26165.631257,0.167172,0.002768
9908017,9908017,,2,23,25,2,23,25,0.000091,0.004547,0,10130,0,0.000011,14,0.184673,0.208634,24.009709,0.33,0.001088
9710245,9710245,,5,12,17,5,12,17,0.000235,0.003463,0,5586,2,0.000013,16,0.176093,0.205634,84912.429417,0.161765,0.001562
9501036,9501036,,3,7,10,3,7,10,0.000166,0.000115,0,804,4,0.000012,5,0.392857,0.461869,26428.743145,0.044444,0.000825
9910143,9910143,,12,28,40,12,28,40,0.000453,0.002988,0,11141,0,0.000015,13,0.195593,0.223021,11180.249418,0.123077,0.003791
9911190,9911190,,22,11,33,22,11,33,0.00134,0.000612,0,11137,0,0.000024,13,0.182218,0.203818,4714.66559,0.227273,0.012113
1213,1213,,20,53,73,20,53,73,0.002717,0.022308,0,11150,30,0.000019,12,0.226751,0.256532,67501.214095,0.11054,0.006959
9906232,9906232,,3,15,18,3,15,18,0.000667,0.001463,0,10219,13,0.000011,14,0.196127,0.224028,3174.92267,0.133987,0.001017
9908010,9908010,,6,24,30,6,24,30,0.001573,0.01796,0,9624,1,0.000012,11,0.232386,0.26384,46944.545908,0.191954,0.00199
9910019,9910019,,19,25,44,19,25,44,0.002622,0.023339,0,10228,30,0.000021,12,0.212614,0.237168,22702.917339,0.151163,0.006992
9912100,9912100,,1,17,18,1,17,18,0.000262,0.004333,0,11149,30,0.00001,12,0.210616,0.232339,6822.517779,0.130719,0.000384
9912140,9912140,,36,24,60,36,24,60,0.002093,0.003148,0,11147,30,0.000046,12,0.218594,0.241509,114362.286483,0.153672,0.018747
9912165,9912165,,26,30,56,26,30,56,0.003757,0.007964,0,11146,30,0.000024,12,0.215156,0.241028,27276.187328,0.130519,0.010149
9212030,9212030,,50,0,50,50,0,50,0.002371,0,0,251,13,0.000264,0,0,0,0,0.072245,0.02481
9410051,9410051,,1,10,11,1,10,11,0.000048,0.000849,0,854,13,0.000056,3,0.609756,0.693333,107.471369,0.254545,0.002672
9512061,9512061,,18,14,32,18,14,32,0.001895,0.006707,0,1538,13,0.000059,11,0.212981,0.249257,3051.394442,0.094758,0.010457
9612144,9612144,,14,9,23,14,9,23,0.002522,0.003924,0,3305,2,0.000043,12,0.192409,0.220519,133.272505,0.22332,0.007727
9610171,9610171,,19,20,39,19,20,39,0.002395,0.005805,0,3363,13,0.000029,14,0.211088,0.253657,17258.466118,0.151147,0.008109
9508045,9508045,,18,13,31,18,13,31,0.001538,0.001217,0,1164,13,0.000066,10,0.220859,0.264173,5610.373213,0.12043,0.009007
9610021,9610021,,12,1,13,12,1,13,0.000776,0.000005,0,4302,28,0.000021,1,1,1,975.7154,0.057692,0.003394
9703077,9703077,,15,12,27,15,12,27,0.002442,0.005422,0,3730,2,0.000027,15,0.191112,0.221915,5608.233435,0.2151,0.006554
9704194,9704194,,13,7,20,13,7,20,0.000203,0.000009,0,4793,28,0.000034,10,0.18824,0.224639,328598.441504,0.173684,0.003854
9708116,9708116,,13,12,25,13,12,25,0.000945,0.000933,0,4630,13,0.000017,17,0.194027,0.226161,53605.090008,0.145,0.004452
9802080,9802080,,12,9,21,12,9,21,0.001277,0.003813,0,6889,13,0.000017,12,0.197257,0.223677,17365.768178,0.142857,0.003884
9802186,9802186,,8,17,25,8,17,25,0.00038,0.001778,0,7681,13,0.000015,14,0.188852,0.220519,6020.072896,0.108333,0.002524
9811207,9811207,,7,16,23,7,16,23,0.001038,0.003187,0,8880,13,0.000013,14,0.186967,0.214606,4087.375028,0.140316,0.001948
9903038,9903038,,20,23,43,20,23,43,0.003756,0.010438,0,8299,13,0.000022,13,0.213329,0.247582,9164.006238,0.148948,0.00779
9907188,9907188,,14,52,66,14,52,66,0.002544,0.024345,0,9623,1,0.00002,11,0.238399,0.272395,115536.817486,0.120513,0.004775
9903023,9903023,,7,27,34,7,27,34,0.001649,0.019422,0,9608,1,0.000013,14,0.213917,0.243356,3282.160207,0.2041,0.002415
9402004,9402004,,22,4,26,22,4,26,0.000478,0.000753,0,1103,5,0.000043,4,0.370787,0.42298,4039.817596,0.104615,0.006315
9406209,9406209,,6,8,14,6,8,14,0.000462,0.000459,0,1105,5,0.000033,5,0.299595,0.375,23161.344087,0.17033,0.003303
9706046,9706046,,3,37,40,3,37,40,0.000704,0.008415,0,5191,13,0.00001,13,0.210286,0.256364,281.31718,0.19359,0.000883
9905067,9905067,,1,18,19,1,18,19,0.000278,0.0097,0,10226,1,0.00001,12,0.204962,0.231754,119.085205,0.30117,0.000391
9907003,9907003,,19,11,30,19,11,30,0.003421,0.01527,0,9598,1,0.000021,11,0.226203,0.256236,16366.902618,0.205747,0.005357
9908148,9908148,,9,32,41,9,32,41,0.002504,0.025972,0,10224,1,0.000014,11,0.230023,0.262403,3716.158757,0.170122,0.002537
9909049,9909049,,7,42,49,7,42,49,0.001321,0.019296,0,10223,2,0.000013,11,0.245,0.285079,23544.509851,0.13648,0.002309
9909102,9909102,,4,29,33,4,29,33,0.00043,0.003569,0,10218,13,0.000012,11,0.229896,0.263624,7592.755662,0.083333,0.001477
9706153,9706153,,12,39,51,12,39,51,0.001325,0.007463,0,6131,13,0.000015,11,0.212578,0.250851,11918.941501,0.14902,0.00352
9910126,9910126,,12,35,47,12,35,47,0.002371,0.012581,0,9521,30,0.000015,13,0.216533,0.24805,28459.24363,0.075856,0.004151
9910194,9910194,,19,28,47,19,28,47,0.003471,0.012764,0,10217,30,0.000018,13,0.219729,0.250605,38065.946406,0.125809,0.006448
9702176,9702176,,1,1,2,1,1,2,0.000063,0.000002,0,11116,3,0.00001,2,0.666667,0.75,56.249167,0,0.00025
9705194,9705194,,6,14,20,6,14,20,0.0007,0.003582,0,8236,2,0.000015,13,0.201757,0.233477,13244.991756,0.068421,0.001624
9907021,9907021,,3,16,19,3,16,19,0.000133,0.017411,0,11148,1,0.000011,14,0.193952,0.218407,1688.116856,0.175439,0.000721
9906147,9906147,,6,8,14,6,8,14,0.001279,0.006704,0,9625,1,0.000014,14,0.188752,0.210931,361.433539,0.302198,0.002279
1214,1214,,4,13,17,4,13,17,0.000504,0.001907,0,11152,2,0.000012,14,0.171076,0.196788,282.815174,0.257353,0.000944
9708001,9708001,,12,13,25,12,13,25,0.000944,0.005543,0,6698,2,0.000016,12,0.196212,0.226781,2152.350584,0.223333,0.003161
9712068,9712068,,12,14,26,12,14,26,0.000951,0.003831,0,6706,2,0.000017,15,0.193698,0.224271,76059.434313,0.186154,0.003331
9809113,9809113,,9,5,14,9,5,14,0.000694,0.000474,0,8872,2,0.000016,16,0.1714,0.19537,1199.253737,0.307692,0.002374
9811143,9811143,,6,9,15,6,9,15,0.000567,0.00183,0,8876,2,0.000014,15,0.169456,0.192939,6791.568434,0.204762,0.0015
9903234,9903234,,7,23,30,7,23,30,0.000606,0.005693,0,8877,2,0.000014,16,0.165196,0.19774,10431.794537,0.148276,0.001845
9909143,9909143,,6,10,16,6,10,16,0.000692,0.00048,0,11151,2,0.000013,14,0.164556,0.185793,2996.068927,0.241667,0.001466
9212037,9212037,,6,1,7,6,1,7,0.000195,0.000003,0,364,26,0.000058,1,1,1,32.58201,0.166667,0.004607
9705062,9705062,,1,4,5,1,4,5,0.000045,0.000471,0,6705,41,0.000011,7,0.201207,0.240905,49050.248316,0.05,0.000306
9708093,9708093,,3,17,20,3,17,20,0.000275,0.002785,0,6697,2,0.000011,13,0.186032,0.216679,12277.83312,0.292105,0.000828
9703104,9703104,,7,6,13,7,6,13,0.000319,0.000075,0,8875,2,0.000016,11,0.175942,0.195157,11546.721393,0.153846,0.00186
9810203,9810203,,5,18,23,5,18,23,0.000465,0.004097,0,8871,2,0.000013,14,0.187995,0.214768,18320.670033,0.243083,0.001425
9706185,9706185,,6,16,22,6,16,22,0.00052,0.006466,0,4648,0,0.000015,15,0.196926,0.230256,9886.20931,0.201299,0.002054
9612220,9612220,,3,4,7,3,4,7,0.000092,0.000278,0,4645,2,0.000015,11,0.176255,0.195003,139.138715,0.214286,0.000978
1215,1215,,57,16,73,57,16,73,0.002588,0.001578,0,11163,30,0.000063,13,0.197092,0.215847,85842.839864,0.151636,0.026826
9912153,9912153,,37,16,53,37,16,53,0.001857,0.004158,0,11162,30,0.00004,13,0.198039,0.218228,16914.803375,0.129536,0.015216
9912158,9912158,,10,13,23,10,13,23,0.000222,0.000109,0,11161,28,0.00002,14,0.17559,0.191673,80973.079687,0.189723,0.004165
9212141,9212141,,13,1,14,13,1,14,0.000091,0.000001,0,8994,15,0.000029,2,0.666667,0.75,484.340437,0.120879,0.003177
9302090,9302090,,23,0,23,23,0,23,0.000124,0,0,3795,15,0.000065,0,0,0,0,0.031621,0.005587
9402070,9402070,,8,6,14,8,6,14,0.00032,0.000006,0,6497,15,0.000056,2,0.714286,0.8,14699.453094,0.054945,0.001956
9510210,9510210,,21,7,28,21,7,28,0.001148,0.00006,0,5120,26,0.000035,7,0.270531,0.338393,91627.863466,0.109788,0.006456
9608137,9608137,,18,12,30,18,12,30,0.002093,0.005218,0,5122,2,0.000025,11,0.214092,0.251962,30807.930899,0.087356,0.006355
9804032,9804032,,8,8,16,8,8,16,0.00012,0.001738,0,8993,28,0.00002,14,0.17273,0.193865,14085.113493,0.166667,0.002658
9709019,9709019,,16,15,31,16,15,31,0.000275,0.000063,0,11155,28,0.000021,12,0.174925,0.195475,26837.433254,0.169892,0.004995
9808164,9808164,,4,4,8,4,4,8,0.00006,0.000022,0,11160,28,0.000014,15,0.147497,0.160548,72.113476,0.375,0.001583
9811140,9811140,,10,24,34,10,24,34,0.000323,0.017501,0,9543,28,0.000023,14,0.199015,0.226205,74331.805969,0.090909,0.002569
9812229,9812229,,10,24,34,10,24,34,0.000055,0.000049,0,11159,28,0.000019,13,0.167552,0.192011,66421.414734,0.188057,0.003088
9903027,9903027,,5,10,15,5,10,15,0.000064,0.000091,0,11156,28,0.000014,14,0.173884,0.194895,9648.710555,0.180952,0.001882
1216,1216,,18,31,49,18,31,49,0.000987,0.001872,0,11169,2,0.000026,12,0.210552,0.236102,59073.437769,0.138605,0.004966
9912051,9912051,,1,11,12,1,11,12,0.000022,0.000227,0,11168,2,0.000011,12,0.201056,0.222029,2195.916368,0.106061,0.00035
9912076,9912076,,10,21,31,10,21,31,0.001435,0.018484,0,11167,41,0.000022,11,0.230382,0.260309,56181.430451,0.260215,0.005112
9912222,9912222,,13,16,29,13,16,29,0.000721,0.000766,0,11166,2,0.000017,16,0.178909,0.206885,6287.987569,0.172414,0.003479
9912264,9912264,,4,10,14,4,10,14,0.000053,0.000319,0,11165,1,0.000012,12,0.204438,0.224611,10091.904431,0.10989,0.00105
9912292,9912292,,1,16,17,1,16,17,0.000022,0.000766,0,11164,2,0.000011,16,0.178909,0.206885,886.249968,0.147059,0.00035
9808031,9808031,,6,2,8,6,2,8,0.000252,0.000852,0,7951,23,0.000022,16,0.159059,0.174659,8448.384345,0.035714,0.001603
9710066,9710066,,11,23,34,11,23,34,0.000593,0.001704,0,5374,0,0.000026,14,0.194678,0.227179,8725.391377,0.26025,0.003623
9904063,9904063,,32,37,69,32,37,69,0.001602,0.017527,0,11014,0,0.000033,13,0.200894,0.232652,33583.178528,0.12191,0.008478
9906223,9906223,,14,23,37,14,23,37,0.000939,0.017707,0,11016,0,0.00002,14,0.18699,0.21392,4115.244672,0.216216,0.003908
9907113,9907113,,15,24,39,15,24,39,0.001286,0.018265,0,11017,41,0.000019,11,0.231359,0.26283,63502.52482,0.118084,0.004127
1217,1217,,7,8,15,7,8,15,0.000175,0.000075,0,11172,0,0.000012,14,0.168561,0.193233,2417.659067,0.219048,0.00228
9812061,9812061,,2,115,117,2,115,117,0.000031,0.016998,0,11171,0,0.000011,13,0.214406,0.273662,4294.404628,0.05924,0.000494
9405031,9405031,,4,3,7,4,3,7,0.000218,0.000047,0,1710,0,0.000013,2,0.666667,0.75,10.574737,0.190476,0.001064
9405188,9405188,,26,12,38,26,12,38,0.001125,0.000593,0,2432,0,0.000033,3,0.561404,0.661458,5406.14782,0.047653,0.00822
9405198,9405198,,3,4,7,3,4,7,0.000204,0.000119,0,11170,0,0.000012,2,0.75,0.833333,0,0.380952,0.000671
9512143,9512143,,30,2,32,30,2,32,0.000745,0.000146,0,2292,0,0.000069,10,0.205717,0.237736,9621.431856,0.185484,0.008752
9609016,9609016,,16,4,20,16,4,20,0.000591,0.00013,0,3589,0,0.00004,12,0.176401,0.202482,18670.206239,0.25,0.004656
1218,1218,,5,10,15,5,10,15,0.000114,0.00174,0,11173,30,0.000014,13,0.189401,0.206435,3263.480006,0.209524,0.001408
9605018,9605018,,30,14,44,30,14,44,0.000225,0.000093,0,6025,23,0.000102,12,0.183312,0.217319,144316.212565,0.059725,0.008651
9610090,9610090,,5,6,11,5,6,11,0.000027,0.000061,0,6027,23,0.000024,13,0.155611,0.176899,7108.753533,0.290909,0.001517
9704034,9704034,,9,4,13,9,4,13,0.000082,0.000005,0,6034,23,0.000025,13,0.162557,0.185266,5045.870724,0.217949,0.002488
1219,1219,,0,13,13,0,13,13,0,0.002643,0,11175,4,0.00001,15,0.168905,0.192887,0,0.391026,0
9603206,9603206,,25,15,40,25,15,40,0.001045,0.003208,0,4002,4,0.000027,10,0.187567,0.244552,4764.918823,0.176923,0.007284
9801157,9801157,,14,19,33,14,19,33,0.000516,0.001023,0,7454,4,0.000019,15,0.192468,0.221857,68420.482978,0.16572,0.003473
9803146,9803146,,9,22,31,9,22,31,0.000289,0.002901,0,7999,4,0.000015,16,0.1774,0.206503,1675.588361,0.241935,0.002249
9808114,9808114,,2,22,24,2,22,24,0.00009,0.001071,0,11174,4,0.000011,14,0.189471,0.216914,4300.158156,0.26087,0.000451
9506139,9506139,,31,15,46,31,15,46,0.001021,0.000546,0,1369,4,0.000052,9,0.192948,0.234976,69567.904163,0.131884,0.012923
9506196,9506196,,23,15,38,23,15,38,0.000565,0.000945,0,1372,4,0.000046,9,0.195825,0.239214,650.817963,0.213371,0.009903
9509165,9509165,,3,5,8,3,5,8,0.000111,0.000584,0,3446,4,0.000014,10,0.17252,0.205617,5.398915,0.339286,0.001015
9407185,9407185,,13,0,13,13,0,13,0.000204,0,0,1370,4,0.000042,0,0,0,0,0.153846,0.004177
9607200,9607200,,21,13,34,21,13,34,0.00063,0.000881,0,3597,4,0.000022,10,0.178692,0.226526,1262.86536,0.172014,0.006623
9609021,9609021,,19,10,29,19,10,29,0.000757,0.001225,0,3447,4,0.000031,13,0.167884,0.196396,21191.14072,0.147783,0.006744
9609230,9609230,,4,12,16,4,12,16,0.000132,0.000721,0,3672,4,0.000013,10,0.177343,0.222133,4.312586,0.441667,0.001538
9610211,9610211,,7,15,22,7,15,22,0.00053,0.002917,0,3998,4,0.000013,13,0.171148,0.200912,251.898772,0.316017,0.002293
9611049,9611049,,14,8,22,14,8,22,0.000798,0.001108,0,3997,4,0.000016,16,0.137055,0.166305,71.708552,0.181818,0.005092
9611088,9611088,,16,21,37,16,21,37,0.000442,0.003264,0,3671,4,0.000022,12,0.153738,0.180318,5828.321387,0.265766,0.005361
9702059,9702059,,7,20,27,7,20,27,0.000163,0.001028,0,3993,4,0.000014,12,0.189842,0.216116,16736.621128,0.259259,0.002203
9703197,9703197,,28,8,36,28,8,36,0.00108,0.000587,0,3938,4,0.000028,13,0.164739,0.191112,285.090759,0.186508,0.007766
9512024,9512024,,7,8,15,7,8,15,0.00037,0.000526,0,3450,4,0.000027,9,0.200448,0.237673,12189.60302,0.166667,0.002481
9705152,9705152,,5,9,14,5,9,14,0.00006,0.004199,0,6214,4,0.000024,11,0.190701,0.217186,17926.83025,0.087912,0.001368
9707260,9707260,,8,17,25,8,17,25,0.000472,0.000974,0,4867,4,0.000019,12,0.184123,0.209499,6534.514903,0.193333,0.002374
9708087,9708087,,6,2,8,6,2,8,0.000016,0.000165,0,7452,26,0.000027,13,0.156311,0.188428,1676.383384,0.160714,0.001505
9708113,9708113,,7,16,23,7,16,23,0.000232,0.001756,0,7448,4,0.000015,12,0.184504,0.210234,1723.038249,0.270751,0.001753
9709177,9709177,,8,7,15,8,7,15,0.000191,0.00036,0,7453,4,0.000021,15,0.139206,0.16259,8925.014347,0.152381,0.001935
9711166,9711166,,12,11,23,12,11,23,0.000304,0.002267,0,7451,4,0.000023,12,0.174234,0.196964,6777.065586,0.142292,0.003215
9801097,9801097,,3,8,11,3,8,11,0.000054,0.00256,0,7449,4,0.000012,13,0.172894,0.197371,23.440681,0.363636,0.000773
9804097,9804097,,5,27,32,5,27,32,0.000087,0.002651,0,8021,4,0.000024,13,0.215192,0.247621,114535.533074,0.228831,0.001206
1220,1220,,0,1,1,0,1,1,0,0,0,11176,23,0.00001,1,1,1,0,0,0
9205092,9205092,,15,0,15,15,0,15,0.000002,0,0,4830,23,0.000071,0,0,0,0,0.004762,0.003434
1221,1221,,1,8,9,1,8,9,0,0.000003,0,11182,22,0.000011,7,0.227462,0.287413,16.166667,0.194444,0.000232
9209005,9209005,,27,0,27,27,0,27,0.000093,0,0,3123,22,0.000093,0,0,0,0,0.048433,0.006984
9210149,9210149,,8,0,8,8,0,8,0,0,0,10030,22,0.000076,0,0,0,0,0.125,0.001925
9405055,9405055,,1,4,5,1,4,5,0,0.000007,0,11181,22,0.000011,1,1,1,8.833333,0.2,0.000226
9607233,9607233,,12,16,28,12,16,28,0.000064,0.00001,0,4374,28,0.000037,6,0.272563,0.357506,145887.49424,0.074074,0.002971
9703121,9703121,,7,18,25,7,18,25,0.000062,0.000011,0,9182,28,0.000029,6,0.280072,0.369124,14573.111279,0.095,0.001705
9705198,9705198,,2,0,2,2,0,2,0,0,0,11179,22,0.000013,0,0,0,0,0,0.000445
9810106,9810106,,4,1,5,4,1,5,0,0,0,11177,22,0.000017,1,1,1,1.333333,0.35,0.000936
9904139,9904139,,4,3,7,4,3,7,0,0.000001,0,11178,22,0.000013,1,1,1,7.833333,0.214286,0.000916
9309123,9309123,,8,2,10,8,2,10,0,0.000001,0,11180,22,0.000053,1,1,1,11.5,0.066667,0.001786
9201058,9201058,,19,0,19,19,0,19,0.000179,0,0,4373,26,0.000308,0,0,0,0,0.067251,0.004865
9206007,9206007,,66,0,66,66,0,66,0.000067,0,0,50,22,0.000597,0,0,0,0,0.037995,0.018021
9308045,9308045,,34,0,34,34,0,34,0.000021,0,0,3610,28,0.000366,0,0,0,0,0.085561,0.009024
9402096,9402096,,27,1,28,27,1,28,0.000021,0,0,3616,28,0.000105,1,1,1,37.474139,0.10582,0.006826
9410064,9410064,,15,1,16,15,1,16,0.000001,0,0,4363,28,0.000044,1,1,1,23.866667,0.1125,0.003608
9505146,9505146,,7,1,8,7,1,8,0,0,0,4365,28,0.000027,2,0.666667,0.75,0,0.339286,0.001814
9508113,9508113,,9,5,14,9,5,14,0.000001,0,0,4366,28,0.000024,1,1,1,1339.000893,0.214286,0.00225
9509109,9509109,,2,1,3,2,1,3,0,0,0,4372,28,0.000013,1,1,1,11620,0.166667,0.000568
9601080,9601080,,9,4,13,9,4,13,0.000441,0.000027,0,4370,4,0.000031,5,0.300813,0.365766,18440.102174,0.108974,0.002339
9604087,9604087,,3,4,7,3,4,7,0,0.000003,0,4368,22,0.000018,5,0.4,0.528125,1858.844642,0.071429,0.000801
9605194,9605194,,4,6,10,4,6,10,0,0.000001,0,4367,28,0.000017,4,0.538462,0.672619,0,0.388889,0.00106
9606149,9606149,,6,5,11,6,5,11,0.000015,0.000001,0,4364,28,0.000019,4,0.363636,0.475694,46243.780375,0.172727,0.001585
9607208,9607208,,6,4,10,6,4,10,0,0.000009,0,4357,22,0.00002,5,0.391892,0.472414,15804.647587,0.177778,0.001484
9611180,9611180,,5,9,14,5,9,14,0.000001,0.000003,0,9181,28,0.000016,4,0.55,0.670455,619.106908,0.21978,0.00117
1222,1222,,5,9,14,5,9,14,0.000289,0.000005,0,11194,6,0.000017,12,0.186613,0.22846,55230.485512,0.104396,0.001223
9210060,9210060,,8,0,8,8,0,8,0.000024,0,0,846,9,0.000065,0,0,0,0,0.089286,0.002779
9508175,9508175,,7,3,10,7,3,10,0.000051,0.000008,0,5801,28,0.000019,3,0.6,0.722222,739.867186,0.077778,0.001941
9603190,9603190,,4,10,14,4,10,14,0,0.000008,0,10662,6,0.000021,8,0.202445,0.253625,6682.265428,0.06044,0.001072
9608190,9608190,,6,9,15,6,9,15,0.000001,0.000004,0,11193,6,0.000017,3,0.492754,0.583333,21820.157821,0.085714,0.001396
9711140,9711140,,7,6,13,7,6,13,0.000004,0.000001,0,11184,6,0.000022,11,0.204815,0.245069,17045.91625,0.089744,0.001759
9902008,9902008,,12,6,18,12,6,18,0.000257,0.000001,0,11186,6,0.000028,12,0.176337,0.211122,9182.768257,0.094771,0.002946
9207025,9207025,,5,0,5,5,0,5,0.000001,0,0,2424,6,0.000017,0,0,0,0,0.3,0.001604
9304141,9304141,,73,1,74,73,1,74,0.000026,0,0,2405,6,0.000124,1,1,1,7873.285347,0.059052,0.020353
9309142,9309142,,47,2,49,47,2,49,0.000011,0.000076,0,2403,6,0.000076,1,1,1,5883.514138,0.096088,0.013359
9310188,9310188,,59,1,60,59,1,60,0.000015,0.000003,0,2064,6,0.000108,2,0.6,0.666667,0.764933,0.090395,0.017466
9407148,9407148,,27,9,36,27,9,36,0.000004,0.000006,0,2417,6,0.000039,4,0.519231,0.62963,18267.454683,0.138095,0.007575
9402084,9402084,,7,0,7,7,0,7,0.000003,0,0,2813,6,0.000042,0,0,0,0,0.166667,0.00172
9409141,9409141,,4,1,5,4,1,5,0.000001,0,0,9310,6,0.00002,1,1,1,55.653495,0.2,0.000979
9409142,9409142,,6,5,11,6,5,11,0.000159,0.000063,0,4320,4,0.000023,3,0.513514,0.596491,52541.830453,0.118182,0.001921
9205045,9205045,,5,0,5,5,0,5,0.000001,0,0,11192,6,0.000017,0,0,0,0,0.15,0.001211
9207018,9207018,,5,0,5,5,0,5,0.000001,0,0,11190,6,0.000015,0,0,0,0,0.25,0.001197
9207102,9207102,,35,0,35,35,0,35,0.000014,0,0,1045,9,0.000178,0,0,0,0,0.039496,0.009421
9302134,9302134,,3,3,6,3,3,6,0,0.000021,0,11189,6,0.000013,2,0.8,0.875,49.761094,0.166667,0.000724
9407069,9407069,,2,12,14,2,12,14,0,0.00001,0,11191,6,0.000012,2,0.676471,0.76087,5016.201691,0.054945,0.000491
9510226,9510226,,2,0,2,2,0,2,0.000001,0,0,11187,6,0.000012,0,0,0,0,0,0.000485
9706006,9706006,,1,1,2,1,1,2,0,0,0,11183,22,0.000013,8,0.237991,0.277971,3056.144646,0,0.000268
9501079,9501079,,2,1,3,2,1,3,0,0,0,11185,6,0.000014,1,1,1,0.333333,0.166667,0.00052
2001,2001,,1,4,5,1,4,5,0.000037,0.003455,0,11196,2,0.000011,13,0.185245,0.20176,190.009037,0.2,0.000219
9808064,9808064,,1,1,2,1,1,2,0.000041,0.001536,0,11195,2,0.000012,11,0.178929,0.195789,0,0.5,0.000226
2002,2002,,3,27,30,3,27,30,0.000368,0.010318,0,11202,2,0.000012,12,0.223596,0.255247,11734.076124,0.095402,0.000771
9907095,9907095,,2,32,34,2,32,34,0.000229,0.009065,0,11201,0,0.000011,12,0.218554,0.260677,981.303266,0.151515,0.000466
9907144,9907144,,14,26,40,14,26,40,0.002126,0.018688,0,11198,1,0.000017,12,0.220454,0.246453,20589.460776,0.11859,0.004058
9909088,9909088,,6,36,42,6,36,42,0.000792,0.013375,0,11200,13,0.000012,11,0.243906,0.283619,19394.38399,0.124274,0.001618
9910111,9910111,,5,16,21,5,16,21,0.001104,0.009258,0,11199,1,0.000012,12,0.210507,0.234737,1496.742084,0.209524,0.001352
9302080,9302080,,33,3,36,33,3,36,0.000719,0.000013,0,407,5,0.000149,3,0.5,0.590909,8492.58329,0.096825,0.018173
9407008,9407008,,18,6,24,18,6,24,0.000961,0.000189,0,980,5,0.000104,7,0.305085,0.375331,14809.851784,0.097826,0.012405
9411219,9411219,,14,0,14,14,0,14,0.000872,0,0,1692,8,0.000099,0,0,0,0,0.186813,0.011367
9510180,9510180,,10,1,11,10,1,11,0.000424,0.000011,0,1689,13,0.00014,1,1,1,656.603667,0.136364,0.014222
9508090,9508090,,3,13,16,3,13,16,0.000199,0.000099,0,1820,5,0.000038,6,0.301282,0.378487,91340.126163,0.079167,0.004538
9508151,9508151,,9,13,22,9,13,22,0.001404,0.000445,0,1815,5,0.000042,7,0.320442,0.390531,41949.900782,0.075758,0.007452
9512148,9512148,,5,9,14,5,9,14,0.000306,0.000242,0,1814,5,0.00004,7,0.334623,0.395389,122732.883474,0.131868,0.00515
9507041,9507041,,5,11,16,5,11,16,0.000273,0.000146,0,7170,5,0.000014,8,0.254626,0.291298,3153.110201,0.145833,0.001384
9705215,9705215,,3,8,11,3,8,11,0.000252,0.001648,0,7171,5,0.000013,11,0.191711,0.220857,3410.494257,0.154545,0.001115
9506071,9506071,,20,18,38,20,18,38,0.001221,0.000719,0,1152,3,0.000034,7,0.276501,0.331337,6467.599263,0.096017,0.008354
9601171,9601171,,10,18,28,10,18,28,0.000718,0.005912,0,2666,13,0.000019,11,0.211914,0.271758,3562.44859,0.166667,0.003937
9602145,9602145,,6,27,33,6,27,33,0.000528,0.006415,0,2668,13,0.000013,10,0.232476,0.283604,6601.297918,0.144886,0.00205
9609152,9609152,,9,26,35,9,26,35,0.000542,0.006616,0,2669,13,0.00002,12,0.20844,0.253167,46994.225103,0.131933,0.003853
9203069,9203069,,18,0,18,18,0,18,0.000374,0,0,2628,9,0.000071,0,0,0,0,0.19281,0.006244
9712061,9712061,,17,12,29,17,12,29,0.002322,0.006215,0,6428,2,0.000017,15,0.187024,0.217481,4029.857772,0.16133,0.004568
9902189,9902189,,3,4,7,3,4,7,0.000237,0.000949,0,11197,2,0.000012,14,0.18866,0.210916,2011.847182,0.071429,0.00093
9708109,9708109,,12,15,27,12,15,27,0.001361,0.001715,0,6146,13,0.000016,13,0.196302,0.228277,5420.722123,0.122507,0.003683
9802151,9802151,,3,55,58,3,55,58,0.000518,0.008392,0,7991,4,0.000011,12,0.224491,0.267613,6366.500647,0.164247,0.001053
9903213,9903213,,21,43,64,21,43,64,0.003783,0.011959,0,8303,13,0.000022,14,0.218705,0.258594,45135.666098,0.113343,0.007677
9903110,9903110,,6,60,66,6,60,66,0.00064,0.02845,0,8615,0,0.000014,12,0.224116,0.260303,35834.168908,0.055012,0.001632
2003,2003,,1,10,11,1,10,11,0,0.000004,0,11205,23,0.00001,14,0.164044,0.17894,0,0.381818,0.000219
9802105,9802105,,8,1,9,8,1,9,0.000027,0.000002,0,10805,23,0.000032,13,0.136518,0.150234,0,0.458333,0.00205
9804004,9804004,,6,2,8,6,2,8,0.000027,0.000002,0,10809,23,0.000018,13,0.136602,0.150839,2184.139672,0.375,0.001459
9805094,9805094,,9,5,14,9,5,14,0.000027,0.000002,0,10808,23,0.000023,13,0.151492,0.171372,6362.587051,0.236264,0.002206
9806084,9806084,,7,7,14,7,7,14,0.000027,0.000003,0,10814,23,0.000019,13,0.138605,0.157701,7713.680251,0.236264,0.001694
9809149,9809149,,5,6,11,5,6,11,0.000027,0.000003,0,10817,23,0.000016,13,0.138657,0.157038,3275.516667,0.3,0.001163
9902141,9902141,,10,8,18,10,8,18,0.000028,0.000007,0,11203,23,0.00002,14,0.155758,0.169724,26817.233961,0.189542,0.002291
9903168,9903168,,2,8,10,2,8,10,0,0.000012,0,11204,23,0.000011,15,0.173272,0.193367,4257.235143,0.244444,0.000445
9301098,9301098,,14,0,14,14,0,14,0.000056,0,0,3225,28,0.000082,0,0,0,0,0.076923,0.003631
9410147,9410147,,6,6,12,6,6,12,0.000069,0.000007,0,6918,28,0.000036,2,0.8,0.875,20129.488417,0.128788,0.001661
9606066,9606066,,15,17,32,15,17,32,0.000112,0.000016,0,6917,6,0.000038,11,0.181274,0.215673,128336.648157,0.09879,0.003796
9607017,9607017,,4,5,9,4,5,9,0,0.000007,0,6911,6,0.000032,13,0.167244,0.196186,27320.683022,0.125,0.001109
9707169,9707169,,3,2,5,3,2,5,0,0,0,10807,1,0.000019,3,0.571429,0.708333,1798.995455,0.15,0.000726
9802131,9802131,,2,1,3,2,1,3,0,0.000002,0,10804,30,0.000017,1,1,1,239.353969,0.166667,0.0005
9202026,9202026,,6,0,6,6,0,6,0.000004,0,0,10078,41,0.000052,0,0,0,0,0.066667,0.001471
9207039,9207039,,8,0,8,8,0,8,0.000005,0,0,1135,26,0.000048,0,0,0,0,0.017857,0.002044
9509022,9509022,,6,7,13,6,7,13,0.000003,0.000003,0,10813,22,0.000022,3,0.571429,0.6875,5531.594579,0.096154,0.001382
9404057,9404057,,1,2,3,1,2,3,0,0,0,10816,23,0.000012,1,1,1,1659.766667,0,0.000252
9902161,9902161,,9,31,40,9,31,40,0.00063,0.004011,0,10891,4,0.000013,14,0.199877,0.230477,8563.192964,0.241667,0.002445
2004,2004,,10,26,36,10,26,36,0.000247,0.001561,0,11206,0,0.000016,16,0.17758,0.208839,3402.838645,0.12619,0.003715
9404186,9404186,,6,5,11,6,5,11,0.000206,0.000231,0,808,0,0.000023,2,0.692308,0.777778,5578.979433,0.090909,0.001913
9203066,9203066,,10,0,10,10,0,10,0.000116,0,0,126,4,0.001363,0,0,0,0,0.055556,0.004804
9311143,9311143,,7,3,10,7,3,10,0.000158,0.000027,0,807,0,0.000018,2,0.8,0.875,561.416036,0.044444,0.002137
9405086,9405086,,6,13,19,6,13,19,0.000215,0.000321,0,806,0,0.000021,2,0.782609,0.861111,15770.870555,0.102339,0.002038
9707149,9707149,,20,15,35,20,15,35,0.001003,0.001815,0,5922,0,0.00002,12,0.210519,0.245016,1651.280365,0.170588,0.006017
9810168,9810168,,4,8,12,4,8,12,0.000139,0.001955,0,8305,0,0.000014,15,0.175145,0.208737,2530.825273,0.242424,0.001539
2006,2006,,2,15,17,2,15,17,0.000097,0.003684,0,11207,13,0.00001,11,0.233425,0.26867,22195.818712,0.150735,0.000574
9904174,9904174,,4,7,11,4,7,11,0.000105,0.00651,0,9757,1,0.000013,14,0.186869,0.214447,5834.034344,0.218182,0.001051
9202004,9202004,,44,0,44,44,0,44,0.000777,0,0,65,5,0.000724,0,0,0,0,0.053911,0.017433
9211030,9211030,,39,6,45,39,6,45,0.000189,0.00006,0,342,5,0.000233,2,0.75,0.833333,4455.625624,0.086364,0.013154
9305115,9305115,,14,0,14,14,0,14,0.000775,0,0,692,4,0.000034,0,0,0,0,0.208791,0.006722
9306001,9306001,,3,2,5,3,2,5,0.000004,0.000096,0,2963,13,0.00002,3,0.37963,0.410569,342.61766,0.25,0.000702
2007,2007,,15,19,34,15,19,34,0.000847,0.006098,0,11211,1,0.000024,11,0.197593,0.219743,117382.03884,0.136364,0.003706
9202036,9202036,,17,0,17,17,0,17,0.000599,0,0,308,13,0.000127,0,0,0,0,0.084559,0.00769
9307013,9307013,,19,0,19,19,0,19,0.000176,0,0,921,28,0.000331,0,0,0,0,0.05848,0.005675
9503063,9503063,,3,5,8,3,5,8,0.000088,0.000019,0,1237,28,0.000015,3,0.666667,0.791667,6958.660392,0.107143,0.001117
9602108,9602108,,19,5,24,19,5,24,0.000959,0.000043,0,2888,13,0.000033,8,0.243851,0.280345,19729.208229,0.106884,0.006251
9908202,9908202,,6,6,12,6,6,12,0.000424,0.000638,0,11037,1,0.000017,14,0.170169,0.1957,9332.46081,0.121212,0.001821
9911001,9911001,,21,16,37,21,16,37,0.001489,0.000413,0,11209,1,0.000026,13,0.188568,0.211366,237012.315584,0.11036,0.005541
9911066,9911066,,25,21,46,25,21,46,0.00154,0.006887,0,11210,1,0.00003,11,0.209976,0.23333,184624.135291,0.080676,0.006544
9203070,9203070,,25,0,25,25,0,25,0.0009,0,0,344,13,0.000079,0,0,0,0,0.081667,0.011103
9401003,9401003,,16,0,16,16,0,16,0.000298,0,0,1391,13,0.000095,0,0,0,0,0.05,0.006826
9505119,9505119,,3,3,6,3,3,6,0.000031,0.000016,0,2887,13,0.00002,6,0.24838,0.285362,208.033648,0.266667,0.00114
9502126,9502126,,18,8,26,18,8,26,0.001033,0.002447,0,2221,13,0.000025,7,0.324653,0.384097,6677.659223,0.181538,0.005346
9511166,9511166,,7,8,15,7,8,15,0.000138,0.000011,0,4282,22,0.000027,6,0.27907,0.389583,100643.623956,0.180952,0.001776
9502009,9502009,,29,2,31,29,2,31,0.000743,0.000869,0,3161,10,0.000061,6,0.280519,0.312269,1857.924139,0.06129,0.008388
9706124,9706124,,19,13,32,19,13,32,0.001224,0.003099,0,4270,10,0.000036,15,0.188422,0.224549,19493.848592,0.080645,0.007289
9903267,9903267,,5,17,22,5,17,22,0.000205,0.002565,0,8277,13,0.000014,12,0.195693,0.224547,7888.091528,0.175325,0.00138
9806191,9806191,,11,19,30,11,19,30,0.001367,0.003584,0,8357,13,0.000017,14,0.184757,0.219125,9068.575268,0.14023,0.003498
9702067,9702067,,15,9,24,15,9,24,0.001075,0.001747,0,3885,0,0.000027,12,0.2049,0.231631,31587.95709,0.130435,0.005802
9907046,9907046,,3,18,21,3,18,21,0.000162,0.002074,0,11040,0,0.000014,12,0.196639,0.222611,27772.51294,0.145238,0.001313
9205061,9205061,,3,0,3,3,0,3,0.00001,0,0,11208,1,0.000013,0,0,0,0,0.333333,0.000813
9812066,9812066,,8,26,34,8,26,34,0.000809,0.008801,0,8428,1,0.000017,13,0.203696,0.234916,24047.323036,0.088235,0.002684
9810204,9810204,,31,10,41,31,10,41,0.001787,0.000638,0,8427,13,0.000062,13,0.177872,0.200262,36961.058739,0.07439,0.00891
2008,2008,,11,34,45,11,34,45,0.001981,0.019033,0,11214,41,0.00002,11,0.229771,0.261732,45580.716273,0.158081,0.003529
9908114,9908114,,20,25,45,20,25,45,0.002716,0.019157,0,11212,41,0.000026,11,0.228453,0.259832,39887.967482,0.178283,0.008544
9912284,9912284,,12,15,27,12,15,27,0.001801,0.001697,0,11213,41,0.000019,12,0.194239,0.21465,1171.145864,0.277778,0.004275
9603031,9603031,,20,3,23,20,3,23,0.000864,0.000007,0,3351,2,0.000048,7,0.330309,0.368093,96199.459583,0.051383,0.006033
9509052,9509052,,15,17,32,15,17,32,0.000324,0.002464,0,3357,2,0.000036,8,0.242365,0.289161,38542.446045,0.09879,0.005316
9704093,9704093,,21,12,33,21,12,33,0.00051,0.000396,0,5155,2,0.000037,12,0.173826,0.197151,23448.955499,0.16572,0.006947
9512071,9512071,,3,0,3,3,0,3,0.00033,0,0,6678,22,0.000014,0,0,0,0,0,0.001333
9503210,9503210,,2,4,6,2,4,6,0.000293,0.000147,0,4672,52,0.000012,5,0.373494,0.423118,14551.878789,0.033333,0.000586
9610091,9610091,,3,9,12,3,9,12,0.000354,0.005418,0,4679,0,0.000012,12,0.192378,0.233461,59019.740178,0.121212,0.000814
9407152,9407152,,3,5,8,3,5,8,0.000165,0.000005,0,6595,9,0.000015,5,0.267857,0.351481,5928.796532,0.25,0.00094
9202032,9202032,,7,0,7,7,0,7,0.00041,0,0,1897,9,0.000019,0,0,0,0,0.238095,0.002104
9307037,9307037,,7,3,10,7,3,10,0.000398,0.000069,0,1083,9,0.00002,4,0.319672,0.384615,3340.807077,0.111111,0.001946
9408109,9408109,,12,2,14,12,2,14,0.000398,0.00001,0,6335,9,0.000034,3,0.4375,0.547619,968.760449,0.126374,0.003176
9611083,9611083,,7,6,13,7,6,13,0.000211,0.000018,0,7511,9,0.000019,13,0.185693,0.207879,18898.257038,0.153846,0.001982
9506125,9506125,,22,4,26,22,4,26,0.001056,0.000336,0,3259,26,0.000052,4,0.377049,0.452899,2305.152204,0.076923,0.005921
9705048,9705048,,5,0,5,5,0,5,0.000492,0,0,9175,1,0.000013,0,0,0,0,0.2,0.001412
9707066,9707066,,5,0,5,5,0,5,0.000328,0,0,9173,1,0.000037,0,0,0,0,0.15,0.001461
9802097,9802097,,6,2,8,6,2,8,0.000617,0.00007,0,9174,1,0.000015,1,1,1,57.257084,0.232143,0.001841
9812194,9812194,,9,41,50,9,41,50,0.001474,0.021526,0,7697,1,0.000022,12,0.207022,0.235052,37643.791814,0.160816,0.002526
2009,2009,,22,27,49,22,27,49,0.00194,0.006024,0,11222,41,0.000023,13,0.198704,0.223871,69480.714106,0.105442,0.006201
9710191,9710191,,14,12,26,14,12,26,0.001614,0.006095,0,6465,2,0.000027,15,0.168674,0.196804,2367.51039,0.123077,0.00442
9904009,9904009,,8,0,8,8,0,8,0.0012,0,0,11221,41,0.000021,0,0,0,0,0.267857,0.002746
9911068,9911068,,39,65,104,39,65,104,0.005,0.021047,0,11220,2,0.000028,12,0.219184,0.251963,148199.568401,0.049104,0.011484
9912137,9912137,,6,3,9,6,3,9,0.000916,0.000097,0,11219,41,0.000016,15,0.166603,0.186149,13259.171471,0.222222,0.002249
9202018,9202018,,12,0,12,12,0,12,0.000002,0,0,759,15,0.000116,0,0,0,0,0.05303,0.003173
9506072,9506072,,5,1,6,5,1,6,0.000077,0.000001,0,6896,41,0.000034,1,1,1,159.487549,0.1,0.001386
9508128,9508128,,1,3,4,1,3,4,0.000001,0.000067,0,6895,5,0.000014,3,0.571429,0.666667,1175.239296,0,0.000348
9405004,9405004,,13,10,23,13,10,23,0.000017,0.000082,0,1272,4,0.000029,4,0.36803,0.436869,6547.918748,0.15415,0.003441
9407141,9407141,,9,13,22,9,13,22,0.00001,0.000089,0,1274,4,0.000023,5,0.34589,0.431683,15731.340036,0.15368,0.002216
9604184,9604184,,1,0,1,1,0,1,0,0,0,10277,41,0.000016,0,0,0,0,0,0.000256
9612096,9612096,,9,37,46,9,37,46,0.000319,0.014454,0,6165,2,0.000023,14,0.216822,0.260501,23580.538347,0.098551,0.002518
9705005,9705005,,15,4,19,15,4,19,0.001607,0.001909,0,4709,2,0.000025,14,0.168923,0.188421,8059.909878,0.169591,0.004632
9807092,9807092,,11,6,17,11,6,17,0.000956,0.000016,0,9364,15,0.000033,13,0.16351,0.186814,32878.4634,0.044118,0.002713
9301111,9301111,,31,0,31,31,0,31,0.000615,0,0,4468,2,0.000174,0,0,0,0,0.091398,0.008057
9602020,9602020,,9,2,11,9,2,11,0.000476,0.000008,0,9329,2,0.000018,4,0.4375,0.559524,784.578558,0.254545,0.002425
9609114,9609114,,9,1,10,9,1,10,0.00039,0.000007,0,7708,2,0.000022,1,1,1,41.231556,0.211111,0.002369
9706027,9706027,,12,8,20,12,8,20,0.001638,0.002641,0,6430,2,0.000018,12,0.196773,0.225171,4302.891444,0.144737,0.004267
9711034,9711034,,5,9,14,5,9,14,0.000646,0.006487,0,6466,2,0.000014,15,0.187498,0.219057,4566.223491,0.247253,0.00168
9904016,9904016,,9,13,22,9,13,22,0.000814,0.000872,0,11218,41,0.000019,14,0.193709,0.22564,26963.738055,0.190476,0.002389
2010,2010,,6,6,12,6,6,12,0.000171,0.000025,0,11228,1,0.000017,13,0.16014,0.174993,5944.918787,0.181818,0.001347
9401039,9401039,,7,2,9,7,2,9,0.000068,0.000005,0,11225,1,0.000033,1,1,1,14.75,0.25,0.001686
9504025,9504025,,16,2,18,16,2,18,0.000219,0.000003,0,6964,1,0.000051,3,0.5,0.551282,21074.399235,0.078431,0.003932
9510151,9510151,,12,0,12,12,0,12,0.000058,0,0,8165,1,0.000046,0,0,0,0,0.121212,0.002974
9610023,9610023,,5,3,8,5,3,8,0.000068,0.000004,0,11227,1,0.000018,2,0.8,0.875,8,0.321429,0.001187
9806038,9806038,,9,3,12,9,3,12,0.000172,0.001539,0,11223,1,0.000024,11,0.179693,0.197685,2707.955785,0.189394,0.00207
9203067,9203067,,6,0,6,6,0,6,0.000244,0,0,11224,1,0.000041,0,0,0,0,0.166667,0.00145
9210011,9210011,,23,0,23,23,0,23,0.000162,0,0,2253,26,0.000155,0,0,0,0,0.037549,0.006325
9411091,9411091,,9,1,10,9,1,10,0.000241,0.000002,0,1596,28,0.000051,1,1,1,267.795649,0.077778,0.003086
9407119,9407119,,4,2,6,4,2,6,0.000001,0.000004,0,11226,1,0.00002,2,0.75,0.833333,1.5,0.333333,0.000962
2011,2011,,10,43,53,10,43,53,0.000714,0.013664,0,11229,2,0.000014,11,0.247667,0.283188,43260.510698,0.079826,0.00288
9210164,9210164,,1,0,1,1,0,1,0,0,0,897,2,0.000096,0,0,0,0,0,0.000298
9301033,9301033,,4,4,8,4,4,8,0.00043,0.000122,0,1354,0,0.000017,1,1,1,137.019378,0.160714,0.003141
9308151,9308151,,21,0,21,21,0,21,0.000373,0,0,334,13,0.00016,0,0,0,0,0.064286,0.007791
9505106,9505106,,7,4,11,7,4,11,0.000236,0.00002,0,1320,13,0.000025,5,0.345679,0.427976,16413.336602,0.118182,0.003301
9506210,9506210,,7,6,13,7,6,13,0.000241,0.00008,0,1316,9,0.000018,2,0.714286,0.8,11138.025012,0.153846,0.003384
9503072,9503072,,17,0,17,17,0,17,0.000911,0,0,1153,9,0.00007,0,0,0,0,0.194853,0.007764
9211059,9211059,,44,1,45,44,1,45,0.000617,0.000005,0,467,28,0.000117,1,1,1,11010.763926,0.070202,0.016099
2012,2012,,5,28,33,5,28,33,0.000299,0.002992,0,11231,0,0.000011,14,0.182939,0.212858,1043.508605,0.162879,0.001136
9807170,9807170,,2,17,19,2,17,19,0.000131,0.001836,0,11230,0,0.00001,14,0.195066,0.228169,426.069375,0.216374,0.000507
9605020,9605020,,2,3,5,2,3,5,0.00002,0.000001,0,2324,52,0.000018,2,0.615385,0.6875,75821.138307,0.15,0.001041
2013,2013,,1,4,5,1,4,5,0.000012,0.000005,0,11232,4,0.00001,16,0.146833,0.159264,19.628243,0.4,0.000219
9612066,9612066,,12,10,22,12,10,22,0.000131,0.001464,0,8080,0,0.000021,11,0.195795,0.223777,41857.729284,0.062771,0.003067
2014,2014,,0,7,7,0,7,7,0,0.000004,0,11252,23,0.00001,17,0.120338,0.140764,0,0.261905,0
9707067,9707067,,1,2,3,1,2,3,0,0,0,11251,23,0.000011,1,1,1,2,0.166667,0.000219
9804142,9804142,,7,7,14,7,7,14,0,0.000003,0,11248,23,0.000036,17,0.122335,0.1445,6005.761453,0.148352,0.0016
9811071,9811071,,4,3,7,4,3,7,0.000011,0.000004,0,10409,23,0.00003,16,0.128151,0.145409,4432.980449,0.214286,0.000956
9904160,9904160,,4,4,8,4,4,8,0,0.000006,0,11233,23,0.00003,17,0.115012,0.130627,1675.470138,0.196429,0.000905
9409182,9409182,,2,0,2,2,0,2,0,0,0,4967,23,0.000053,0,0,0,0,0.5,0.000568
9610030,9610030,,5,5,10,5,5,10,0.000033,0.000014,0,4966,23,0.000065,15,0.145881,0.169357,71860.632728,0.133333,0.001356
9609168,9609168,,2,0,2,2,0,2,0,0,0,11249,23,0.000028,0,0,0,0,0.5,0.000451
9612211,9612211,,1,1,2,1,1,2,0,0,0,11250,23,0.000015,1,1,1,0,0.5,0.000226
9301101,9301101,,2,0,2,2,0,2,0,0,0,11247,23,0.000015,0,0,0,0,0.5,0.000491
9710084,9710084,,1,8,9,1,8,9,0,0.000004,0,11246,23,0.000015,17,0.124369,0.151037,2189.641829,0.097222,0.000265
9803125,9803125,,2,3,5,2,3,5,0,0.000003,0,11240,23,0.000017,18,0.104797,0.119785,315.345036,0.2,0.000485
2015,2015,,4,4,8,4,4,8,0.000001,0.000031,0,11256,22,0.000017,3,0.551724,0.614583,15,0.285714,0.000883
9507132,9507132,,9,0,9,9,0,9,0.000003,0,0,11253,22,0.000043,0,0,0,0,0.166667,0.002085
9910254,9910254,,5,3,8,5,3,8,0.000001,0.00002,0,11255,22,0.000021,2,0.6,0.666667,5,0.303571,0.001128
9904038,9904038,,2,2,4,2,2,4,0.000001,0.00002,0,11254,22,0.000016,2,0.571429,0.625,0,0.333333,0.000504
2016,2016,,52,104,156,52,104,156,0.005631,0.027055,0,11257,2,0.000044,12,0.237952,0.275274,319922.852008,0.06861,0.016452
9709044,9709044,,7,16,23,7,16,23,0.001241,0.003851,0,6431,2,0.000013,17,0.187837,0.220755,12278.068206,0.148221,0.002738
9802187,9802187,,12,15,27,12,15,27,0.001896,0.00459,0,5616,2,0.000024,13,0.195204,0.224361,33433.856128,0.179487,0.005169
9803191,9803191,,4,41,45,4,41,45,0.00129,0.024684,0,8350,2,0.000011,13,0.210157,0.246362,7721.690795,0.140909,0.001997
9804067,9804067,,6,17,23,6,17,23,0.001815,0.00537,0,6418,2,0.000012,14,0.196328,0.227449,1587.556814,0.243083,0.002731
9807182,9807182,,7,7,14,7,7,14,0.002014,0.00312,0,9111,2,0.000011,15,0.171183,0.194323,27.895294,0.313187,0.002501
9809103,9809103,,26,38,64,26,38,64,0.003903,0.008875,0,6725,2,0.000026,13,0.203169,0.237052,41575.47499,0.090278,0.007965
9811037,9811037,,16,10,26,16,10,26,0.00221,0.00045,0,6667,2,0.000022,14,0.184242,0.211186,20009.99353,0.112308,0.005442
9910001,9910001,,15,47,62,15,47,62,0.002104,0.023023,0,10561,2,0.000019,11,0.235944,0.272491,71188.128007,0.102327,0.004845
9205099,9205099,,5,1,6,5,1,6,0.000116,0.000003,0,367,26,0.000053,1,1,1,0.25,0.3,0.003835
9210061,9210061,,4,1,5,4,1,5,0.000103,0.000003,0,365,26,0.00005,1,1,1,0.25,0.2,0.003519
9311129,9311129,,8,2,10,8,2,10,0.000641,0.000014,0,1018,2,0.000023,2,0.75,0.833333,728.179805,0.088889,0.003313
9705225,9705225,,22,25,47,22,25,47,0.001977,0.012179,0,4711,2,0.00003,13,0.204965,0.240653,17504.033353,0.142461,0.006579
9706002,9706002,,8,6,14,8,6,14,0.000871,0.001988,0,5592,2,0.000019,12,0.181366,0.201392,2440.758259,0.192308,0.002837
9708007,9708007,,7,7,14,7,7,14,0.00023,0.000684,0,6429,25,0.00002,16,0.181508,0.204713,20735.624066,0.137363,0.001691
9612083,9612083,,19,17,36,19,17,36,0.00093,0.000063,0,5095,26,0.000035,8,0.225901,0.270171,284269.299201,0.1,0.005996
9702048,9702048,,3,1,4,3,1,4,0.000291,0,0,5074,2,0.000019,1,1,1,8475.863698,0.166667,0.001752
9704171,9704171,,15,3,18,15,3,18,0.000271,0.000018,0,5076,26,0.00004,2,0.636364,0.714286,9254.756886,0.098039,0.00422
9707141,9707141,,3,3,6,3,3,6,0.000081,0.000019,0,5222,26,0.000029,3,0.571429,0.666667,11298.64329,0.2,0.001724
9702169,9702169,,8,1,9,8,1,9,0.001153,0.001536,0,5098,2,0.000019,11,0.178929,0.195789,0,0.25,0.003978
9710032,9710032,,12,12,24,12,12,24,0.000642,0.007333,0,5308,2,0.000022,15,0.179215,0.208672,21734.557968,0.105072,0.003975
9710057,9710057,,5,22,27,5,22,27,0.000283,0.005941,0,4971,2,0.00002,12,0.201719,0.233743,2449.869784,0.18661,0.00218
9710192,9710192,,7,19,26,7,19,26,0.000406,0.00589,0,4976,2,0.000022,15,0.184899,0.215507,60398.902902,0.123077,0.002903
9711010,9711010,,8,36,44,8,36,44,0.002089,0.006518,0,5263,2,0.000013,13,0.207581,0.243615,4676.422537,0.168076,0.003309
9806109,9806109,,15,15,30,15,15,30,0.00299,0.004147,0,6413,2,0.000019,13,0.195503,0.222915,4085.780843,0.283908,0.005363
9806166,9806166,,8,6,14,8,6,14,0.001459,0.000384,0,6416,2,0.000014,14,0.177088,0.195387,77.975417,0.362637,0.002666
9807071,9807071,,5,34,39,5,34,39,0.001015,0.006615,0,6683,2,0.000012,13,0.204035,0.235049,2334.757616,0.205803,0.001809
9309134,9309134,,12,0,12,12,0,12,0.001088,0,0,4708,2,0.000046,0,0,0,0,0.068182,0.004871
9707261,9707261,,7,32,39,7,32,39,0.000786,0.012833,0,6721,2,0.000015,13,0.206667,0.242428,19450.536911,0.167341,0.002052
9802173,9802173,,11,20,31,11,20,31,0.001974,0.00427,0,6382,2,0.000017,13,0.203249,0.2365,65991.192502,0.12043,0.003947
9707199,9707199,,29,6,35,29,6,35,0.000397,0.000003,0,6746,23,0.000056,6,0.284946,0.371069,47850.281423,0.152941,0.007405
9704135,9704135,,7,5,12,7,5,12,0.000382,0.000013,0,7793,26,0.000027,8,0.2,0.282451,28766.539265,0.05303,0.002017
9811165,9811165,,5,13,18,5,13,18,0.000611,0.002669,0,7789,2,0.000012,14,0.187235,0.210403,57556.017778,0.189542,0.001594
9901158,9901158,,4,22,26,4,22,26,0.000803,0.003947,0,7781,2,0.000012,13,0.197218,0.222891,10877.704346,0.153846,0.001411
9609216,9609216,,4,8,12,4,8,12,0.000699,0.000044,0,6392,26,0.000012,10,0.225361,0.273543,155337.489078,0.060606,0.001368
9612130,9612130,,7,11,18,7,11,18,0.00098,0.004536,0,3735,13,0.000017,13,0.20419,0.238178,362.486855,0.19281,0.003123
9709225,9709225,,19,17,36,19,17,36,0.002246,0.003858,0,5060,2,0.000032,12,0.198655,0.227791,6163.542362,0.123016,0.00809
9801053,9801053,,14,23,37,14,23,37,0.002154,0.005574,0,6571,13,0.000015,14,0.190019,0.225416,4984.38559,0.151652,0.003758
9805115,9805115,,7,7,14,7,7,14,0.001655,0.006979,0,6442,2,0.000013,15,0.174256,0.198685,257.870438,0.269231,0.002916
9806214,9806214,,17,25,42,17,25,42,0.003562,0.010024,0,6393,2,0.000021,12,0.201096,0.229939,75557.027478,0.132404,0.006012
2017,2017,,0,8,8,0,8,8,0,0.002769,0,11260,2,0.00001,16,0.164266,0.186004,0,0.107143,0
9702021,9702021,,2,1,3,2,1,3,0.000037,0.000007,0,11258,2,0.000014,1,1,1,2,0.166667,0.000445
9806048,9806048,,1,3,4,1,3,4,0.000033,0.000393,0,11259,2,0.000011,14,0.186243,0.211582,0,0.333333,0.000219
2019,2019,,2,7,9,2,7,9,0.000144,0.000494,0,11272,23,0.000013,14,0.148837,0.165386,991.63121,0.125,0.000491
9902090,9902090,,2,3,5,2,3,5,0.000149,0.000005,0,11271,23,0.000014,16,0.105251,0.111291,82.166667,0.05,0.000504
9909226,9909226,,9,5,14,9,5,14,0.000186,0.004833,0,11267,23,0.000025,14,0.168082,0.186514,13233.009011,0.137363,0.002111
9912259,9912259,,11,4,15,11,4,15,0.000332,0.000581,0,11266,1,0.000023,7,0.207983,0.24733,5576.705653,0.114286,0.002586
9502024,9502024,,10,3,13,10,3,13,0.000052,0.000004,0,3291,26,0.000058,2,0.714286,0.8,13368.145911,0.064103,0.002636
9205022,9205022,,2,0,2,2,0,2,0.000006,0,0,11270,23,0.000015,0,0,0,0,0,0.000452
9812083,9812083,,1,4,5,1,4,5,0,0.000468,0,11269,23,0.000014,15,0.117524,0.125757,3287.5,0.05,0.000233
9505037,9505037,,10,1,11,10,1,11,0.000069,0.000468,0,11264,1,0.000041,1,1,1,0,0.281818,0.002452
9909111,9909111,,2,3,5,2,3,5,0.000014,0.000469,0,11265,1,0.000016,6,0.249344,0.281404,2654.940907,0.35,0.000525
2020,2020,,16,14,30,16,14,30,0.000725,0.004358,0,11273,30,0.000024,13,0.194308,0.215063,13829.660648,0.167816,0.006738
9504104,9504104,,5,4,9,5,4,9,0.000128,0.000037,0,1937,3,0.000022,1,1,1,14782.513273,0.069444,0.001667
2021,2021,,7,34,41,7,34,41,0.000484,0.023028,0,11283,2,0.000014,11,0.242864,0.280354,110351.209587,0.07561,0.001669
9210045,9210045,,20,0,20,20,0,20,0.000549,0,0,188,23,0.000099,0,0,0,0,0.068421,0.006606
9501052,9501052,,13,0,13,13,0,13,0.000272,0,0,1751,26,0.000125,0,0,0,0,0.115385,0.00326
9501097,9501097,,5,0,5,5,0,5,0.000271,0,0,1759,26,0.000033,0,0,0,0,0.35,0.001238
9502116,9502116,,4,2,6,4,2,6,0.000271,0.000006,0,4730,26,0.000018,1,1,1,174.712784,0.233333,0.000973
9505160,9505160,,5,3,8,5,3,8,0.000271,0.000008,0,1760,26,0.000031,3,0.529412,0.62963,25561.485212,0.25,0.001241
9806231,9806231,,10,7,17,10,7,17,0.000617,0.000042,0,7946,26,0.000033,16,0.144218,0.159498,184494.805287,0.047794,0.002428
9812190,9812190,,7,30,37,7,30,37,0.000556,0.000042,0,11282,26,0.000018,9,0.230983,0.291754,77476.411869,0.059309,0.00179
9904125,9904125,,3,9,12,3,9,12,0.000298,0.000017,0,11278,26,0.000011,3,0.652174,0.777778,9087.04179,0.128788,0.000749
9905198,9905198,,3,16,19,3,16,19,0.000419,0.006555,0,11274,2,0.000011,15,0.184592,0.21213,4146.279628,0.122807,0.000764
9907146,9907146,,2,17,19,2,17,19,0.000389,0.006414,0,11275,2,0.00001,16,0.177346,0.208004,220.639819,0.254386,0.000485
9301102,9301102,,27,0,27,27,0,27,0.000144,0,0,2841,23,0.000078,0,0,0,0,0.111111,0.007505
9306073,9306073,,8,1,9,8,1,9,0.000082,0,0,2840,23,0.000048,1,1,1,13477.673709,0.041667,0.002235
9401105,9401105,,43,3,46,43,3,46,0.000404,0.000033,0,844,23,0.000201,1,1,1,18113.268318,0.058454,0.012364
9406154,9406154,,16,2,18,16,2,18,0.000085,0.000013,0,2838,23,0.000059,6,0.245652,0.277139,1622.31338,0.117647,0.00457
9407078,9407078,,39,3,42,39,3,42,0.000311,0.000045,0,2837,23,0.000096,6,0.246187,0.281563,4273.059911,0.070848,0.010595
9501065,9501065,,33,6,39,33,6,39,0.000678,0.00013,0,2448,0,0.000086,6,0.25641,0.309583,5757.166745,0.072874,0.009994
9603181,9603181,,14,5,19,14,5,19,0.000285,0.000054,0,2836,0,0.000032,8,0.208048,0.23447,2570.347533,0.140351,0.004492
9203026,9203026,,19,0,19,19,0,19,0.000973,0,0,2197,4,0.000058,0,0,0,0,0.040936,0.005777
9312096,9312096,,3,0,3,3,0,3,0.000231,0,0,5864,4,0.000013,0,0,0,0,0,0.000882
9401103,9401103,,2,1,3,2,1,3,0.000232,0,0,1276,52,0.000021,1,1,1,390.329324,0.166667,0.001101
9405035,9405035,,23,1,24,23,1,24,0.001077,0.00002,0,738,4,0.000053,1,1,1,187.417017,0.07971,0.008274
9601044,9601044,,6,12,18,6,12,18,0.000491,0.003061,0,5863,0,0.000013,10,0.207281,0.242681,681.638693,0.179739,0.001974
9610229,9610229,,3,12,15,3,12,15,0.000304,0.000217,0,5862,5,0.000011,11,0.187835,0.214657,130977.226308,0.119048,0.000901
9711074,9711074,,3,13,16,3,13,16,0.000341,0.002508,0,6006,0,0.000011,15,0.194482,0.225553,372.204836,0.158333,0.000791
9605105,9605105,,5,8,13,5,8,13,0.000543,0.000014,0,4235,52,0.000013,7,0.244156,0.324037,93347.069696,0.198718,0.001856
9609082,9609082,,5,35,40,5,35,40,0.000948,0.006921,0,2685,0,0.000013,10,0.230254,0.273601,13305.927496,0.162821,0.00266
9609084,9609084,,18,50,68,18,50,68,0.002612,0.010128,0,2149,13,0.000032,13,0.229056,0.282906,46664.217554,0.118086,0.008918
9711026,9711026,,1,0,1,1,0,1,0.000537,0,0,6226,0,0.00001,0,0,0,0,0,0.000938
9712150,9712150,,5,57,62,5,57,62,0.001299,0.012466,0,5197,13,0.000012,13,0.1995,0.243953,72293.241173,0.123744,0.002749
9205043,9205043,,26,0,26,26,0,26,0.000576,0,0,899,23,0.000268,0,0,0,0,0.044615,0.006645
9601030,9601030,,11,2,13,11,2,13,0.00002,0.000007,0,4323,23,0.000037,1,1,1,4339.126311,0.141026,0.003133
9612103,9612103,,34,5,39,34,5,39,0.000781,0.000123,0,4324,23,0.000053,12,0.179799,0.205494,28911.847353,0.110661,0.008903
9712008,9712008,,13,5,18,13,5,18,0.000071,0.00009,0,7910,23,0.000028,12,0.179138,0.204308,6270.725812,0.25817,0.003543
9311015,9311015,,47,6,53,47,6,53,0.000714,0.000223,0,735,26,0.000137,5,0.272189,0.36558,3570.596044,0.076923,0.013436
9509020,9509020,,24,11,35,24,11,35,0.000464,0.000059,0,4435,26,0.000071,6,0.262712,0.400806,19055.864377,0.09916,0.006398
9512106,9512106,,11,5,16,11,5,16,0.00018,0.00004,0,6850,26,0.000031,6,0.255814,0.337013,11244.298892,0.145833,0.002808
9803035,9803035,,3,2,5,3,2,5,0.000001,0.00001,0,7945,26,0.000021,7,0.21865,0.28813,2265.685328,0.15,0.000745
9803204,9803204,,5,14,19,5,14,19,0.000385,0.001813,0,7944,26,0.000016,15,0.166736,0.190101,39254.495021,0.169591,0.001346
9804024,9804024,,3,4,7,3,4,7,0.000001,0.000031,0,7943,26,0.000016,10,0.182107,0.207411,106410.444574,0.119048,0.000725
9212009,9212009,,52,0,52,52,0,52,0.000581,0,0,1776,26,0.000235,0,0,0,0,0.071267,0.014504
9302097,9302097,,2,0,2,2,0,2,0,0,0,2112,26,0.000035,0,0,0,0,0,0.000509
9306075,9306075,,14,1,15,14,1,15,0.000029,0,0,5091,23,0.000087,1,1,1,426.879219,0.042857,0.00341
9309128,9309128,,26,0,26,26,0,26,0.000095,0,0,3909,26,0.000093,0,0,0,0,0.063077,0.006941
9311065,9311065,,13,0,13,13,0,13,0.000001,0,0,11281,26,0.000068,0,0,0,0,0.121795,0.003126
9311108,9311108,,10,2,12,10,2,12,0.000028,0.000007,0,5092,26,0.000031,2,0.75,0.833333,6485.825756,0.136364,0.002499
9402092,9402092,,14,1,15,14,1,15,0.000005,0.000001,0,4436,26,0.000065,1,1,1,915.911179,0.042857,0.003554
9403038,9403038,,27,3,30,27,3,30,0.000483,0.000016,0,3907,26,0.000062,3,0.55,0.621212,1243.840495,0.102299,0.007619
9406094,9406094,,18,0,18,18,0,18,0.000003,0,0,5080,26,0.000103,0,0,0,0,0.094771,0.00466
9409019,9409019,,38,2,40,38,2,40,0.000195,0.000008,0,1777,26,0.000103,1,1,1,11292.315797,0.079487,0.010481
9502102,9502102,,9,1,10,9,1,10,0.000002,0.000001,0,7308,26,0.000036,1,1,1,0.916667,0.222222,0.002396
9503002,9503002,,32,30,62,32,30,62,0.000153,0.000422,0,3921,26,0.000088,6,0.321883,0.407115,59282.135261,0.035167,0.008281
9506058,9506058,,3,12,15,3,12,15,0.000001,0.000267,0,7940,26,0.000016,5,0.303867,0.442121,506.194211,0.104762,0.000787
9512179,9512179,,14,13,27,14,13,27,0.000061,0.000039,0,5093,26,0.000033,7,0.253482,0.384537,21009.671861,0.10114,0.003407
9512208,9512208,,3,5,8,3,5,8,0.000001,0.000019,0,7591,26,0.000013,2,0.692308,0.777778,220.769677,0.160714,0.000746
9602006,9602006,,14,7,21,14,7,21,0.000026,0.000019,0,5094,26,0.000032,7,0.234848,0.32107,46858.78771,0.107143,0.003527
9602175,9602175,,10,5,15,10,5,15,0.000001,0,0,7926,26,0.000035,5,0.418182,0.530435,8844.458641,0.17619,0.002493
9604018,9604018,,4,13,17,4,13,17,0.000027,0.000027,0,10964,26,0.000017,7,0.264781,0.386015,12076.487279,0.055147,0.000992
9608043,9608043,,9,7,16,9,7,16,0.000027,0.000002,0,7939,26,0.000023,9,0.189578,0.220424,1875.685474,0.1125,0.002235
9610173,9610173,,1,1,2,1,1,2,0,0,0,11280,26,0.00001,2,0.666667,0.75,404.526015,0,0.000268
9704064,9704064,,17,18,35,17,18,35,0.000016,0.000012,0,7937,26,0.000044,8,0.233839,0.272481,113668.538918,0.064706,0.004001
9704162,9704162,,4,3,7,4,3,7,0.000052,0.000014,0,8032,26,0.000014,7,0.21671,0.277453,126.621382,0.166667,0.001011
9705159,9705159,,11,7,18,11,7,18,0.000027,0.000004,0,7941,26,0.000034,9,0.217847,0.255115,95801.668394,0.114379,0.002625
9709165,9709165,,4,5,9,4,5,9,0.000001,0.000017,0,11279,26,0.000017,8,0.210526,0.293064,238.166392,0.180556,0.000966
9509053,9509053,,2,3,5,2,3,5,0,0.00001,0,11277,26,0.000013,4,0.4,0.533333,8.25,0.25,0.000466
9611096,9611096,,3,1,4,3,1,4,0,0.000003,0,11276,23,0.000044,1,1,1,4.4,0.166667,0.000725
9610065,9610065,,4,10,14,4,10,14,0.000146,0.001994,0,5785,4,0.000014,12,0.182013,0.215158,12027.083329,0.236264,0.001124
9708129,9708129,,12,7,19,12,7,19,0.001674,0.003318,0,5165,2,0.000017,15,0.177983,0.203463,1461.941582,0.233918,0.003884
2022,2022,,4,2,6,4,2,6,0.000078,0,0,11285,23,0.000025,2,0.75,0.833333,2684.465486,0.133333,0.000935
9412177,9412177,,3,1,4,3,1,4,0,0,0,5040,23,0.000026,1,1,1,513.246369,0.166667,0.000691
9712229,9712229,,3,0,3,3,0,3,0,0,0,11284,23,0.000032,0,0,0,0,0.5,0.000697
9408032,9408032,,4,0,4,4,0,4,0,0,0,5039,23,0.000045,0,0,0,0,0.25,0.000916
2023,2023,,45,11,56,45,11,56,0.002473,0.002709,0,11286,3,0.00004,13,0.198909,0.219734,29213.780492,0.111364,0.01376
2024,2024,,2,4,6,2,4,6,0.000198,0.000009,0,11296,1,0.000011,9,0.177398,0.196603,272.749568,0.166667,0.000522
9805174,9805174,,3,4,7,3,4,7,0.00001,0.00007,0,11291,1,0.000019,5,0.282609,0.348718,5879.181994,0,0.000827
9810228,9810228,,6,4,10,6,4,10,0.000061,0.00007,0,11288,1,0.000025,2,0.7,0.785714,824.967065,0.211111,0.001562
9812005,9812005,,11,7,18,11,7,18,0.000457,0.000072,0,11295,1,0.000027,8,0.208355,0.232523,5346.261216,0.160131,0.003038
9302046,9302046,,26,1,27,26,1,27,0.000077,0.000022,0,1656,23,0.000135,1,1,1,198.634003,0.034188,0.00649
9504061,9504061,,6,4,10,6,4,10,0.000188,0.000075,0,11290,52,0.000027,4,0.346154,0.418519,3088.268282,0.111111,0.001409
9708150,9708150,,7,1,8,7,1,8,0.000063,0,0,11287,1,0.000027,2,0.6,0.666667,63.742014,0.142857,0.001821
9408073,9408073,,14,2,16,14,2,16,0.000017,0.000024,0,1613,3,0.000114,1,1,1,478.426409,0.075,0.00364
9809142,9809142,,4,6,10,4,6,10,0.000011,0.000176,0,11294,3,0.000018,7,0.255548,0.285639,3149.234613,0.111111,0.00113
9811030,9811030,,5,3,8,5,3,8,0.000062,0.000004,0,11292,1,0.000018,6,0.235294,0.295536,1399.261029,0.267857,0.001412
2025,2025,,6,14,20,6,14,20,0.001288,0.018058,0,11297,1,0.000013,11,0.227971,0.257462,3659.830342,0.321053,0.002285
9602054,9602054,,5,6,11,5,6,11,0.000706,0.000103,0,7557,41,0.000016,11,0.172424,0.206361,9878.071754,0.136364,0.001811
9305012,9305012,,6,0,6,6,0,6,0.000185,0,0,3248,41,0.000039,0,0,0,0,0.1,0.001644
9305131,9305131,,15,1,16,15,1,16,0.00082,0,0,3247,41,0.000082,1,1,1,4079.299636,0.079167,0.003954
9404150,9404150,,6,0,6,6,0,6,0.000038,0,0,3241,41,0.000034,0,0,0,0,0.166667,0.002182
9306107,9306107,,11,0,11,11,0,11,0.000192,0,0,3251,41,0.000076,0,0,0,0,0.072727,0.003018
9308073,9308073,,8,0,8,8,0,8,0.000002,0,0,7556,6,0.000053,0,0,0,0,0.053571,0.002202
9506116,9506116,,13,6,19,13,6,19,0.000515,0.000463,0,3252,41,0.000038,7,0.225597,0.268441,28043.058041,0.076023,0.004016
9808067,9808067,,2,5,7,2,5,7,0.000219,0.004771,0,7595,26,0.000012,15,0.170497,0.188457,403175.294681,0.238095,0.000875
2026,2026,,3,8,11,3,8,11,0,0.000002,0,11300,23,0.000012,10,0.19349,0.252037,15.183802,0.181818,0.000664
9504015,9504015,,11,1,12,11,1,12,0.000103,0,0,2174,10,0.00003,1,1,1,402.789586,0.068182,0.002755
9801107,9801107,,3,7,10,3,7,10,0,0.000006,0,11299,23,0.000013,9,0.228942,0.298963,363.656699,0.2,0.000677
9209072,9209072,,6,0,6,6,0,6,0,0,0,2173,10,0.000056,0,0,0,0,0.066667,0.001468
9408028,9408028,,8,1,9,8,1,9,0.000001,0,0,11298,23,0.000023,2,0.571429,0.625,9.442532,0.194444,0.001974
2027,2027,,21,9,30,21,9,30,0.001365,0.000634,0,11302,3,0.000027,15,0.16692,0.18979,17715.485192,0.143678,0.006759
9209048,9209048,,3,0,3,3,0,3,0.000023,0,0,11301,3,0.000015,0,0,0,0,0.166667,0.000831
9808049,9808049,,7,21,28,7,21,28,0.000249,0.00089,0,9470,2,0.000015,15,0.175414,0.206067,11766.370249,0.246032,0.001861
9911138,9911138,,12,19,31,12,19,31,0.00057,0.003513,0,9475,2,0.00002,14,0.184216,0.21229,15617.611873,0.152688,0.003353
9912066,9912066,,7,15,22,7,15,22,0.000091,0.000659,0,9474,2,0.000016,16,0.158969,0.187072,27415.15857,0.149351,0.001808
9912077,9912077,,10,9,19,10,9,19,0.000164,0.000239,0,9468,23,0.000014,13,0.181391,0.198986,38355.63761,0.157895,0.00253
2028,2028,,18,32,50,18,32,50,0.002879,0.021029,0,11303,1,0.000022,13,0.225749,0.259,52181.070209,0.128571,0.006769
9306095,9306095,,4,1,5,4,1,5,0.00012,0.00013,0,1118,13,0.000015,1,1,1,2.288601,0.15,0.00125
9206028,9206028,,10,0,10,10,0,10,0.00073,0,0,4351,22,0.000033,0,0,0,0,0.088889,0.003028
9810041,9810041,,11,7,18,11,7,18,0.001146,0.006314,0,8936,1,0.000018,12,0.19641,0.221726,2609.550203,0.111111,0.003703
2029,2029,,5,47,52,5,47,52,0.000176,0.007538,0,11319,2,0.000017,12,0.228676,0.259825,49527.645575,0.077677,0.001136
9510152,9510152,,3,4,7,3,4,7,0.000093,0.000003,0,6965,9,0.000016,7,0.235149,0.290752,19356.9713,0.119048,0.000764
9606090,9606090,,4,8,12,4,8,12,0.000694,0.000369,0,10910,28,0.000011,10,0.19479,0.216533,11070.002834,0.037879,0.000966
9706148,9706148,,19,19,38,19,19,38,0.001128,0.001723,0,4697,0,0.000022,13,0.216026,0.248394,19102.976225,0.11522,0.005036
9901027,9901027,,2,14,16,2,14,16,0.000092,0.003043,0,11318,0,0.000011,12,0.197652,0.225259,1942.260589,0.083333,0.0005
9901104,9901104,,7,14,21,7,14,21,0.000693,0.008909,0,11013,0,0.000014,13,0.194227,0.219241,6089.371182,0.192857,0.002038
9907109,9907109,,10,10,20,10,10,20,0.000379,0.005974,0,11317,2,0.000018,14,0.186395,0.208969,8104.066163,0.073684,0.002367
9912206,9912206,,10,41,51,10,41,51,0.000423,0.004258,0,11314,0,0.000014,14,0.189815,0.2205,21956.162324,0.131373,0.002395
9301024,9301024,,17,0,17,17,0,17,0.00003,0,0,3946,9,0.000045,0,0,0,0,0.110294,0.004206
9510033,9510033,,13,4,17,13,4,17,0.000031,0.000002,0,3967,9,0.000029,6,0.269103,0.32037,4561.84483,0.110294,0.003011
9203080,9203080,,13,0,13,13,0,13,0.00015,0,0,1092,28,0.000037,0,0,0,0,0.032051,0.003133
9207042,9207042,,39,0,39,39,0,39,0.000861,0,0,1090,28,0.000107,0,0,0,0,0.025641,0.010583
9404125,9404125,,5,7,12,5,7,12,0.000007,0.000021,0,10909,28,0.000023,1,1,1,259.74582,0.113636,0.001201
9407147,9407147,,7,1,8,7,1,8,0.000081,0,0,8540,4,0.000017,2,0.6,0.666667,8490.061928,0.071429,0.001949
9703012,9703012,,17,10,27,17,10,27,0.001174,0.001637,0,4682,13,0.000022,12,0.206443,0.235572,19875.296966,0.106838,0.005174
9704040,9704040,,9,34,43,9,34,43,0.000215,0.002,0,4693,28,0.000018,11,0.209146,0.24383,98244.95442,0.079734,0.002565
9707215,9707215,,21,22,43,21,22,43,0.0016,0.001681,0,4695,0,0.000031,14,0.195387,0.228122,17270.801468,0.241971,0.006641
9602011,9602011,,12,4,16,12,4,16,0.000228,0.002508,0,3808,2,0.00004,13,0.187882,0.220991,2918.488862,0.0625,0.0035
9710141,9710141,,20,22,42,20,22,42,0.001303,0.003375,0,5375,0,0.000025,14,0.192784,0.227615,6525.877095,0.215447,0.006017
9802009,9802009,,4,24,28,4,24,28,0.000107,0.001917,0,6812,2,0.000013,14,0.193167,0.226547,3668.28284,0.145503,0.001061
9807195,9807195,,2,26,28,2,26,28,0.000047,0.030226,0,10796,1,0.000012,13,0.226996,0.26966,4787.664979,0.14418,0.000488
9803188,9803188,,27,22,49,27,22,49,0.001745,0.009421,0,8169,0,0.000043,14,0.194253,0.223765,57958.811108,0.181122,0.007928
9810025,9810025,,23,9,32,23,9,32,0.001531,0.006769,0,8856,0,0.000034,12,0.191992,0.214669,45579.421133,0.181452,0.006622
9809109,9809109,,12,12,24,12,12,24,0.000267,0.001235,0,10636,1,0.000031,13,0.182376,0.201663,62926.022062,0.096014,0.002977
9904022,9904022,,1,1,2,1,1,2,0.00007,0,0,11316,2,0.000011,1,1,1,1541,0,0.000286
9908147,9908147,,1,32,33,1,32,33,0.00005,0.002876,0,11313,0,0.00001,15,0.191525,0.225288,1311.734934,0.249053,0.000287
9911156,9911156,,5,32,37,5,32,37,0.000365,0.003178,0,11312,0,0.000013,14,0.203517,0.236706,20632.136814,0.11036,0.002379
9912108,9912108,,17,20,37,17,20,37,0.001113,0.003354,0,11308,0,0.000017,14,0.196666,0.220738,40247.379723,0.160661,0.006652
2030,2030,,4,34,38,4,34,38,0.000427,0.014057,0,11321,41,0.00002,12,0.220667,0.249723,38668.171467,0.142248,0.003207
9903157,9903157,,1,35,36,1,35,36,0.000165,0.014514,0,11320,1,0.00001,14,0.205856,0.239267,1234.282481,0.128571,0.000276
9905118,9905118,,9,34,43,9,34,43,0.001855,0.02465,0,9384,1,0.000013,14,0.210504,0.244032,11172.509511,0.153378,0.002422
9907022,9907022,,20,31,51,20,31,51,0.002854,0.019031,0,9395,1,0.00002,14,0.198155,0.227204,23454.879232,0.108235,0.005435
9612248,9612248,,13,32,45,13,32,45,0.001797,0.001968,0,3373,13,0.00002,11,0.213445,0.25603,134052.803506,0.101515,0.004725
9702086,9702086,,10,42,52,10,42,52,0.000626,0.007081,0,2830,13,0.000021,12,0.209537,0.251143,74398.904358,0.087858,0.003485
9709005,9709005,,9,6,15,9,6,15,0.000527,0.002142,0,6164,30,0.000017,15,0.17387,0.198183,630.836864,0.295238,0.002557
9710030,9710030,,11,19,30,11,19,30,0.001016,0.005402,0,6206,2,0.000019,12,0.202833,0.23256,253960.166544,0.145977,0.003548
9802152,9802152,,9,15,24,9,15,24,0.00092,0.004364,0,7334,2,0.000014,16,0.178257,0.212551,2700.921081,0.25,0.002649
9801158,9801158,,9,19,28,9,19,28,0.000831,0.003091,0,6891,2,0.000015,13,0.192301,0.223552,2377.499811,0.160053,0.003096
9807050,9807050,,5,30,35,5,30,35,0.000853,0.00268,0,9394,2,0.000011,13,0.189651,0.221612,1343.254093,0.14958,0.001326
2031,2031,,1,13,14,1,13,14,0.000117,0.014319,0,11322,1,0.00001,12,0.19742,0.219781,6.675512,0.230769,0.000219
9910082,9910082,,17,22,39,17,22,39,0.002096,0.015316,0,10533,1,0.000034,11,0.229882,0.26274,27463.031162,0.103239,0.00442
9802041,9802041,,5,34,39,5,34,39,0.00024,0.007554,0,7035,0,0.000026,12,0.213181,0.252101,166833.287677,0.159919,0.00239
9904005,9904005,,8,19,27,8,19,27,0.000973,0.002551,0,10532,13,0.000015,12,0.197581,0.227838,3698.6212,0.188034,0.002281
9907030,9907030,,19,11,30,19,11,30,0.002453,0.002523,0,10531,13,0.000023,14,0.175068,0.204797,5802.525658,0.149425,0.00522
9909056,9909056,,30,13,43,30,13,43,0.003554,0.019147,0,10530,1,0.000047,11,0.226016,0.255861,29492.892331,0.136213,0.008421
2032,2032,,1,16,17,1,16,17,0.000069,0.007156,0,11327,1,0.00001,15,0.185729,0.215591,9795.609053,0.1875,0.000361
9902209,9902209,,3,9,12,3,9,12,0.000107,0.002035,0,11326,4,0.000014,18,0.158492,0.186225,8819.984193,0.159091,0.000666
9310200,9310200,,29,1,30,29,1,30,0.000131,0.000017,0,1324,9,0.00011,5,0.338843,0.371545,137.933781,0.124138,0.009117
9311139,9311139,,23,3,26,23,3,26,0.000087,0.000022,0,1325,9,0.000078,5,0.349593,0.400775,4370.079227,0.147692,0.007169
9312013,9312013,,16,8,24,16,8,24,0.000124,0.000003,0,1336,9,0.000068,4,0.389831,0.481884,73269.821201,0.117754,0.005861
9403150,9403150,,13,10,23,13,10,23,0.000277,0.000035,0,1340,9,0.000037,5,0.402778,0.48908,38611.607486,0.179842,0.004881
9404109,9404109,,5,10,15,5,10,15,0.000012,0.000082,0,835,0,0.000038,3,0.642857,0.759259,53512.012101,0.057143,0.002307
9405039,9405039,,2,6,8,2,6,8,0.000009,0.000046,0,1342,9,0.000021,5,0.359477,0.432121,44.284376,0.25,0.001515
9405144,9405144,,12,12,24,12,12,24,0.000031,0.000056,0,1341,9,0.000034,5,0.396226,0.493122,31370.01149,0.17029,0.004069
9405174,9405174,,5,3,8,5,3,8,0.000012,0.000101,0,836,0,0.000031,4,0.446809,0.511905,737.096169,0.160714,0.002282
9804147,9804147,,7,1,8,7,1,8,0.000762,0.000468,0,6106,1,0.000027,1,1,1,1.618687,0.089286,0.002271
9202061,9202061,,14,0,14,14,0,14,0.001239,0,0,1072,10,0.000068,0,0,0,0,0.093407,0.004925
9211019,9211019,,2,3,5,2,3,5,0.000358,0.000004,0,6647,9,0.000012,1,1,1,15277.570178,0.2,0.001394
9303133,9303133,,16,1,17,16,1,17,0.000986,0,0,1053,9,0.000044,2,0.555556,0.6,14706.795951,0.077206,0.005469
9306096,9306096,,33,1,34,33,1,34,0.00224,0,0,644,0,0.000068,1,1,1,4785.192042,0.058824,0.012541
9707236,9707236,,8,21,29,8,21,29,0.000888,0.004795,0,5245,2,0.000017,11,0.209192,0.243544,28249.23026,0.107143,0.00359
9804173,9804173,,5,17,22,5,17,22,0.000863,0.004692,0,6630,13,0.000017,13,0.188521,0.218848,3696.1102,0.238095,0.003057
9804200,9804200,,7,39,46,7,39,46,0.001718,0.026282,0,6639,2,0.000013,14,0.205912,0.244201,11780.925612,0.145894,0.00294
9804201,9804201,,7,16,23,7,16,23,0.002197,0.004393,0,6643,2,0.000013,16,0.183741,0.217203,10641.036539,0.158103,0.003573
9811107,9811107,,6,38,44,6,38,44,0.000885,0.013236,0,7494,13,0.000013,11,0.211366,0.247491,22636.543326,0.131607,0.002003
9510062,9510062,,1,1,2,1,1,2,0.000024,0,0,11325,4,0.000011,1,1,1,2264,0,0.000239
9806204,9806204,,4,23,27,4,23,27,0.000127,0.002498,0,9420,4,0.000017,17,0.169685,0.19979,17949.964133,0.182336,0.001211
9810127,9810127,,2,3,5,2,3,5,0.000046,0.000038,0,11323,4,0.000013,18,0.148507,0.167153,575.58496,0.35,0.000458
2033,2033,,5,4,9,5,4,9,0.000209,0.0006,0,11328,25,0.000012,12,0.17216,0.18569,40.779116,0.236111,0.001493
2034,2034,,50,71,121,50,71,121,0.000357,0.000052,0,11368,20,0.000073,12,0.195534,0.219362,493465.572856,0.054132,0.012326
9312114,9312114,,62,0,62,62,0,62,0.000025,0,0,3035,20,0.00027,0,0,0,0,0.071655,0.018425
9403074,9403074,,11,0,11,11,0,11,0.000079,0,0,3034,20,0.000063,0,0,0,0,0.136364,0.003896
9403164,9403164,,9,1,10,9,1,10,0.000001,0.000002,0,5199,20,0.000029,1,1,1,8.664716,0.155556,0.002636
9411122,9411122,,53,2,55,53,2,55,0.000079,0.000002,0,3041,20,0.000146,1,1,1,65.705558,0.114478,0.015768
9412195,9412195,,46,4,50,46,4,50,0.0001,0.000004,0,3038,20,0.000114,1,1,1,11158.681724,0.09551,0.013532
9511046,9511046,,16,6,22,16,6,22,0.000003,0.000004,0,4166,20,0.000023,3,0.576923,0.677778,5385.07085,0.205628,0.004568
9512086,9512086,,15,18,33,15,18,33,0.000005,0.000008,0,5208,20,0.000035,6,0.261194,0.344381,11318.786434,0.13447,0.004547
9604125,9604125,,9,17,26,9,17,26,0.000026,0.000008,0,11353,20,0.000018,7,0.226293,0.304252,1673.24963,0.143077,0.002558
9604192,9604192,,1,6,7,1,6,7,0.000001,0.000003,0,11367,20,0.000011,8,0.186726,0.234084,156.430942,0.285714,0.000562
9609040,9609040,,13,9,22,13,9,22,0.000003,0.000005,0,9768,20,0.000025,9,0.210555,0.2529,12969.795214,0.203463,0.004086
9609236,9609236,,3,2,5,3,2,5,0.000056,0.000002,0,11364,20,0.000012,7,0.208284,0.244751,87.272503,0.3,0.001031
9611019,9611019,,9,5,14,9,5,14,0.000002,0.000022,0,9274,28,0.000041,4,0.529412,0.615741,5811.348775,0.115385,0.002638
9611038,9611038,,6,8,14,6,8,14,0.000002,0.00001,0,9765,20,0.000017,5,0.442105,0.526587,8016.293507,0.225275,0.00228
9701028,9701028,,27,5,32,27,5,32,0.000005,0.000003,0,5200,20,0.000049,2,0.631579,0.708333,13985.098092,0.160282,0.008064
9702082,9702082,,9,17,26,9,17,26,0.000003,0.00001,0,5215,20,0.000019,7,0.223392,0.306071,11225.412153,0.203077,0.002848
9704094,9704094,,11,9,20,11,9,20,0.000003,0.000004,0,5213,20,0.000024,8,0.192771,0.251004,1965.654154,0.294737,0.003658
9704202,9704202,,29,15,44,29,15,44,0.000167,0.000004,0,5217,20,0.000043,7,0.232179,0.30472,102688.719736,0.122093,0.007861
9705088,9705088,,9,19,28,9,19,28,0.000086,0.000023,0,6652,20,0.000022,18,0.1406,0.180799,151576.967663,0.146825,0.002866
9705129,9705129,,20,6,26,20,6,26,0.000076,0.000003,0,9796,20,0.000034,7,0.219262,0.270338,855.445773,0.147692,0.005809
9707094,9707094,,14,6,20,14,6,20,0.000014,0.000007,0,9792,20,0.000026,6,0.385417,0.476126,71.180714,0.263158,0.004225
9708124,9708124,,4,3,7,4,3,7,0.000001,0,0,11366,20,0.000012,1,1,1,1.95,0.380952,0.001265
9709060,9709060,,3,2,5,3,2,5,0.000001,0,0,11347,20,0.000013,1,1,1,22.302751,0.3,0.001082
9712038,9712038,,8,8,16,8,8,16,0.000001,0.000003,0,11349,20,0.000019,19,0.128923,0.162278,3787.332573,0.175,0.002337
9801124,9801124,,3,30,33,3,30,33,0.000001,0.000016,0,11365,20,0.000013,19,0.131826,0.178219,347.902011,0.171402,0.001007
9802064,9802064,,26,15,41,26,15,41,0.000026,0.000007,0,9771,20,0.000043,10,0.183989,0.233113,31458.054782,0.134756,0.00743
9802196,9802196,,9,11,20,9,11,20,0.000032,0.000009,0,9794,20,0.000019,15,0.16766,0.185592,35438.793445,0.223684,0.00271
9803056,9803056,,19,10,29,19,10,29,0.000015,0.000007,0,10563,20,0.000046,8,0.194894,0.255713,725.148622,0.146552,0.005141
9803173,9803173,,3,17,20,3,17,20,0.000001,0.000007,0,11354,20,0.000013,16,0.15458,0.173264,10592.655689,0.171053,0.00112
9809020,9809020,,9,3,12,9,3,12,0.000002,0.000002,0,9772,20,0.000025,11,0.155946,0.182655,7840.050666,0.310606,0.002817
9810117,9810117,,11,13,24,11,13,24,0.000022,0.000025,0,9809,20,0.000019,16,0.15154,0.169956,11013.187749,0.221014,0.003138
9811055,9811055,,2,6,8,2,6,8,0.000001,0.000005,0,11362,20,0.000013,16,0.144792,0.157602,2105.137503,0.375,0.000938
9811151,9811151,,6,9,15,6,9,15,0.000002,0.000007,0,11341,20,0.000017,19,0.128975,0.162665,1449.380901,0.27619,0.001933
9901063,9901063,,21,16,37,21,16,37,0.000023,0.000013,0,11363,20,0.000031,16,0.151966,0.171054,8360.99043,0.157658,0.00605
9902064,9902064,,20,6,26,20,6,26,0.000042,0.000002,0,11361,28,0.000056,11,0.153964,0.187112,26305.139152,0.06,0.00503
9905206,9905206,,12,18,30,12,18,30,0.000002,0.000008,0,11355,20,0.000023,16,0.154046,0.172732,29309.131215,0.175862,0.003668
9906166,9906166,,13,18,31,13,18,31,0.000005,0.000011,0,11342,20,0.000024,19,0.142001,0.183075,15749.645783,0.14086,0.003607
9907027,9907027,,15,8,23,15,8,23,0.000212,0.00001,0,11332,20,0.000023,8,0.21,0.255972,64423.488563,0.209486,0.004168
9908043,9908043,,7,13,20,7,13,20,0.000018,0.000011,0,10565,20,0.000018,9,0.209169,0.257107,5863.342155,0.228947,0.002243
9908062,9908062,,9,1,10,9,1,10,0.000042,0,0,10564,20,0.000018,9,0.163701,0.193451,4012.016429,0.155556,0.002846
9912215,9912215,,3,6,9,3,6,9,0.000001,0.000003,0,11330,20,0.000013,10,0.178776,0.213758,2439.960542,0.236111,0.001128
5245,5245,,21,7,28,21,7,28,0.000005,0.000003,0,11369,20,0.000026,17,0.142317,0.157849,1317.085147,0.186508,0.005433
8123,8123,,24,16,40,24,16,40,0.000829,0.000084,0,11380,20,0.000028,13,0.17121,0.186913,21099.655773,0.11859,0.005682
2231,2231,,13,10,23,13,10,23,0.000028,0.000006,0,11379,20,0.000022,16,0.135489,0.147553,540.356848,0.112648,0.003511
6064,6064,,23,29,52,23,29,52,0.000472,0.000358,0,11376,20,0.000029,12,0.197908,0.219875,203110.30608,0.088612,0.005719
9110,9110,,18,13,31,18,13,31,0.000127,0.000022,0,11381,20,0.000022,13,0.168652,0.182644,35770.876136,0.168817,0.0045
9601081,9601081,,20,2,22,20,2,22,0.000017,0.000002,0,5203,20,0.000038,2,0.583333,0.642857,6.553369,0.160173,0.005698
103195,103195,,21,13,34,21,13,34,0.000003,0.000016,0,11382,20,0.000036,13,0.164915,0.178568,31140.576763,0.152406,0.005073
9401104,9401104,,3,0,3,3,0,3,0.000053,0,0,573,20,0.000036,0,0,0,0,0,0.001464
9310198,9310198,,19,0,19,19,0,19,0.000045,0,0,3238,20,0.000173,0,0,0,0,0.05848,0.004831
9310042,9310042,,26,1,27,26,1,27,0.000014,0.000001,0,3047,20,0.000079,1,1,1,6098.379819,0.065527,0.007683
9408132,9408132,,8,0,8,8,0,8,0.000001,0,0,3045,20,0.00003,0,0,0,0,0.071429,0.002569
9404086,9404086,,1,0,1,1,0,1,0,0,0,4168,20,0.000022,0,0,0,0,0,0.000509
9303072,9303072,,12,2,14,12,2,14,0.000001,0.000001,0,4134,22,0.000043,1,1,1,12281,0.153846,0.00332
9403117,9403117,,12,1,13,12,1,13,0.000002,0.000001,0,4132,22,0.000046,1,1,1,35.610209,0.147436,0.003466
9411227,9411227,,3,3,6,3,3,6,0,0.000002,0,4131,20,0.00002,2,0.8,0.875,131.930189,0.066667,0.000828
9503021,9503021,,6,8,14,6,8,14,0.000006,0.000015,0,1030,13,0.000023,5,0.297468,0.349645,21220.744781,0.087912,0.001552
9505003,9505003,,6,2,8,6,2,8,0.000001,0.000001,0,4171,20,0.000015,3,0.454545,0.511111,498.808958,0.214286,0.001707
9507098,9507098,,1,7,8,1,7,8,0,0.000006,0,5205,20,0.000015,3,0.607143,0.696078,7023.390398,0.321429,0.000567
9411226,9411226,,5,1,6,5,1,6,0.000002,0.000001,0,5993,20,0.000031,1,1,1,0,0.266667,0.001221
9503230,9503230,,21,0,21,21,0,21,0,0,0,9014,20,0.000233,0,0,0,0,0.042857,0.005465
9511073,9511073,,5,5,10,5,5,10,0,0.000003,0,5351,20,0.000023,2,0.631579,0.708333,6678.34321,0.166667,0.001249
9305172,9305172,,7,1,8,7,1,8,0.000002,0.000006,0,3643,20,0.000041,1,1,1,157.03294,0.035714,0.001981
9306078,9306078,,3,3,6,3,3,6,0,0,0,4179,17,0.000045,2,0.8,0.875,24363.695868,0.166667,0.000969
9501056,9501056,,14,5,19,14,5,19,0.00001,0.000016,0,4186,5,0.000027,3,0.5,0.611111,25575.72272,0.187135,0.003878
9501083,9501083,,15,2,17,15,2,17,0.000124,0.000004,0,4182,17,0.000062,3,0.466667,0.571429,8802.73245,0.044118,0.003869
9502109,9502109,,8,4,12,8,4,12,0.00001,0.000012,0,4174,5,0.000021,1,1,1,9424.697863,0.037879,0.002245
9411154,9411154,,6,3,9,6,3,9,0.000003,0.000019,0,9767,28,0.000025,1,1,1,386.060539,0.208333,0.001501
9609019,9609019,,8,12,20,8,12,20,0.000002,0.000037,0,9766,20,0.000021,8,0.243214,0.307637,6702.791391,0.118421,0.002051
9511051,9511051,,10,1,11,10,1,11,0.000178,0.000002,0,9453,26,0.00007,2,0.6,0.666667,7552.381987,0.118182,0.002359
9507093,9507093,,18,6,24,18,6,24,0.000005,0.000004,0,5216,20,0.000036,2,0.75,0.833333,915.240827,0.085145,0.004415
9411019,9411019,,9,0,9,9,0,9,0.00007,0,0,3237,20,0.000033,0,0,0,0,0.222222,0.00238
9511090,9511090,,13,4,17,13,4,17,0.000088,0.00004,0,3239,20,0.000032,5,0.309091,0.36634,13718.996307,0.128676,0.003355
9602123,9602123,,4,6,10,4,6,10,0.000003,0.000083,0,3253,20,0.000018,10,0.176184,0.208626,3089.79612,0.211111,0.001112
9610040,9610040,,5,3,8,5,3,8,0.000039,0.000011,0,5966,20,0.000014,5,0.307692,0.35609,1395.848449,0.178571,0.001414
9611132,9611132,,5,11,16,5,11,16,0.000211,0.000173,0,3257,20,0.000017,10,0.192308,0.243486,108439.172194,0.095833,0.001796
9610143,9610143,,2,6,8,2,6,8,0,0.000002,0,9802,20,0.000013,3,0.538462,0.666667,10078.688452,0.089286,0.000616
9511140,9511140,,1,0,1,1,0,1,0,0,0,9770,20,0.000012,0,0,0,0,0,0.000412
9605037,9605037,,5,6,11,5,6,11,0.000001,0.000003,0,9769,20,0.000016,5,0.396694,0.469444,532.558459,0.181818,0.001471
9607118,9607118,,3,4,7,3,4,7,0,0.000003,0,7113,23,0.000026,3,0.636364,0.761905,4260.993543,0.166667,0.001083
9404155,9404155,,4,0,4,4,0,4,0.000069,0,0,3255,20,0.000015,0,0,0,0,0.083333,0.001006
9611003,9611003,,12,10,22,12,10,22,0.000071,0.000009,0,7383,23,0.000033,7,0.237476,0.27272,36487.937875,0.04329,0.002898
9802113,9802113,,7,17,24,7,17,24,0.000002,0.000053,0,9791,20,0.000015,14,0.197955,0.226972,90431.950083,0.164855,0.001814
9605024,9605024,,4,8,12,4,8,12,0.000002,0.000003,0,11352,20,0.000013,3,0.64,0.739583,253.071404,0.204545,0.001022
9712147,9712147,,8,8,16,8,8,16,0.000001,0.000012,0,11348,20,0.000018,15,0.178167,0.203584,76512.400431,0.083333,0.002014
9505101,9505101,,7,3,10,7,3,10,0.000001,0.000003,0,9805,23,0.000025,3,0.5,0.611111,2101.057648,0.122222,0.001797
9605137,9605137,,3,0,3,3,0,3,0,0,0,9804,20,0.000014,0,0,0,0,0.166667,0.000793
9612226,9612226,,4,1,5,4,1,5,0.000001,0,0,9797,20,0.000018,2,0.666667,0.75,308.257605,0.2,0.001324
9705146,9705146,,4,15,19,4,15,19,0.000001,0.000011,0,9795,20,0.000014,7,0.221992,0.293703,727.146726,0.236842,0.001398
9210046,9210046,,12,0,12,12,0,12,0.000832,0,0,2552,23,0.000034,0,0,0,0,0.007576,0.003273
9707189,9707189,,20,15,35,20,15,35,0.000048,0.000048,0,9746,28,0.000045,11,0.174414,0.225077,46036.491841,0.089076,0.005179
9710062,9710062,,13,2,15,13,2,15,0.000001,0,0,9275,28,0.000042,4,0.395833,0.451754,1609.005186,0.095238,0.00327
9802167,9802167,,10,1,11,10,1,11,0.00004,0,0,11360,28,0.000041,1,1,1,2377.838363,0.127273,0.002436
9807031,9807031,,6,6,12,6,6,12,0.00004,0.000002,0,11358,28,0.000025,11,0.155281,0.18488,6967.094722,0.189394,0.001506
9902144,9902144,,3,1,4,3,1,4,0,0.000001,0,11351,20,0.000012,2,0.6,0.666667,0.611111,0.166667,0.000791
9903173,9903173,,6,6,12,6,6,12,0,0.000001,0,11350,20,0.000016,16,0.154323,0.171374,6537.666688,0.159091,0.00158
9812050,9812050,,2,3,5,2,3,5,0,0,0,11340,20,0.000012,11,0.156808,0.176134,11365.572971,0.15,0.000533
9404171,9404171,,24,3,27,24,3,27,0.000418,0.000025,0,4184,5,0.000054,2,0.636364,0.714286,4938.928474,0.079772,0.006172
9612019,9612019,,15,15,30,15,15,30,0.000005,0.000012,0,9789,20,0.000028,8,0.228923,0.287873,68294.394868,0.110345,0.004084
9705008,9705008,,8,5,13,8,5,13,0.000002,0.000003,0,11331,20,0.000018,8,0.210214,0.251503,4614.400201,0.307692,0.002239
9707239,9707239,,12,5,17,12,5,17,0.000003,0.000004,0,9778,20,0.000022,8,0.202284,0.24892,6386.2081,0.231618,0.003191
9607181,9607181,,5,0,5,5,0,5,0.00001,0,0,10566,20,0.000017,0,0,0,0,0.1,0.00152
9908042,9908042,,5,10,15,5,10,15,0.000013,0.00001,0,11329,20,0.000015,6,0.420455,0.548198,18.445411,0.247619,0.00127
2035,2035,,4,24,28,4,24,28,0.00019,0.010108,0,11386,2,0.000012,17,0.206553,0.240436,26475.72519,0.070106,0.001063
9608082,9608082,,16,4,20,16,4,20,0.000536,0.000012,0,3888,2,0.000038,10,0.207118,0.238617,24311.428715,0.065789,0.004582
9710210,9710210,,8,5,13,8,5,13,0.000517,0.000001,0,6458,2,0.00002,11,0.172508,0.191702,49546.650641,0.057692,0.002091
9903057,9903057,,17,12,29,17,12,29,0.001384,0.001328,0,8257,2,0.000025,12,0.192213,0.216664,26925.788925,0.068966,0.005274
9903111,9903111,,7,5,12,7,5,12,0.000305,0.001069,0,11385,2,0.000022,13,0.177016,0.197885,3406.993447,0.121212,0.002006
9911158,9911158,,9,14,23,9,14,23,0.000165,0.000358,0,11384,28,0.000017,13,0.178288,0.201505,18444.811373,0.160079,0.002362
9207107,9207107,,2,0,2,2,0,2,0.000004,0,0,498,5,0.000028,0,0,0,0,0,0.000991
9305152,9305152,,3,1,4,3,1,4,0.000004,0.000001,0,497,6,0.000044,1,1,1,7359.64896,0.166667,0.001239
9309052,9309052,,13,3,16,13,3,16,0.000337,0.00007,0,1319,2,0.000051,1,1,1,1454.954411,0.045833,0.003475
9412072,9412072,,12,0,12,12,0,12,0.000241,0,0,1947,2,0.000049,0,0,0,0,0.143939,0.003345
9504088,9504088,,5,2,7,5,2,7,0.000002,0.000003,0,3887,2,0.000026,1,1,1,3998.379226,0.309524,0.001429
9506076,9506076,,14,25,39,14,25,39,0.00048,0.005709,0,1950,13,0.000036,9,0.259001,0.323253,39469.714148,0.111336,0.004661
9703160,9703160,,14,11,25,14,11,25,0.001064,0.002713,0,5690,13,0.00003,12,0.2091,0.242848,7506.575783,0.096667,0.004663
9409025,9409025,,10,2,12,10,2,12,0.000001,0,0,6457,6,0.000031,1,1,1,4046.566766,0.022727,0.002391
9605144,9605144,,10,8,18,10,8,18,0.000027,0.000007,0,6446,2,0.000023,7,0.254606,0.292638,42965.514808,0.081699,0.002505
9607064,9607064,,10,13,23,10,13,23,0.000001,0.000012,0,2764,6,0.000024,6,0.338369,0.419494,29994.523631,0.146245,0.002523
9607095,9607095,,3,12,15,3,12,15,0.000001,0.000115,0,6453,2,0.000018,10,0.201526,0.228286,43384.131744,0.066667,0.000798
9509043,9509043,,4,12,16,4,12,16,0.000079,0.000376,0,2430,0,0.000013,9,0.233273,0.273333,787.948735,0.1875,0.001512
9703198,9703198,,13,27,40,13,27,40,0.000888,0.004753,0,5851,0,0.000017,12,0.218923,0.262706,4423.091997,0.117949,0.003696
9707075,9707075,,12,70,82,12,70,82,0.001481,0.014233,0,5052,0,0.000015,11,0.230178,0.276238,21836.837615,0.125414,0.003954
9712254,9712254,,9,4,13,9,4,13,0.000287,0.000017,0,6455,2,0.000027,12,0.159575,0.180213,35463.508429,0.108974,0.002761
9904026,9904026,,8,10,18,8,10,18,0.000057,0.015787,0,11383,28,0.000018,15,0.186642,0.211887,13245.289053,0.196078,0.00193
2037,2037,,52,17,69,52,17,69,0.002187,0.001806,0,11388,52,0.000034,14,0.191063,0.217599,13219.45668,0.113598,0.017555
9606192,9606192,,4,11,15,4,11,15,0.00014,0.002401,0,3461,4,0.000015,11,0.177317,0.197105,93.550563,0.209524,0.001814
9908009,9908009,,4,6,10,4,6,10,0.000124,0.000841,0,11387,3,0.000014,14,0.188029,0.208779,4943.902687,0.233333,0.00234
9804075,9804075,,1,10,11,1,10,11,0.000019,0.000164,0,8549,0,0.000011,16,0.167709,0.195853,199.586157,0.290909,0.000314
2038,2038,,5,19,24,5,19,24,0.000001,0.000029,0,11378,20,0.000014,15,0.155801,0.173207,7489.664734,0.193841,0.00123
9708051,9708051,,10,9,19,10,9,19,0.000003,0.000008,0,11377,20,0.000018,4,0.470588,0.580729,262.717576,0.146199,0.002488
2039,2039,,8,18,26,8,18,26,0.001837,0.019798,0,11389,1,0.000015,11,0.227965,0.25852,5090.427502,0.333846,0.003351
9907129,9907129,,11,13,24,11,13,24,0.001855,0.019531,0,9596,1,0.000027,11,0.226289,0.256225,14354.413476,0.224638,0.004531
2041,2041,,2,1,3,2,1,3,0,0,0,11390,28,0.000016,16,0.121293,0.129765,0,0.333333,0.000438
9901036,9901036,,2,1,3,2,1,3,0,0.000001,0,10146,28,0.000027,2,0.666667,0.75,5563.673567,0.166667,0.000466
9906091,9906091,,3,3,6,3,3,6,0,0.001881,0,10145,28,0.00003,14,0.159909,0.180653,21818.976589,0.1,0.000685
2042,2042,,11,17,28,11,17,28,0.000922,0.017797,0,11391,25,0.000024,13,0.198218,0.221647,2051.577762,0.15873,0.003679
2043,2043,,9,29,38,9,29,38,0,0.003054,0,11404,23,0.000026,16,0.159128,0.184325,70667.645038,0.02845,0.002072
9310201,9310201,,13,2,15,13,2,15,0.000051,0,0,4798,15,0.000074,2,0.625,0.7,1472.2621,0.057143,0.003265
9403045,9403045,,25,4,29,25,4,29,0.000227,0.000012,0,2245,5,0.000069,3,0.5625,0.685185,15831.310794,0.071429,0.007067
9403112,9403112,,15,2,17,15,2,17,0.00004,0.000002,0,4800,15,0.000043,2,0.625,0.7,310.887626,0.095588,0.003524
9506005,9506005,,3,9,12,3,9,12,0.000036,0.000165,0,10962,15,0.000021,3,0.543478,0.646667,5215.510802,0.037879,0.000745
9509015,9509015,,2,2,4,2,2,4,0.000036,0,0,11403,26,0.000015,2,0.75,0.833333,930,0.166667,0.000498
9607003,9607003,,1,12,13,1,12,13,0.000036,0.000079,0,11401,4,0.000011,7,0.285472,0.331608,7104.745508,0.057692,0.000279
9607147,9607147,,9,2,11,9,2,11,0.000075,0.000012,0,9459,23,0.000031,7,0.249169,0.285968,8561.647269,0.036364,0.002175
9607224,9607224,,4,0,4,4,0,4,0.000036,0,0,10990,23,0.00003,0,0,0,0,0,0.001071
9608027,9608027,,6,1,7,6,1,7,0.000036,0,0,11370,23,0.000034,2,0.666667,0.75,15.016667,0.214286,0.001479
9701051,9701051,,3,0,3,3,0,3,0.000036,0,0,11393,23,0.000023,0,0,0,0,0.166667,0.000744
9702102,9702102,,3,1,4,3,1,4,0.000037,0,0,11398,23,0.000014,3,0.5,0.611111,19.5,0.25,0.000763
9705009,9705009,,4,5,9,4,5,9,0.000036,0.000002,0,11392,23,0.000019,7,0.228571,0.258018,1821.113017,0.069444,0.000976
9804133,9804133,,5,2,7,5,2,7,0.000036,0.000001,0,11397,23,0.000028,1,1,1,933.333333,0.142857,0.001175
9807024,9807024,,19,0,19,19,0,19,0.000037,0,0,11395,23,0.00008,0,0,0,0,0.055556,0.004532
9808151,9808151,,3,9,12,3,9,12,0.000036,0.000004,0,11394,23,0.000014,8,0.209214,0.239418,186.962313,0.128788,0.000724
9809119,9809119,,11,6,17,11,6,17,0.000053,0.000235,0,11373,23,0.00004,15,0.175101,0.193893,82497.268461,0.113971,0.002684
9902017,9902017,,4,3,7,4,3,7,0.00004,0.000002,0,11371,23,0.000019,1,1,1,2968.578389,0.214286,0.001189
9301063,9301063,,2,0,2,2,0,2,0.000002,0,0,765,15,0.000044,0,0,0,0,0,0.00057
9305045,9305045,,7,3,10,7,3,10,0.000003,0.000001,0,760,15,0.000098,1,1,1,22714.645899,0.077778,0.001939
9302132,9302132,,7,3,10,7,3,10,0.000003,0.000018,0,2244,5,0.000046,2,0.714286,0.8,9179.695332,0.077778,0.001922
9202053,9202053,,22,0,22,22,0,22,0.000207,0,0,767,15,0.000122,0,0,0,0,0.073593,0.005326
9310037,9310037,,3,1,4,3,1,4,0.000001,0.000034,0,829,0,0.000049,1,1,1,98.371727,0.083333,0.000788
9308007,9308007,,9,1,10,9,1,10,0,0,0,2981,23,0.00005,1,1,1,1,0.266667,0.002375
9309002,9309002,,15,1,16,15,1,16,0,0,0,2980,23,0.000058,1,1,1,3.833333,0.141667,0.003731
9309003,9309003,,10,1,11,10,1,11,0,0,0,5995,23,0.00007,1,1,1,37.574138,0.227273,0.002597
9405160,9405160,,2,3,5,2,3,5,0,0,0,10193,23,0.000022,1,1,1,690.283319,0.3,0.000574
9307026,9307026,,15,0,15,15,0,15,0.00001,0,0,2260,9,0.000036,0,0,0,0,0.080952,0.003802
9403021,9403021,,3,0,3,3,0,3,0.000007,0,0,6037,15,0.000014,0,0,0,0,0,0.000756
9406165,9406165,,1,2,3,1,2,3,0.000002,0.000034,0,10961,0,0.000012,1,1,1,10.205332,0.166667,0.00024
9412073,9412073,,17,3,20,17,3,20,0.000006,0.000003,0,4799,15,0.000066,2,0.636364,0.714286,7433.75396,0.073684,0.003979
9501089,9501089,,2,0,2,2,0,2,0,0,0,11402,26,0.000021,0,0,0,0,0.5,0.000452
9210151,9210151,,1,0,1,1,0,1,0.000001,0,0,11400,4,0.000011,0,0,0,0,0,0.000227
9406096,9406096,,6,1,7,6,1,7,0.000026,0,0,729,4,0.000021,3,0.5,0.611111,11166.828499,0.238095,0.001927
9411049,9411049,,12,10,22,12,10,22,0.000215,0.000218,0,838,0,0.000032,5,0.375,0.480864,29026.249019,0.060606,0.0033
9501075,9501075,,33,26,59,33,26,59,0.000989,0.00255,0,2624,4,0.000082,6,0.328909,0.420703,141492.990015,0.052309,0.009071
9510003,9510003,,10,10,20,10,10,20,0.000006,0.000115,0,10608,4,0.000048,6,0.285552,0.327888,8823.563094,0.047368,0.002334
9511037,9511037,,8,22,30,8,22,30,0.00085,0.002467,0,5146,4,0.000015,6,0.311657,0.374173,18462.918072,0.172414,0.002098
9511038,9511038,,11,9,20,11,9,20,0.000897,0.000573,0,5137,4,0.000019,7,0.282246,0.331183,13134.127533,0.131579,0.002811
9511156,9511156,,2,3,5,2,3,5,0.000004,0,0,11399,4,0.000011,7,0.223206,0.245172,11.242857,0.4,0.000446
9601039,9601039,,9,0,9,9,0,9,0.000001,0,0,9458,23,0.000071,0,0,0,0,0.138889,0.002698
9702135,9702135,,2,1,3,2,1,3,0,0.000001,0,11396,23,0.000024,1,1,1,0.333333,0.333333,0.000478
9606007,9606007,,12,0,12,12,0,12,0.000019,0,0,11372,23,0.000037,0,0,0,0,0.189394,0.002865
9803170,9803170,,27,14,41,27,14,41,0.002101,0.008354,0,11074,26,0.000038,14,0.184594,0.211273,57460.912172,0.173171,0.007343
2044,2044,,31,22,53,31,22,53,0.005444,0.018103,0,11405,8,0.000029,13,0.187758,0.209842,52980.500167,0.079463,0.008475
9909013,9909013,,17,17,34,17,17,34,0.002986,0.019851,0,10534,1,0.000025,13,0.188646,0.210361,7699.564227,0.172906,0.004915
9204002,9204002,,9,0,9,9,0,9,0.000025,0,0,229,5,0.000076,0,0,0,0,0.055556,0.003961
9510115,9510115,,1,8,9,1,8,9,0.000278,0.000299,0,7433,5,0.000011,7,0.319312,0.37706,1848.412852,0.263889,0.000454
2045,2045,,3,4,7,3,4,7,0.000002,0.000006,0,11410,23,0.000015,18,0.135382,0.148996,3063.315512,0.166667,0.000812
9904096,9904096,,6,2,8,6,2,8,0.000011,0,0,11409,23,0.000021,17,0.147018,0.159362,20062.451479,0.178571,0.001532
9203078,9203078,,23,0,23,23,0,23,0.000319,0,0,1093,28,0.000075,0,0,0,0,0.051383,0.006051
9203081,9203081,,22,0,22,22,0,22,0.000456,0,0,1091,28,0.000063,0,0,0,0,0.034632,0.006127
9410150,9410150,,3,0,3,3,0,3,0.000025,0,0,7217,28,0.000016,0,0,0,0,0.166667,0.000794
9602072,9602072,,1,6,7,1,6,7,0.000024,0.000079,0,7218,28,0.000012,11,0.158519,0.176732,427.031756,0.190476,0.000314
9604141,9604141,,10,4,14,10,4,14,0.000238,0.000093,0,2869,28,0.000045,11,0.193323,0.226944,11945.938363,0.148352,0.002636
9706163,9706163,,1,11,12,1,11,12,0,0.000003,0,11408,23,0.000019,12,0.165456,0.184732,13871.210963,0.136364,0.000261
2046,2046,,7,12,19,7,12,19,0.00052,0.004766,0,11423,2,0.000018,14,0.180759,0.202933,16294.484179,0.134503,0.001742
9910183,9910183,,6,12,18,6,12,18,0.000482,0.010875,0,11422,2,0.000014,14,0.166407,0.190413,23236.419444,0.153595,0.001479
9812030,9812030,,3,3,6,3,3,6,0.000128,0.000008,0,11421,23,0.000018,14,0.140819,0.156677,7955.751108,0.2,0.000771
9907179,9907179,,1,5,6,1,5,6,0.000128,0.003499,0,11415,2,0.000011,13,0.169873,0.184853,12775.432187,0.2,0.00026
2047,2047,,5,16,21,5,16,21,0.000218,0.002456,0,11424,0,0.000012,12,0.198645,0.220479,7460.976243,0.154762,0.001266
9611078,9611078,,15,4,19,15,4,19,0.000002,0,0,9218,5,0.00005,4,0.355932,0.456349,6468.902533,0.140351,0.004016
9610100,9610100,,1,1,2,1,1,2,0,0,0,9257,5,0.000011,2,0.666667,0.75,0,0.5,0.000301
9803105,9803105,,3,6,9,3,6,9,0,0,0,9256,5,0.000014,11,0.135441,0.16187,189.782383,0.263889,0.000806
2050,2050,,14,4,18,14,4,18,0.000418,0.000019,0,11425,17,0.000024,12,0.160015,0.175852,5096.057852,0.228758,0.003417
2051,2051,,1,3,4,1,3,4,0,0,0,11428,26,0.000011,12,0.131818,0.147244,4.583333,0.25,0.000219
9705136,9705136,,10,3,13,10,3,13,0,0.000001,0,7583,26,0.000044,3,0.545455,0.694444,8585.477908,0.160256,0.002405
9712080,9712080,,13,5,18,13,5,18,0.000014,0.000001,0,10991,26,0.000042,12,0.141251,0.164554,1919.661919,0.114379,0.003099
9805013,9805013,,12,6,18,12,6,18,0.000002,0.000001,0,11427,26,0.000035,11,0.151106,0.17268,10217.423088,0.104575,0.002709
9408081,9408081,,17,0,17,17,0,17,0.000004,0,0,3293,26,0.000071,0,0,0,0,0.084559,0.004182
9410067,9410067,,20,0,20,20,0,20,0.00007,0,0,3292,26,0.000087,0,0,0,0,0.042105,0.004869
9703128,9703128,,1,3,4,1,3,4,0,0.000057,0,7582,26,0.000023,2,0.714286,0.8,123.469444,0.166667,0.000287
9605207,9605207,,3,5,8,3,5,8,0.000012,0,0,8388,26,0.000025,2,0.857143,0.916667,9673.82037,0.178571,0.000872
9711189,9711189,,3,3,6,3,3,6,0,0.000001,0,11426,26,0.00002,4,0.444444,0.604167,115.932634,0.166667,0.000736
9803250,9803250,,9,8,17,9,8,17,0.000002,0.000005,0,10831,26,0.00004,10,0.161621,0.183996,12804.651332,0.139706,0.002117
2052,2052,,2,18,20,2,18,20,0.000045,0.020464,0,11431,1,0.000011,11,0.230198,0.261532,4488.042723,0.165789,0.000445
9907175,9907175,,2,20,22,2,20,22,0.000334,0.012003,0,11429,2,0.000011,11,0.233903,0.268608,5557.85251,0.11039,0.000458
9909080,9909080,,1,17,18,1,17,18,0.00024,0.007994,0,11430,2,0.00001,12,0.198096,0.222373,74.394425,0.124183,0.000232
9507141,9507141,,7,16,23,7,16,23,0.000856,0.000222,0,2003,5,0.000022,7,0.27981,0.318874,143772.308586,0.098814,0.003866
9803189,9803189,,4,36,40,4,36,40,0.001048,0.021743,0,7154,9,0.000012,14,0.208215,0.243259,454678.342624,0.098077,0.001426
2053,2053,,1,12,13,1,12,13,0.000006,0.007319,0,11432,1,0.000011,13,0.197709,0.218089,1312.045079,0.166667,0.000233
9811183,9811183,,32,18,50,32,18,50,0.00231,0.003631,0,8348,52,0.000031,14,0.206203,0.234286,78104.44902,0.137143,0.010675
2054,2054,,28,20,48,28,20,48,0.003856,0.003767,0,11433,25,0.000025,16,0.206861,0.23198,25010.272449,0.108156,0.008853
9911084,9911084,,8,13,21,8,13,21,0.001522,0.003071,0,8845,0,0.000013,13,0.199288,0.224867,28485.193566,0.119048,0.003762
2055,2055,,0,3,3,0,3,3,0,0.000002,0,11437,23,0.00001,10,0.175122,0.198214,0,0.5,0
9504067,9504067,,23,1,24,23,1,24,0.000073,0.000003,0,4749,23,0.000054,2,0.666667,0.75,447.941289,0.077899,0.006161
9711184,9711184,,13,7,20,13,7,20,0.000127,0.000005,0,11435,23,0.000026,9,0.208999,0.243907,2947.297716,0.128947,0.003087
9803153,9803153,,4,6,10,4,6,10,0.000001,0.000007,0,11436,23,0.000015,10,0.17549,0.203888,403.306383,0.211111,0.000917
9407182,9407182,,72,1,73,72,1,73,0.000262,0,0,4326,23,0.000333,1,1,1,2973.115351,0.0586,0.019259
9502066,9502066,,25,1,26,25,1,26,0.000015,0.000003,0,4732,23,0.000053,2,0.666667,0.75,0.416667,0.155385,0.006616
9509086,9509086,,5,3,8,5,3,8,0.000018,0.001028,0,4833,23,0.000023,6,0.268145,0.308145,1926.476814,0.178571,0.001327
9607065,9607065,,12,12,24,12,12,24,0.000012,0.000016,0,6615,23,0.00004,8,0.227778,0.276485,22918.28908,0.105072,0.003157
9609202,9609202,,12,11,23,12,11,23,0.000047,0.000018,0,6616,23,0.000029,9,0.222444,0.266991,41656.907496,0.189723,0.003373
9611077,9611077,,12,5,17,12,5,17,0.000017,0.000007,0,11434,23,0.000023,8,0.185515,0.229004,301.146806,0.117647,0.002895
9409183,9409183,,23,3,26,23,3,26,0.000047,0.000001,0,6230,23,0.000063,1,1,1,76.8948,0.129231,0.005836
9411224,9411224,,13,1,14,13,1,14,0.000033,0,0,10386,23,0.000053,1,1,1,97.293317,0.038462,0.003069
9504066,9504066,,23,3,26,23,3,26,0.000063,0.000004,0,4752,23,0.000072,2,0.8,0.875,10525.214304,0.087692,0.006455
2056,2056,,12,15,27,12,15,27,0.001488,0.001426,0,11438,1,0.000019,13,0.19833,0.220971,5871.273367,0.230769,0.003897
2057,2057,,5,22,27,5,22,27,0.000897,0.003911,0,11439,1,0.000011,15,0.209928,0.238351,24985.651773,0.155271,0.001559
9411095,9411095,,3,21,24,3,21,24,0.000086,0.001416,0,3222,13,0.000013,6,0.310465,0.379089,3938.695958,0.077899,0.001179
9603191,9603191,,12,20,32,12,20,32,0.000756,0.004046,0,2265,0,0.000017,14,0.201337,0.252462,1296.098702,0.1875,0.003677
9612203,9612203,,21,5,26,21,5,26,0.000365,0.000275,0,5949,0,0.000047,10,0.204497,0.231475,14540.082897,0.266154,0.005887
9705197,9705197,,5,12,17,5,12,17,0.00043,0.001397,0,5854,0,0.000013,12,0.199422,0.229851,397.218522,0.294118,0.001469
9707047,9707047,,4,31,35,4,31,35,0.000517,0.005247,0,5032,0,0.000011,12,0.214467,0.254315,5394.744118,0.131092,0.001106
9707212,9707212,,3,41,44,3,41,44,0.000289,0.006731,0,5033,0,0.000012,10,0.217308,0.257478,14004.184044,0.130021,0.001127
9708009,9708009,,1,90,91,1,90,91,0.000247,0.017104,0,6234,0,0.00001,11,0.236027,0.288474,55309.608325,0.131868,0.000369
9709222,9709222,,4,48,52,4,48,52,0.000374,0.009867,0,6228,0,0.000011,12,0.213245,0.257476,7556.455567,0.138763,0.001131
2058,2058,,3,3,6,3,3,6,0,0.000015,0,11440,23,0.000016,18,0.103868,0.116034,52.217964,0.1,0.000716
2059,2059,,0,2,2,0,2,2,0,0,0,11441,28,0.00001,16,0.121326,0.130034,0,0.5,0
2060,2060,,2,13,15,2,13,15,0.000053,0.000518,0,11444,2,0.000011,15,0.149065,0.172158,10683.959755,0.219048,0.000487
9305031,9305031,,15,0,15,15,0,15,0.000015,0,0,6542,23,0.000084,0,0,0,0,0.047619,0.003583
9405053,9405053,,2,0,2,2,0,2,0.000014,0,0,9473,2,0.000012,0,0,0,0,0.5,0.000501
9411229,9411229,,9,2,11,9,2,11,0.000019,0,0,9472,26,0.000022,1,1,1,6030,0.045455,0.002088
9805110,9805110,,16,12,28,16,12,28,0.000334,0.000422,0,9469,2,0.000026,12,0.182555,0.205086,3668.114653,0.164021,0.003923
9901084,9901084,,2,17,19,2,17,19,0.000008,0.000956,0,11443,2,0.000012,14,0.164327,0.191745,13299.405841,0.216374,0.000465
9312044,9312044,,1,0,1,1,0,1,0,0,0,9471,26,0.00002,0,0,0,0,0,0.000279
9506081,9506081,,5,4,9,5,4,9,0.000059,0.000035,0,3344,0,0.00003,8,0.224659,0.259661,8998.347626,0.111111,0.002102
9505096,9505096,,4,2,6,4,2,6,0.000037,0.000001,0,3356,2,0.000017,1,1,1,4087.035941,0.1,0.001152
9812217,9812217,,2,4,6,2,4,6,0.000011,0.000009,0,11442,26,0.000013,8,0.202353,0.274751,906.650786,0.066667,0.000465
9202043,9202043,,6,0,6,6,0,6,0.000008,0,0,3349,2,0.000096,0,0,0,0,0.1,0.001562
2061,2061,,9,22,31,9,22,31,0.000462,0.008713,0,11445,3,0.000013,11,0.215154,0.241104,11339.055331,0.124731,0.00238
9907201,9907201,,4,21,25,4,21,25,0.000277,0.004159,0,11122,1,0.000011,13,0.195793,0.223095,2711.454456,0.135,0.001042
2062,2062,,5,5,10,5,5,10,0.000018,0.00001,0,11448,26,0.000019,4,0.423077,0.526515,76.157692,0.122222,0.001154
9308006,9308006,,5,0,5,5,0,5,0.000091,0,0,11447,26,0.000021,0,0,0,0,0.1,0.001216
9901110,9901110,,5,1,6,5,1,6,0.000018,0.000001,0,11446,26,0.00002,1,1,1,2.107143,0.266667,0.001181
2063,2063,,2,3,5,2,3,5,0.000016,0.000006,0,11450,26,0.000015,3,0.5,0.611111,491.28166,0.1,0.000452
9511151,9511151,,17,1,18,17,1,18,0.000204,0,0,9447,26,0.000076,1,1,1,324.877794,0.055556,0.004
9904189,9904189,,5,3,8,5,3,8,0.000003,0.000005,0,11449,26,0.000024,2,0.636364,0.714286,44.40193,0.125,0.001169
9408141,9408141,,5,0,5,5,0,5,0,0,0,7014,26,0.000096,0,0,0,0,0.1,0.00136
9404093,9404093,,9,1,10,9,1,10,0.000027,0,0,7015,26,0.000047,1,1,1,1822.616585,0.1,0.003098
9711133,9711133,,10,5,15,10,5,15,0.000158,0.000004,0,9448,26,0.000033,1,1,1,10381.458013,0.057143,0.002843
2064,2064,,0,2,2,0,2,2,0,0.000022,0,11451,5,0.00001,3,0.463415,0.508772,0,0,0
9205021,9205021,,15,0,15,15,0,15,0.000328,0,0,1161,25,0.000068,0,0,0,0,0.104762,0.003938
9208070,9208070,,18,0,18,18,0,18,0.000597,0,0,1160,25,0.00007,0,0,0,0,0.078431,0.004705
9210003,9210003,,8,0,8,8,0,8,0.000001,0,0,4608,5,0.000053,0,0,0,0,0.053571,0.002227
9210085,9210085,,6,1,7,6,1,7,0.000079,0.000023,0,2007,5,0.000024,1,1,1,13.132756,0.142857,0.001768
9211050,9211050,,2,0,2,2,0,2,0.000012,0,0,4607,5,0.000018,0,0,0,0,0,0.00083
9212097,9212097,,3,1,4,3,1,4,0.000003,0.000023,0,4606,5,0.00002,1,1,1,0.333333,0.166667,0.001049
9302051,9302051,,13,0,13,13,0,13,0.00001,0,0,1637,5,0.000071,0,0,0,0,0.051282,0.003639
9304092,9304092,,10,0,10,10,0,10,0.000002,0,0,4348,5,0.000103,0,0,0,0,0.011111,0.002779
9306123,9306123,,2,1,3,2,1,3,0.000001,0,0,4605,5,0.000019,2,0.666667,0.75,11739,0.166667,0.00083
9308106,9308106,,31,4,35,31,4,35,0.000127,0.000002,0,1640,5,0.000116,1,1,1,25794.518712,0.111765,0.00915
2065,2065,,8,23,31,8,23,31,0.000001,0.000009,0,11481,6,0.000016,13,0.140664,0.162397,4826.623562,0.248387,0.002029
9501105,9501105,,20,4,24,20,4,24,0.000059,0.000007,0,3548,6,0.000033,3,0.5625,0.685185,1851.466261,0.137681,0.005493
9502011,9502011,,23,8,31,23,8,31,0.000018,0.000004,0,11460,6,0.000038,6,0.290076,0.373904,2043.350954,0.121505,0.006114
9503083,9503083,,17,12,29,17,12,29,0.000043,0.000009,0,3553,6,0.000025,5,0.5,0.635859,99392.184791,0.211823,0.004892
9504018,9504018,,19,10,29,19,10,29,0.000003,0.000005,0,11453,6,0.000026,5,0.452381,0.565351,3606.180722,0.248768,0.005235
9506031,9506031,,13,14,27,13,14,27,0.000002,0.000008,0,11455,6,0.00002,5,0.476744,0.60935,259.210552,0.267806,0.003652
9506157,9506157,,21,2,23,21,2,23,0.000024,0.000004,0,11467,6,0.000035,3,0.473684,0.555556,32.031744,0.126482,0.005376
9510071,9510071,,9,11,20,9,11,20,0.000001,0.000007,0,11456,6,0.000018,5,0.452174,0.544551,403.627761,0.278947,0.002635
9609233,9609233,,11,14,25,11,14,25,0.000015,0.000014,0,11458,6,0.000017,8,0.271468,0.349866,7307.267874,0.223333,0.003044
9612138,9612138,,18,29,47,18,29,47,0.000056,0.00003,0,11470,6,0.000021,9,0.219813,0.293932,7519.514493,0.142461,0.004692
9707235,9707235,,23,23,46,23,23,46,0.000021,0.000012,0,11472,6,0.000027,10,0.198445,0.26213,38848.840018,0.16087,0.005867
9806003,9806003,,16,17,33,16,17,33,0.000019,0.000008,0,11473,6,0.000021,12,0.158639,0.180496,78733.799201,0.183712,0.004117
9807146,9807146,,7,21,28,7,21,28,0.000001,0.000008,0,11475,6,0.000016,13,0.139659,0.160855,111569.002077,0.280423,0.0019
9807189,9807189,,8,21,29,8,21,29,0.000001,0.000011,0,11478,6,0.000017,13,0.140087,0.161985,6577.473332,0.178571,0.00215
9904002,9904002,,18,29,47,18,29,47,0.000016,0.000012,0,11479,6,0.000023,12,0.160442,0.184893,39594.203881,0.167438,0.004452
9909145,9909145,,7,15,22,7,15,22,0.000003,0.000006,0,11480,6,0.000013,13,0.140967,0.160569,861.045393,0.233766,0.001675
9205039,9205039,,14,0,14,14,0,14,0.000015,0,0,2402,6,0.000084,0,0,0,0,0.038462,0.004026
9403049,9403049,,7,4,11,7,4,11,0.000002,0.000003,0,2416,6,0.000018,2,0.666667,0.75,6079.436136,0.218182,0.001918
9401078,9401078,,10,2,12,10,2,12,0.000008,0.00001,0,2365,6,0.000038,1,1,1,454.593957,0.045455,0.002963
9309135,9309135,,12,0,12,12,0,12,0.000023,0,0,857,6,0.000051,0,0,0,0,0.068182,0.004606
9402045,9402045,,30,1,31,30,1,31,0.000006,0.000001,0,2061,6,0.000079,1,1,1,291.413939,0.050538,0.008696
9407089,9407089,,19,3,22,19,3,22,0.000002,0.000001,0,3551,6,0.000055,1,1,1,2696.552512,0.062771,0.005422
9408004,9408004,,25,3,28,25,3,28,0.000007,0.000008,0,3550,6,0.000045,3,0.5,0.6,166.179243,0.115079,0.006774
9411112,9411112,,29,11,40,29,11,40,0.000002,0.000033,0,4086,6,0.000074,3,0.565217,0.679487,33951.579966,0.062821,0.007048
9311027,9311027,,19,5,24,19,5,24,0.000003,0.000008,0,3552,6,0.000035,2,0.777778,0.857143,15387.128042,0.119565,0.005591
9410026,9410026,,14,3,17,14,3,17,0.000001,0.000003,0,11452,6,0.000025,2,0.636364,0.714286,46.029913,0.165441,0.003883
9505138,9505138,,6,9,15,6,9,15,0.000001,0.000007,0,11454,6,0.000014,6,0.375,0.505128,48.248619,0.3,0.00175
9305154,9305154,,16,0,16,16,0,16,0.00011,0,0,2377,6,0.00003,0,0,0,0,0.070833,0.004391
9510070,9510070,,2,7,9,2,7,9,0,0.000005,0,11457,6,0.000012,6,0.395349,0.515686,7.07075,0.236111,0.000576
9404188,9404188,,19,11,30,19,11,30,0.000005,0.000081,0,3852,6,0.000025,3,0.636364,0.746032,5250.154366,0.147126,0.005055
9510084,9510084,,4,6,10,4,6,10,0.000001,0.000006,0,11463,6,0.000013,5,0.404762,0.497059,2.309894,0.355556,0.001093
9605061,9605061,,2,21,23,2,21,23,0.000001,0.000009,0,11469,6,0.000012,9,0.219589,0.301662,7252.539996,0.203557,0.000726
9503088,9503088,,22,4,26,22,4,26,0.000079,0.000048,0,11461,6,0.000038,6,0.282051,0.344805,992.054109,0.078462,0.005518
9605219,9605219,,11,9,20,11,9,20,0.000002,0.000016,0,11471,6,0.00002,8,0.25557,0.312686,1092.899359,0.205263,0.002905
9603111,9603111,,5,14,19,5,14,19,0.000001,0.000008,0,11466,6,0.000014,8,0.234442,0.301026,3332.034616,0.269006,0.001456
9512174,9512174,,5,18,23,5,18,23,0.000001,0.000025,0,11465,6,0.000014,7,0.303393,0.40271,27586.550785,0.15415,0.001262
9601055,9601055,,3,19,22,3,19,22,0.000004,0.000026,0,11474,6,0.000012,8,0.252438,0.341043,192.754751,0.21645,0.000775
9211114,9211114,,38,1,39,38,1,39,0.000007,0.000001,0,1185,6,0.000147,1,1,1,26.445112,0.062078,0.009823
9809140,9809140,,7,12,19,7,12,19,0.000001,0.000007,0,11477,6,0.000015,13,0.13804,0.154992,3250.448785,0.128655,0.001751
9810098,9810098,,19,13,32,19,13,32,0.000006,0.000008,0,11476,6,0.000026,14,0.126711,0.145874,179316.106556,0.154234,0.004878
2066,2066,,26,16,42,26,16,42,0.004774,0.012184,0,11482,1,0.000022,13,0.194308,0.216045,9811.347545,0.170732,0.007921
9406156,9406156,,3,1,4,3,1,4,0.000019,0.000056,0,2877,4,0.000028,2,0.666667,0.75,81.667023,0.166667,0.001373
9407109,9407109,,3,17,20,3,17,20,0.000038,0.000293,0,2882,4,0.000031,5,0.34058,0.429078,84301.818448,0.031579,0.001513
2067,2067,,57,27,84,57,27,84,0.003378,0.002946,0,11483,30,0.000064,12,0.213651,0.23644,94120.375418,0.140275,0.027888
9304114,9304114,,13,2,15,13,2,15,0.000023,0.000003,0,7009,26,0.000112,1,1,1,2537.982789,0.114286,0.004021
9402098,9402098,,6,1,7,6,1,7,0.000038,0,0,6834,30,0.000028,1,1,1,3884.709053,0.119048,0.002213
9404159,9404159,,5,4,9,5,4,9,0.000009,0.000005,0,7019,26,0.000038,2,0.75,0.833333,8419.525612,0.055556,0.001945
9407193,9407193,,14,2,16,14,2,16,0.000023,0,0,7011,26,0.000096,2,0.666667,0.75,1509.87141,0.125,0.00417
9501092,9501092,,8,4,12,8,4,12,0.000034,0.000001,0,7020,26,0.00004,3,0.458333,0.530303,10314.846512,0.212121,0.002725
9508003,9508003,,10,5,15,10,5,15,0.000179,0.000001,0,7022,26,0.000037,4,0.371429,0.474359,11756.563699,0.138095,0.003541
9509002,9509002,,3,5,8,3,5,8,0.000085,0.000003,0,7024,26,0.000024,4,0.41791,0.5,26212.82521,0.142857,0.001531
9509034,9509034,,5,8,13,5,8,13,0.000012,0.000005,0,7025,26,0.000036,4,0.407895,0.532258,8507.815864,0.153846,0.001883
9608003,9608003,,1,8,9,1,8,9,0.000009,0.000003,0,7026,26,0.000019,4,0.415584,0.53125,4585.365804,0.291667,0.00097
9206024,9206024,,11,0,11,11,0,11,0.000006,0,0,4816,15,0.000121,0,0,0,0,0.090909,0.003953
9409048,9409048,,3,5,8,3,5,8,0.000026,0.000004,0,7006,15,0.000043,2,0.857143,0.916667,26877.901465,0.160714,0.001856
9707202,9707202,,18,37,55,18,37,55,0.000955,0.006985,0,6837,30,0.000056,12,0.219671,0.262019,179275.124844,0.080135,0.008226
9409106,9409106,,2,2,4,2,2,4,0.000002,0.000001,0,8528,15,0.000021,3,0.545455,0.638889,21226.197651,0,0.000947
9810215,9810215,,6,11,17,6,11,17,0.000294,0.000857,0,8525,15,0.000026,15,0.176508,0.197984,33425.834375,0.132353,0.001881
2068,2068,,1,4,5,1,4,5,0.000054,0,0,11484,52,0.00001,1,1,1,8,0.25,0.000226
2069,2069,,2,5,7,2,5,7,0.000088,0.000465,0,11485,13,0.000011,14,0.188266,0.211406,27.474274,0.214286,0.000535
9807156,9807156,,5,19,24,5,19,24,0.001414,0.021015,0,7424,1,0.000013,13,0.203539,0.230512,1099.215091,0.213768,0.00213
9902128,9902128,,19,15,34,19,15,34,0.0033,0.002963,0,8247,13,0.000021,13,0.201398,0.231218,2653.671198,0.21123,0.007294
2070,2070,,14,20,34,14,20,34,0.000359,0.000673,0,11506,0,0.000018,12,0.198753,0.225436,24284.207221,0.09893,0.003605
9401160,9401160,,1,0,1,1,0,1,0.000008,0,0,11505,0,0.000011,0,0,0,0,0,0.000317
9412157,9412157,,6,4,10,6,4,10,0.000247,0.000077,0,5121,13,0.000017,5,0.312203,0.343232,7849.194685,0.1,0.001658
9501070,9501070,,2,15,17,2,15,17,0.00001,0.000254,0,11501,41,0.000014,6,0.339344,0.404831,717.562675,0.136029,0.000551
9503218,9503218,,2,4,6,2,4,6,0.000008,0.000202,0,11502,13,0.000014,6,0.295285,0.3257,263.28226,0.1,0.000556
9605043,9605043,,6,12,18,6,12,18,0.000461,0.002768,0,6462,13,0.000017,10,0.227815,0.277191,2106.209074,0.091503,0.001737
9707233,9707233,,3,8,11,3,8,11,0.000039,0.000559,0,11504,13,0.000011,12,0.187471,0.211247,3163.831479,0.127273,0.000762
9806167,9806167,,7,14,21,7,14,21,0.000391,0.001701,0,11495,0,0.000014,14,0.175712,0.201031,193.187271,0.22381,0.002259
9909061,9909061,,61,154,215,61,154,215,0.00244,0.017662,0,11500,0,0.000065,11,0.245409,0.296836,517130.182223,0.042947,0.016363
9203082,9203082,,17,0,17,17,0,17,0.000379,0,0,4181,13,0.000081,0,0,0,0,0.029412,0.004275
9406009,9406009,,21,3,24,21,3,24,0.000728,0.000181,0,347,13,0.000087,2,0.714286,0.8,225.855486,0.11413,0.011257
9407099,9407099,,21,33,54,21,33,54,0.001065,0.001082,0,506,13,0.000061,4,0.441913,0.517612,36567.354213,0.075821,0.010251
9404132,9404132,,4,14,18,4,14,18,0.000049,0.000229,0,1084,41,0.000015,5,0.327332,0.377583,16664.472529,0.248366,0.001434
9406136,9406136,,8,18,26,8,18,26,0.000241,0.000363,0,505,41,0.00002,5,0.375519,0.442726,3291.276242,0.235385,0.003322
9408048,9408048,,4,5,9,4,5,9,0.000037,0.000134,0,547,41,0.000017,6,0.264045,0.314539,190.535204,0.277778,0.001722
9408169,9408169,,6,5,11,6,5,11,0.000256,0.000788,0,5726,13,0.00002,4,0.331551,0.388441,330.87423,0.054545,0.00176
9311080,9311080,,3,3,6,3,3,6,0.000066,0.000186,0,493,0,0.000017,2,0.8,0.875,9984.078812,0.1,0.001205
9502007,9502007,,19,11,30,19,11,30,0.00035,0.000191,0,2302,0,0.000039,6,0.320408,0.380042,1799.640561,0.128736,0.006428
9503142,9503142,,8,9,17,8,9,17,0.000373,0.000121,0,2304,0,0.000023,7,0.247525,0.289685,41957.104499,0.216912,0.003519
9703009,9703009,,12,33,45,12,33,45,0.000896,0.011127,0,4443,13,0.000022,11,0.234875,0.273282,60882.990488,0.124242,0.003654
9210001,9210001,,5,0,5,5,0,5,0.000096,0,0,3366,8,0.000014,0,0,0,0,0.05,0.001213
9511163,9511163,,3,3,6,3,3,6,0.000038,0.000006,0,11503,13,0.000012,7,0.238659,0.261895,80.269752,0.1,0.000685
9502002,9502002,,17,0,17,17,0,17,0.000606,0,0,1109,13,0.000035,0,0,0,0,0.158088,0.005253
9504057,9504057,,6,10,16,6,10,16,0.000241,0.000183,0,2637,0,0.000015,8,0.226607,0.278604,487.888167,0.179167,0.00232
9504155,9504155,,7,3,10,7,3,10,0.000383,0.000214,0,2154,13,0.000013,5,0.315271,0.357031,530.911056,0.1,0.002211
9506205,9506205,,4,14,18,4,14,18,0.00026,0.000939,0,11499,13,0.000012,8,0.267888,0.323583,4673.644558,0.140523,0.001359
9602087,9602087,,35,6,41,35,6,41,0.000974,0.000144,0,2613,0,0.000049,7,0.25498,0.293601,869.635337,0.143293,0.011289
9608041,9608041,,9,13,22,9,13,22,0.00042,0.000172,0,4554,0,0.00002,12,0.174794,0.209068,19554.491991,0.136364,0.0033
9609013,9609013,,1,2,3,1,2,3,0.000208,0.000005,0,11498,5,0.00001,7,0.21129,0.235823,1938.675993,0.166667,0.000655
9610179,9610179,,13,9,22,13,9,22,0.000507,0.00016,0,4550,0,0.000018,12,0.169799,0.197545,1360.368657,0.203463,0.004246
9701115,9701115,,13,14,27,13,14,27,0.000818,0.000283,0,4538,0,0.00002,11,0.193637,0.220444,59407.421942,0.188034,0.004784
9701146,9701146,,8,8,16,8,8,16,0.00044,0.000157,0,4537,0,0.000016,8,0.230721,0.269295,396.611809,0.320833,0.003479
9705016,9705016,,9,17,26,9,17,26,0.000852,0.005491,0,5910,0,0.000015,12,0.20334,0.23377,4052.136318,0.215385,0.002803
9705058,9705058,,8,35,43,8,35,43,0.000561,0.012365,0,5911,13,0.000017,11,0.231596,0.271005,38657.75501,0.136213,0.002706
9708008,9708008,,8,36,44,8,36,44,0.000513,0.002054,0,6117,0,0.000015,16,0.17868,0.227147,17175.534657,0.179704,0.002876
9708153,9708153,,1,23,24,1,23,24,0.000208,0.005927,0,11497,0,0.00001,11,0.227674,0.264136,405.345953,0.199275,0.000655
9708157,9708157,,21,20,41,21,20,41,0.001629,0.004764,0,6545,13,0.000023,13,0.213111,0.248568,8347.191234,0.171341,0.005883
9802138,9802138,,6,2,8,6,2,8,0.000294,0.002531,0,11496,2,0.000017,8,0.221546,0.251135,607.765233,0.053571,0.001887
9809185,9809185,,2,17,19,2,17,19,0.000321,0.000224,0,11494,0,0.00001,14,0.168454,0.19194,7563.660359,0.245614,0.001017
9810159,9810159,,8,39,47,8,39,47,0.000667,0.007118,0,11491,13,0.000016,13,0.207254,0.243757,17093.304508,0.083256,0.002448
9810240,9810240,,3,29,32,3,29,32,0.000565,0.007012,0,11490,0,0.000011,11,0.237697,0.275725,13986.751354,0.110887,0.001126
9811019,9811019,,4,97,101,4,97,101,0.000284,0.050963,0,11489,2,0.000015,11,0.241623,0.290615,66824.748336,0.090891,0.001382
9901044,9901044,,11,14,25,11,14,25,0.000496,0.000329,0,10233,0,0.000015,12,0.213976,0.245989,7531.747685,0.208333,0.003813
9903008,9903008,,20,47,67,20,47,67,0.000612,0.005022,0,10234,0,0.000031,12,0.218934,0.25598,87614.68102,0.103573,0.006102
9904033,9904033,,5,42,47,5,42,47,0.001494,0.027384,0,11487,13,0.000011,12,0.227966,0.268482,6318.779907,0.112858,0.001605
9906006,9906006,,12,28,40,12,28,40,0.00065,0.001164,0,11486,0,0.000015,12,0.215529,0.246884,12028.974533,0.122436,0.003811
2071,2071,,0,5,5,0,5,5,0,0.000008,0,11507,2,0.00001,16,0.143437,0.15793,0,0.4,0
9512036,9512036,,13,7,20,13,7,20,0.000133,0.000044,0,7881,2,0.000036,2,0.705882,0.791667,39874.750416,0.102632,0.003223
9604006,9604006,,13,4,17,13,4,17,0.000198,0.000002,0,8874,2,0.00003,3,0.518519,0.607143,7223.212301,0.161765,0.003214
9604074,9604074,,10,7,17,10,7,17,0.000084,0.000047,0,8886,2,0.00003,3,0.576923,0.7,93.038696,0.150735,0.002378
9712056,9712056,,9,5,14,9,5,14,0.000211,0.000009,0,8889,0,0.000019,15,0.165844,0.186038,4039.899287,0.175824,0.002052
9805044,9805044,,4,22,26,4,22,26,0.000031,0.000012,0,8906,22,0.000016,16,0.143764,0.161084,138796.68953,0.050769,0.000921
9308022,9308022,,11,4,15,11,4,15,0.000021,0.000038,0,7879,2,0.000038,1,1,1,158.660674,0.057143,0.002699
9308140,9308140,,6,2,8,6,2,8,0.000039,0,0,7878,2,0.000028,1,1,1,6994.348806,0.25,0.001587
9401011,9401011,,2,0,2,2,0,2,0.000001,0,0,7877,22,0.000016,0,0,0,0,0.5,0.000528
9409001,9409001,,10,0,10,10,0,10,0.000078,0,0,7876,2,0.000028,0,0,0,0,0.111111,0.002483
9502148,9502148,,1,0,1,1,0,1,0,0,0,8873,2,0.000017,0,0,0,0,0,0.000308
9706152,9706152,,5,12,17,5,12,17,0.000168,0.004628,0,8885,0,0.000017,11,0.21455,0.244693,5136.908185,0.202206,0.001236
9709025,9709025,,7,20,27,7,20,27,0.000159,0.003833,0,8887,0,0.00002,14,0.195517,0.229581,16797.059029,0.178063,0.001667
9711196,9711196,,4,14,18,4,14,18,0.000123,0.004969,0,8888,0,0.000016,15,0.183121,0.218784,4805.005935,0.205882,0.000969
9202025,9202025,,7,0,7,7,0,7,0.000002,0,0,4150,22,0.000042,0,0,0,0,0.142857,0.001833
9208049,9208049,,2,0,2,2,0,2,0,0,0,8900,22,0.000013,0,0,0,0,0.5,0.000527
9209086,9209086,,12,0,12,12,0,12,0.000002,0,0,3723,22,0.00008,0,0,0,0,0.075758,0.002901
9310142,9310142,,8,0,8,8,0,8,0.000005,0,0,4774,28,0.00006,0,0,0,0,0.089286,0.00203
9403196,9403196,,18,1,19,18,1,19,0.00002,0.000027,0,7882,22,0.000094,1,1,1,58.965243,0.134503,0.004546
9405164,9405164,,2,2,4,2,2,4,0,0,0,8905,23,0.000012,2,0.666667,0.75,15442.355962,0.083333,0.000478
9506010,9506010,,7,0,7,7,0,7,0.000003,0,0,3726,22,0.000021,0,0,0,0,0.214286,0.001745
9602048,9602048,,9,3,12,9,3,12,0.000001,0,0,3721,22,0.000026,1,1,1,194.090269,0.227273,0.002215
9603052,9603052,,4,6,10,4,6,10,0.00006,0,0,3727,22,0.000018,3,0.692308,0.814815,97350.130525,0.2,0.001597
9608088,9608088,,4,2,6,4,2,6,0.000016,0,0,8902,22,0.000014,3,0.571429,0.708333,108.911909,0.133333,0.000923
9712247,9712247,,4,8,12,4,8,12,0.000033,0.000011,0,8891,2,0.000015,15,0.16596,0.186692,43530.420543,0.151515,0.000949
2073,2073,,49,18,67,49,18,67,0.002589,0.003331,0,11508,3,0.000057,13,0.194734,0.218667,110507.348,0.049525,0.018168
9207045,9207045,,1,1,2,1,1,2,0.00003,0.000002,0,2679,0,0.000017,1,1,1,56.374884,0,0.001042
9210047,9210047,,1,2,3,1,2,3,0.00003,0.000019,0,2678,0,0.000017,1,1,1,801.896033,0,0.001042
2074,2074,,2,12,14,2,12,14,0.000082,0.001324,0,11509,3,0.00001,13,0.195621,0.219633,1944.02976,0.208791,0.000495
9804081,9804081,,14,5,19,14,5,19,0.001997,0.001232,0,8445,2,0.000015,13,0.178044,0.198403,311.195821,0.195906,0.004771
9901136,9901136,,9,14,23,9,14,23,0.001016,0.003954,0,9445,2,0.000014,15,0.176305,0.201728,586.963541,0.12253,0.002531
2075,2075,,182,8,190,182,8,190,0.00898,0.002069,0,11510,30,0.00016,13,0.189389,0.205939,15798.319284,0.062657,0.0688
2077,2077,,4,13,17,4,13,17,0.000161,0.003735,0,11514,2,0.000012,13,0.191154,0.213872,2997.540459,0.143382,0.000911
9702052,9702052,,3,13,16,3,13,16,0.000066,0.001219,0,11513,0,0.000012,11,0.212964,0.240759,868.90402,0.258333,0.000691
9908136,9908136,,4,9,13,4,9,13,0.000111,0.000255,0,11512,13,0.000013,13,0.183504,0.20442,4346.738336,0.057692,0.001108
9612102,9612102,,31,36,67,31,36,67,0.001238,0.005297,0,2954,0,0.000046,11,0.238245,0.28152,321367.590695,0.063772,0.009682
9612171,9612171,,4,20,24,4,20,24,0.000055,0.004152,0,8858,28,0.000014,11,0.220344,0.255733,3418.722915,0.11413,0.000993
9905161,9905161,,7,21,28,7,21,28,0.000445,0.018591,0,11511,13,0.000015,12,0.208523,0.238557,10378.168129,0.108466,0.001838
2078,2078,,4,12,16,4,12,16,0.000008,0.000083,0,11516,28,0.000014,12,0.194043,0.212886,19946.866493,0.241667,0.000916
9809160,9809160,,10,20,30,10,20,30,0.00044,0.000157,0,9542,28,0.00002,18,0.159583,0.185328,35526.255795,0.110345,0.002495
9912033,9912033,,3,8,11,3,8,11,0.000023,0.00181,0,11515,28,0.000013,11,0.226608,0.255885,24478.36881,0.227273,0.000697
9207024,9207024,,25,0,25,25,0,25,0.000208,0,0,1519,28,0.000074,0,0,0,0,0.083333,0.007296
9412179,9412179,,17,1,18,17,1,18,0.000122,0.000056,0,1518,28,0.000043,6,0.307125,0.3388,0,0.196078,0.005173
9510005,9510005,,1,5,6,1,5,6,0.000002,0.000087,0,9541,28,0.000011,8,0.234303,0.271545,108.578621,0.2,0.000288
9605208,9605208,,13,3,16,13,3,16,0.000242,0.000038,0,2870,28,0.000064,11,0.186644,0.209691,14540.024743,0.1,0.003637
9605233,9605233,,15,4,19,15,4,19,0.000416,0.000008,0,2896,15,0.00003,3,0.529412,0.666667,46229.928634,0.067251,0.003999
9606061,9606061,,25,5,30,25,5,30,0.000259,0.000076,0,3934,28,0.000082,12,0.173003,0.193878,103277.059602,0.093103,0.006776
9608196,9608196,,16,9,25,16,9,25,0.000167,0.000081,0,4196,28,0.000025,6,0.3222,0.377134,19103.440768,0.165,0.004388
9611101,9611101,,13,3,16,13,3,16,0.000243,0.000006,0,9535,28,0.000051,13,0.154764,0.168843,15620.91422,0.15,0.003169
9704076,9704076,,15,13,28,15,13,28,0.000105,0.000111,0,6714,28,0.000023,13,0.159894,0.184984,5234.163338,0.160053,0.004126
9710196,9710196,,5,2,7,5,2,7,0.000208,0.000003,0,9540,28,0.000016,14,0.134125,0.143383,915.764525,0.238095,0.001248
9710197,9710197,,7,2,9,7,2,9,0.000024,0.000003,0,9536,28,0.000023,14,0.134125,0.143383,37.805591,0.277778,0.001696
9711111,9711111,,6,4,10,6,4,10,0.000024,0.000004,0,9539,28,0.000022,14,0.13429,0.144417,11803.524889,0.2,0.001437
9804206,9804206,,4,24,28,4,24,28,0.000211,0.000345,0,9534,28,0.000013,17,0.177388,0.212196,17769.855882,0.128307,0.001122
9203074,9203074,,36,0,36,36,0,36,0.000413,0,0,466,28,0.00034,0,0,0,0,0.055556,0.010355
2080,2080,,0,5,5,0,5,5,0,0.000036,0,11520,52,0.00001,17,0.130241,0.149157,0,0.2,0
9207071,9207071,,10,0,10,10,0,10,0.000008,0,0,528,52,0.000041,0,0,0,0,0.133333,0.002977
9712243,9712243,,1,1,2,1,1,2,0,0,0,11519,52,0.000012,1,1,1,1,0,0.000219
9912112,9912112,,1,5,6,1,5,6,0,0.000036,0,11517,52,0.000012,16,0.145347,0.166397,2984.80641,0.066667,0.000219
9301094,9301094,,3,0,3,3,0,3,0.000003,0,0,564,6,0.000017,0,0,0,0,0.166667,0.001015
9305072,9305072,,6,0,6,6,0,6,0.000004,0,0,525,52,0.000038,0,0,0,0,0.266667,0.001904
9305174,9305174,,15,0,15,15,0,15,0.000045,0,0,545,9,0.000079,0,0,0,0,0.019048,0.003881
9306164,9306164,,6,1,7,6,1,7,0.000007,0,0,563,9,0.000019,1,1,1,158.759863,0.095238,0.001755
9307163,9307163,,5,5,10,5,5,10,0.000004,0.000056,0,526,3,0.000028,4,0.473684,0.549383,23467.959471,0.133333,0.001646
9308105,9308105,,1,1,2,1,1,2,0.000003,0,0,562,9,0.000013,1,1,1,121.899718,0,0.000563
9309087,9309087,,4,0,4,4,0,4,0.000003,0,0,536,52,0.00002,0,0,0,0,0.333333,0.001347
9310040,9310040,,6,4,10,6,4,10,0.000085,0.000007,0,535,52,0.000024,1,1,1,42804.328548,0.055556,0.001958
9311062,9311062,,13,14,27,13,14,27,0.000054,0.000117,0,527,13,0.000049,5,0.442177,0.540769,12019.157044,0.096866,0.004204
9312050,9312050,,9,0,9,9,0,9,0.000008,0,0,530,52,0.000029,0,0,0,0,0.194444,0.002737
9312094,9312094,,12,3,15,12,3,15,0.000039,0.000001,0,529,52,0.000037,6,0.316038,0.364428,5746.366693,0.157143,0.003701
9406076,9406076,,9,7,16,9,7,16,0.000018,0.000002,0,537,52,0.000029,6,0.334821,0.405556,1344.896824,0.129167,0.002575
9407131,9407131,,6,3,9,6,3,9,0.000039,0.000001,0,552,13,0.000023,5,0.350785,0.390796,14484.587944,0.208333,0.00223
9408034,9408034,,1,5,6,1,5,6,0.000003,0.000008,0,550,13,0.000013,5,0.30131,0.347585,22361.204013,0.2,0.000563
9408087,9408087,,2,1,3,2,1,3,0.000003,0.000001,0,546,52,0.000014,1,1,1,2,0.166667,0.000789
9408112,9408112,,1,16,17,1,16,17,0.000003,0.000247,0,544,13,0.000013,5,0.350495,0.422222,20390.494555,0.110294,0.000563
9411209,9411209,,1,6,7,1,6,7,0.000003,0.000001,0,538,52,0.000013,7,0.257627,0.317356,0,0.309524,0.000563
9503209,9503209,,53,2,55,53,2,55,0.002246,0.000073,0,2270,9,0.0001,1,1,1,1709.080068,0.184848,0.01897
9607048,9607048,,8,6,14,8,6,14,0.000276,0.000186,0,7095,9,0.000014,7,0.25,0.286853,540.782057,0.28022,0.002284
9611208,9611208,,4,1,5,4,1,5,0.000023,0.000018,0,7094,9,0.000012,1,1,1,0.7,0.2,0.001134
9710036,9710036,,2,0,2,2,0,2,0,0,0,11518,52,0.000029,0,0,0,0,0,0.000451
9307106,9307106,,9,3,12,9,3,12,0.000007,0.000013,0,1298,9,0.000028,1,1,1,10551.65125,0.068182,0.002591
9410029,9410029,,12,0,12,12,0,12,0.000123,0,0,2316,52,0.000075,0,0,0,0,0.090909,0.002893
2081,2081,,0,17,17,0,17,17,0,0.000009,0,11558,9,0.00001,14,0.158376,0.176972,0,0.227941,0
9204097,9204097,,21,0,21,21,0,21,0.000006,0,0,1484,9,0.000079,0,0,0,0,0.197619,0.005667
9212113,9212113,,20,5,25,20,5,25,0.000011,0.000029,0,2848,9,0.000046,2,0.857143,0.916667,4049.03834,0.088333,0.005166
9511208,9511208,,8,1,9,8,1,9,0.000002,0,0,11521,9,0.000019,5,0.291139,0.316304,2.072084,0.388889,0.002064
9601056,9601056,,19,5,24,19,5,24,0.00009,0.000008,0,6297,9,0.000028,4,0.436782,0.497807,25300.047257,0.146739,0.004948
9602166,9602166,,3,7,10,3,7,10,0,0.000001,0,11522,9,0.000012,5,0.330827,0.394129,8.851611,0.233333,0.000753
9701041,9701041,,14,19,33,14,19,33,0.000003,0.000028,0,11523,9,0.000024,5,0.40724,0.511296,463.263798,0.147727,0.003409
9706041,9706041,,10,7,17,10,7,17,0.000001,0.000001,0,11524,9,0.00002,5,0.339552,0.401282,65.960519,0.227941,0.002392
9707211,9707211,,7,9,16,7,9,16,0.000001,0.000005,0,11530,9,0.000015,6,0.276748,0.330756,358.371562,0.291667,0.001667
9712085,9712085,,8,11,19,8,11,19,0.000001,0.000025,0,11531,9,0.000016,13,0.174583,0.198316,19859.571172,0.24269,0.00186
9712165,9712165,,4,9,13,4,9,13,0,0.000003,0,11554,9,0.000014,14,0.159856,0.181055,11260.879302,0.166667,0.000962
9807234,9807234,,6,12,18,6,12,18,0.000001,0.000001,0,11544,9,0.000014,14,0.153128,0.171395,2951.537627,0.20915,0.001374
9902044,9902044,,3,11,14,3,11,14,0.000001,0.000007,0,11555,9,0.000011,15,0.144392,0.162555,1406.329515,0.208791,0.000684
9905063,9905063,,4,16,20,4,16,20,0.000001,0.000027,0,11556,9,0.000013,13,0.179628,0.203657,9081.127274,0.213158,0.00089
9905150,9905150,,2,8,10,2,8,10,0.000001,0,0,11557,9,0.000012,14,0.156951,0.173611,3770.686508,0.2,0.000438
9201071,9201071,,10,0,10,10,0,10,0.000003,0,0,170,5,0.000094,0,0,0,0,0.066667,0.003062
9204063,9204063,,6,0,6,6,0,6,0.000001,0,0,619,9,0.000112,0,0,0,0,0.166667,0.002008
9207032,9207032,,30,0,30,30,0,30,0.000422,0,0,1482,9,0.000089,0,0,0,0,0.117241,0.008678
9504056,9504056,,12,3,15,12,3,15,0.000002,0.000133,0,7498,9,0.00004,4,0.401786,0.448148,8860.006358,0.252381,0.003127
9308037,9308037,,13,4,17,13,4,17,0.000209,0.000013,0,6294,9,0.000026,1,1,1,14514.923751,0.176471,0.003626
9311180,9311180,,17,10,27,17,10,27,0.000015,0.000023,0,6296,9,0.00004,2,0.777778,0.857143,8760.565626,0.10114,0.004587
9403124,9403124,,9,10,19,9,10,19,0.000002,0.000013,0,6295,9,0.000022,3,0.621622,0.710145,11672.712664,0.178363,0.002366
9411119,9411119,,5,3,8,5,3,8,0.000002,0.000001,0,7496,9,0.000021,3,0.571429,0.666667,7.265981,0.25,0.001357
9512079,9512079,,11,15,26,11,15,26,0.00001,0.000016,0,7501,9,0.000021,5,0.382222,0.476938,33166.832513,0.152308,0.00282
9201079,9201079,,10,0,10,10,0,10,0.000006,0,0,6293,9,0.000023,0,0,0,0,0.144444,0.002663
9209105,9209105,,18,3,21,18,3,21,0.000085,0.000005,0,1485,9,0.000067,1,1,1,14221.196332,0.142857,0.004782
9306034,9306034,,13,3,16,13,3,16,0.000006,0.000001,0,1487,9,0.000025,2,0.714286,0.8,28625.32542,0.141667,0.003381
9309014,9309014,,8,3,11,8,3,11,0.000059,0.000001,0,6292,9,0.000018,2,0.714286,0.8,130.685438,0.2,0.002132
9403032,9403032,,9,3,12,9,3,12,0.000004,0.000001,0,6291,9,0.000022,2,0.714286,0.8,612.082612,0.19697,0.00244
9403075,9403075,,5,10,15,5,10,15,0.000001,0.000014,0,7500,9,0.00002,3,0.607143,0.754902,6317.755511,0.085714,0.001302
9505149,9505149,,1,11,12,1,11,12,0,0.000096,0,11529,9,0.000011,5,0.326291,0.389928,431.017078,0.05303,0.000266
9605220,9605220,,12,11,23,12,11,23,0.00002,0.000012,0,7506,9,0.000024,11,0.173339,0.198147,86517.152447,0.104743,0.003034
9705234,9705234,,6,6,12,6,6,12,0.000001,0.000011,0,11553,9,0.000018,11,0.169862,0.189134,2357.4033,0.106061,0.001402
9712102,9712102,,3,21,24,3,21,24,0,0.000147,0,11552,9,0.000013,13,0.195367,0.231765,4475.789727,0.144928,0.000737
9201008,9201008,,7,0,7,7,0,7,0,0,0,1069,9,0.000065,0,0,0,0,0.095238,0.001847
9511032,9511032,,4,0,4,4,0,4,0,0,0,11543,9,0.000014,0,0,0,0,0.166667,0.000949
9712169,9712169,,1,7,8,1,7,8,0,0.000003,0,11542,22,0.000011,8,0.236392,0.270238,1486.229642,0.142857,0.000259
9802204,9802204,,2,13,15,2,13,15,0,0.000025,0,11532,9,0.000012,13,0.174713,0.198967,2607.912123,0.219048,0.000504
2082,2082,,9,6,15,9,6,15,0.000564,0.000104,0,11559,25,0.000017,13,0.158866,0.172638,4812.821482,0.209524,0.002206
2083,2083,,0,2,2,0,2,2,0,0.000001,0,11562,15,0.00001,11,0.156863,0.180887,0,0.5,0
9705075,9705075,,8,1,9,8,1,9,0.000071,0,0,6492,2,0.000042,1,1,1,9432,0.097222,0.002101
9911093,9911093,,2,3,5,2,3,5,0,0.000055,0,11561,15,0.000017,10,0.184278,0.215582,163.679405,0.2,0.000458
9703087,9703087,,1,0,1,1,0,1,0,0,0,6491,2,0.000048,0,0,0,0,0,0.000276
9809175,9809175,,2,1,3,2,1,3,0.000001,0.000001,0,11560,15,0.000018,2,0.666667,0.75,0,0.5,0.000471
2084,2084,,50,32,82,50,32,82,0.002233,0.005099,0,11567,30,0.000048,12,0.215994,0.241656,195343.964313,0.078741,0.018171
9205103,9205103,,27,1,28,27,1,28,0.000121,0,0,3086,15,0.000132,1,1,1,5139.095178,0.048942,0.00706
9902187,9902187,,3,17,20,3,17,20,0.000129,0.001897,0,8521,30,0.000014,15,0.191425,0.217519,21835.65742,0.189474,0.001316
9903089,9903089,,6,31,37,6,31,37,0.000448,0.012422,0,8754,13,0.000014,13,0.216587,0.250428,28338.633488,0.12012,0.001999
9904091,9904091,,3,7,10,3,7,10,0.000339,0.016537,0,8353,1,0.000014,15,0.177867,0.201815,22477.792274,0.122222,0.001235
9910037,9910037,,5,11,16,5,11,16,0.000338,0.007098,0,11566,1,0.000015,12,0.204428,0.225287,35809.164356,0.133333,0.001798
9912212,9912212,,7,12,19,7,12,19,0.000364,0.001964,0,11564,30,0.000019,13,0.191679,0.210019,7611.525054,0.192982,0.002779
9701096,9701096,,12,3,15,12,3,15,0.000708,0.000056,0,6817,30,0.000028,11,0.16161,0.173151,46.919531,0.309524,0.00556
9705153,9705153,,10,4,14,10,4,14,0.00067,0.000065,0,6818,30,0.000023,11,0.161692,0.173649,47.572562,0.296703,0.004735
9706107,9706107,,10,12,22,10,12,22,0.000527,0.003751,0,6833,30,0.000021,12,0.211726,0.24552,21105.783255,0.188312,0.004465
9712174,9712174,,3,2,5,3,2,5,0.000036,0.000001,0,8520,30,0.000017,4,0.391304,0.5,12978.353347,0.1,0.000698
9812235,9812235,,3,11,14,3,11,14,0.000091,0.000576,0,8517,30,0.000013,15,0.182727,0.207832,7033.843536,0.324176,0.000922
9205003,9205003,,15,0,15,15,0,15,0.00026,0,0,5455,30,0.000086,0,0,0,0,0.02381,0.003619
9403033,9403033,,3,1,4,3,1,4,0.000195,0.000003,0,5456,30,0.000019,1,1,1,0,0.25,0.000711
9508170,9508170,,4,0,4,4,0,4,0.000249,0,0,8352,15,0.000022,0,0,0,0,0,0.000923
9306030,9306030,,10,0,10,10,0,10,0.000171,0,0,5459,30,0.000023,0,0,0,0,0.088889,0.002446
9906225,9906225,,8,8,16,8,8,16,0.000098,0.000065,0,11565,15,0.000029,15,0.149156,0.163056,20267.514111,0.045833,0.001987
9912185,9912185,,14,18,32,14,18,32,0.000962,0.004365,0,11563,30,0.000018,13,0.199444,0.221226,2635.472775,0.212702,0.005905
2085,2085,,2,8,10,2,8,10,0.000087,0.006744,0,11571,1,0.000013,13,0.179635,0.20162,2495.517584,0.111111,0.000445
9512098,9512098,,6,1,7,6,1,7,0.000864,0.001027,0,7151,9,0.000017,6,0.262295,0.292839,287.417789,0.142857,0.001512
9606034,9606034,,4,4,8,4,4,8,0.000864,0.00001,0,7153,9,0.000012,7,0.213826,0.247315,24206.227794,0.142857,0.001032
9903221,9903221,,8,13,21,8,13,21,0.000118,0.018541,0,11570,1,0.000028,13,0.188664,0.213085,116853.359586,0.109524,0.001908
9910173,9910173,,5,7,12,5,7,12,0.000118,0.000735,0,11569,1,0.000019,14,0.176497,0.19495,11962.666486,0.090909,0.001201
9504045,9504045,,1,2,3,1,2,3,0,0,0,7152,23,0.000013,1,1,1,3835.260804,0.166667,0.000247
9504046,9504046,,3,2,5,3,2,5,0.000001,0,0,4725,23,0.000016,1,1,1,7423.347319,0.1,0.000693
9712120,9712120,,9,1,10,9,1,10,0.000247,0.000003,0,9192,23,0.000035,7,0.209076,0.227852,162.624681,0.166667,0.002429
9806098,9806098,,4,2,6,4,2,6,0.000227,0.000006,0,11568,23,0.000017,7,0.210356,0.233791,0.7,0.3,0.001
2086,2086,,2,31,33,2,31,33,0.000208,0.010936,0,11572,30,0.000011,12,0.221654,0.248084,3378.249791,0.104167,0.000608
9910154,9910154,,3,12,15,3,12,15,0.000233,0.000004,0,9520,5,0.000013,10,0.179579,0.221863,156386.888805,0.1,0.00087
2087,2087,,5,29,34,5,29,34,0.000197,0.004915,0,11575,0,0.000015,11,0.213634,0.240782,35967.70099,0.103387,0.001662
9405066,9405066,,1,3,4,1,3,4,0.000058,0.000085,0,11574,0,0.00001,1,1,1,1.47406,0.166667,0.000259
9906152,9906152,,4,31,35,4,31,35,0.000156,0.002528,0,11573,0,0.000012,13,0.196443,0.227289,12167.520354,0.226891,0.001139
106174,106174,,3,6,9,3,6,9,0.000017,0.000117,0,11691,0,0.000012,11,0.197514,0.217675,8007.817013,0.125,0.000709
4125,4125,,34,43,77,34,43,77,0.004284,0.006657,0,11690,25,0.000031,11,0.222643,0.25061,115761.106136,0.093985,0.01167
12104,12104,,20,53,73,20,53,73,0.000721,0.004814,0,11676,0,0.000023,16,0.214762,0.247858,145303.816274,0.080099,0.006549
102046,102046,,10,31,41,10,31,41,0.000487,0.004308,0,11679,0,0.000017,17,0.202487,0.230604,9841.604866,0.171951,0.003618
9505145,9505145,,2,34,36,2,34,36,0.000103,0.001144,0,4582,13,0.000012,6,0.325153,0.394584,18837.294426,0.076984,0.001346
9904008,9904008,,8,6,14,8,6,14,0.000485,0.000142,0,8616,0,0.000017,12,0.191202,0.212305,31402.735115,0.076923,0.00258
2088,2088,,1,10,11,1,10,11,0.000001,0.00027,0,11693,41,0.000012,12,0.210588,0.239185,6611,0.045455,0.000219
9502018,9502018,,7,4,11,7,4,11,0.000003,0.000002,0,11692,41,0.000025,1,1,1,19.857143,0.172727,0.001615
9503001,9503001,,8,1,9,8,1,9,0.00023,0.000001,0,1860,41,0.000032,1,1,1,3323.744943,0.069444,0.002503
9608008,9608008,,8,2,10,8,2,10,0.000076,0.000008,0,3703,23,0.000025,5,0.336364,0.39009,17213.640664,0.144444,0.002082
9306046,9306046,,5,0,5,5,0,5,0,0,0,2503,41,0.000039,0,0,0,0,0.3,0.001251
2089,2089,,0,5,5,0,5,5,0,0.002403,0,11694,4,0.00001,15,0.185728,0.20821,0,0.4,0
2090,2090,,31,18,49,31,18,49,0.001573,0.00279,0,11698,30,0.00004,13,0.201677,0.223389,48657.955382,0.166241,0.012553
9912019,9912019,,31,17,48,31,17,48,0.001478,0.002759,0,11696,30,0.000047,13,0.202117,0.226335,177434.99755,0.125887,0.012554
9912047,9912047,,54,23,77,54,23,77,0.00266,0.006329,0,11697,30,0.000056,13,0.204394,0.228487,66282.381137,0.103213,0.019077
9908204,9908204,,10,18,28,10,18,28,0.000845,0.000824,0,11695,4,0.000017,15,0.192938,0.223591,15331.534041,0.07672,0.004055
9701078,9701078,,38,23,61,38,23,61,0.001233,0.000108,0,6832,30,0.000064,11,0.170323,0.196781,94375.804214,0.033607,0.011692
9805132,9805132,,10,3,13,10,3,13,0.000796,0.00106,0,7913,30,0.000017,15,0.172197,0.192162,311.783834,0.179487,0.003676
2092,2092,,2,2,4,2,2,4,0.000278,0.000138,0,11699,1,0.000011,13,0.180546,0.19607,2.398589,0.25,0.000731
2093,2093,,4,21,25,4,21,25,0.000045,0.000158,0,11707,26,0.000014,15,0.174352,0.197001,17815.625402,0.126667,0.000952
9402029,9402029,,24,1,25,24,1,25,0.000257,0.000004,0,2858,26,0.000087,2,0.666667,0.75,10212.226657,0.136667,0.006111
9606194,9606194,,12,12,24,12,12,24,0.000126,0.00019,0,5089,26,0.000022,8,0.237368,0.275895,84795.147739,0.105072,0.003
9612246,9612246,,2,18,20,2,18,20,0.000003,0.000262,0,11706,26,0.000011,9,0.223206,0.269802,516.539826,0.107895,0.000465
9708115,9708115,,6,19,25,6,19,25,0.000008,0.000118,0,11078,26,0.000014,15,0.129849,0.159763,3559.386612,0.146667,0.001445
9709101,9709101,,15,6,21,15,6,21,0.000254,0.000007,0,7357,26,0.000023,4,0.409836,0.523333,20323.809366,0.188095,0.003771
9906049,9906049,,8,28,36,8,28,36,0.000759,0.00358,0,11591,4,0.000017,14,0.195886,0.225082,77115.946257,0.084921,0.003315
9906125,9906125,,8,15,23,8,15,23,0.000204,0.007642,0,11703,26,0.000015,15,0.174385,0.199158,22006.98826,0.167984,0.001888
9911208,9911208,,3,16,19,3,16,19,0.00004,0.000077,0,11704,26,0.000012,16,0.152804,0.172616,562.131285,0.190058,0.000753
9306013,9306013,,53,5,58,53,5,58,0.001182,0.000211,0,733,26,0.000179,4,0.335938,0.418605,14023.824703,0.075015,0.01522
9206015,9206015,,45,0,45,45,0,45,0.000058,0,0,673,4,0.000264,0,0,0,0,0.033333,0.011742
9207086,9207086,,8,0,8,8,0,8,0.000006,0,0,669,26,0.000069,0,0,0,0,0.071429,0.002094
9208002,9208002,,33,0,33,33,0,33,0.000046,0,0,672,4,0.000093,0,0,0,0,0.050189,0.008153
9212011,9212011,,6,0,6,6,0,6,0.000003,0,0,671,4,0.000022,0,0,0,0,0.133333,0.001645
9212074,9212074,,7,1,8,7,1,8,0.000008,0,0,670,26,0.000034,1,1,1,74.178205,0.125,0.001932
9306091,9306091,,10,1,11,10,1,11,0.000309,0.000001,0,2857,26,0.000152,1,1,1,225.798626,0.036364,0.002628
9207017,9207017,,24,0,24,24,0,24,0.000101,0,0,843,26,0.000218,0,0,0,0,0.047101,0.006582
9501024,9501024,,25,6,31,25,6,31,0.000136,0.000086,0,3449,26,0.000066,5,0.287293,0.38109,12386.242179,0.124731,0.007034
9503033,9503033,,6,23,29,6,23,29,0.000659,0.003054,0,3914,26,0.00003,6,0.307692,0.365476,37419.123855,0.103448,0.002365
9504150,9504150,,51,19,70,51,19,70,0.003576,0.002307,0,3918,26,0.000076,7,0.28481,0.338896,126995.679247,0.081574,0.013835
9512135,9512135,,13,10,23,13,10,23,0.000661,0.000078,0,5077,26,0.000025,5,0.313559,0.413514,6879.603085,0.183794,0.003753
9605172,9605172,,10,6,16,10,6,16,0.000252,0.00007,0,5084,26,0.000019,5,0.304487,0.365614,34675.115641,0.216667,0.002524
9311164,9311164,,4,4,8,4,4,8,0.00003,0.000067,0,3988,26,0.000025,5,0.271676,0.347163,779.27493,0.303571,0.001226
9312110,9312110,,12,0,12,12,0,12,0.000013,0,0,3986,26,0.000152,0,0,0,0,0.128788,0.003466
9602176,9602176,,4,5,9,4,5,9,0.00011,0.000008,0,3985,23,0.000028,7,0.217544,0.317358,85418.54644,0.138889,0.001265
9604017,9604017,,2,2,4,2,2,4,0.000013,0.001171,0,3976,4,0.000023,6,0.262834,0.296745,30.788254,0.166667,0.000628
9509036,9509036,,12,12,24,12,12,24,0.000439,0.000076,0,4440,26,0.000025,6,0.278626,0.412329,22225.12836,0.195652,0.003307
9603205,9603205,,4,5,9,4,5,9,0.000022,0.000018,0,5090,26,0.000017,2,0.692308,0.777778,2237.072123,0.138889,0.001148
9609140,9609140,,8,1,9,8,1,9,0.000001,0,0,5081,26,0.000055,1,1,1,9.833333,0.097222,0.002087
9612073,9612073,,10,13,23,10,13,23,0.000705,0.001107,0,5079,26,0.000023,8,0.23641,0.28425,11778.387805,0.175889,0.003236
9210136,9210136,,1,0,1,1,0,1,0.000003,0,0,11705,26,0.00001,0,0,0,0,0,0.000232
9310105,9310105,,4,5,9,4,5,9,0.000013,0.000198,0,726,26,0.000013,2,0.857143,0.916667,61.077546,0.25,0.000955
9501099,9501099,,5,18,23,5,18,23,0.000019,0.000257,0,2516,26,0.000013,5,0.393665,0.49636,281.910595,0.250988,0.001223
9208012,9208012,,10,0,10,10,0,10,0.000008,0,0,716,4,0.00002,0,0,0,0,0.077778,0.002753
9311064,9311064,,7,9,16,7,9,16,0.000008,0.000052,0,2864,26,0.000021,3,0.607143,0.735294,31834.575546,0.0625,0.001715
9503109,9503109,,7,12,19,7,12,19,0.000011,0.000193,0,4273,26,0.00007,3,0.622222,0.708333,16353.142088,0.122807,0.001928
9511110,9511110,,17,2,19,17,2,19,0.000254,0.000003,0,7294,26,0.000035,5,0.307018,0.350952,10472.932029,0.099415,0.004346
9512048,9512048,,11,10,21,11,10,21,0.000248,0.00007,0,7365,26,0.000022,8,0.230392,0.269117,8442.786703,0.111905,0.002682
9609228,9609228,,4,13,17,4,13,17,0.000029,0.000042,0,7377,26,0.000015,12,0.188088,0.221458,44535.454284,0.058824,0.001124
9612030,9612030,,5,22,27,5,22,27,0.000007,0.00037,0,7369,26,0.000015,12,0.17668,0.219077,48440.328394,0.138177,0.001218
9401044,9401044,,13,2,15,13,2,15,0.000881,0.000073,0,3448,26,0.000035,2,0.666667,0.75,21.974153,0.133333,0.003881
9401046,9401046,,5,3,8,5,3,8,0.000004,0.000002,0,3922,26,0.000021,1,1,1,2457.943647,0.178571,0.001334
9508006,9508006,,7,8,15,7,8,15,0.000008,0.000045,0,3924,26,0.000021,7,0.259369,0.304074,6659.951235,0.228571,0.001751
9610007,9610007,,2,7,9,2,7,9,0.000026,0.00004,0,11071,26,0.000012,8,0.2198,0.252113,5.774088,0.208333,0.000542
9701140,9701140,,12,8,20,12,8,20,0.000006,0.000051,0,3936,26,0.000034,14,0.141011,0.163042,106718.619114,0.126316,0.003077
9703114,9703114,,12,4,16,12,4,16,0.000451,0.000013,0,3925,26,0.000029,8,0.223123,0.247688,23739.494165,0.191667,0.003491
9603084,9603084,,5,2,7,5,2,7,0.000001,0.000005,0,7353,26,0.000035,4,0.394737,0.461111,258.148185,0.214286,0.001283
9609185,9609185,,5,2,7,5,2,7,0.000001,0.000003,0,7356,26,0.000021,5,0.313725,0.392708,134.362377,0.166667,0.001247
9701017,9701017,,7,4,11,7,4,11,0.000013,0.000045,0,7354,26,0.000026,5,0.350877,0.464167,179.178868,0.245455,0.001771
9706019,9706019,,9,3,12,9,3,12,0.000018,0.000007,0,7355,26,0.000022,6,0.287671,0.396032,4193.161546,0.325758,0.002345
9310165,9310165,,16,2,18,16,2,18,0.000154,0.000063,0,678,26,0.000038,1,1,1,144.678866,0.107843,0.004321
9510154,9510154,,6,25,31,6,25,31,0.000009,0.000392,0,4796,26,0.00002,9,0.218553,0.281092,11306.257906,0.144086,0.001604
9710112,9710112,,15,20,35,15,20,35,0.000911,0.002798,0,5962,4,0.000021,13,0.184509,0.220001,6182.835109,0.172269,0.004056
9711054,9711054,,4,1,5,4,1,5,0.00014,0.000014,0,9630,4,0.000013,18,0.129725,0.151573,29.734154,0.1,0.001004
9712046,9712046,,38,16,54,38,16,54,0.001623,0.002931,0,7950,25,0.000061,15,0.188819,0.216306,31609.977769,0.141509,0.011051
9805142,9805142,,6,28,34,6,28,34,0.000554,0.002824,0,8022,4,0.000014,11,0.214383,0.246841,113411.396631,0.21836,0.003162
9808005,9808005,,7,17,24,7,17,24,0.000518,0.003836,0,9421,25,0.000014,14,0.186769,0.215312,4947.797114,0.192029,0.002088
9809184,9809184,,6,14,20,6,14,20,0.000584,0.006139,0,9422,25,0.000014,14,0.184432,0.209448,1997.493901,0.231579,0.00185
9806190,9806190,,7,8,15,7,8,15,0.000105,0.000046,0,11700,26,0.000016,11,0.162704,0.198653,27.571409,0.309524,0.001698
9811050,9811050,,6,20,26,6,20,26,0.000172,0.000777,0,11702,26,0.000038,16,0.168044,0.191998,35457.903221,0.156923,0.001523
9904061,9904061,,4,11,15,4,11,15,0.000093,0.000086,0,11701,26,0.000013,11,0.163084,0.202111,52.613157,0.295238,0.000958
2094,2094,,41,67,108,41,67,108,0.001892,0.004918,0,11710,0,0.000036,13,0.20789,0.239235,136764.578672,0.07468,0.014198
9602084,9602084,,8,11,19,8,11,19,0.000235,0.000634,0,4536,0,0.000017,5,0.359524,0.416336,1333.403076,0.093567,0.002664
9712122,9712122,,4,5,9,4,5,9,0.000184,0.000092,0,11493,0,0.000012,13,0.157303,0.173961,103.352467,0.222222,0.001469
9908024,9908024,,4,29,33,4,29,33,0.00018,0.000686,0,11709,0,0.000011,13,0.188073,0.212993,907.037556,0.206439,0.001478
9910169,9910169,,14,25,39,14,25,39,0.000375,0.000694,0,11708,0,0.000016,12,0.205369,0.233276,8873.308288,0.176113,0.003977
9506140,9506140,,2,4,6,2,4,6,0.00001,0.000099,0,3498,0,0.000017,7,0.240876,0.260584,572.964577,0.366667,0.000762
9204079,9204079,,5,0,5,5,0,5,0.000031,0,0,1155,0,0.000031,0,0,0,0,0.2,0.002327
9205016,9205016,,5,0,5,5,0,5,0.00009,0,0,510,13,0.000025,0,0,0,0,0,0.001614
9602078,9602078,,3,8,11,3,8,11,0.000012,0.000012,0,2634,5,0.000018,8,0.207199,0.247518,95399.696537,0.054545,0.000933
9607027,9607027,,13,19,32,13,19,32,0.001017,0.002665,0,2498,13,0.000036,10,0.214406,0.250843,23532.663173,0.139113,0.006743
9403048,9403048,,3,22,25,3,22,25,0.000068,0.001403,0,2641,13,0.000012,4,0.427885,0.546816,27527.495424,0.071667,0.001194
9502136,9502136,,2,8,10,2,8,10,0.000006,0.000121,0,2303,0,0.000013,7,0.247059,0.287904,224.748221,0.244444,0.000808
9507092,9507092,,9,2,11,9,2,11,0.000952,0.000001,0,2497,13,0.000018,4,0.414634,0.47549,17157.610746,0.163636,0.003294
9512091,9512091,,5,8,13,5,8,13,0.000402,0.000362,0,2445,0,0.000017,7,0.257812,0.292504,11098.971668,0.160256,0.002203
9608148,9608148,,3,7,10,3,7,10,0.000028,0.000034,0,2605,23,0.000015,11,0.201087,0.240932,66129.320322,0.088889,0.000958
9609063,9609063,,1,11,12,1,11,12,0.000018,0.000014,0,2662,22,0.000012,5,0.351485,0.439437,43039.871129,0.05303,0.000677
9408137,9408137,,1,10,11,1,10,11,0.000059,0.000105,0,2670,5,0.000011,4,0.396739,0.464612,2745.391388,0.063636,0.000506
9501055,9501055,,14,5,19,14,5,19,0.000154,0.000573,0,2294,0,0.000032,5,0.321839,0.382292,356.035788,0.163743,0.003987
9509149,9509149,,7,18,25,7,18,25,0.000477,0.003232,0,4545,13,0.000017,8,0.294288,0.343734,47718.106121,0.048333,0.003204
9611122,9611122,,2,9,11,2,9,11,0.000006,0.000278,0,4544,0,0.000013,12,0.166904,0.193499,1566.01486,0.109091,0.000837
9611223,9611223,,6,12,18,6,12,18,0.000241,0.002709,0,4533,0,0.000016,12,0.212536,0.251737,11616.930511,0.183007,0.002222
9702009,9702009,,2,7,9,2,7,9,0.000007,0.000004,0,4523,5,0.000012,5,0.425926,0.571739,55730.640346,0.013889,0.000814
9704115,9704115,,3,21,24,3,21,24,0.000009,0.000253,0,6252,5,0.000013,13,0.193788,0.228877,50440.587349,0.137681,0.001053
9706053,9706053,,3,8,11,3,8,11,0.000009,0.000009,0,6270,26,0.000012,7,0.242424,0.338814,89379.086746,0.2,0.001077
9706154,9706154,,3,16,19,3,16,19,0.000084,0.000206,0,6255,0,0.000012,13,0.169592,0.195348,17330.15377,0.22807,0.001039
9604159,9604159,,2,8,10,2,8,10,0.000006,0.000148,0,6273,0,0.000011,7,0.248927,0.279146,27.99778,0.366667,0.000566
9706201,9706201,,4,14,18,4,14,18,0.000124,0.000263,0,6272,0,0.000012,11,0.190241,0.215835,282.044821,0.277778,0.001172
9704178,9704178,,4,17,21,4,17,21,0.00012,0.005946,0,6128,13,0.000013,11,0.220279,0.25485,1576.018573,0.119048,0.001239
9707243,9707243,,2,12,14,2,12,14,0.000125,0.000614,0,6126,0,0.000012,11,0.192509,0.220701,69504.122842,0.087912,0.000689
9403133,9403133,,18,12,30,18,12,30,0.001386,0.000065,0,2747,9,0.000036,2,0.928571,0.961538,29536.88683,0.125287,0.006114
9608026,9608026,,12,8,20,12,8,20,0.000626,0.002623,0,4532,0,0.00002,12,0.213093,0.246441,37064.383706,0.110526,0.003425
9609115,9609115,,5,8,13,5,8,13,0.000136,0.002746,0,6115,0,0.000016,12,0.176203,0.2105,7978.084868,0.121795,0.001747
9704047,9704047,,2,7,9,2,7,9,0.000071,0.000112,0,6114,0,0.000011,12,0.194409,0.217343,448.209919,0.388889,0.00074
9704169,9704169,,9,23,32,9,23,32,0.000958,0.002456,0,7033,9,0.000015,11,0.227616,0.26147,43117.568262,0.157258,0.002601
9607148,9607148,,3,17,20,3,17,20,0.000153,0.005482,0,6116,0,0.000014,11,0.196613,0.23507,857.92512,0.102632,0.001288
9308066,9308066,,13,4,17,13,4,17,0.0001,0.000093,0,627,0,0.000061,1,1,1,6608.454934,0.066176,0.003342
9812104,9812104,,5,7,12,5,7,12,0.000696,0.00094,0,10797,8,0.000015,14,0.215397,0.248711,14784.827152,0.106061,0.001376
2096,2096,,2,4,6,2,4,6,0,0.000006,0,11712,23,0.000016,15,0.15472,0.169695,3140.665461,0.166667,0.000445
9903167,9903167,,2,0,2,2,0,2,0,0,0,11711,23,0.000016,0,0,0,0,0.5,0.000458
9212112,9212112,,10,0,10,10,0,10,0.000005,0,0,2566,23,0.000041,0,0,0,0,0.077778,0.002556
9302123,9302123,,10,0,10,10,0,10,0.000038,0,0,4108,23,0.000068,0,0,0,0,0.055556,0.002934
9305132,9305132,,10,2,12,10,2,12,0.000001,0,0,4098,23,0.000028,2,0.75,0.833333,1535.187237,0.075758,0.002631
9401140,9401140,,4,0,4,4,0,4,0,0,0,4096,23,0.000019,0,0,0,0,0,0.001062
9510089,9510089,,2,0,2,2,0,2,0,0,0,7382,23,0.000013,0,0,0,0,0,0.000566
9606045,9606045,,6,2,8,6,2,8,0.000166,0.000002,0,5027,23,0.000018,9,0.18013,0.198429,12582.542209,0.107143,0.001524
2097,2097,,0,15,15,0,15,15,0,0.001408,0,11713,0,0.00001,15,0.197999,0.227771,0,0.095238,0
9805045,9805045,,12,38,50,12,38,50,0.002276,0.011222,0,6946,0,0.000013,13,0.213816,0.248442,12864.032425,0.112245,0.003388
9307108,9307108,,31,1,32,31,1,32,0.001529,0.000006,0,1612,41,0.000169,1,1,1,6403.706558,0.064516,0.010097
9405195,9405195,,1,7,8,1,7,8,0.000097,0.000174,0,1748,41,0.000023,6,0.367521,0.479845,30225.820984,0.035714,0.001575
9702104,9702104,,3,0,3,3,0,3,0.000064,0,0,4861,21,0.00002,0,0,0,0,0,0.001061
9707106,9707106,,1,0,1,1,0,1,0.000064,0,0,4859,4,0.000011,0,0,0,0,0,0.000622
9709211,9709211,,8,27,35,8,27,35,0.000961,0.008088,0,4814,4,0.000013,14,0.200547,0.237241,156029.242323,0.14958,0.002867
2098,2098,,8,15,23,8,15,23,0.000015,0.012216,0,11715,23,0.000033,13,0.187958,0.212859,23765.996747,0.073123,0.001792
9911209,9911209,,6,6,12,6,6,12,0.000179,0.000075,0,11714,23,0.000019,15,0.148476,0.161925,327.250413,0.151515,0.0014
9408156,9408156,,7,0,7,7,0,7,0,0,0,3069,22,0.000084,0,0,0,0,0.214286,0.001809
2099,2099,,11,17,28,11,17,28,0.001984,0.002154,0,11596,1,0.000021,13,0.198139,0.221135,30908.512198,0.206349,0.004449
2100,2100,,21,31,52,21,31,52,0.001266,0.020166,0,11716,1,0.00002,11,0.234428,0.267216,38253.299573,0.113499,0.005986
9204041,9204041,,13,0,13,13,0,13,0.000019,0,0,314,0,0.000202,0,0,0,0,0.121795,0.004507
9707031,9707031,,2,5,7,2,5,7,0.000111,0.000018,0,3937,26,0.000017,15,0.125773,0.144508,168458.931289,0.190476,0.002061
9507036,9507036,,24,13,37,24,13,37,0.00072,0.003239,0,3296,4,0.00007,8,0.231181,0.269654,178538.335904,0.075075,0.007325
9707121,9707121,,1,0,1,1,0,1,0.000135,0,0,3896,2,0.000012,0,0,0,0,0,0.000946
9609113,9609113,,14,6,20,14,6,20,0.000534,0.000857,0,3665,10,0.000028,12,0.209532,0.240063,168128.873924,0.171053,0.004664
2101,2101,,11,16,27,11,16,27,0.000932,0.003221,0,11717,30,0.000015,13,0.196623,0.216241,2109.364961,0.173789,0.004002
9607182,9607182,,6,2,8,6,2,8,0.000115,0.000068,0,3411,2,0.000021,8,0.228764,0.253729,1186.203665,0.142857,0.001976
9709145,9709145,,6,6,12,6,6,12,0.000147,0.000014,0,6863,30,0.000018,12,0.142928,0.157834,59497.312856,0.128788,0.001943
9709198,9709198,,5,17,22,5,17,22,0.000256,0.006278,0,6838,30,0.000017,12,0.201445,0.233726,2270.035256,0.142857,0.002178
9805027,9805027,,1,21,22,1,21,22,0.000068,0.007626,0,6839,13,0.000012,14,0.19162,0.227698,14995.617211,0.158009,0.000747
2102,2102,,3,58,61,3,58,61,0.000186,0.012485,0,11725,0,0.000011,14,0.229606,0.266819,5413.586462,0.121858,0.000684
9606016,9606016,,7,20,27,7,20,27,0.001145,0.006042,0,2140,13,0.000017,10,0.220982,0.255124,11939.087224,0.205128,0.002521
9805190,9805190,,9,17,26,9,17,26,0.000497,0.002255,0,11724,0,0.000014,14,0.18878,0.221118,1930.019872,0.207692,0.002065
9812141,9812141,,6,31,37,6,31,37,0.000442,0.002938,0,11723,0,0.000012,12,0.21569,0.252194,17395.47606,0.113363,0.001599
9812253,9812253,,3,11,14,3,11,14,0.000326,0.001641,0,11718,0,0.000011,12,0.197461,0.22579,164.256426,0.214286,0.000704
9305040,9305040,,12,63,75,12,63,75,0.000792,0.000278,0,429,5,0.000033,4,0.696296,0.819149,267090.358112,0.040541,0.004089
9601104,9601104,,2,20,22,2,20,22,0.000096,0.000223,0,2521,26,0.000013,9,0.210925,0.264807,97685.134701,0.170996,0.000664
9607067,9607067,,13,9,22,13,9,22,0.000889,0.008186,0,2440,0,0.000031,10,0.218039,0.247416,8281.80159,0.077922,0.004306
9608056,9608056,,10,7,17,10,7,17,0.000152,0.00001,0,2715,5,0.000029,3,0.517241,0.588889,215653.373384,0.069853,0.003273
9609051,9609051,,3,4,7,3,4,7,0.000197,0.000744,0,2686,0,0.000013,10,0.223269,0.255065,3077.448111,0.142857,0.00136
9609046,9609046,,13,7,20,13,7,20,0.000946,0.001873,0,2719,0,0.00002,10,0.209826,0.237943,7565.751434,0.157895,0.004684
9403017,9403017,,4,0,4,4,0,4,0.000073,0,0,2878,4,0.000022,0,0,0,0,0.166667,0.001997
9510105,9510105,,1,1,2,1,1,2,0.000035,0.000001,0,3309,30,0.000027,1,1,1,12414.552212,0,0.000562
9705068,9705068,,7,17,24,7,17,24,0.000408,0.002469,0,8819,0,0.000012,13,0.210746,0.250536,1611.508392,0.199275,0.001778
9706075,9706075,,7,7,14,7,7,14,0.000403,0.00067,0,6359,4,0.000017,13,0.169097,0.190257,2243.456687,0.28022,0.002117
9807222,9807222,,4,19,23,4,19,23,0.00032,0.00041,0,8285,4,0.000012,15,0.161045,0.183619,28096.788524,0.241107,0.001144
9605019,9605019,,7,3,10,7,3,10,0.000035,0.000001,0,11722,15,0.000016,1,1,1,4124.085749,0.166667,0.001636
9708112,9708112,,7,34,41,7,34,41,0.000159,0.001937,0,8597,0,0.000014,15,0.200104,0.243502,8750.490591,0.087805,0.001756
9803262,9803262,,7,17,24,7,17,24,0.000199,0.001939,0,11719,0,0.000012,11,0.214949,0.249203,3011.105635,0.173913,0.001689
9906108,9906108,,2,9,11,2,9,11,0.000199,0.002183,0,10142,0,0.00001,11,0.225932,0.257147,820.538406,0.163636,0.000612
2103,2103,,19,29,48,19,29,48,0.002061,0.003016,0,11730,52,0.000017,11,0.217653,0.245764,26560.501872,0.138298,0.006893
9907086,9907086,,27,54,81,27,54,81,0.003064,0.008471,0,11729,4,0.000021,10,0.239666,0.277213,82734.136073,0.110648,0.010417
9409096,9409096,,10,1,11,10,1,11,0.000148,0,0,972,0,0.000052,2,0.666667,0.75,14086.924467,0.209091,0.003243
9409151,9409151,,8,0,8,8,0,8,0.000154,0,0,969,0,0.00003,0,0,0,0,0.196429,0.002482
9311014,9311014,,12,6,18,12,6,18,0.000352,0.000104,0,605,0,0.000032,1,1,1,3540.022425,0.088235,0.004915
9510022,9510022,,3,13,16,3,13,16,0.000169,0.000693,0,2454,0,0.000013,8,0.23322,0.281089,696.485348,0.2125,0.001188
9706023,9706023,,9,29,38,9,29,38,0.000671,0.003849,0,4493,4,0.000018,12,0.203065,0.23651,39585.800942,0.113798,0.003964
9805158,9805158,,24,30,54,24,30,54,0.00211,0.00319,0,8025,4,0.000017,12,0.211131,0.246924,18251.402272,0.128581,0.007168
9812072,9812072,,11,106,117,11,106,117,0.001666,0.031614,0,7995,4,0.000014,13,0.234386,0.281988,31639.487891,0.073165,0.003413
9903061,9903061,,4,10,14,4,10,14,0.000495,0.007299,0,11728,1,0.000011,11,0.191963,0.215836,5077.652732,0.247253,0.001441
9907074,9907074,,10,54,64,10,54,64,0.001155,0.008474,0,11726,4,0.000012,11,0.24025,0.278162,14779.388962,0.160466,0.002954
9412086,9412086,,1,7,8,1,7,8,0.000035,0.000172,0,11140,0,0.00001,2,0.733333,0.818182,5.495789,0.160714,0.000312
9801201,9801201,,7,2,9,7,2,9,0.000066,0.000035,0,11139,0,0.000016,3,0.461538,0.527778,39.469666,0.152778,0.00182
2104,2104,,7,23,30,7,23,30,0.001044,0.008604,0,11731,1,0.000012,12,0.206187,0.233859,1801.045256,0.165517,0.001758
9902166,9902166,,7,28,35,7,28,35,0.001218,0.008923,0,8359,13,0.000015,14,0.203638,0.238445,19107.856797,0.110084,0.002214
9707232,9707232,,3,2,5,3,2,5,0.000222,0.000024,0,7418,10,0.000013,17,0.160367,0.182883,17339.64843,0.05,0.000984
9705079,9705079,,9,33,42,9,33,42,0.001263,0.009235,0,4705,13,0.000014,11,0.226626,0.267751,4296.616505,0.168409,0.002744
9901102,9901102,,11,12,23,11,12,23,0.000718,0.00132,0,8435,13,0.000041,12,0.194269,0.220938,5613.905934,0.108696,0.005863
9412002,9412002,,11,2,13,11,2,13,0.000912,0.000014,0,1246,13,0.000036,6,0.30922,0.335321,9949.889694,0.044872,0.00358
2105,2105,,1,4,5,1,4,5,0,0.000006,0,11768,26,0.000013,16,0.143884,0.155419,7682.687876,0.1,0.000219
9504105,9504105,,15,2,17,15,2,17,0.000252,0,0,4274,26,0.000118,4,0.402597,0.443548,16660.800944,0.095588,0.004019
9803115,9803115,,3,0,3,3,0,3,0,0,0,11767,26,0.000025,0,0,0,0,0,0.000664
9911177,9911177,,4,12,16,4,12,16,0.000001,0.000049,0,11766,26,0.000016,15,0.167408,0.185475,23338.092515,0.091667,0.00089
9302129,9302129,,15,1,16,15,1,16,0.000013,0,0,3122,28,0.000092,1,1,1,12236.61285,0.0625,0.003747
9306050,9306050,,4,0,4,4,0,4,0.000016,0,0,7364,23,0.000013,0,0,0,0,0.166667,0.001028
9612112,9612112,,6,4,10,6,4,10,0.000184,0,0,11739,23,0.00002,4,0.415094,0.507576,11851.886826,0.166667,0.001436
9802040,9802040,,6,2,8,6,2,8,0.000367,0.000003,0,11756,23,0.000015,14,0.177964,0.195265,9377.353519,0.160714,0.001447
9803149,9803149,,3,5,8,3,5,8,0.000194,0.000053,0,11752,41,0.000013,19,0.118343,0.141031,358.223897,0.232143,0.000745
9812166,9812166,,8,22,30,8,22,30,0.000407,0.015599,0,11757,41,0.000017,14,0.182307,0.209503,209710.658296,0.055172,0.001931
9904173,9904173,,2,6,8,2,6,8,0.000001,0.000003,0,11762,26,0.000016,16,0.123657,0.141424,2336.094507,0.089286,0.000471
9904180,9904180,,1,15,16,1,15,16,0.000001,0.010501,0,11765,28,0.000011,15,0.179113,0.204569,1947.1254,0.075,0.000245
9905132,9905132,,1,2,3,1,2,3,0.000001,0,0,11764,26,0.000011,17,0.110144,0.121783,6,0.166667,0.000245
9906085,9906085,,4,14,18,4,14,18,0.000283,0.015519,0,11758,1,0.000013,14,0.192923,0.216723,87604.329682,0.111111,0.001269
2106,2106,,20,7,27,20,7,27,0.003134,0.017073,0,11769,1,0.000036,15,0.17703,0.200229,11378.650178,0.138177,0.005407
2107,2107,,5,14,19,5,14,19,0.000767,0.003207,0,11771,2,0.000012,13,0.178104,0.19887,4235.725229,0.280702,0.001812
9909191,9909191,,8,6,14,8,6,14,0.000884,0.000115,0,11583,2,0.000019,17,0.159868,0.17625,21952.048747,0.258242,0.002464
9912163,9912163,,5,2,7,5,2,7,0.000732,0.000039,0,11770,2,0.000013,17,0.155849,0.169688,0,0.380952,0.001672
2108,2108,,3,6,9,3,6,9,0,0.000009,0,11778,26,0.000025,17,0.137647,0.150864,14701,0.041667,0.000658
9605079,9605079,,5,2,7,5,2,7,0.000233,0.000018,0,8030,26,0.000029,4,0.4,0.470238,306.793747,0.02381,0.001194
9608083,9608083,,9,4,13,9,4,13,0.000063,0.000037,0,9052,6,0.000029,10,0.173424,0.207614,7611.591372,0.057692,0.002282
9711144,9711144,,9,2,11,9,2,11,0.000001,0,0,11774,26,0.000055,2,0.6,0.666667,3291.212349,0.063636,0.002064
9805089,9805089,,4,6,10,4,6,10,0,0.00004,0,11777,26,0.000026,8,0.218281,0.273371,674.401818,0.044444,0.000896
9807039,9807039,,1,3,4,1,3,4,0,0,0,11776,26,0.000014,3,0.533333,0.645833,3,0.166667,0.000239
9410085,9410085,,5,1,6,5,1,6,0.000018,0,0,5087,6,0.000034,1,1,1,9603.642412,0.1,0.001347
9510119,9510119,,7,2,9,7,2,9,0.000011,0.000002,0,2525,0,0.000059,1,1,1,21704.711113,0.097222,0.001687
9608006,9608006,,9,2,11,9,2,11,0.000001,0,0,11773,26,0.000057,1,1,1,1682.625392,0.045455,0.002098
9709151,9709151,,5,0,5,5,0,5,0,0,0,11775,26,0.000027,0,0,0,0,0,0.001129
9405135,9405135,,7,0,7,7,0,7,0,0,0,10178,6,0.000092,0,0,0,0,0.095238,0.00165
9606046,9606046,,6,2,8,6,2,8,0.00001,0,0,10180,6,0.000046,1,1,1,4907,0.071429,0.001371
2109,2109,,0,1,1,0,1,1,0,0.000002,0,11779,22,0.00001,1,1,1,0,0,0
2110,2110,,14,7,21,14,7,21,0.001465,0.000367,0,11781,4,0.000017,15,0.173679,0.194893,4718.695658,0.2,0.003588
9906193,9906193,,19,36,55,19,36,55,0.001812,0.004348,0,11780,4,0.000017,14,0.1841,0.213289,5673.927199,0.221549,0.005781
3272,3272,,16,22,38,16,22,38,0.001541,0.008886,0,11782,4,0.000017,16,0.200687,0.230134,26959.685152,0.150071,0.004069
9211121,9211121,,35,0,35,35,0,35,0.001464,0,0,824,4,0.000066,0,0,0,0,0.07479,0.011347
9306150,9306150,,11,0,11,11,0,11,0.000284,0,0,1198,4,0.000052,0,0,0,0,0.118182,0.005384
9904087,9904087,,25,39,64,25,39,64,0.002191,0.004177,0,10888,4,0.000016,13,0.202545,0.234707,19469.471476,0.196181,0.007441
9809159,9809159,,8,2,10,8,2,10,0.001074,0.000475,0,8134,1,0.000023,1,1,1,7493.508907,0.088889,0.002221
9906175,9906175,,1,9,10,1,9,10,0.000329,0.018658,0,8746,1,0.00001,11,0.225776,0.255274,0,0.466667,0.000369
2112,2112,,0,4,4,0,4,4,0,0.000208,0,11801,28,0.00001,18,0.141967,0.159217,0,0.5,0
9412222,9412222,,8,4,12,8,4,12,0.000056,0.002091,0,7461,28,0.000028,6,0.266393,0.308846,452.672123,0.143939,0.002025
9901038,9901038,,5,10,15,5,10,15,0.000009,0.003092,0,11799,28,0.000021,17,0.165375,0.194223,21020.120332,0.090476,0.001117
9910007,9910007,,1,4,5,1,4,5,0.000002,0.000212,0,11800,28,0.000012,18,0.142522,0.16029,63.308384,0.45,0.000219
9805043,9805043,,8,3,11,8,3,11,0.000044,0.000002,0,11798,2,0.000022,14,0.158423,0.174415,4094.975067,0.172727,0.001892
9810137,9810137,,4,19,23,4,19,23,0.000063,0.002056,0,10406,4,0.00002,16,0.167727,0.191638,30938.283986,0.152174,0.000923
9409173,9409173,,1,0,1,1,0,1,0,0,0,10787,25,0.000016,0,0,0,0,0,0.000226
9412156,9412156,,1,0,1,1,0,1,0,0,0,10786,25,0.000016,0,0,0,0,0,0.000226
2114,2114,,3,9,12,3,9,12,0.000007,0.000007,0,11806,23,0.000011,18,0.135722,0.164953,546.207578,0.113636,0.000664
9208062,9208062,,7,0,7,7,0,7,0.000001,0,0,4721,23,0.000072,0,0,0,0,0.214286,0.001961
9411180,9411180,,6,1,7,6,1,7,0,0,0,11803,23,0.000024,1,1,1,6.75,0.214286,0.0014
9603020,9603020,,2,2,4,2,2,4,0,0,0,11804,23,0.000013,1,1,1,0,0.5,0.000478
9603180,9603180,,3,6,9,3,6,9,0,0,0,11805,23,0.000014,8,0.229765,0.264035,290.023677,0.138889,0.000684
9708098,9708098,,10,3,13,10,3,13,0.000006,0.000003,0,6604,23,0.000023,8,0.191957,0.211203,10621.484359,0.115385,0.002463
9901125,9901125,,8,0,8,8,0,8,0.000014,0,0,11802,23,0.00002,0,0,0,0,0.071429,0.001813
9303145,9303145,,11,0,11,11,0,11,0.000002,0,0,4325,23,0.000345,0,0,0,0,0.3,0.003909
9301034,9301034,,11,0,11,11,0,11,0.000001,0,0,2687,23,0.000081,0,0,0,0,0.054545,0.002576
9306068,9306068,,4,0,4,4,0,4,0,0,0,4764,23,0.000022,0,0,0,0,0.083333,0.001041
9511100,9511100,,10,4,14,10,4,14,0.000007,0.000087,0,4748,23,0.000028,7,0.288136,0.32388,6501.197115,0.131868,0.002778
9609074,9609074,,7,9,16,7,9,16,0.00005,0.00001,0,6212,22,0.000031,7,0.236581,0.271128,24372.276147,0.108333,0.001759
9412141,9412141,,4,7,11,4,7,11,0.000013,0.00001,0,6627,23,0.000014,5,0.356061,0.447163,3957.610145,0.181818,0.001253
9505049,9505049,,23,8,31,23,8,31,0.000005,0.000044,0,4735,23,0.000051,7,0.208333,0.265496,25433.082735,0.147312,0.006001
9508075,9508075,,26,6,32,26,6,32,0.000021,0.000004,0,4745,23,0.000043,8,0.18544,0.241817,34920.990241,0.114919,0.006585
9509133,9509133,,29,9,38,29,9,38,0.000023,0.000014,0,4763,23,0.000091,7,0.22291,0.281481,34040.74664,0.08037,0.007748
9602017,9602017,,14,8,22,14,8,22,0.000006,0.000015,0,4747,23,0.000028,7,0.217116,0.274157,1437.713108,0.181818,0.003469
9607040,9607040,,17,9,26,17,9,26,0.000018,0.000009,0,4765,23,0.00003,8,0.234965,0.273352,118201.445102,0.133846,0.004333
9703048,9703048,,11,12,23,11,12,23,0.000002,0.000005,0,6618,23,0.000019,8,0.229467,0.264438,8923.638921,0.20751,0.002646
9703219,9703219,,8,14,22,8,14,22,0.000006,0.000094,0,6626,22,0.000024,17,0.144795,0.177602,43157.656882,0.075758,0.002071
9705186,9705186,,5,17,22,5,17,22,0.000001,0.000019,0,6625,23,0.000013,8,0.237558,0.281402,27410.055616,0.203463,0.001197
9707033,9707033,,6,8,14,6,8,14,0.000011,0.000007,0,6622,23,0.000016,8,0.2355,0.272047,15734.355886,0.252747,0.001506
9707100,9707100,,11,10,21,11,10,21,0.000026,0.000007,0,6623,23,0.000022,8,0.236567,0.276341,22376.448585,0.147619,0.002736
9710091,9710091,,2,12,14,2,12,14,0.000119,0.000017,0,6621,23,0.000011,9,0.211775,0.246468,20931.276785,0.203297,0.000514
9712157,9712157,,9,9,18,9,9,18,0.00001,0.000069,0,6614,23,0.000015,11,0.179991,0.228049,75698.579614,0.04902,0.002192
9801021,9801021,,7,13,20,7,13,20,0.000151,0.000023,0,6608,23,0.000017,11,0.187518,0.226311,28194.431214,0.076316,0.001696
2115,2115,,0,3,3,0,3,3,0,0.000001,0,11819,15,0.00001,13,0.160384,0.173842,0,0.5,0
9308128,9308128,,5,0,5,5,0,5,0.000009,0,0,11815,15,0.00004,0,0,0,0,0.35,0.001175
9404190,9404190,,5,1,6,5,1,6,0.000009,0,0,11816,15,0.000022,1,1,1,1,0.266667,0.001155
9704049,9704049,,4,11,15,4,11,15,0.000047,0.000062,0,11818,15,0.000015,12,0.190899,0.214979,2408.041614,0.085714,0.000896
9401009,9401009,,21,0,21,21,0,21,0.000018,0,0,11721,15,0.000084,0,0,0,0,0.104762,0.005012
9410014,9410014,,5,6,11,5,6,11,0.000127,0.000101,0,5401,2,0.000014,4,0.46988,0.534188,2082.549157,0.072727,0.001226
9410239,9410239,,1,2,3,1,2,3,0.000001,0,0,11817,15,0.000011,1,1,1,0,0.5,0.000245
9607140,9607140,,5,4,9,5,4,9,0.000009,0,0,11810,15,0.000017,2,0.833333,0.9,12.733333,0.25,0.001175
9609032,9609032,,3,8,11,3,8,11,0.000001,0.000001,0,11814,15,0.000014,1,1,1,40.9,0.1,0.000703
9609033,9609033,,3,6,9,3,6,9,0.000009,0.000001,0,11811,15,0.000012,1,1,1,12.783333,0.263889,0.000703
2116,2116,,3,68,71,3,68,71,0.000483,0.03166,0,11828,1,0.000013,12,0.236504,0.274475,39595.642366,0.112274,0.00092
9306080,9306080,,31,3,34,31,3,34,0.001588,0.000042,0,831,0,0.000053,1,1,1,13251.602515,0.08467,0.010654
9907216,9907216,,23,20,43,23,20,43,0.004842,0.019836,0,8836,1,0.000025,10,0.230304,0.261869,15788.620221,0.168328,0.009064
9907219,9907219,,21,29,50,21,29,50,0.003829,0.020117,0,8833,1,0.000024,11,0.212487,0.241078,8105.609863,0.138367,0.006167
9908005,9908005,,8,1,9,8,1,9,0.001729,0.00569,0,11827,1,0.000026,14,0.177664,0.19711,2410.687842,0.083333,0.002504
9909137,9909137,,7,5,12,7,5,12,0.001117,0.006354,0,8834,1,0.000015,12,0.18666,0.207523,87.915624,0.333333,0.001807
9909188,9909188,,10,11,21,10,11,21,0.001645,0.013066,0,8838,1,0.000015,11,0.227087,0.256714,8287.659306,0.247619,0.002551
9911095,9911095,,9,32,41,9,32,41,0.002396,0.031078,0,11826,1,0.000014,11,0.234183,0.268483,22437.65814,0.143293,0.002457
9912107,9912107,,12,33,45,12,33,45,0.002003,0.022146,0,11821,1,0.000016,11,0.232252,0.265679,12540.619756,0.161616,0.003298
9912277,9912277,,4,9,13,4,9,13,0.000754,0.017023,0,11822,1,0.000012,11,0.224661,0.254431,883.854182,0.288462,0.000954
9205066,9205066,,13,0,13,13,0,13,0.000078,0,0,758,0,0.000149,0,0,0,0,0.051282,0.003539
9208029,9208029,,40,0,40,40,0,40,0.001161,0,0,826,0,0.000091,0,0,0,0,0.066026,0.01194
9411205,9411205,,29,11,40,29,11,40,0.00124,0.001723,0,839,4,0.000048,6,0.284553,0.344286,45730.460618,0.129487,0.009754
9505123,9505123,,14,17,31,14,17,31,0.000907,0.003142,0,840,0,0.000023,8,0.236355,0.289347,42128.262284,0.165591,0.00521
9706048,9706048,,4,6,10,4,6,10,0.000877,0.000521,0,6155,13,0.000025,12,0.186313,0.210701,2207.805083,0.077778,0.001905
9806226,9806226,,17,13,30,17,13,30,0.002061,0.003504,0,7654,0,0.000017,12,0.212898,0.244095,4125.581823,0.166667,0.006232
9401073,9401073,,5,4,9,5,4,9,0.000238,0.000165,0,696,26,0.000024,1,1,1,490.15224,0.208333,0.002139
9310019,9310019,,6,3,9,6,3,9,0.000175,0.00002,0,830,0,0.000023,2,0.8,0.875,5580.699524,0.055556,0.001626
9811098,9811098,,4,26,30,4,26,30,0.000141,0.00432,0,8635,13,0.000014,14,0.187504,0.220052,14192.322479,0.093103,0.001066
9603083,9603083,,3,7,10,3,7,10,0.000463,0.000016,0,10739,15,0.000016,2,0.705882,0.791667,15439.963362,0.133333,0.00074
9812022,9812022,,11,14,25,11,14,25,0.000873,0.000063,0,9810,20,0.000016,16,0.152534,0.172361,114446.989023,0.126667,0.002793
9902137,9902137,,17,9,26,17,9,26,0.003686,0.016602,0,8242,1,0.000019,13,0.195023,0.218428,7127.533576,0.196923,0.004609
9908162,9908162,,8,32,40,8,32,40,0.000959,0.019048,0,8837,1,0.000013,11,0.214269,0.242175,2762.436368,0.16859,0.002961
9711153,9711153,,1,58,59,1,58,59,0.000365,0.019657,0,11825,13,0.00001,14,0.212384,0.262539,10737.664005,0.127119,0.000284
9910155,9910155,,8,36,44,8,36,44,0.001233,0.004594,0,11820,0,0.000012,11,0.211786,0.24059,5012.277696,0.162262,0.002233
2117,2117,,107,16,123,107,16,123,0.005034,0.002089,0,11829,3,0.000124,11,0.213555,0.23516,123582.846967,0.137745,0.061547
9311056,9311056,,7,0,7,7,0,7,0.000018,0,0,984,3,0.00006,0,0,0,0,0.071429,0.002844
9306089,9306089,,15,2,17,15,2,17,0.000062,0.000001,0,2066,6,0.000038,1,1,1,1099.159812,0.0625,0.004217
9311058,9311058,,3,7,10,3,7,10,0.000001,0,0,2063,6,0.000024,4,0.533333,0.621528,25393.932673,0.077778,0.001316
2118,2118,,5,99,104,5,99,104,0.000258,0.008169,0,11849,0,0.000011,11,0.254088,0.296036,221971.0253,0.069735,0.001352
9806001,9806001,,2,27,29,2,27,29,0.000159,0.013532,0,11848,2,0.00001,12,0.207013,0.237803,1061.008825,0.12069,0.000662
9808185,9808185,,9,31,40,9,31,40,0.001389,0.003632,0,8446,0,0.000013,15,0.199592,0.227548,10581.674508,0.167308,0.002636
9812021,9812021,,6,20,26,6,20,26,0.000313,0.003755,0,11847,0,0.000013,13,0.215155,0.250401,7394.331437,0.110769,0.001481
9901107,9901107,,16,20,36,16,20,36,0.000605,0.000829,0,8447,4,0.000019,16,0.187292,0.212262,17320.227206,0.224603,0.00482
9903095,9903095,,5,18,23,5,18,23,0.000189,0.001957,0,9984,4,0.000013,17,0.182263,0.207192,37498.795553,0.233202,0.001489
9905230,9905230,,10,29,39,10,29,39,0.000676,0.004863,0,11659,52,0.000014,11,0.209826,0.237713,4290.133784,0.175439,0.0028
9906247,9906247,,5,13,18,5,13,18,0.000879,0.001716,0,11840,0,0.000011,15,0.190726,0.216809,87.944747,0.30719,0.001211
9907157,9907157,,5,14,19,5,14,19,0.000196,0.001797,0,11831,0,0.000012,18,0.187097,0.211863,14275.181907,0.236842,0.001261
9909035,9909035,,11,17,28,11,17,28,0.000434,0.001956,0,11835,4,0.000015,17,0.183378,0.207714,6294.145379,0.272487,0.003091
9910236,9910236,,1,38,39,1,38,39,0.000096,0.008237,0,11846,0,0.00001,13,0.230632,0.261776,14373.565266,0.070175,0.000255
9911090,9911090,,5,51,56,5,51,56,0.000266,0.006917,0,11844,0,0.000011,12,0.204311,0.2379,18452.204469,0.119805,0.001166
9912082,9912082,,16,27,43,16,27,43,0.000629,0.002573,0,11839,4,0.000017,13,0.187578,0.213032,7549.545674,0.158361,0.004181
9912083,9912083,,13,23,36,13,23,36,0.000722,0.001995,0,11838,4,0.000017,16,0.178404,0.203478,33663.850791,0.185714,0.003521
9607151,9607151,,21,19,40,21,19,40,0.00137,0.003744,0,3482,4,0.000018,14,0.158737,0.19324,622.448824,0.203846,0.006817
9705069,9705069,,15,15,30,15,15,30,0.000736,0.003303,0,4864,4,0.000015,12,0.162629,0.189279,3059.699091,0.214943,0.004413
9711076,9711076,,1,10,11,1,10,11,0.000046,0.003541,0,5804,4,0.00001,11,0.187457,0.213137,14.335858,0.245455,0.000394
9607198,9607198,,5,5,10,5,5,10,0.000093,0.000077,0,6352,26,0.000019,9,0.206487,0.243614,44562.356155,0.244444,0.001493
9701185,9701185,,16,26,42,16,26,42,0.001555,0.006383,0,4021,0,0.000019,12,0.214803,0.251042,4082.392128,0.175958,0.006284
9706068,9706068,,3,10,13,3,10,13,0.000065,0.000006,0,6348,22,0.000012,7,0.241706,0.318145,138888.107345,0.102564,0.001076
9804018,9804018,,5,16,21,5,16,21,0.000281,0.007236,0,6875,2,0.000015,13,0.200765,0.231848,11500.050581,0.195238,0.001994
9707125,9707125,,6,9,15,6,9,15,0.000219,0.003974,0,6903,0,0.000013,11,0.202884,0.231204,532.705581,0.157143,0.001742
9803078,9803078,,2,33,35,2,33,35,0.000487,0.004058,0,8065,13,0.00001,13,0.204884,0.242295,666.582752,0.157143,0.000617
9708149,9708149,,5,17,22,5,17,22,0.000097,0.002608,0,6943,4,0.000022,13,0.164203,0.190079,5696.719041,0.127706,0.001433
9704153,9704153,,12,5,17,12,5,17,0.000128,0.000091,0,5320,4,0.000029,12,0.158862,0.177122,1372.556138,0.224265,0.003281
9709080,9709080,,7,7,14,7,7,14,0.000119,0.000103,0,6471,4,0.000018,13,0.1701,0.189157,24638.847984,0.197802,0.001953
9805163,9805163,,3,7,10,3,7,10,0.000023,0.000348,0,9983,4,0.000013,16,0.164668,0.188437,31884.55669,0.233333,0.000708
9806237,9806237,,4,6,10,4,6,10,0.00007,0.000046,0,9974,4,0.000013,15,0.150772,0.167777,3548.777206,0.188889,0.001125
9310134,9310134,,11,4,15,11,4,15,0.000089,0.000165,0,2515,26,0.000019,1,1,1,55.89122,0.204762,0.002771
9602009,9602009,,4,3,7,4,3,7,0.000079,0.000001,0,4848,23,0.000013,1,1,1,14401.265226,0.071429,0.001074
9811258,9811258,,17,14,31,17,14,31,0.001459,0.002994,0,8349,52,0.000018,14,0.191498,0.216414,574.856409,0.241935,0.005334
9905212,9905212,,16,16,32,16,16,32,0.00111,0.004658,0,8641,52,0.000029,11,0.230625,0.262176,102954.297098,0.190524,0.005344
9707175,9707175,,12,5,17,12,5,17,0.000008,0.000009,0,10727,22,0.000033,8,0.192308,0.280881,4251.6815,0.231618,0.002961
9905169,9905169,,5,5,10,5,5,10,0.000091,0.000714,0,11830,3,0.000018,12,0.194918,0.21474,41342.394906,0.122222,0.001226
9410166,9410166,,1,2,3,1,2,3,0.000097,0.000014,0,11845,17,0.00001,4,0.4,0.458333,2538.526878,0,0.000226
9805031,9805031,,4,15,19,4,15,19,0.000247,0.002906,0,11842,0,0.000011,15,0.183447,0.212132,485.531477,0.210526,0.000937
9812081,9812081,,2,40,42,2,40,42,0.000113,0.005479,0,11843,0,0.00001,12,0.22013,0.25425,8745.333504,0.106272,0.000485
9907152,9907152,,34,19,53,34,19,53,0.00267,0.002811,0,10216,13,0.000026,15,0.2052,0.238656,30822.410993,0.066401,0.009969
9705041,9705041,,6,19,25,6,19,25,0.000219,0.002218,0,9391,4,0.000013,15,0.159187,0.188181,1251.191433,0.201667,0.001607
9901094,9901094,,2,0,2,2,0,2,0.000032,0,0,11837,10,0.000011,0,0,0,0,0,0.000545
9907156,9907156,,2,21,23,2,21,23,0.000039,0.004434,0,11836,13,0.000011,15,0.202458,0.233223,12369.586188,0.075099,0.000545
9909218,9909218,,2,18,20,2,18,20,0.000027,0.000324,0,11834,4,0.000011,17,0.176512,0.197512,5524.987947,0.184211,0.000538
2119,2119,,34,18,52,34,18,52,0.001153,0.004064,0,11850,30,0.000035,13,0.196557,0.217625,16100.283852,0.134615,0.012167
2120,2120,,1,4,5,1,4,5,0.000003,0.000204,0,11855,4,0.000011,15,0.164461,0.184814,0,0.5,0.000226
9803183,9803183,,10,27,37,10,27,37,0.00013,0.000855,0,11852,28,0.000019,15,0.19115,0.22647,26668.189809,0.066817,0.002735
9909135,9909135,,2,5,7,2,5,7,0.000005,0.00022,0,11854,4,0.000013,14,0.17535,0.200101,2071.280801,0.309524,0.000452
9406101,9406101,,32,10,42,32,10,42,0.000394,0.000054,0,1800,28,0.000086,5,0.373494,0.463978,18232.595104,0.087108,0.009386
9512130,9512130,,7,3,10,7,3,10,0.000099,0.00002,0,2898,28,0.000016,10,0.216886,0.245982,630.415721,0.2,0.002128
9606077,9606077,,15,30,45,15,30,45,0.000262,0.003687,0,2903,28,0.000022,10,0.233576,0.283827,113134.059187,0.056061,0.004028
9702144,9702144,,3,6,9,3,6,9,0.00005,0.000057,0,6971,28,0.000012,12,0.201735,0.227537,939.958916,0.138889,0.000828
9703154,9703154,,12,6,18,12,6,18,0.000145,0.00012,0,4685,28,0.000021,13,0.158042,0.179078,4367.261097,0.173203,0.003267
9710041,9710041,,9,15,24,9,15,24,0.000312,0.001573,0,6989,15,0.000017,15,0.17343,0.203109,42034.154938,0.052536,0.002467
9710064,9710064,,7,24,31,7,24,31,0.00014,0.011127,0,5316,2,0.000017,13,0.203571,0.240533,7021.987919,0.121505,0.001835
9710165,9710165,,12,34,46,12,34,46,0.000638,0.007618,0,5570,2,0.000018,11,0.217648,0.249593,41047.379272,0.092271,0.003182
9801100,9801100,,1,2,3,1,2,3,0.00001,0.000133,0,11851,28,0.00001,7,0.233766,0.265476,1370.316067,0.166667,0.000291
9709192,9709192,,14,47,61,14,47,61,0.001208,0.003394,0,6055,4,0.000021,13,0.202328,0.245338,250265.428026,0.097268,0.003704
9806239,9806239,,6,15,21,6,15,21,0.00017,0.001211,0,11853,28,0.000016,13,0.185184,0.213861,12683.315097,0.066667,0.001548
2121,2121,,43,12,55,43,12,55,0.003921,0.002288,0,11683,25,0.000053,16,0.197154,0.218303,18465.64819,0.113805,0.014075
2122,2122,,2,3,5,2,3,5,0,0,0,11859,6,0.000011,13,0.150589,0.178908,81.9,0.3,0.000471
9712111,9712111,,14,9,23,14,9,23,0,0.000002,0,11346,6,0.000033,12,0.170201,0.212949,18693.487834,0.130435,0.003302
9903082,9903082,,2,5,7,2,5,7,0,0,0,11857,6,0.000015,13,0.148855,0.182879,47.841919,0.333333,0.000478
9911192,9911192,,4,11,15,4,11,15,0,0.000001,0,11858,6,0.000019,12,0.169423,0.211054,911.168602,0.157143,0.000897
9709028,9709028,,8,5,13,8,5,13,0,0.000001,0,11345,6,0.000026,11,0.180589,0.220083,16915.871796,0.115385,0.001955
9811215,9811215,,5,6,11,5,6,11,0,0,0,11856,6,0.000019,12,0.164077,0.19888,865.24443,0.190909,0.001202
2123,2123,,4,4,8,4,4,8,0,0.000001,0,11863,6,0.000033,3,0.615385,0.729167,25.133333,0.089286,0.000916
9303043,9303043,,11,0,11,11,0,11,0,0,0,11862,6,0.000041,0,0,0,0,0.027273,0.002524
9506195,9506195,,2,1,3,2,1,3,0,0,0,11861,2,0.00002,1,1,1,6,0,0.000465
9806083,9806083,,2,2,4,2,2,4,0,0.000001,0,11860,6,0.000024,2,0.75,0.833333,15.266667,0.083333,0.000484
9411045,9411045,,6,1,7,6,1,7,0,0,0,6759,6,0.000048,1,1,1,158.560537,0.095238,0.001382
2126,2126,,11,25,36,11,25,36,0.003218,0.020684,0,11867,1,0.000015,11,0.207427,0.23245,25805.033466,0.153175,0.003754
9406061,9406061,,4,0,4,4,0,4,0.000312,0,0,5998,4,0.000013,0,0,0,0,0,0.001092
9910233,9910233,,3,8,11,3,8,11,0.000725,0.017212,0,11866,1,0.000012,11,0.226894,0.256287,1666.230404,0.336364,0.000883
9907079,9907079,,14,22,36,14,22,36,0.002755,0.019434,0,11865,1,0.000018,14,0.189143,0.213824,7325.357345,0.210317,0.004123
2127,2127,,3,21,24,3,21,24,0.000095,0.002786,0,11873,0,0.000011,13,0.186337,0.210343,9135.90336,0.231884,0.000906
9901001,9901001,,5,9,14,5,9,14,0.000193,0.000537,0,10573,0,0.000012,13,0.185011,0.206218,2795.792054,0.335165,0.001351
9909178,9909178,,3,20,23,3,20,23,0.000134,0.001805,0,11868,0,0.000011,12,0.198864,0.223876,731.030297,0.209486,0.000713
9910054,9910054,,13,44,57,13,44,57,0.001049,0.00712,0,11643,0,0.000015,17,0.194063,0.231097,17379.460085,0.117794,0.004537
9910207,9910207,,4,49,53,4,49,53,0.000196,0.006656,0,11872,0,0.000011,13,0.20781,0.24036,12988.454315,0.095791,0.000919
9408133,9408133,,13,4,17,13,4,17,0.000854,0.000054,0,11642,52,0.000018,2,0.833333,0.9,1415.101901,0.121324,0.005165
9909173,9909173,,2,8,10,2,8,10,0.000242,0.00006,0,11871,6,0.000011,14,0.178669,0.197465,3868.177398,0.066667,0.000484
2128,2128,,5,17,22,5,17,22,0.000625,0.017915,0,11875,1,0.000012,13,0.196401,0.222292,3289.090898,0.272727,0.001146
9711068,9711068,,3,10,13,3,10,13,0.000738,0.001033,0,10587,13,0.000011,14,0.184485,0.208463,58.626761,0.25,0.000738
9806010,9806010,,3,13,16,3,13,16,0.000544,0.008543,0,11874,1,0.000011,13,0.190661,0.216836,236.984026,0.208333,0.000713
9904135,9904135,,7,25,32,7,25,32,0.000915,0.018359,0,10588,1,0.000013,13,0.19607,0.227165,5422.167285,0.190524,0.001673
9704204,9704204,,11,27,38,11,27,38,0.001007,0.005025,0,4983,13,0.000024,13,0.213901,0.249635,4708.480386,0.239687,0.004637
9901115,9901115,,6,25,31,6,25,31,0.000734,0.00905,0,10586,13,0.000015,13,0.19711,0.227316,37576.715501,0.178495,0.001534
2129,2129,,2,9,11,2,9,11,0.000124,0.001725,0,11876,52,0.000011,14,0.179779,0.202988,262.194678,0.227273,0.000704
2130,2130,,14,84,98,14,84,98,0.001066,0.01024,0,11878,25,0.000023,16,0.211876,0.243081,45533.62451,0.101199,0.006534
9911134,9911134,,4,6,10,4,6,10,0.000564,0.002318,0,11877,25,0.000013,12,0.191812,0.21091,1164.097317,0.188889,0.001328
9605087,9605087,,14,18,32,14,18,32,0.000528,0.002929,0,3353,0,0.000037,11,0.214854,0.248223,21231.310176,0.091734,0.004998
2131,2131,,6,18,24,6,18,24,0.00153,0.004367,0,11879,2,0.000012,15,0.17645,0.20341,2451.129718,0.163043,0.002603
2132,2132,,21,27,48,21,27,48,0.001396,0.00314,0,11880,25,0.000029,12,0.199011,0.220643,14383.052704,0.130762,0.006695
2133,2133,,1,13,14,1,13,14,0.000041,0.002998,0,11883,13,0.000011,15,0.178851,0.202211,64.001709,0.252747,0.000232
9907202,9907202,,33,15,48,33,15,48,0.001745,0.001429,0,11881,41,0.000033,13,0.195336,0.220551,27224.8655,0.068262,0.011376
9912236,9912236,,8,17,25,8,17,25,0.00039,0.004105,0,11882,13,0.000014,14,0.192149,0.215848,8023.69605,0.115,0.002049
9509145,9509145,,4,20,24,4,20,24,0.000293,0.006207,0,2665,13,0.000013,11,0.216484,0.268637,709.215495,0.190217,0.001539
9610074,9610074,,19,41,60,19,41,60,0.001027,0.011944,0,3159,0,0.000037,10,0.236022,0.280249,33312.800348,0.120339,0.007792
9708055,9708055,,24,38,62,24,38,62,0.002995,0.005884,0,4629,13,0.000024,16,0.198815,0.239659,107830.774296,0.081967,0.00813
9803006,9803006,,7,23,30,7,23,30,0.000954,0.005311,0,6551,13,0.000013,15,0.180894,0.217647,42484.951219,0.233333,0.002475
9910030,9910030,,41,5,46,41,5,46,0.002228,0.000299,0,9826,13,0.000045,17,0.190727,0.219735,40529.934711,0.033333,0.011422
2134,2134,,1,13,14,1,13,14,0.000008,0.000935,0,11884,2,0.000011,12,0.20187,0.223323,170.300396,0.186813,0.000252
2135,2135,,1,7,8,1,7,8,0.000189,0.007759,0,11885,1,0.00001,11,0.226379,0.255907,333.885823,0.232143,0.000374
9710212,9710212,,13,29,42,13,29,42,0.000623,0.003618,0,9659,0,0.000022,11,0.210199,0.246312,26830.044851,0.114983,0.003384
9803202,9803202,,1,3,4,1,3,4,0.000118,0.000031,0,9830,4,0.00001,14,0.158849,0.175675,6011.887347,0.083333,0.000333
9805152,9805152,,14,15,29,14,15,29,0.000139,0.000182,0,9828,0,0.000025,11,0.188944,0.214042,17252.609067,0.205665,0.00354
2136,2136,,3,6,9,3,6,9,0,0,0,11886,20,0.000021,9,0.163623,0.207784,910.058498,0.069444,0.000785
9407027,9407027,,18,1,19,18,1,19,0,0,0,1362,20,0.000167,1,1,1,121.938259,0.108187,0.004535
9505084,9505084,,18,2,20,18,2,20,0.000007,0,0,1363,20,0.000085,1,1,1,12579.57111,0.115789,0.004631
9803264,9803264,,13,0,13,13,0,13,0.000001,0,0,9815,20,0.000058,0,0,0,0,0.012821,0.002968
9310031,9310031,,12,0,12,12,0,12,0,0,0,1361,20,0.000251,0,0,0,0,0.265152,0.003134
2138,2138,,15,25,40,15,25,40,0.000954,0.002823,0,11889,30,0.000023,13,0.204235,0.226654,27526.274831,0.107692,0.005353
9912174,9912174,,7,7,14,7,7,14,0.000532,0.002713,0,11888,30,0.000022,13,0.188007,0.205237,6387.888392,0.120879,0.002376
9912238,9912238,,20,2,22,20,2,22,0.000342,0.00079,0,11887,30,0.000043,13,0.184412,0.199792,5351.855907,0.090909,0.005956
9311094,9311094,,4,0,4,4,0,4,0.000101,0,0,6999,28,0.000019,0,0,0,0,0.166667,0.001227
9509092,9509092,,14,0,14,14,0,14,0.000374,0,0,5312,15,0.000067,0,0,0,0,0.076923,0.004478
9510011,9510011,,7,5,12,7,5,12,0.000144,0.000015,0,6980,30,0.000034,2,0.727273,0.8125,18118.763072,0.037879,0.002009
9512056,9512056,,1,1,2,1,1,2,0.000081,0.000002,0,6998,30,0.000011,3,0.45,0.5,0,0.5,0.000495
9604142,9604142,,8,9,17,8,9,17,0.000178,0.000012,0,6983,15,0.00003,7,0.258312,0.361975,54791.742103,0.084559,0.002197
9612221,9612221,,7,10,17,7,10,17,0.000213,0.002428,0,6984,15,0.000018,15,0.185981,0.213534,14542.548616,0.073529,0.002052
9702046,9702046,,12,14,26,12,14,26,0.000442,0.000097,0,6975,15,0.000022,13,0.198707,0.228616,49003.553446,0.047692,0.003285
9705013,9705013,,6,18,24,6,18,24,0.000877,0.00456,0,5717,2,0.000017,14,0.198962,0.235818,10099.847537,0.092391,0.002492
9802091,9802091,,4,29,33,4,29,33,0.000753,0.008852,0,5743,2,0.000015,13,0.206664,0.242377,157265.937017,0.132576,0.002008
9512124,9512124,,23,26,49,23,26,49,0.001343,0.00302,0,3288,13,0.000027,12,0.196063,0.247583,28292.804985,0.193027,0.006837
9904168,9904168,,2,2,4,2,2,4,0.000233,0.000009,0,8996,5,0.000011,3,0.555556,0.666667,464.198009,0.25,0.000742
9711183,9711183,,32,6,38,32,6,38,0.000394,0.000096,0,9358,30,0.000104,14,0.164191,0.181953,28425.050777,0.047653,0.01042
2139,2139,,3,7,10,3,7,10,0.000036,0.000004,0,11898,3,0.000013,9,0.20217,0.227601,78.262373,0.3,0.000684
9207051,9207051,,6,0,6,6,0,6,0.000052,0,0,11895,3,0.000019,0,0,0,0,0.3,0.001404
9307093,9307093,,7,0,7,7,0,7,0.000034,0,0,11893,3,0.000023,0,0,0,0,0.309524,0.001826
9509097,9509097,,6,8,14,6,8,14,0.000018,0.000197,0,11892,3,0.000019,4,0.46875,0.572222,300.964728,0.181319,0.00146
9511153,9511153,,4,12,16,4,12,16,0.000017,0.000221,0,11896,3,0.000016,8,0.251427,0.295566,7002.35099,0.145833,0.001043
9512224,9512224,,8,7,15,8,7,15,0.000044,0.000026,0,11894,3,0.000022,8,0.250802,0.291724,9575.363543,0.114286,0.002029
9704116,9704116,,4,6,10,4,6,10,0.000038,0.000004,0,11897,3,0.000015,9,0.201942,0.226509,2138.966711,0.311111,0.001028
9210065,9210065,,142,0,142,142,0,142,0.005268,0,0,472,3,0.000153,0,0,0,0,0.06338,0.055616
9303143,9303143,,117,0,117,117,0,117,0.004658,0,0,796,3,0.000111,0,0,0,0,0.074565,0.048694
9306119,9306119,,9,2,11,9,2,11,0.00006,0.000006,0,5927,3,0.000036,1,1,1,382.377682,0.1,0.002257
9505134,9505134,,4,5,9,4,5,9,0.000015,0.000194,0,11891,3,0.000018,1,1,1,138.856806,0.208333,0.00112
9508062,9508062,,4,4,8,4,4,8,0.000006,0.000003,0,10446,3,0.000017,2,0.75,0.833333,7423.832736,0.125,0.001031
9309015,9309015,,4,0,4,4,0,4,0.000015,0,0,11890,3,0.000019,0,0,0,0,0.416667,0.001108
2140,2140,,11,30,41,11,30,41,0.00061,0.001365,0,11904,0,0.000016,12,0.188003,0.210389,80844.005348,0.24939,0.003049
9804028,9804028,,22,20,42,22,20,42,0.001344,0.002721,0,8170,0,0.000034,15,0.178019,0.207018,6245.105562,0.238676,0.006575
9806085,9806085,,17,21,38,17,21,38,0.001267,0.001254,0,8854,0,0.000027,15,0.177894,0.20674,7234.43187,0.283784,0.005332
9809034,9809034,,20,22,42,20,22,42,0.00147,0.006956,0,8855,0,0.000028,14,0.193825,0.222699,7795.444621,0.246806,0.005983
9812113,9812113,,8,17,25,8,17,25,0.000221,0.000286,0,11903,0,0.00002,13,0.176171,0.198223,10854.852459,0.215,0.002292
9907077,9907077,,10,8,18,10,8,18,0.000531,0.000568,0,11901,0,0.000016,14,0.172709,0.19112,2143.899609,0.372549,0.002903
9912049,9912049,,9,10,19,9,10,19,0.000397,0.001147,0,11899,0,0.000018,13,0.179256,0.204119,6714.075975,0.078947,0.002525
9504124,9504124,,6,6,12,6,6,12,0.000128,0.000091,0,1598,28,0.000035,4,0.457143,0.614583,39491.286247,0.121212,0.002509
9601125,9601125,,5,0,5,5,0,5,0.000135,0,0,1551,0,0.000034,0,0,0,0,0.1,0.002324
9312150,9312150,,11,10,21,11,10,21,0.00025,0.000063,0,1802,28,0.000032,5,0.393443,0.497917,27128.646558,0.085714,0.003782
9206076,9206076,,7,0,7,7,0,7,0.000141,0,0,2879,28,0.000043,0,0,0,0,0.02381,0.001819
9512115,9512115,,7,3,10,7,3,10,0.000342,0.000006,0,8168,1,0.000033,4,0.407407,0.477273,39841.313296,0.033333,0.002138
9805127,9805127,,3,0,3,3,0,3,0.000244,0,0,11902,1,0.000012,0,0,0,0,0.166667,0.000869
9709007,9709007,,2,1,3,2,1,3,0.000396,0.000003,0,5535,0,0.000017,1,1,1,2537.287708,0.166667,0.00159
9907034,9907034,,3,7,10,3,7,10,0.00008,0.000563,0,11900,0,0.000013,14,0.17299,0.191341,1256.232674,0.277778,0.000822
2141,2141,,6,11,17,6,11,17,0.00155,0.011399,0,11905,1,0.000011,11,0.196415,0.217764,2387.644021,0.183824,0.001879
12168,12168,,5,3,8,5,3,8,0.00073,0.000115,0,11906,1,0.000014,14,0.170286,0.18325,0.421429,0.446429,0.001686
9702047,9702047,,5,10,15,5,10,15,0.00102,0.001257,0,5385,4,0.00003,11,0.175765,0.212581,33402.835119,0.119048,0.002849
9701076,9701076,,1,8,9,1,8,9,0.000145,0.000022,0,5568,26,0.000023,8,0.191933,0.22346,93227.378493,0.222222,0.001848
2142,2142,,11,7,18,11,7,18,0.000356,0.000106,0,11907,9,0.000014,17,0.170006,0.19477,500.835919,0.245098,0.003037
9303050,9303050,,10,6,16,10,6,16,0.000004,0,0,3787,9,0.000035,1,1,1,5951.632367,0.258333,0.003148
9606130,9606130,,28,29,57,28,29,57,0.000533,0.000205,0,7092,9,0.000027,12,0.172218,0.199716,119216.511843,0.16698,0.009217
9606143,9606143,,28,12,40,28,12,40,0.000347,0.000195,0,7076,9,0.000028,11,0.202559,0.230817,34469.140279,0.25641,0.009034
9704082,9704082,,14,7,21,14,7,21,0.000397,0.00017,0,7100,9,0.000018,11,0.202206,0.228773,1084.029958,0.3,0.004395
9707090,9707090,,30,36,66,30,36,66,0.001462,0.0005,0,7104,9,0.000026,16,0.202961,0.245928,99749.271452,0.195571,0.009442
9209046,9209046,,8,0,8,8,0,8,0.000002,0,0,3783,9,0.000096,0,0,0,0,0.375,0.002357
9212010,9212010,,10,1,11,10,1,11,0.000003,0,0,3784,9,0.000057,1,1,1,1532.252177,0.363636,0.003225
9212015,9212015,,8,0,8,8,0,8,0.000003,0,0,3786,9,0.000025,0,0,0,0,0.392857,0.002243
9212019,9212019,,12,0,12,12,0,12,0.000005,0,0,3781,9,0.000044,0,0,0,0,0.265152,0.003839
9212021,9212021,,14,2,16,14,2,16,0.000005,0,0,3785,9,0.000049,1,1,1,1547.847205,0.241667,0.004291
9212145,9212145,,24,0,24,24,0,24,0.000019,0,0,543,9,0.000151,0,0,0,0,0.074275,0.006185
9301030,9301030,,6,0,6,6,0,6,0.000003,0,0,3780,9,0.000023,0,0,0,0,0.3,0.001895
9310056,9310056,,4,5,9,4,5,9,0.000003,0,0,7084,9,0.000014,2,0.727273,0.8125,27.75748,0.347222,0.001217
9312097,9312097,,6,1,7,6,1,7,0.000013,0,0,2735,9,0.000022,1,1,1,0,0.380952,0.002793
9503005,9503005,,29,4,33,29,4,33,0.000289,0,0,3788,9,0.000042,2,0.7,0.785714,23429.136708,0.211174,0.009892
9505111,9505111,,5,3,8,5,3,8,0.000202,0,0,3782,9,0.000016,1,1,1,22.685776,0.25,0.001674
9506189,9506189,,10,1,11,10,1,11,0.000003,0,0,3779,9,0.000069,1,1,1,26.352443,0.109091,0.002795
9507165,9507165,,2,2,4,2,2,4,0.000003,0,0,7091,9,0.000011,1,1,1,27.29656,0.416667,0.000703
9507166,9507166,,28,9,37,28,9,37,0.000295,0.000006,0,3791,9,0.000033,2,0.764706,0.846154,73455.929924,0.195195,0.009761
9508040,9508040,,4,9,13,4,9,13,0.000005,0,0,7087,9,0.000014,2,0.846154,0.909091,12657.480748,0.326923,0.001268
9510149,9510149,,41,4,45,41,4,45,0.000521,0.000091,0,2741,9,0.000056,6,0.267016,0.311928,6360.633207,0.221717,0.014072
9512022,9512022,,6,11,17,6,11,17,0.000016,0.000004,0,7088,9,0.000018,2,0.866667,0.923077,4571.366439,0.246324,0.0017
9603200,9603200,,2,4,6,2,4,6,0.000002,0.000001,0,7090,9,0.000012,3,0.535714,0.611111,2174.802114,0.3,0.000683
9604007,9604007,,15,9,24,15,9,24,0.00026,0.000206,0,3807,9,0.000022,6,0.300613,0.360998,42540.504253,0.273551,0.005834
9604026,9604026,,34,9,43,34,9,43,0.000748,0.0002,0,3757,9,0.000043,6,0.295775,0.357143,21533.858121,0.27021,0.012775
9605062,9605062,,42,6,48,42,6,48,0.000864,0.000147,0,3760,9,0.000044,6,0.281659,0.330103,21355.802694,0.252216,0.014337
9605151,9605151,,46,17,63,46,17,63,0.001884,0.000241,0,3792,9,0.000042,11,0.203648,0.234929,153569.157891,0.200717,0.015741
9605152,9605152,,9,13,22,9,13,22,0.000092,0.000094,0,7083,9,0.000016,6,0.316239,0.40045,42852.832651,0.170996,0.003497
9605157,9605157,,3,2,5,3,2,5,0.000003,0,0,7079,22,0.000021,4,0.433333,0.50641,13357.621218,0,0.000923
9606050,9606050,,39,13,52,39,13,52,0.000952,0.000244,0,6290,9,0.000034,12,0.170152,0.191182,17488.267207,0.225113,0.012176
9605046,9605046,,32,47,79,32,47,79,0.001225,0.004427,0,3778,9,0.000044,10,0.248918,0.299838,428442.13543,0.067186,0.011527
9212075,9212075,,29,0,29,29,0,29,0.000849,0,0,2278,9,0.000074,0,0,0,0,0.076355,0.008249
9404113,9404113,,23,11,34,23,11,34,0.000193,0.000014,0,1481,9,0.000038,3,0.492958,0.6,24963.127709,0.089127,0.007422
9406203,9406203,,18,24,42,18,24,42,0.000022,0.000016,0,1492,9,0.000043,4,0.465517,0.578189,212901.501256,0.065041,0.006007
9407151,9407151,,25,2,27,25,2,27,0.001028,0.000073,0,2742,9,0.000064,1,1,1,363.01799,0.270655,0.009388
9606138,9606138,,34,17,51,34,17,51,0.001371,0.000362,0,7077,9,0.000028,10,0.209662,0.238173,10519.797177,0.235294,0.010379
9606154,9606154,,11,14,25,11,14,25,0.000257,0.000226,0,7103,9,0.000013,12,0.170851,0.193087,5996.487701,0.261667,0.003201
9611160,9611160,,30,21,51,30,21,51,0.001246,0.000303,0,7102,9,0.000024,15,0.199896,0.236581,83620.914603,0.229804,0.009396
9612217,9612217,,3,6,9,3,6,9,0.000025,0.000056,0,7101,6,0.000011,6,0.280098,0.33845,6513.689236,0.222222,0.000975
9705240,9705240,,39,21,60,39,21,60,0.00174,0.000423,0,7099,9,0.000033,10,0.216344,0.247491,13681.298558,0.219492,0.011697
9707060,9707060,,11,12,23,11,12,23,0.000149,0.000207,0,7093,9,0.000014,11,0.176656,0.198217,461.959281,0.355731,0.003449
2143,2143,,45,12,57,45,12,57,0.001454,0.002108,0,11908,30,0.000069,13,0.193412,0.211001,21553.047598,0.152569,0.018604
2171,2171,,62,28,90,62,28,90,0.002122,0.002874,0,11911,30,0.000079,13,0.20306,0.225492,73999.853535,0.10412,0.024028
9910031,9910031,,6,18,24,6,18,24,0.000135,0.010298,0,11910,30,0.000017,13,0.201507,0.224188,8084.777455,0.164855,0.003048
9912172,9912172,,1,4,5,1,4,5,0.000034,0.000006,0,11909,15,0.000012,3,0.533333,0.604167,7468.635336,0.1,0.000761
2144,2144,,0,3,3,0,3,3,0,0.000015,0,11915,23,0.00001,17,0.167956,0.186674,0,0.166667,0
9908128,9908128,,1,5,6,1,5,6,0,0.00012,0,11914,23,0.000013,16,0.193247,0.219623,5952.670869,0.033333,0.000219
9901147,9901147,,32,7,39,32,7,39,0.003824,0.001632,0,11913,8,0.000042,15,0.170497,0.195474,6290.015652,0.145749,0.015697
9902056,9902056,,1,0,1,1,0,1,0.000001,0,0,11912,23,0.000012,0,0,0,0,0,0.000226
2145,2145,,45,20,65,45,20,65,0.006379,0.010863,0,11916,8,0.000051,11,0.204349,0.228399,57216.179006,0.084615,0.020791
9607104,9607104,,24,19,43,24,19,43,0.001095,0.000635,0,4616,5,0.000039,11,0.19987,0.234209,97302.459929,0.105205,0.006539
9703178,9703178,,22,10,32,22,10,32,0.001061,0.000186,0,6381,5,0.00004,12,0.168612,0.192523,41110.431344,0.092742,0.005962
9204072,9204072,,40,0,40,40,0,40,0.000211,0,0,94,5,0.00011,0,0,0,0,0.037179,0.011804
9207105,9207105,,18,0,18,18,0,18,0.000073,0,0,83,5,0.000048,0,0,0,0,0.091503,0.00564
9304027,9304027,,14,13,27,14,13,27,0.000069,0.00007,0,410,5,0.000045,2,0.610169,0.680556,12958.775498,0.178063,0.005107
9304128,9304128,,30,4,34,30,4,34,0.000484,0.00012,0,402,5,0.000069,2,0.666667,0.75,2972.785406,0.034759,0.008853
9306083,9306083,,5,18,23,5,18,23,0.000238,0.000201,0,431,5,0.000022,5,0.459459,0.539052,65545.125662,0.146245,0.001916
9307079,9307079,,5,7,12,5,7,12,0.000031,0.000053,0,382,5,0.000022,3,0.558824,0.657895,193.799233,0.181818,0.001597
9408089,9408089,,15,7,22,15,7,22,0.000735,0.000369,0,1659,5,0.000027,5,0.344828,0.423,4033.710362,0.199134,0.005293
9408098,9408098,,22,8,30,22,8,30,0.000452,0.000378,0,437,5,0.00009,7,0.293706,0.363511,124913.044188,0.08046,0.008276
9504033,9504033,,17,17,34,17,17,34,0.000158,0.000247,0,1669,5,0.000029,7,0.320189,0.388224,13791.032032,0.123886,0.004548
9508104,9508104,,11,15,26,11,15,26,0.000097,0.000216,0,4597,5,0.000022,8,0.239829,0.303221,32390.144865,0.124615,0.003184
9512184,9512184,,15,30,45,15,30,45,0.000133,0.000258,0,4600,5,0.000029,6,0.326586,0.413843,20293.300423,0.14899,0.004063
9603106,9603106,,15,23,38,15,23,38,0.000068,0.001229,0,4611,5,0.000041,10,0.211821,0.248027,107756.079848,0.138691,0.003854
9603175,9603175,,4,10,14,4,10,14,0.000071,0.000185,0,4615,5,0.000013,7,0.295261,0.349706,376.684333,0.28022,0.00118
9604118,9604118,,10,20,30,10,20,30,0.000304,0.000379,0,4602,5,0.00002,8,0.266958,0.339739,8136.192293,0.162069,0.002855
9605153,9605153,,11,21,32,11,21,32,0.000064,0.000207,0,4614,5,0.000026,11,0.178929,0.210223,30665.640351,0.168347,0.003123
9406011,9406011,,3,2,5,3,2,5,0.000043,0.000308,0,6380,5,0.000014,4,0.363636,0.40625,5.12106,0.25,0.000939
9612061,9612061,,6,14,20,6,14,20,0.000066,0.00022,0,6379,5,0.000017,12,0.169891,0.197357,954.324533,0.234211,0.001626
9701099,9701099,,3,14,17,3,14,17,0.000004,0.000208,0,6378,5,0.000015,11,0.177921,0.204162,9661.19082,0.1875,0.000829
2146,2146,,13,9,22,13,9,22,0.000619,0.001286,0,11918,0,0.000016,13,0.187474,0.206578,333.38886,0.292208,0.006815
9912218,9912218,,13,37,50,13,37,50,0.001633,0.004239,0,11917,0,0.000017,12,0.217445,0.245844,25622.430865,0.146939,0.005809
9909003,9909003,,3,12,15,3,12,15,0.000446,0.001169,0,10129,0,0.000011,16,0.181201,0.206502,25.529851,0.304762,0.001222
9911205,9911205,,8,54,62,8,54,62,0.001376,0.005767,0,10152,0,0.000013,12,0.218926,0.254243,21684.839601,0.121364,0.003178
2147,2147,,28,16,44,28,16,44,0.003457,0.002274,0,11688,25,0.000036,16,0.198218,0.220119,15893.515905,0.117865,0.009939
2148,2148,,2,7,9,2,7,9,0.000001,0.00002,0,11919,17,0.000011,12,0.183147,0.239214,47.902156,0.194444,0.000499
9205014,9205014,,18,1,19,18,1,19,0.000416,0,0,721,17,0.000041,1,1,1,4025.70643,0.114035,0.004947
9202006,9202006,,13,0,13,13,0,13,0.000025,0,0,710,4,0.000115,0,0,0,0,0.044872,0.003963
9201033,9201033,,15,0,15,15,0,15,0.000089,0,0,714,4,0.000078,0,0,0,0,0.080952,0.004118
9201001,9201001,,30,0,30,30,0,30,0.00009,0,0,1172,4,0.000151,0,0,0,0,0.03908,0.009191
9203009,9203009,,16,1,17,16,1,17,0.000181,0.000005,0,1211,4,0.000053,1,1,1,678.727696,0.088235,0.004285
9212127,9212127,,5,0,5,5,0,5,0.000004,0,0,5412,4,0.000024,0,0,0,0,0.1,0.001326
9503185,9503185,,2,3,5,2,3,5,0,0.000011,0,10423,4,0.000015,2,0.636364,0.714286,21.883638,0.35,0.000636
9504089,9504089,,4,7,11,4,7,11,0.000062,0.000009,0,10422,4,0.000016,2,0.684211,0.769231,2537.121056,0.181818,0.001065
9512052,9512052,,10,3,13,10,3,13,0.000035,0.000008,0,4238,4,0.000024,5,0.357143,0.442667,81.318482,0.185897,0.002567
2149,2149,,15,26,41,15,26,41,0.002004,0.001889,0,11920,0,0.000015,13,0.20076,0.226293,25441.539493,0.104878,0.005879
9711077,9711077,,7,23,30,7,23,30,0.001068,0.002694,0,6141,0,0.000013,12,0.194513,0.225196,1073.460192,0.268966,0.002133
9701103,9701103,,5,4,9,5,4,9,0.000061,0.000014,0,7823,52,0.000022,5,0.356383,0.402736,5375.79695,0.166667,0.00158
9801190,9801190,,1,4,5,1,4,5,0.000058,0.000139,0,10133,52,0.00001,12,0.179163,0.197266,83.690455,0.3,0.000433
9908172,9908172,,6,4,10,6,4,10,0.000039,0.000003,0,11307,20,0.000023,3,0.529412,0.666667,14191.321572,0.255556,0.001517
9911223,9911223,,7,8,15,7,8,15,0.000231,0.000987,0,11304,0,0.000014,13,0.202976,0.224151,22268.691583,0.228571,0.001978
2150,2150,,2,30,32,2,30,32,0.000102,0.002696,0,11921,0,0.00001,14,0.191322,0.219783,3404.846175,0.172379,0.000451
9807139,9807139,,3,18,21,3,18,21,0.000125,0.00305,0,11841,0,0.000011,14,0.185116,0.213612,531.327852,0.219048,0.000691
9701152,9701152,,16,47,63,16,47,63,0.002547,0.011892,0,4578,13,0.00002,11,0.227643,0.275783,22442.982693,0.122632,0.005266
9610048,9610048,,3,0,3,3,0,3,0.000072,0,0,5284,26,0.00002,0,0,0,0,0.166667,0.001003
9811186,9811186,,4,6,10,4,6,10,0.000071,0.000518,0,7248,22,0.000015,17,0.164271,0.187942,35071.416907,0.088889,0.000961
2151,2151,,1,2,3,1,2,3,0,0,0,11924,22,0.000012,1,1,1,2,0,0.000219
9706085,9706085,,1,0,1,1,0,1,0,0,0,11923,22,0.000015,0,0,0,0,0,0.000226
9707096,9707096,,1,0,1,1,0,1,0,0,0,11922,22,0.000015,0,0,0,0,0,0.000226
2152,2152,,4,15,19,4,15,19,0.001404,0.01208,0,11926,1,0.00001,13,0.199529,0.220571,55.712817,0.327485,0.001274
9912250,9912250,,25,26,51,25,26,51,0.005641,0.018824,0,11925,1,0.000018,13,0.206442,0.230693,3632.345383,0.259216,0.008392
2153,2153,,2,1,3,2,1,3,0.000012,0,0,11927,23,0.000012,11,0.163537,0.204757,6864.189145,0,0.00057
2154,2154,,23,30,53,23,30,53,0.004927,0.020906,0,11929,1,0.000025,10,0.228198,0.259414,96983.289873,0.188316,0.007498
9906155,9906155,,10,8,18,10,8,18,0.002683,0.0111,0,11928,1,0.000014,16,0.19173,0.213313,1430.648576,0.25817,0.002826
2155,2155,,2,27,29,2,27,29,0.000006,0.000727,0,11936,10,0.000019,12,0.195402,0.224816,4757.246255,0.062808,0.000445
9302044,9302044,,11,0,11,11,0,11,0.000059,0,0,1343,10,0.000111,0,0,0,0,0.054545,0.003008
9407179,9407179,,2,4,6,2,4,6,0.000009,0.000004,0,2929,10,0.000031,3,0.5,0.611111,26540.781676,0.166667,0.000498
9503053,9503053,,4,3,7,4,3,7,0.000009,0.000003,0,11935,10,0.000017,4,0.4,0.489583,13,0.261905,0.000896
9508010,9508010,,4,3,7,4,3,7,0.000009,0.000001,0,11932,15,0.000012,1,1,1,3.416667,0.214286,0.000903
9601072,9601072,,10,17,27,10,17,27,0.000049,0.001238,0,3165,10,0.00002,9,0.212452,0.250347,18414.776003,0.058405,0.002361
9703162,9703162,,2,4,6,2,4,6,0.000017,0.000003,0,11931,15,0.000011,4,0.466667,0.543651,15.9,0.133333,0.000458
9710082,9710082,,5,14,19,5,14,19,0.000139,0.002485,0,9487,10,0.000014,14,0.183612,0.214558,4348.681532,0.181287,0.001632
9710168,9710168,,3,11,14,3,11,14,0.000047,0.002299,0,11930,10,0.000012,14,0.194379,0.22185,782.326955,0.192308,0.000677
9209107,9209107,,2,4,6,2,4,6,0,0.000046,0,1348,2,0.000115,2,0.833333,0.9,7874.027386,0.066667,0.00079
9303039,9303039,,2,0,2,2,0,2,0,0,0,2928,10,0.00002,0,0,0,0,0,0.000459
9407045,9407045,,3,4,7,3,4,7,0,0.000031,0,2927,10,0.00003,3,0.526316,0.65,143.327083,0.142857,0.000692
9410202,9410202,,7,2,9,7,2,9,0,0.000003,0,2930,10,0.000045,3,0.433333,0.5,39781.365009,0.236111,0.00165
9501007,9501007,,3,2,5,3,2,5,0,0,0,11934,10,0.000019,4,0.333333,0.411111,5,0.45,0.00069
9402118,9402118,,8,1,9,8,1,9,0.000197,0.000004,0,1339,9,0.000026,2,0.6,0.666667,41.460689,0.166667,0.002092
9308142,9308142,,14,0,14,14,0,14,0,0,0,11808,15,0.000046,0,0,0,0,0.164835,0.003346
9203045,9203045,,13,0,13,13,0,13,0.000643,0,0,2905,10,0.000052,0,0,0,0,0.051282,0.003482
9207009,9207009,,15,2,17,15,2,17,0.000877,0.000001,0,1071,9,0.000037,1,1,1,12191.412194,0.077206,0.003919
9301049,9301049,,6,0,6,6,0,6,0.000228,0,0,3162,10,0.000021,0,0,0,0,0.166667,0.001647
9307043,9307043,,5,2,7,5,2,7,0.000024,0.000022,0,3164,10,0.000026,1,1,1,110.745997,0.142857,0.001256
9307189,9307189,,10,4,14,10,4,14,0.000815,0.000029,0,1073,10,0.000021,2,0.833333,0.9,13994.342005,0.120879,0.002749
9409020,9409020,,6,5,11,6,5,11,0.000211,0.000049,0,2906,10,0.000019,5,0.376,0.440426,5019.314994,0.081818,0.001559
9501140,9501140,,5,4,9,5,4,9,0.000718,0.00001,0,3163,10,0.000013,6,0.294798,0.355229,7883.445292,0.111111,0.001451
9506179,9506179,,12,1,13,12,1,13,0,0.000001,0,11807,15,0.000037,1,1,1,3.166667,0.166667,0.002816
9509059,9509059,,8,3,11,8,3,11,0,0,0,11809,15,0.000022,2,0.8,0.875,210.166667,0.254545,0.00186
9611036,9611036,,7,31,38,7,31,38,0.00024,0.010912,0,3666,0,0.000024,11,0.222517,0.263762,27735.252674,0.108108,0.002695
9603033,9603033,,18,24,42,18,24,42,0.001133,0.009574,0,1795,0,0.000031,9,0.228211,0.26847,3052.956075,0.134146,0.006736
9705161,9705161,,3,1,4,3,1,4,0.00023,0.000008,0,4502,10,0.00002,13,0.149979,0.161672,9562.013267,0,0.000943
2156,2156,,8,12,20,8,12,20,0.001001,0.01783,0,10539,1,0.000016,12,0.194782,0.215024,7624.84256,0.184211,0.00259
9911142,9911142,,2,2,4,2,2,4,0.000224,0.000484,0,10538,1,0.000012,14,0.155925,0.168225,9.195353,0.416667,0.000548
2157,2157,,13,12,25,13,12,25,0.001447,0.006049,0,11937,2,0.000021,12,0.215678,0.239301,10201.851006,0.185,0.003693
2158,2158,,61,24,85,61,24,85,0.004614,0.004583,0,11938,30,0.000056,13,0.20377,0.225837,14450.741443,0.115546,0.027674
2159,2159,,114,40,154,114,40,154,0.020603,0.02416,0,11594,1,0.000071,11,0.221121,0.250306,129148.302734,0.074739,0.044189
2160,2160,,102,70,172,102,70,172,0.017867,0.031827,0,11593,1,0.000084,11,0.244052,0.281091,482471.637727,0.060928,0.03843
9305016,9305016,,17,2,19,17,2,19,0.001844,0.00001,0,1643,8,0.000044,2,0.625,0.7,4285.530236,0.032164,0.005575
9903144,9903144,,1,14,15,1,14,15,0.000374,0.002267,0,11592,0,0.000011,14,0.198587,0.226198,7316.898267,0.32381,0.001096
9403089,9403089,,11,2,13,11,2,13,0.000284,0.000009,0,4242,17,0.000028,1,1,1,1401.315792,0.192308,0.003625
9407014,9407014,,12,3,15,12,3,15,0.000286,0.000013,0,4241,17,0.000028,2,0.8,0.875,3427.529228,0.214286,0.00386
9410103,9410103,,38,0,38,38,0,38,0.000902,0,0,1102,13,0.000267,0,0,0,0,0.027027,0.01508
9810255,9810255,,1,3,4,1,3,4,0.00024,0.000015,0,7889,26,0.000012,2,0.588235,0.65,6349.658345,0.083333,0.000831
2161,2161,,66,3,69,66,3,69,0.004075,0.001092,0,11939,25,0.000105,12,0.191306,0.208018,6828.432771,0.108696,0.024409
2190,2190,,75,6,81,75,6,81,0.005062,0.001319,0,11940,25,0.000103,13,0.185465,0.20215,1782.662601,0.103395,0.026803
2162,2162,,1,4,5,1,4,5,0.000153,0.000003,0,11941,41,0.000013,3,0.6,0.703704,8788.944636,0.1,0.000764
2164,2164,,57,6,63,57,6,63,0.002965,0.001606,0,11689,25,0.000057,17,0.187748,0.207086,9073.38878,0.116743,0.017754
2165,2165,,1,28,29,1,28,29,0.000253,0.014906,0,11942,2,0.00001,13,0.225479,0.264145,894.588174,0.130542,0.000219
9711120,9711120,,12,2,14,12,2,14,0.000807,0.000002,0,7167,2,0.000027,7,0.190871,0.238509,8695.509049,0.104396,0.003243
9303065,9303065,,2,0,2,2,0,2,0.000535,0,0,852,13,0.000024,0,0,0,0,0,0.00125
9403173,9403173,,31,3,34,31,3,34,0.000704,0.000484,0,845,23,0.000164,5,0.32,0.373363,27290.220515,0.062389,0.009476
9512066,9512066,,2,11,13,2,11,13,0.000012,0.000294,0,3685,2,0.000024,6,0.416,0.526923,51729.655492,0.064103,0.000597
9705173,9705173,,3,45,48,3,45,48,0.000303,0.008676,0,5031,0,0.000011,12,0.229125,0.27139,7075.543271,0.113918,0.000808
9709104,9709104,,7,0,7,7,0,7,0.000045,0,0,7166,2,0.000041,0,0,0,0,0.166667,0.00183
9812207,9812207,,5,10,15,5,10,15,0.000505,0.000306,0,8148,13,0.000012,17,0.141225,0.169709,10957.875909,0.214286,0.001329
2166,2166,,1,25,26,1,25,26,0.000005,0.002774,0,11943,13,0.000011,12,0.207882,0.234988,1552.240641,0.109231,0.000226
9505038,9505038,,9,10,19,9,10,19,0.000121,0.000381,0,2088,13,0.000021,7,0.269472,0.309346,33683.141293,0.046784,0.002293
9806186,9806186,,4,23,27,4,23,27,0.000794,0.004593,0,8472,2,0.000012,14,0.200239,0.23203,1357.315412,0.233618,0.001455
9312058,9312058,,10,2,12,10,2,12,0.000347,0.000327,0,265,13,0.00007,2,0.75,0.833333,46.880431,0.19697,0.008905
9502099,9502099,,12,7,19,12,7,19,0.000544,0.000298,0,1124,13,0.000051,7,0.262162,0.297104,33171.67255,0.160819,0.007395
9505045,9505045,,17,20,37,17,20,37,0.001432,0.004999,0,1129,13,0.00004,8,0.26233,0.313205,3914.982699,0.098348,0.007856
9707059,9707059,,2,5,7,2,5,7,0.000247,0.002063,0,4295,4,0.000012,13,0.176991,0.200673,2778.613356,0.214286,0.000925
9807136,9807136,,11,40,51,11,40,51,0.001558,0.010597,0,8062,13,0.000016,15,0.19286,0.243969,11451.53826,0.153333,0.003197
9810150,9810150,,3,7,10,3,7,10,0.00029,0.001987,0,8060,2,0.000011,14,0.185359,0.210701,1130.436931,0.211111,0.000801
9811251,9811251,,8,37,45,8,37,45,0.000739,0.013121,0,8063,13,0.000013,12,0.202146,0.238325,11532.808671,0.15303,0.002197
2167,2167,,5,7,12,5,7,12,0.000001,0.000026,0,11951,23,0.000017,18,0.153276,0.171869,40480.42023,0.090909,0.001149
9407105,9407105,,15,1,16,15,1,16,0.000032,0,0,4095,23,0.000056,1,1,1,134.498677,0.045833,0.003606
9512026,9512026,,8,1,9,8,1,9,0.000005,0.000007,0,2852,23,0.000029,1,1,1,162.497678,0.055556,0.002189
9611070,9611070,,4,4,8,4,4,8,0,0.000003,0,11950,23,0.000021,2,0.833333,0.9,1352.333333,0.125,0.000916
9805200,9805200,,14,10,24,14,10,24,0.000241,0.000163,0,7735,10,0.000035,13,0.178925,0.205276,25910.3917,0.068841,0.003372
9909166,9909166,,2,5,7,2,5,7,0.000001,0.000064,0,11948,10,0.000013,17,0.166442,0.184426,27253.039738,0.142857,0.000478
9305148,9305148,,19,0,19,19,0,19,0.000007,0,0,2565,23,0.000093,0,0,0,0,0.134503,0.005252
9505181,9505181,,3,1,4,3,1,4,0,0,0,11949,23,0.000019,2,0.666667,0.75,0.25,0.333333,0.00069
9606080,9606080,,11,10,21,11,10,21,0.000145,0.000376,0,2850,10,0.000021,8,0.234561,0.28046,12405.209923,0.078571,0.002706
9611136,9611136,,10,16,26,10,16,26,0.00029,0.000273,0,2907,10,0.00002,11,0.205791,0.237297,92163.640849,0.086154,0.002722
9707209,9707209,,11,24,35,11,24,35,0.00024,0.000972,0,11947,23,0.00002,13,0.177974,0.207604,13642.376821,0.078151,0.002701
2168,2168,,0,2,2,0,2,2,0,0.000008,0,11953,4,0.00001,15,0.149965,0.165246,0,0.5,0
9612216,9612216,,14,7,21,14,7,21,0.000653,0.000777,0,4501,4,0.000046,12,0.176369,0.196879,19160.703856,0.040476,0.003582
9811199,9811199,,3,7,10,3,7,10,0.000031,0.001081,0,11952,4,0.000017,14,0.17301,0.196923,3258.408211,0.1,0.000718
9401061,9401061,,13,1,14,13,1,14,0.00016,0.000038,0,4500,5,0.000034,1,1,1,36.462607,0.087912,0.003647
9511196,9511196,,3,1,4,3,1,4,0.000009,0.000007,0,2615,5,0.00002,1,1,1,0,0.25,0.000785
9405151,9405151,,6,0,6,6,0,6,0.000087,0,0,3028,4,0.00002,0,0,0,0,0.1,0.0016
2169,2169,,5,30,35,5,30,35,0.000211,0.00204,0,11959,0,0.000011,16,0.183958,0.215622,16269.328659,0.087395,0.001246
9811214,9811214,,7,21,28,7,21,28,0.000847,0.002468,0,11958,4,0.000014,13,0.216475,0.250847,44850.141528,0.096561,0.00166
9901151,9901151,,8,12,20,8,12,20,0.000181,0.000881,0,11648,0,0.000013,15,0.176543,0.203224,233.350436,0.228947,0.002149
9910181,9910181,,15,33,48,15,33,48,0.000333,0.004668,0,11649,0,0.000018,15,0.192019,0.222994,14717.44301,0.118794,0.004426
9405023,9405023,,10,3,13,10,3,13,0.000055,0,0,1190,6,0.000026,2,0.666667,0.75,50976.824273,0.083333,0.002492
9607029,9607029,,13,4,17,13,4,17,0.001038,0.000293,0,1933,0,0.000028,11,0.200249,0.230601,5044.416488,0.194853,0.004948
9403193,9403193,,10,2,12,10,2,12,0.000597,0.000002,0,742,4,0.000017,1,1,1,21194.162854,0.090909,0.003491
9503105,9503105,,17,12,29,17,12,29,0.001338,0.002411,0,3026,4,0.000026,6,0.290683,0.347578,1364.230885,0.219212,0.005044
9504010,9504010,,24,14,38,24,14,38,0.00119,0.002462,0,3027,4,0.000028,6,0.299595,0.351892,21842.475998,0.211949,0.007195
9507140,9507140,,21,17,38,21,17,38,0.001222,0.002496,0,4836,4,0.000026,7,0.26014,0.307616,2073.692658,0.21266,0.006054
9603169,9603169,,13,18,31,13,18,31,0.00069,0.002463,0,5135,4,0.000018,6,0.307692,0.366102,16798.700542,0.245161,0.004295
9403099,9403099,,11,0,11,11,0,11,0.000054,0,0,3602,26,0.000047,0,0,0,0,0.009091,0.002714
9403119,9403119,,10,17,27,10,17,27,0.000431,0.000234,0,695,4,0.000031,5,0.330409,0.436283,43263.605258,0.074074,0.004598
9510218,9510218,,1,8,9,1,8,9,0.000035,0.000501,0,7321,0,0.00001,10,0.2,0.235916,11.798074,0.25,0.000274
9612200,9612200,,4,27,31,4,27,31,0.000317,0.002288,0,4587,0,0.000011,11,0.222363,0.260329,1661.081402,0.230108,0.001236
9805128,9805128,,4,5,9,4,5,9,0.00006,0.000017,0,7235,22,0.000016,6,0.336634,0.435294,55893.149505,0.152778,0.000974
9410011,9410011,,4,3,7,4,3,7,0.000417,0.000117,0,7844,4,0.000016,5,0.31746,0.373333,8280.842158,0.142857,0.002027
9611120,9611120,,3,24,27,3,24,27,0.000527,0.002278,0,11957,4,0.000011,11,0.198105,0.240551,15913.060093,0.128205,0.000705
9412175,9412175,,4,1,5,4,1,5,0.000154,0.000001,0,1303,4,0.000015,1,1,1,1557.631709,0.05,0.001633
2170,2170,,29,25,54,29,25,54,0.006475,0.018046,0,11960,1,0.00002,11,0.201848,0.225051,47058.317565,0.220126,0.009541
9904056,9904056,,19,35,54,19,35,54,0.000964,0.018258,0,9760,9,0.000016,12,0.203177,0.234263,16497.773883,0.1471,0.005434
9904039,9904039,,5,7,12,5,7,12,0.001412,0.010029,0,9763,1,0.000013,14,0.185535,0.205934,1481.128116,0.287879,0.001984
9701079,9701079,,1,2,3,1,2,3,0.000003,0.000003,0,8514,15,0.000018,2,0.625,0.7,10672.642756,0,0.000659
9811117,9811117,,8,0,8,8,0,8,0.000003,0,0,8512,22,0.000043,0,0,0,0,0.321429,0.00234
9211093,9211093,,13,1,14,13,1,14,0.000002,0,0,3797,15,0.000048,1,1,1,6919.605353,0.071429,0.003055
9601033,9601033,,9,5,14,9,5,14,0.000024,0.000008,0,9579,15,0.000024,2,0.857143,0.916667,632.345917,0.17033,0.00212
2172,2172,,20,42,62,20,42,62,0.00418,0.025301,0,11961,1,0.000018,12,0.216569,0.24494,16710.425318,0.155473,0.007106
9603034,9603034,,19,17,36,19,17,36,0.000344,0.00193,0,3590,4,0.000029,10,0.178087,0.229223,528.798089,0.284127,0.006628
9611020,9611020,,14,18,32,14,18,32,0.000588,0.001376,0,3669,4,0.00002,11,0.173411,0.197162,6741.025458,0.241935,0.004824
9710053,9710053,,2,34,36,2,34,36,0.000071,0.009367,0,5923,0,0.000013,11,0.212929,0.248969,58610.369392,0.127778,0.000888
2173,2173,,6,5,11,6,5,11,0.000028,0.000007,0,11966,6,0.000015,12,0.156812,0.178501,627.674487,0.254545,0.001487
9203039,9203039,,31,0,31,31,0,31,0.000208,0,0,77,6,0.000218,0,0,0,0,0.053763,0.009056
9803122,9803122,,10,2,12,10,2,12,0.000109,0.000003,0,11962,6,0.000028,1,1,1,13.648352,0.265152,0.002455
9803234,9803234,,8,5,13,8,5,13,0.000129,0.000025,0,11963,6,0.000023,2,0.727273,0.8125,213.734383,0.224359,0.001988
9810057,9810057,,5,5,10,5,5,10,0.000013,0.000006,0,11965,6,0.000018,3,0.555556,0.7,132.322955,0.322222,0.001269
9304156,9304156,,8,3,11,8,3,11,0.000022,0.000005,0,1458,6,0.000026,2,0.8,0.875,11713.490225,0.127273,0.002588
9512030,9512030,,14,5,19,14,5,19,0.00017,0.000004,0,5675,6,0.000027,3,0.5,0.592593,31819.562844,0.169591,0.003517
9312108,9312108,,19,1,20,19,1,20,0.00001,0.000002,0,6908,6,0.000071,1,1,1,5.583333,0.097368,0.004658
9403197,9403197,,9,4,13,9,4,13,0.000001,0.00001,0,10445,6,0.00003,2,0.833333,0.9,3328.207468,0.128205,0.002076
9810011,9810011,,2,4,6,2,4,6,0.000095,0.000003,0,11964,6,0.000013,2,0.642857,0.722222,5.112302,0.333333,0.000473
2174,2174,,31,18,49,31,18,49,0.003641,0.009224,0,11687,25,0.000029,17,0.206841,0.231458,43050.236573,0.119048,0.010718
2175,2175,,12,28,40,12,28,40,0.001177,0.01736,0,11967,30,0.000018,12,0.2267,0.25645,43680.66378,0.085256,0.004382
2176,2176,,14,35,49,14,35,49,0.0008,0.003548,0,11968,25,0.000018,15,0.210393,0.242205,68777.741916,0.094813,0.004271
9708060,9708060,,22,5,27,22,5,27,0.000561,0.000315,0,6007,25,0.000064,16,0.162256,0.179899,4434.25021,0.162393,0.007395
9805086,9805086,,11,7,18,11,7,18,0.000435,0.000493,0,9402,25,0.000024,15,0.185262,0.207596,2562.364036,0.238562,0.003602
9805134,9805134,,4,8,12,4,8,12,0.000334,0.000453,0,9416,25,0.000013,18,0.185082,0.214889,2654.321144,0.19697,0.001596
2177,2177,,0,3,3,0,3,3,0,0.000077,0,11969,8,0.00001,12,0.167039,0.182805,0,0,0
9405141,9405141,,12,6,18,12,6,18,0.000104,0.000212,0,8179,22,0.00003,3,0.576923,0.677778,5433.346653,0.04902,0.002872
9206027,9206027,,69,0,69,69,0,69,0.000244,0,0,1297,22,0.000261,0,0,0,0,0.027067,0.019165
9211071,9211071,,26,0,26,26,0,26,0.000331,0,0,1465,22,0.000066,0,0,0,0,0.053846,0.006675
9402128,9402128,,3,3,6,3,3,6,0.000028,0.000005,0,8178,22,0.000017,2,0.714286,0.8,89.710541,0.2,0.0008
9405057,9405057,,11,8,19,11,8,19,0.000096,0.000019,0,3205,22,0.000025,2,0.785714,0.863636,5877.039914,0.169591,0.002955
2178,2178,,0,3,3,0,3,3,0,0,0,11970,28,0.00001,4,0.359375,0.438406,0,0.5,0
9506069,9506069,,3,6,9,3,6,9,0,0.000004,0,4361,28,0.000042,3,0.619048,0.717949,3693.82949,0.180556,0.000713
9305007,9305007,,8,0,8,8,0,8,0.000232,0,0,3612,28,0.000072,0,0,0,0,0.035714,0.001908
2180,2180,,25,16,41,25,16,41,0.001888,0.004186,0,11971,2,0.000029,12,0.214137,0.238333,25407.192491,0.142683,0.008049
9712057,9712057,,6,12,18,6,12,18,0.000409,0.00339,0,5742,2,0.000018,13,0.190012,0.223209,37655.111982,0.150327,0.00207
2181,2181,,2,2,4,2,2,4,0,0,0,11976,22,0.000011,17,0.145278,0.156459,679.900262,0.25,0.000445
9803043,9803043,,4,1,5,4,1,5,0.00001,0,0,11975,22,0.000019,8,0.228261,0.270144,45.784331,0.25,0.000909
9905225,9905225,,3,7,10,3,7,10,0.000007,0.000216,0,11972,25,0.000018,16,0.169311,0.187416,11092.138969,0.155556,0.000705
9803020,9803020,,1,6,7,1,6,7,0,0.000002,0,11974,22,0.000027,7,0.29108,0.379339,103.784331,0.238095,0.000246
9204007,9204007,,3,0,3,3,0,3,0.000005,0,0,8592,25,0.000024,0,0,0,0,0.166667,0.000726
2182,2182,,3,2,5,3,2,5,0,0.000175,0,11977,2,0.000014,14,0.154877,0.169995,9.89,0.3,0.000677
9803179,9803179,,9,3,12,9,3,12,0.000275,0.000248,0,7214,4,0.000039,13,0.182994,0.20841,22158.402971,0.060606,0.002101
2183,2183,,9,21,30,9,21,30,0.000449,0.019546,0,11978,1,0.00002,13,0.2015,0.223715,34206.42526,0.117241,0.002499
9808190,9808190,,8,4,12,8,4,12,0.000252,0.001789,0,9344,1,0.000077,15,0.205947,0.234773,53095.582212,0.075758,0.002165
2184,2184,,8,75,83,8,75,83,0.001519,0.032122,0,11981,13,0.000013,14,0.247218,0.289022,41492.550921,0.10241,0.002178
9503125,9503125,,5,13,18,5,13,18,0.000506,0.000164,0,1997,5,0.000013,6,0.300156,0.337674,71958.496748,0.163399,0.001319
9511218,9511218,,10,10,20,10,10,20,0.00106,0.000878,0,1804,13,0.000043,10,0.210445,0.243396,3745.306887,0.205263,0.005475
9610120,9610120,,4,14,18,4,14,18,0.000682,0.004383,0,5195,13,0.000012,13,0.206851,0.246556,340.485316,0.218954,0.001195
9805121,9805121,,16,32,48,16,32,48,0.003236,0.006107,0,8302,13,0.000016,15,0.190741,0.232784,3187.246165,0.111259,0.004491
9906112,9906112,,12,13,25,12,13,25,0.002426,0.016153,0,11980,1,0.000015,15,0.196673,0.223152,880.737526,0.191667,0.003597
9911003,9911003,,5,53,58,5,53,58,0.001232,0.029367,0,11979,13,0.000011,12,0.227604,0.261177,2143.271762,0.160617,0.001347
9203060,9203060,,22,0,22,22,0,22,0.000085,0,0,385,4,0.000172,0,0,0,0,0.058442,0.007266
9210107,9210107,,24,0,24,24,0,24,0.000321,0,0,396,5,0.000109,0,0,0,0,0.081522,0.008561
9210120,9210120,,26,2,28,26,2,28,0.000328,0.000009,0,395,5,0.000124,2,0.521739,0.541667,38092.499219,0.082011,0.009037
9212027,9212027,,8,3,11,8,3,11,0.000224,0.000013,0,690,5,0.000038,3,0.369863,0.419753,5696.876637,0.127273,0.003093
9303116,9303116,,8,5,13,8,5,13,0.000305,0.000018,0,946,5,0.00002,3,0.38961,0.461111,5870.796143,0.160256,0.002605
9304072,9304072,,12,7,19,12,7,19,0.000321,0.000019,0,406,5,0.000024,3,0.555556,0.611111,27918.588662,0.125731,0.003805
9501071,9501071,,49,47,96,49,47,96,0.00202,0.000614,0,1996,5,0.000084,5,0.410802,0.510757,247546.469622,0.046162,0.013655
9301129,9301129,,6,3,9,6,3,9,0.000198,0.000146,0,575,13,0.000045,1,1,1,343.328511,0.111111,0.004769
9504139,9504139,,13,7,20,13,7,20,0.000521,0.000178,0,1101,13,0.000049,5,0.362832,0.461789,22661.365717,0.118421,0.005409
9504142,9504142,,5,4,9,5,4,9,0.00016,0.000011,0,1098,13,0.000037,2,0.625,0.7,96312.843908,0.166667,0.003556
9312107,9312107,,10,2,12,10,2,12,0.000449,0.000014,0,1009,5,0.000033,2,0.75,0.833333,686.893285,0.106061,0.0032
9601117,9601117,,1,9,10,1,9,10,0.000095,0.003827,0,1951,13,0.000028,10,0.230769,0.27078,18522.582049,0.177778,0.002333
9303060,9303060,,5,0,5,5,0,5,0.000187,0,0,2135,0,0.000023,0,0,0,0,0.15,0.003217
9210031,9210031,,15,0,15,15,0,15,0.000656,0,0,276,13,0.000138,0,0,0,0,0.195238,0.011365
9603019,9603019,,3,1,4,3,1,4,0.000035,0,0,3157,26,0.000052,1,1,1,12712,0.083333,0.001117
9701077,9701077,,10,12,22,10,12,22,0.001279,0.003435,0,4577,13,0.000017,12,0.194333,0.228803,3238.851638,0.231602,0.00322
9703126,9703126,,3,9,12,3,9,12,0.000053,0.000003,0,5001,6,0.000013,8,0.196353,0.24284,119564.237011,0.136364,0.00079
9611146,9611146,,5,48,53,5,48,53,0.000716,0.013249,0,4703,13,0.000012,11,0.242397,0.287496,3778.787958,0.125181,0.001958
9701095,9701095,,7,36,43,7,36,43,0.000916,0.007106,0,3514,13,0.000014,12,0.212403,0.256086,2625.870641,0.1866,0.002696
9408134,9408134,,18,0,18,18,0,18,0.001273,0,0,1555,2,0.00003,0,0,0,0,0.094771,0.006171
9706151,9706151,,11,36,47,11,36,47,0.001698,0.00727,0,4988,13,0.000019,15,0.20623,0.246232,4034.518001,0.179926,0.003951
9410074,9410074,,9,4,13,9,4,13,0.001204,0.000283,0,1130,5,0.00002,3,0.52,0.564103,2515.069016,0.083333,0.003866
9606026,9606026,,3,0,3,3,0,3,0.000618,0,0,2139,13,0.000012,0,0,0,0,0.333333,0.001677
9705063,9705063,,4,25,29,4,25,29,0.000636,0.004632,0,5266,13,0.000013,15,0.193946,0.229273,2589.520853,0.246305,0.001682
9705095,9705095,,3,24,27,3,24,27,0.00048,0.002025,0,5286,13,0.000012,11,0.221261,0.260622,11079.638826,0.081197,0.001311
9707124,9707124,,6,17,23,6,17,23,0.001075,0.003265,0,5218,13,0.000013,13,0.186116,0.22409,148455.176123,0.189723,0.002248
9710158,9710158,,4,8,12,4,8,12,0.000978,0.001418,0,5267,13,0.000012,16,0.175445,0.205524,17363.290353,0.234848,0.001666
9901092,9901092,,11,5,16,11,5,16,0.000588,0.001042,0,9087,13,0.000023,14,0.180952,0.20848,2823.697745,0.070833,0.002967
2185,2185,,2,8,10,2,8,10,0.000001,0.000025,0,11987,6,0.00001,13,0.131345,0.149815,9.524392,0.244444,0.000465
9903134,9903134,,9,10,19,9,10,19,0.000027,0.000058,0,11985,52,0.000021,14,0.118654,0.139002,8159.041846,0.137427,0.002185
9907072,9907072,,9,5,14,9,5,14,0.000051,0.000025,0,11986,6,0.000016,14,0.118024,0.135345,3239.140641,0.197802,0.002111
9506111,9506111,,4,2,6,4,2,6,0.000002,0,0,8688,22,0.000014,2,0.75,0.833333,2877.162522,0.266667,0.001176
9602148,9602148,,10,3,13,10,3,13,0.00036,0.000044,0,11983,52,0.000026,4,0.444444,0.526042,263.753447,0.192308,0.002678
9607120,9607120,,6,5,11,6,5,11,0.00033,0.000052,0,11984,52,0.000017,6,0.318584,0.418519,209.563392,0.263636,0.001475
9807236,9807236,,13,11,24,13,11,24,0.000027,0.000026,0,11982,6,0.000024,10,0.214371,0.273087,3323.561262,0.105072,0.003103
2186,2186,,134,20,154,134,20,154,0.008555,0.001871,0,11585,30,0.000129,13,0.197718,0.217171,182028.433666,0.074824,0.056726
2187,2187,,3,30,33,3,30,33,0.00038,0.01987,0,11988,30,0.000011,12,0.224371,0.251494,9138.152407,0.162879,0.001388
2188,2188,,5,23,28,5,23,28,0.000621,0.018522,0,11992,1,0.000013,11,0.229627,0.26124,13059.152964,0.185185,0.001289
9301010,9301010,,7,0,7,7,0,7,0.00129,0,0,11990,1,0.000014,0,0,0,0,0.166667,0.001894
9706091,9706091,,13,20,33,13,20,33,0.00094,0.000073,0,7532,9,0.000025,13,0.197128,0.225186,233366.170922,0.107008,0.003592
9906096,9906096,,4,32,36,4,32,36,0.00082,0.016318,0,11991,1,0.000012,13,0.192659,0.222887,3065.512633,0.066667,0.000967
9202058,9202058,,10,0,10,10,0,10,0.000072,0,0,1048,9,0.0001,0,0,0,0,0.111111,0.002627
9209075,9209075,,8,4,12,8,4,12,0.000002,0.000001,0,1049,9,0.000175,1,1,1,36472.462068,0.068182,0.002527
9207010,9207010,,8,2,10,8,2,10,0.000264,0.000001,0,1070,9,0.000031,1,1,1,61.273136,0.122222,0.001905
9204095,9204095,,33,0,33,33,0,33,0.000028,0,0,1029,9,0.000084,0,0,0,0,0.054924,0.008881
9304122,9304122,,14,0,14,14,0,14,0.000007,0,0,7504,9,0.000027,0,0,0,0,0.126374,0.003557
9407180,9407180,,9,3,12,9,3,12,0.000179,0.000001,0,6323,9,0.000027,3,0.485714,0.54902,16622.913758,0.136364,0.002964
9504082,9504082,,23,2,25,23,2,25,0.000972,0.000004,0,6322,9,0.000039,5,0.320513,0.374667,2440.704471,0.093333,0.006621
9504127,9504127,,24,4,28,24,4,28,0.000756,0.000011,0,4232,9,0.000047,4,0.428571,0.538889,20605.031968,0.140212,0.006903
9510059,9510059,,6,8,14,6,8,14,0.000204,0.000026,0,6328,9,0.000018,7,0.256303,0.349883,7876.4157,0.285714,0.001845
9512175,9512175,,12,14,26,12,14,26,0.000418,0.000116,0,6329,9,0.000022,7,0.257919,0.300738,14015.325708,0.132308,0.003308
9605102,9605102,,8,3,11,8,3,11,0.000021,0.000009,0,6336,9,0.000021,3,0.473684,0.592593,2318.521854,0.136364,0.002204
9606015,9606015,,8,9,17,8,9,17,0.000162,0.000011,0,7507,9,0.000018,12,0.148138,0.164873,116233.10891,0.139706,0.002263
9610167,9610167,,16,32,48,16,32,48,0.000311,0.001198,0,7510,9,0.000029,12,0.227492,0.270614,66686.526014,0.069592,0.004077
9610224,9610224,,10,11,21,10,11,21,0.000075,0.000029,0,7531,9,0.000023,6,0.247801,0.311834,27428.847822,0.114286,0.002448
9703222,9703222,,1,15,16,1,15,16,0.000001,0.000139,0,7526,6,0.000011,12,0.200802,0.234047,151208.045347,0.0375,0.000313
9704052,9704052,,12,17,29,12,17,29,0.000387,0.000067,0,7512,9,0.000028,13,0.1875,0.214108,31022.474493,0.14532,0.003186
9809154,9809154,,1,3,4,1,3,4,0.000198,0,0,7703,6,0.000011,11,0.164319,0.210925,112398.957044,0.166667,0.000468
9205065,9205065,,7,1,8,7,1,8,0.000147,0,0,1955,5,0.000024,1,1,1,278.893313,0.035714,0.002002
9403081,9403081,,5,0,5,5,0,5,0.000254,0,0,7509,1,0.000015,0,0,0,0,0.05,0.001612
9207057,9207057,,3,0,3,3,0,3,0.000193,0,0,268,41,0.000014,0,0,0,0,0,0.000704
9402042,9402042,,21,1,22,21,1,22,0.000307,0.000004,0,1333,9,0.000041,2,0.6,0.666667,193.149005,0.093074,0.0058
9406189,9406189,,3,6,9,3,6,9,0.000235,0.000989,0,1240,13,0.000015,5,0.341538,0.411261,15945.00418,0.125,0.001091
9410149,9410149,,7,1,8,7,1,8,0.000209,0.000023,0,9317,28,0.00002,6,0.276336,0.301657,1711.129867,0.071429,0.00169
9504099,9504099,,5,9,14,5,9,14,0.000203,0.000031,0,2853,9,0.000014,5,0.371429,0.450256,371.729688,0.247253,0.001216
9905181,9905181,,2,16,18,2,16,18,0.000296,0.01657,0,11989,1,0.000011,13,0.191544,0.218307,411.8125,0.277778,0.000494
2189,2189,,20,17,37,20,17,37,0.003393,0.019612,0,11993,1,0.000023,11,0.226874,0.257069,18157.129163,0.141892,0.006617
9908001,9908001,,10,20,30,10,20,30,0.001986,0.019569,0,9626,1,0.000016,11,0.231814,0.262678,13378.872105,0.202299,0.002921
9810069,9810069,,8,16,24,8,16,24,0.001657,0.020508,0,8793,1,0.000015,13,0.200321,0.225428,7967.602861,0.186594,0.002409
2191,2191,,13,48,61,13,48,61,0.002409,0.005859,0,11668,13,0.000014,12,0.212901,0.244344,15767.76727,0.115027,0.003597
9906094,9906094,,10,28,38,10,28,38,0.001741,0.002682,0,11666,13,0.000013,12,0.197755,0.228754,2212.81704,0.152916,0.002629
9910179,9910179,,5,21,26,5,21,26,0.000474,0.002728,0,11667,13,0.000012,12,0.196613,0.225647,8252.719741,0.209231,0.001672
9910237,9910237,,13,40,53,13,40,53,0.00158,0.012411,0,11664,13,0.000014,12,0.212789,0.243559,10817.906009,0.12119,0.003434
9404067,9404067,,2,7,9,2,7,9,0.00002,0.000392,0,1244,13,0.000016,3,0.531915,0.613333,1629.858526,0.083333,0.000899
9702167,9702167,,3,46,49,3,46,49,0.000346,0.010232,0,4626,13,0.000012,10,0.241686,0.290408,5356.755476,0.108844,0.001213
9812082,9812082,,15,16,31,15,16,31,0.001348,0.002383,0,8276,13,0.00002,12,0.197151,0.225417,6237.759053,0.193548,0.003907
9307194,9307194,,12,3,15,12,3,15,0.001469,0.000058,0,1644,8,0.000016,4,0.311594,0.366279,2470.778364,0.071429,0.003629
9906095,9906095,,5,11,16,5,11,16,0.000618,0.002053,0,11665,13,0.000013,12,0.192954,0.218225,1267.695429,0.3375,0.001334
2192,2192,,33,7,40,33,7,40,0.006234,0.002662,0,11597,1,0.000029,14,0.214337,0.24638,38973.560087,0.099359,0.01289
2193,2193,,20,3,23,20,3,23,0.000723,0.000262,0,11994,30,0.000024,14,0.177519,0.193692,4032.69681,0.183794,0.005682
2194,2194,,10,25,35,10,25,35,0.000519,0.01272,0,11995,30,0.000017,12,0.213587,0.237311,3543.134349,0.179832,0.003317
9903117,9903117,,3,22,25,3,22,25,0.000219,0.006375,0,8504,30,0.000017,13,0.196906,0.22373,818.279034,0.276667,0.001741
2195,2195,,1,5,6,1,5,6,0,0.001402,0,11996,23,0.000013,11,0.180173,0.203111,1351.507003,0.066667,0.000219
9311050,9311050,,5,0,5,5,0,5,0.000024,0,0,3981,23,0.000045,0,0,0,0,0.1,0.001204
9406013,9406013,,13,1,14,13,1,14,0.000274,0.00001,0,5519,30,0.000033,1,1,1,123.906372,0.10989,0.00465
9510197,9510197,,8,3,11,8,3,11,0.000017,0.000001,0,8966,23,0.000063,1,1,1,874.313438,0.1,0.001954
9412165,9412165,,15,0,15,15,0,15,0.000032,0,0,1099,23,0.000131,0,0,0,0,0.161905,0.003698
9501012,9501012,,11,1,12,11,1,12,0.000002,0,0,1100,23,0.000068,1,1,1,8993.354562,0.212121,0.002801
2196,2196,,10,9,19,10,9,19,0.000002,0.000021,0,11997,20,0.000018,15,0.15034,0.168259,15399.090488,0.175439,0.002627
9601154,9601154,,11,13,24,11,13,24,0.000181,0.000375,0,4601,5,0.000023,7,0.294189,0.356153,2526.259586,0.164855,0.002894
9309127,9309127,,6,0,6,6,0,6,0.000017,0,0,4612,5,0.00002,0,0,0,0,0.066667,0.001773
9406144,9406144,,11,2,13,11,2,13,0.000081,0.000002,0,1662,5,0.000027,3,0.466667,0.571429,11499.612294,0.224359,0.003386
9412161,9412161,,15,6,21,15,6,21,0.000231,0.000161,0,4590,5,0.000022,7,0.297414,0.359075,2792.486853,0.088095,0.004026
9210013,9210013,,22,0,22,22,0,22,0.000039,0,0,1638,5,0.000193,0,0,0,0,0.069264,0.006183
9302078,9302078,,12,0,12,12,0,12,0.000026,0,0,1636,5,0.000113,0,0,0,0,0.280303,0.003909
9406210,9406210,,14,1,15,14,1,15,0.00006,0.000123,0,1404,5,0.000043,4,0.349206,0.375,35.082547,0.133333,0.003985
2197,2197,,1,4,5,1,4,5,0,0.000002,0,11999,26,0.000013,5,0.396226,0.501587,20,0.1,0.000219
9310085,9310085,,13,0,13,13,0,13,0.000128,0,0,7296,26,0.000059,0,0,0,0,0.038462,0.003376
9503137,9503137,,13,1,14,13,1,14,0.000001,0,0,7304,26,0.00004,1,1,1,10.119048,0.159341,0.003223
9602027,9602027,,8,10,18,8,10,18,0,0.000002,0,7924,26,0.000027,4,0.558824,0.714912,25683.0921,0.120915,0.001977
9608103,9608103,,4,0,4,4,0,4,0,0,0,11998,26,0.000018,0,0,0,0,0,0.00089
9312102,9312102,,16,0,16,16,0,16,0.000001,0,0,7295,26,0.000116,0,0,0,0,0.141667,0.00446
9308067,9308067,,2,0,2,2,0,2,0,0,0,7923,26,0.000016,0,0,0,0,0,0.000506
9308130,9308130,,5,0,5,5,0,5,0,0,0,7297,26,0.000031,0,0,0,0,0.1,0.001375
9412018,9412018,,16,3,19,16,3,19,0.000026,0.000002,0,7298,26,0.00004,1,1,1,14154.045686,0.076023,0.004028
9502113,9502113,,18,7,25,18,7,25,0.000002,0.000004,0,7302,26,0.000052,3,0.636364,0.738095,20761.568025,0.128333,0.004551
9505092,9505092,,1,2,3,1,2,3,0,0,0,7922,26,0.000012,1,1,1,0,0.5,0.000274
9505168,9505168,,3,2,5,3,2,5,0,0.000001,0,7921,26,0.000015,4,0.416667,0.483333,5.564583,0.3,0.000733
2198,2198,,13,25,38,13,25,38,0.001643,0.011493,0,12001,30,0.000015,11,0.2359,0.26666,11268.975546,0.170697,0.004039
9911147,9911147,,37,29,66,37,29,66,0.005287,0.021957,0,12000,2,0.000028,11,0.234189,0.267028,99095.420559,0.101399,0.012262
9305117,9305117,,9,4,13,9,4,13,0.000154,0.000031,0,2744,9,0.000024,1,1,1,905.84158,0.217949,0.00303
9405196,9405196,,7,9,16,7,9,16,0.000088,0.00006,0,3771,9,0.000028,4,0.348214,0.474359,1392.584259,0.083333,0.002145
9607117,9607117,,2,14,16,2,14,16,0.000033,0.000076,0,7145,5,0.000012,7,0.299113,0.363317,39901.428341,0.095833,0.000595
9706157,9706157,,4,17,21,4,17,21,0.000335,0.003633,0,7142,13,0.000016,13,0.205201,0.241361,2755.702223,0.202381,0.001118
2199,2199,,1,18,19,1,18,19,0.000231,0.018819,0,12003,1,0.000012,12,0.226245,0.25753,1048.564844,0.327485,0.001024
9910066,9910066,,8,25,33,8,25,33,0.001869,0.020119,0,12002,1,0.000014,11,0.228209,0.260028,3229.121657,0.211174,0.003169
9802106,9802106,,2,0,2,2,0,2,0.000191,0,0,8307,5,0.000014,0,0,0,0,0,0.000703
2200,2200,,0,10,10,0,10,10,0,0.00764,0,12014,13,0.00001,16,0.204236,0.235998,0,0.1,0
9802121,9802121,,11,26,37,11,26,37,0.001253,0.004756,0,6550,13,0.000016,14,0.19531,0.234356,56647.371939,0.216216,0.002832
9910041,9910041,,6,42,48,6,42,48,0.000533,0.008249,0,12013,13,0.000013,15,0.213188,0.260667,5081.947798,0.177305,0.001443
9603107,9603107,,5,2,7,5,2,7,0.000694,0.000008,0,3519,13,0.000013,5,0.262548,0.297549,7618.239551,0.238095,0.001618
9710207,9710207,,15,16,31,15,16,31,0.001232,0.003236,0,6549,13,0.000018,14,0.208445,0.242159,31880.91833,0.165591,0.003795
9805113,9805113,,5,21,26,5,21,26,0.000628,0.002064,0,12007,13,0.000011,15,0.203752,0.236548,5225.981143,0.238462,0.001302
9807004,9807004,,10,6,16,10,6,16,0.000581,0.00003,0,12006,26,0.000017,12,0.165794,0.212452,5030.134109,0.175,0.002409
9901130,9901130,,5,14,19,5,14,19,0.000523,0.001024,0,12012,13,0.000013,12,0.194375,0.224095,3143.812087,0.119883,0.001261
9907019,9907019,,9,37,46,9,37,46,0.000782,0.007431,0,12008,13,0.000014,15,0.208596,0.254072,3599.715116,0.185507,0.002218
2201,2201,,0,2,2,0,2,2,0,0,0,12016,26,0.00001,12,0.145627,0.170254,0,0.5,0
9908119,9908119,,2,2,4,2,2,4,0,0,0,12015,26,0.000016,12,0.150602,0.176686,78.533333,0.333333,0.000438
9306132,9306132,,28,0,28,28,0,28,0.000023,0,0,4503,23,0.000238,0,0,0,0,0.109788,0.007644
9403147,9403147,,15,2,17,15,2,17,0.000014,0,0,8012,26,0.000065,1,1,1,351.332349,0.091912,0.003657
9412145,9412145,,2,3,5,2,3,5,0.000012,0,0,8013,26,0.000023,1,1,1,172.930841,0.3,0.000628
9510050,9510050,,3,1,4,3,1,4,0.000045,0.000001,0,10995,26,0.000014,4,0.340426,0.385417,330.002048,0.083333,0.000756
9612250,9612250,,5,5,10,5,5,10,0.000014,0.000001,0,8389,26,0.000024,3,0.666667,0.791667,22019.701331,0.144444,0.001241
9707136,9707136,,12,2,14,12,2,14,0.0001,0,0,10994,26,0.000035,1,1,1,7163.525905,0.104396,0.002858
2202,2202,,0,22,22,0,22,22,0,0.019324,0,12019,2,0.00001,12,0.211219,0.237408,0,0.147186,0
9912244,9912244,,3,31,34,3,31,34,0.000516,0.025451,0,12018,1,0.000012,12,0.213681,0.240134,4599.484326,0.108734,0.001379
9201005,9201005,,30,0,30,30,0,30,0.000017,0,0,145,5,0.000274,0,0,0,0,0.04023,0.009482
9202008,9202008,,8,0,8,8,0,8,0.000094,0,0,143,26,0.000147,0,0,0,0,0.142857,0.004017
9206085,9206085,,2,0,2,2,0,2,0,0,0,166,17,0.000035,0,0,0,0,0,0.00091
9912074,9912074,,7,3,10,7,3,10,0.000718,0.000084,0,12017,0,0.000051,14,0.165194,0.18065,29904.910413,0.177778,0.00182
2203,2203,,1,2,3,1,2,3,0,0.000011,0,12020,4,0.000019,20,0.111452,0.135706,1706,0,0.000219
9810198,9810198,,8,22,30,8,22,30,0.000904,0.000043,0,11747,4,0.000026,19,0.125276,0.166572,36757.699267,0.029885,0.002019
9206045,9206045,,9,0,9,9,0,9,0.000007,0,0,3010,4,0.000038,0,0,0,0,0.041667,0.002204
9211132,9211132,,14,0,14,14,0,14,0.000217,0,0,1672,4,0.000065,0,0,0,0,0.038462,0.00357
9306106,9306106,,9,0,9,9,0,9,0.000185,0,0,10076,28,0.000031,0,0,0,0,0.111111,0.002251
9307156,9307156,,2,3,5,2,3,5,0.000001,0.000002,0,11744,41,0.000014,2,0.714286,0.8,1332.745813,0.1,0.000501
9312055,9312055,,3,1,4,3,1,4,0.000001,0,0,11746,41,0.00002,1,1,1,818.965098,0,0.000753
9406117,9406117,,7,0,7,7,0,7,0.000014,0,0,10065,26,0.000033,0,0,0,0,0.119048,0.001749
9406162,9406162,,6,4,10,6,4,10,0.000002,0.000004,0,10080,28,0.00002,2,0.75,0.833333,3689.76827,0.066667,0.001484
9410121,9410121,,1,3,4,1,3,4,0.000001,0.000004,0,11745,41,0.000011,3,0.538462,0.666667,12.928939,0.25,0.000275
9411016,9411016,,7,2,9,7,2,9,0.000001,0.000002,0,4754,23,0.000029,2,0.75,0.833333,855.595949,0.180556,0.001778
9705020,9705020,,2,3,5,2,3,5,0.000002,0.00014,0,9484,41,0.000013,3,0.484848,0.552083,150.341467,0.25,0.000511
9710015,9710015,,2,5,7,2,5,7,0.000039,0.000142,0,9485,41,0.000012,3,0.515152,0.607843,13811.756927,0.166667,0.000738
9808011,9808011,,1,2,3,1,2,3,0.000001,0,0,11743,20,0.000011,3,0.545455,0.638889,631.334009,0.166667,0.000275
2204,2204,,6,11,17,6,11,17,0.000457,0.000414,0,12021,2,0.000015,13,0.174447,0.199675,1827.49641,0.183824,0.001649
2205,2205,,9,33,42,9,33,42,0.000633,0.00863,0,12022,0,0.000013,12,0.220162,0.248021,10243.077415,0.097561,0.002249
2206,2206,,0,2,2,0,2,2,0,0,0,12025,26,0.00001,12,0.13898,0.162283,0,0.5,0
9909044,9909044,,6,5,11,6,5,11,0,0,0,12024,26,0.000022,12,0.147166,0.174398,843.658388,0.181818,0.001342
9409115,9409115,,1,0,1,1,0,1,0,0,0,12023,26,0.000014,0,0,0,0,0,0.000258
2207,2207,,0,5,5,0,5,5,0,0.000021,0,12026,2,0.00001,12,0.162267,0.18458,0,0.15,0
9201051,9201051,,6,0,6,6,0,6,0.000001,0,0,849,4,0.000047,0,0,0,0,0,0.001877
9612065,9612065,,12,11,23,12,11,23,0.000478,0.000053,0,6454,2,0.000023,11,0.184159,0.215788,91580.452604,0.081028,0.003103
9505161,9505161,,52,13,65,52,13,65,0.000546,0.000146,0,5297,5,0.000104,6,0.298303,0.336105,55394.848149,0.044712,0.013023
9605008,9605008,,27,5,32,27,5,32,0.000784,0.000045,0,6447,5,0.000043,7,0.263608,0.295519,18285.784582,0.078629,0.007021
2208,2208,,2,2,4,2,2,4,0,0.000001,0,12043,23,0.000012,14,0.136269,0.148202,1217.964226,0.083333,0.000459
9809030,9809030,,2,2,4,2,2,4,0,0.000001,0,12042,28,0.000024,13,0.157504,0.175435,2753.047559,0.083333,0.000452
9305004,9305004,,11,0,11,11,0,11,0,0,0,4358,28,0.000112,0,0,0,0,0.009091,0.002618
9805124,9805124,,4,10,14,4,10,14,0.000001,0.000001,0,12041,26,0.000028,12,0.186356,0.218454,5150.781576,0.115385,0.00089
2209,2209,,3,18,21,3,18,21,0.000204,0.01774,0,12046,26,0.000012,14,0.1899,0.218071,2618.169702,0.157143,0.000671
9412110,9412110,,3,6,9,3,6,9,0.000443,0.000157,0,2519,26,0.000011,2,0.6875,0.772727,7379.229658,0.125,0.000746
9910088,9910088,,2,9,11,2,9,11,0.000212,0.000192,0,12044,26,0.000012,4,0.592593,0.744792,23.533333,0.218182,0.000478
9910264,9910264,,3,9,12,3,9,12,0.000405,0.000277,0,12045,26,0.000012,8,0.269388,0.321215,345.968714,0.189394,0.00069
9212090,9212090,,28,0,28,28,0,28,0.000057,0,0,150,26,0.000147,0,0,0,0,0.096561,0.008144
9212148,9212148,,3,0,3,3,0,3,0.000024,0,0,187,6,0.000032,0,0,0,0,0.166667,0.00181
9304060,9304060,,16,1,17,16,1,17,0.000648,0.000038,0,773,4,0.000062,1,1,1,38.771505,0.180147,0.00572
9305095,9305095,,16,2,18,16,2,18,0.000703,0.000046,0,774,4,0.000048,1,1,1,367.229626,0.176471,0.00602
9306110,9306110,,3,4,7,3,4,7,0.000028,0.000171,0,181,26,0.000031,2,0.833333,0.9,1320.566355,0.214286,0.001846
9308132,9308132,,4,2,6,4,2,6,0.000035,0.00004,0,772,4,0.000019,1,1,1,2100.485419,0.133333,0.001682
9308135,9308135,,3,0,3,3,0,3,0.000025,0,0,698,26,0.000023,0,0,0,0,0.166667,0.001428
9310153,9310153,,3,0,3,3,0,3,0.000021,0,0,754,4,0.000016,0,0,0,0,0.166667,0.001189
9312018,9312018,,6,5,11,6,5,11,0.000029,0.000202,0,137,26,0.000039,2,0.777778,0.857143,11381.279713,0.109091,0.002473
9401115,9401115,,19,2,21,19,2,21,0.000117,0.000051,0,753,26,0.00005,1,1,1,15838.778235,0.066667,0.004978
9401130,9401130,,2,1,3,2,1,3,0.00002,0.000208,0,751,4,0.000014,1,1,1,0.5,0.166667,0.000957
9402041,9402041,,6,4,10,6,4,10,0.000142,0.00004,0,750,22,0.000021,2,0.833333,0.9,20364.413323,0.111111,0.002153
9403126,9403126,,6,4,10,6,4,10,0.000023,0.00004,0,746,4,0.000024,1,1,1,27469.157316,0.122222,0.001931
9406046,9406046,,5,6,11,5,6,11,0.000022,0.000218,0,736,26,0.000016,6,0.22488,0.32305,9171.872806,0.136364,0.001682
9406100,9406100,,5,10,15,5,10,15,0.000032,0.000258,0,727,26,0.000015,5,0.35,0.434762,12981.323921,0.22381,0.001719
9408029,9408029,,9,13,22,9,13,22,0.000054,0.000012,0,722,4,0.000017,3,0.6,0.716049,134464.034842,0.132035,0.002652
9408046,9408046,,14,9,23,14,9,23,0.000042,0.000232,0,3600,26,0.000027,3,0.684211,0.820513,1061.782112,0.171937,0.003597
2210,2210,,38,2,40,38,2,40,0.001338,0.000042,0,12047,30,0.000043,14,0.170279,0.182311,138.908769,0.124359,0.014521
2211,2211,,131,29,160,131,29,160,0.006958,0.002218,0,12048,3,0.00013,12,0.203318,0.226054,76787.683028,0.097327,0.065797
9404166,9404166,,1,2,3,1,2,3,0.000101,0.00013,0,1941,2,0.000021,2,0.75,0.833333,38.55297,0.333333,0.001926
9511170,9511170,,3,2,5,3,2,5,0.000253,0,0,1774,22,0.000022,4,0.423077,0.515152,99609.522083,0.05,0.002482
9507038,9507038,,5,4,9,5,4,9,0.000024,0.000059,0,2545,3,0.000022,5,0.35023,0.404605,14094.567559,0.319444,0.001667
9605075,9605075,,4,19,23,4,19,23,0.000017,0.000114,0,4484,3,0.00002,10,0.203863,0.281437,212279.037774,0.128458,0.0014
9606153,9606153,,7,10,17,7,10,17,0.000022,0.000275,0,4485,3,0.000028,11,0.174509,0.231614,4467.729082,0.198529,0.002123
2212,2212,,3,11,14,3,11,14,0.000118,0.001248,0,12059,30,0.000012,13,0.197414,0.21705,46349.09238,0.071429,0.000963
9701182,9701182,,2,0,2,2,0,2,0.000024,0,0,12056,30,0.000014,0,0,0,0,0.5,0.000489
9810149,9810149,,6,18,24,6,18,24,0.000771,0.005718,0,12058,0,0.000013,17,0.180035,0.215746,3636.348711,0.086957,0.001442
9810164,9810164,,5,4,9,5,4,9,0.000052,0.000049,0,12055,30,0.000023,14,0.161582,0.176667,21727.063037,0.180556,0.001485
9909206,9909206,,4,4,8,4,4,8,0.000053,0.000791,0,12057,30,0.000014,13,0.184525,0.200099,1282.526632,0.125,0.000975
9503080,9503080,,4,0,4,4,0,4,0.000169,0,0,2812,13,0.000028,0,0,0,0,0.083333,0.001358
9703105,9703105,,3,4,7,3,4,7,0.000015,0,0,12054,23,0.000021,2,0.75,0.833333,22743.300446,0.119048,0.00086
2213,2213,,8,8,16,8,8,16,0.000026,0.000029,0,12060,6,0.000015,14,0.118077,0.136089,5131.552393,0.208333,0.001826
2214,2214,,2,15,17,2,15,17,0.000074,0.001835,0,12061,0,0.000011,13,0.191455,0.215428,3084.080434,0.279412,0.000465
9811096,9811096,,5,33,38,5,33,38,0.000198,0.005604,0,8602,0,0.000012,15,0.191224,0.230264,1838.43782,0.216927,0.00127
9901123,9901123,,8,24,32,8,24,32,0.000355,0.001858,0,8603,0,0.000014,16,0.179303,0.216424,718.923855,0.1875,0.001859
2215,2215,,1,14,15,1,14,15,0.000006,0.000243,0,12062,0,0.00001,12,0.198396,0.223541,441.244031,0.219048,0.000242
9410217,9410217,,14,5,19,14,5,19,0.000165,0.000232,0,2153,13,0.000032,5,0.396226,0.452646,13745.074093,0.122807,0.003775
2216,2216,,1,11,12,1,11,12,0.000199,0.01546,0,12063,1,0.00001,12,0.196044,0.217178,159.312681,0.143939,0.000259
9509062,9509062,,9,6,15,9,6,15,0.000225,0.000051,0,8167,22,0.000044,1,1,1,9012.673547,0.119048,0.002357
2217,2217,,4,14,18,4,14,18,0.000028,0.001186,0,12073,4,0.000012,13,0.177848,0.200249,5964.833076,0.30719,0.000916
9607219,9607219,,12,18,30,12,18,30,0.000243,0.002206,0,4213,4,0.000035,10,0.215252,0.249035,12922.911373,0.2,0.003378
9610216,9610216,,8,14,22,8,14,22,0.000088,0.001692,0,4214,4,0.000026,11,0.194559,0.227073,1731.418729,0.242424,0.002196
9705108,9705108,,19,5,24,19,5,24,0.00028,0.000113,0,4220,4,0.000055,11,0.178443,0.197862,7750.735396,0.253623,0.004846
9711028,9711028,,14,12,26,14,12,26,0.000245,0.002153,0,12065,4,0.000029,11,0.191391,0.219898,3633.854186,0.227692,0.003518
9801033,9801033,,11,7,18,11,7,18,0.000207,0.000027,0,12066,4,0.000025,11,0.178353,0.197783,786.349186,0.333333,0.002771
9809125,9809125,,10,3,13,10,3,13,0.000135,0.000009,0,12070,4,0.000016,12,0.160807,0.176657,5.071429,0.314103,0.002364
9910042,9910042,,4,39,43,4,39,43,0.000105,0.003536,0,12072,0,0.000012,12,0.212349,0.248234,26668.523069,0.097453,0.000941
5274,5274,,3,17,20,3,17,20,0.000047,0.000208,0,12074,4,0.000011,14,0.157789,0.177117,99.281451,0.302632,0.000684
9809126,9809126,,9,3,12,9,3,12,0.000121,0.000009,0,12069,4,0.000015,12,0.160807,0.176657,5.071429,0.310606,0.002118
9809127,9809127,,11,18,29,11,18,29,0.00013,0.009315,0,12068,4,0.00002,16,0.175033,0.201964,10512.566075,0.137931,0.002583
9909201,9909201,,10,13,23,10,13,23,0.000119,0.000939,0,12071,4,0.000019,17,0.152344,0.17254,353.881281,0.243083,0.002298
9506007,9506007,,12,6,18,12,6,18,0.000172,0.000033,0,4212,4,0.000022,8,0.240495,0.288721,16421.000001,0.133987,0.003351
9605191,9605191,,4,0,4,4,0,4,0.000061,0,0,4208,4,0.000017,0,0,0,0,0.5,0.001194
9604191,9604191,,7,1,8,7,1,8,0.000147,0.000001,0,4218,4,0.000021,2,0.571429,0.625,10793.525173,0.089286,0.002029
9709200,9709200,,4,1,5,4,1,5,0.000358,0.000003,0,12064,4,0.000017,12,0.151487,0.162617,5669.625706,0.3,0.001503
9208023,9208023,,11,0,11,11,0,11,0.00019,0,0,1700,0,0.000022,0,0,0,0,0.172727,0.003114
2218,2218,,1,5,6,1,5,6,0.000243,0.000006,0,11673,52,0.00001,13,0.17886,0.194566,24455.74992,0.033333,0.000453
9605169,9605169,,3,7,10,3,7,10,0.000014,0.001668,0,11670,17,0.000013,10,0.196444,0.226978,2826.105552,0.211111,0.00068
9711008,9711008,,1,14,15,1,14,15,0,0.00104,0,11672,17,0.000012,12,0.204056,0.234862,11817.629085,0.147619,0.000229
9301038,9301038,,38,4,42,38,4,42,0.000269,0.000003,0,708,17,0.000096,1,1,1,12807.583664,0.047619,0.010338
9412203,9412203,,26,7,33,26,7,33,0.000797,0.000064,0,3862,26,0.000059,7,0.261324,0.329556,39687.689531,0.110795,0.007824
9508099,9508099,,10,7,17,10,7,17,0.000037,0.000005,0,3859,6,0.000018,7,0.281726,0.358215,69683.319717,0.139706,0.002339
9510199,9510199,,7,28,35,7,28,35,0.000043,0.000207,0,3864,17,0.00002,7,0.292233,0.37233,164200.141782,0.089076,0.001684
9510208,9510208,,4,8,12,4,8,12,0.000039,0.00011,0,3865,17,0.000016,8,0.217861,0.251926,981.419742,0.227273,0.000947
9311165,9311165,,3,0,3,3,0,3,0.000013,0,0,3858,6,0.000013,0,0,0,0,0.166667,0.000737
9510137,9510137,,10,15,25,10,15,25,0.000221,0.00013,0,2792,17,0.000026,7,0.238655,0.277911,49813.035874,0.111667,0.00239
9603030,9603030,,6,5,11,6,5,11,0.000068,0.000011,0,3876,26,0.000019,5,0.35514,0.433772,50566.460854,0.063636,0.001397
9607218,9607218,,2,9,11,2,9,11,0.000012,0.000635,0,3866,17,0.000013,10,0.208966,0.237311,2573.574804,0.172727,0.000476
9608030,9608030,,1,20,21,1,20,21,0.000012,0.000113,0,11671,17,0.000011,11,0.170265,0.20503,2370.97467,0.207143,0.000226
9611207,9611207,,4,5,9,4,5,9,0.000278,0.000005,0,3877,17,0.000015,11,0.180311,0.20166,291891.914693,0.166667,0.001268
9211138,9211138,,6,1,7,6,1,7,0.000002,0,0,1263,52,0.000044,1,1,1,196.243229,0.071429,0.00151
9803129,9803129,,4,4,8,4,4,8,0.000003,0.000005,0,8978,52,0.000017,4,0.418182,0.503623,606.745275,0.053571,0.000956
2219,2219,,4,17,21,4,17,21,0.000007,0.00006,0,12075,6,0.000013,14,0.173798,0.194168,48783.775377,0.161905,0.000956
9203062,9203062,,8,0,8,8,0,8,0,0,0,1284,9,0.000107,0,0,0,0,0.107143,0.00238
9204080,9204080,,1,0,1,1,0,1,0,0,0,5669,6,0.000017,0,0,0,0,0,0.000366
9309018,9309018,,4,0,4,4,0,4,0.000166,0,0,5668,23,0.000062,0,0,0,0,0,0.001126
9206096,9206096,,32,0,32,32,0,32,0.000007,0,0,1290,9,0.000079,0,0,0,0,0.078629,0.00841
9208058,9208058,,13,0,13,13,0,13,0.000005,0,0,1447,6,0.000067,0,0,0,0,0.083333,0.003488
9304125,9304125,,17,3,20,17,3,20,0.000003,0.00001,0,1051,9,0.000058,3,0.457143,0.53125,18410.67244,0.160526,0.004897
9308086,9308086,,5,7,12,5,7,12,0.000019,0.000005,0,2367,6,0.000016,3,0.6,0.711111,17239.701743,0.113636,0.001419
9408167,9408167,,11,1,12,11,1,12,0.000002,0,0,5671,6,0.000035,1,1,1,0.45,0.265152,0.002757
9505017,9505017,,9,4,13,9,4,13,0.000002,0.000008,0,5672,6,0.000025,3,0.52,0.615385,407.156371,0.237179,0.002168
9304080,9304080,,3,3,6,3,3,6,0,0.000003,0,2362,6,0.000014,1,1,1,0,0.466667,0.000885
9306031,9306031,,2,0,2,2,0,2,0.000007,0,0,2380,6,0.000012,0,0,0,0,0.5,0.000635
9409047,9409047,,4,1,5,4,1,5,0.000505,0.000468,0,6583,1,0.000015,1,1,1,0,0.25,0.001269
2220,2220,,0,3,3,0,3,3,0,0.000009,0,12077,0,0.00001,15,0.160832,0.174272,0,0.166667,0
9906047,9906047,,2,9,11,2,9,11,0,0.011137,0,12076,1,0.000016,14,0.191582,0.215411,14300.080825,0.163636,0.000451
106067,106067,,17,9,26,17,9,26,0.001263,0.000568,0,12491,25,0.000017,18,0.184222,0.208537,19462.312144,0.112308,0.004276
5016,5016,,83,14,97,83,14,97,0.004451,0.001676,0,12274,25,0.000079,17,0.186983,0.205712,16412.507232,0.073883,0.02307
8054,8054,,58,26,84,58,26,84,0.003411,0.0044,0,12343,25,0.00006,12,0.199874,0.222683,74671.001887,0.081038,0.016028
104146,104146,,17,22,39,17,22,39,0.000935,0.00654,0,12490,2,0.000022,14,0.201521,0.229798,33386.046998,0.120108,0.004924
106050,106050,,14,17,31,14,17,31,0.000619,0.001146,0,12487,25,0.00002,17,0.184254,0.214388,33765.465557,0.126882,0.003904
2221,2221,,0,8,8,0,8,8,0,0.000008,0,12497,22,0.00001,15,0.119007,0.130639,0,0.410714,0
9407076,9407076,,16,3,19,16,3,19,0.000116,0.000005,0,4217,22,0.000063,1,1,1,5978.292772,0.169591,0.004234
9502088,9502088,,5,1,6,5,1,6,0.000001,0.000001,0,9502,22,0.000016,2,0.571429,0.625,0,0.466667,0.001322
9712139,9712139,,8,12,20,8,12,20,0.000068,0.000008,0,9503,22,0.000019,9,0.176533,0.255028,18262.729518,0.155263,0.002161
9812105,9812105,,5,12,17,5,12,17,0.000281,0.00001,0,12494,22,0.000014,9,0.178238,0.256045,10106.880833,0.242647,0.001302
9905057,9905057,,17,29,46,17,29,46,0.00015,0.000032,0,12496,22,0.000034,14,0.134446,0.152277,32243.458163,0.060386,0.003992
9210124,9210124,,13,0,13,13,0,13,0.000215,0,0,4216,22,0.000052,0,0,0,0,0.115385,0.003969
9212110,9212110,,18,0,18,18,0,18,0.000103,0,0,4215,22,0.000079,0,0,0,0,0.124183,0.005182
9401055,9401055,,2,3,5,2,3,5,0,0.000002,0,5142,15,0.000065,1,1,1,3531.518499,0.05,0.000647
9407070,9407070,,6,1,7,6,1,7,0.000082,0,0,5143,23,0.000045,2,0.571429,0.625,4116.428599,0.166667,0.00168
9502110,9502110,,18,4,22,18,4,22,0.000079,0.000104,0,5144,23,0.000076,7,0.22082,0.259116,25072.675661,0.132035,0.005073
9305032,9305032,,11,0,11,11,0,11,0.000053,0,0,6052,22,0.000033,0,0,0,0,0.290909,0.002978
9402093,9402093,,11,4,15,11,4,15,0.000142,0.000047,0,5145,22,0.000022,1,1,1,1128.937605,0.142857,0.003254
9412084,9412084,,10,3,13,10,3,13,0.000053,0.000003,0,6053,22,0.000025,2,0.714286,0.8,20023.709148,0.224359,0.002687
9607030,9607030,,10,3,13,10,3,13,0.000079,0.000005,0,6040,22,0.000021,2,0.8,0.875,337.241769,0.205128,0.002831
9602165,9602165,,4,3,7,4,3,7,0.00004,0.000014,0,6048,15,0.000014,3,0.571429,0.666667,24296.198688,0.095238,0.001062
9804122,9804122,,6,4,10,6,4,10,0.000044,0.000003,0,12493,22,0.000017,3,0.636364,0.761905,3304.224286,0.288889,0.001646
9201027,9201027,,15,0,15,15,0,15,0.000168,0,0,2894,15,0.000099,0,0,0,0,0.052381,0.003847
9305021,9305021,,9,1,10,9,1,10,0.000002,0.000001,0,4097,22,0.000047,1,1,1,22.376812,0.166667,0.00246
9312214,9312214,,2,1,3,2,1,3,0,0.000001,0,12495,22,0.000012,1,1,1,0,0.5,0.00056
9312215,9312215,,2,3,5,2,3,5,0,0.000003,0,6051,22,0.000019,1,1,1,9988,0.2,0.000624
9401095,9401095,,3,2,5,3,2,5,0.000013,0.000003,0,12492,22,0.000016,1,1,1,25.574366,0.3,0.000835
9709068,9709068,,3,4,7,3,4,7,0.000072,0.000005,0,12381,22,0.000014,7,0.201641,0.239895,2739.321898,0.190476,0.000811
2222,2222,,74,40,114,74,40,114,0.003643,0.004626,0,11638,4,0.00005,12,0.212864,0.241234,136588.324729,0.05597,0.027043
9503017,9503017,,14,22,36,14,22,36,0.00019,0.000539,0,1306,4,0.000027,7,0.288732,0.371583,44140.413407,0.072222,0.004298
9511206,9511206,,5,5,10,5,5,10,0.000368,0.000198,0,4316,4,0.000016,8,0.230398,0.268424,2590.443547,0.244444,0.001884
9611053,9611053,,3,7,10,3,7,10,0.000059,0.000301,0,11636,4,0.000014,8,0.231141,0.272075,282.108725,0.222222,0.001297
9911220,9911220,,1,7,8,1,7,8,0.000054,0.000298,0,11637,0,0.000011,8,0.230036,0.268536,563.370224,0.107143,0.000844
9204020,9204020,,11,0,11,11,0,11,0.000018,0,0,645,52,0.000185,0,0,0,0,0.045455,0.003073
9312004,9312004,,12,0,12,12,0,12,0.00003,0,0,786,52,0.000032,0,0,0,0,0.045455,0.003628
9405106,9405106,,11,3,14,11,3,14,0.000012,0.00001,0,1279,4,0.000035,3,0.555556,0.633333,3428.784708,0.120879,0.002916
9409029,9409029,,3,0,3,3,0,3,0.000315,0,0,1305,0,0.000013,0,0,0,0,0.166667,0.000785
9411135,9411135,,10,4,14,10,4,14,0.00013,0.000038,0,1304,4,0.000028,4,0.435897,0.534314,12505.757777,0.192308,0.003618
9401029,9401029,,12,2,14,12,2,14,0.00019,0.000004,0,784,0,0.000026,2,0.75,0.833333,4820.692885,0.082418,0.00395
9505122,9505122,,10,17,27,10,17,27,0.00009,0.000077,0,1308,4,0.000022,7,0.295354,0.36483,95854.710031,0.079772,0.002813
9512131,9512131,,2,7,9,2,7,9,0.000021,0.000117,0,3657,5,0.000018,5,0.43038,0.530392,104844.669025,0.125,0.001132
9809197,9809197,,10,12,22,10,12,22,0.000667,0.002799,0,9717,26,0.000025,17,0.15191,0.173276,20073.435817,0.08658,0.003185
2223,2223,,75,24,99,75,24,99,0.00418,0.007819,0,12236,3,0.000052,12,0.203502,0.227205,31035.780044,0.113069,0.03375
2224,2224,,0,1,1,0,1,1,0,0,0,12499,11,0.00001,1,1,1,0,0,0
9806183,9806183,,3,0,3,3,0,3,0,0,0,12498,11,0.00003,0,0,0,0,0,0.000658
2225,2225,,5,16,21,5,16,21,0,0.000001,0,12502,6,0.000014,13,0.163188,0.220016,1357.49361,0.15,0.001142
9612154,9612154,,7,8,15,7,8,15,0.000024,0.000005,0,6793,6,0.000017,10,0.195423,0.265886,671.450818,0.157143,0.001775
9909065,9909065,,9,12,21,9,12,21,0.000001,0.000006,0,12500,6,0.000019,9,0.224553,0.27653,1245.60098,0.166667,0.002185
9911216,9911216,,11,8,19,11,8,19,0,0.000001,0,12501,6,0.000032,9,0.217987,0.26191,1893.047817,0.192982,0.002603
9308057,9308057,,21,3,24,21,3,24,0.00008,0,0,3855,6,0.000054,1,1,1,1020.282357,0.15942,0.006033
9501029,9501029,,13,13,26,13,13,26,0.000002,0.000006,0,3829,6,0.00004,4,0.490196,0.581667,27464.797376,0.093846,0.003847
9205055,9205055,,8,0,8,8,0,8,0.000001,0,0,2398,6,0.00007,0,0,0,0,0.035714,0.001974
9208066,9208066,,31,0,31,31,0,31,0,0,0,1891,6,0.000209,0,0,0,0,0.006452,0.007365
9208067,9208067,,15,0,15,15,0,15,0,0,0,2042,6,0.000063,0,0,0,0,0.042857,0.003731
9209130,9209130,,10,0,10,10,0,10,0.000001,0,0,2395,6,0.000184,0,0,0,0,0.166667,0.002943
9501006,9501006,,2,2,4,2,2,4,0,0,0,5069,6,0.000013,1,1,1,0,0.5,0.000527
9601040,9601040,,2,6,8,2,6,8,0.000049,0.000001,0,5070,6,0.000014,4,0.413793,0.527778,95444.385349,0.160714,0.000732
9205084,9205084,,19,0,19,19,0,19,0.000367,0,0,798,3,0.000087,0,0,0,0,0.087719,0.005535
9312207,9312207,,6,1,7,6,1,7,0.000001,0,0,5990,6,0.000025,2,0.6,0.666667,10086.703964,0.238095,0.001667
9501017,9501017,,11,1,12,11,1,12,0.000004,0,0,2794,6,0.000045,1,1,1,13454.5,0.045455,0.002727
9511209,9511209,,13,5,18,13,5,18,0.000001,0.000007,0,5991,6,0.000029,3,0.529412,0.611111,21362.928932,0.107843,0.00339
9606072,9606072,,9,7,16,9,7,16,0.000024,0.000005,0,6792,6,0.000024,9,0.209414,0.262009,3621.449902,0.1875,0.002334
9607154,9607154,,8,4,12,8,4,12,0.000034,0.000001,0,12039,26,0.00002,10,0.189781,0.240473,4066.647679,0.090909,0.001941
2226,2226,,33,35,68,33,35,68,0.005923,0.021633,0,12271,1,0.000026,14,0.20668,0.235465,92178.186454,0.126866,0.010881
9912122,9912122,,3,10,13,3,10,13,0.000476,0.000272,0,12270,1,0.000012,13,0.160035,0.175525,22130.782768,0.217949,0.001166
9906077,9906077,,4,21,25,4,21,25,0.000947,0.018979,0,11864,1,0.000012,13,0.197691,0.22341,2638.515547,0.298333,0.001101
9611145,9611145,,10,8,18,10,8,18,0.000182,0.000024,0,12269,5,0.000018,10,0.237674,0.301129,18357.355731,0.150327,0.00272
9910255,9910255,,1,11,12,1,11,12,0.000003,0.000545,0,12266,1,0.000011,13,0.162736,0.180491,111.274355,0.325758,0.000246
2227,2227,,5,1,6,5,1,6,0.00034,0.000024,0,12503,52,0.000013,18,0.156498,0.17177,107.592921,0.133333,0.001249
2228,2228,,20,24,44,20,24,44,0.002734,0.02232,0,12148,25,0.00002,16,0.2234,0.257318,15231.748025,0.151691,0.006648
2229,2229,,2,8,10,2,8,10,0.000326,0.000118,0,12510,13,0.00001,15,0.16065,0.187211,494.028867,0.133333,0.000458
9705122,9705122,,29,16,45,29,16,45,0.00042,0.00341,0,6877,4,0.000058,10,0.22437,0.263399,45236.934491,0.036364,0.006974
9811256,9811256,,8,19,27,8,19,27,0.000049,0.000469,0,12505,13,0.000014,15,0.16711,0.194651,1881.778687,0.249288,0.001907
9903170,9903170,,4,24,28,4,24,28,0.000026,0.000243,0,12506,13,0.000012,14,0.176722,0.207396,4798.014714,0.198413,0.00093
9904188,9904188,,3,21,24,3,21,24,0.000018,0.000131,0,12509,13,0.000012,14,0.168177,0.196018,5354.267073,0.210145,0.00075
9209076,9209076,,43,0,43,43,0,43,0.00017,0,0,2058,9,0.000116,0,0,0,0,0.067553,0.01223
9411003,9411003,,13,3,16,13,3,16,0.000198,0.000101,0,1238,13,0.00003,5,0.280702,0.339583,37.282921,0.275,0.005448
9507014,9507014,,10,7,17,10,7,17,0.000151,0.00011,0,2227,13,0.000023,8,0.228881,0.276125,632.279205,0.371324,0.003996
9511061,9511061,,11,11,22,11,11,22,0.000542,0.000657,0,3285,13,0.000029,12,0.200769,0.252341,32685.126513,0.093074,0.003406
9310145,9310145,,5,1,6,5,1,6,0.000017,0.000003,0,12504,15,0.000014,1,1,1,50.024205,0.033333,0.001257
9509019,9509019,,9,9,18,9,9,18,0.000322,0.000303,0,8180,22,0.000017,5,0.305085,0.371142,5988.78096,0.071895,0.002198
9605212,9605212,,12,24,36,12,24,36,0.000099,0.000886,0,3318,13,0.000019,13,0.175191,0.225527,1030.175967,0.238095,0.003582
9611199,9611199,,14,21,35,14,21,35,0.000094,0.000337,0,5833,13,0.000019,14,0.188814,0.251077,5235.834165,0.2,0.003711
9710163,9710163,,15,50,65,15,50,65,0.000089,0.002842,0,5846,13,0.000018,14,0.19542,0.237449,146711.013056,0.164663,0.003758
9307030,9307030,,9,0,9,9,0,9,0.000052,0,0,2219,13,0.000035,0,0,0,0,0.152778,0.002373
9903152,9903152,,6,26,32,6,26,32,0.000017,0.000915,0,12508,13,0.000013,15,0.167556,0.198261,1026.618363,0.226815,0.001382
9804113,9804113,,2,26,28,2,26,28,0.000339,0.018342,0,6552,13,0.000011,12,0.209353,0.24096,71948.912236,0.170635,0.000633
2232,2232,,0,7,7,0,7,7,0,0.001942,0,12512,6,0.00001,14,0.125137,0.140999,0,0.238095,0
9905133,9905133,,2,13,15,2,13,15,0.000077,0.001869,0,12511,6,0.000011,13,0.141446,0.162361,2833.089968,0.147619,0.000445
2233,2233,,25,4,29,25,4,29,0.000324,0.000013,0,12513,30,0.000031,6,0.275676,0.348039,801.78898,0.119458,0.006369
9312048,9312048,,16,1,17,16,1,17,0.000185,0,0,8989,30,0.00004,1,1,1,6357.666667,0.143382,0.004583
9503046,9503046,,14,0,14,14,0,14,0.000219,0,0,8987,30,0.000034,0,0,0,0,0.181319,0.004094
9612017,9612017,,42,9,51,42,9,51,0.000621,0.000036,0,8990,30,0.000069,5,0.357664,0.466667,44348.582059,0.053333,0.011395
9304142,9304142,,5,0,5,5,0,5,0,0,0,8988,6,0.000092,0,0,0,0,0.05,0.001235
9403009,9403009,,3,2,5,3,2,5,0,0,0,8985,23,0.000052,1,1,1,12522,0.1,0.00102
9511219,9511219,,7,1,8,7,1,8,0.000021,0,0,8986,23,0.000037,2,0.6,0.666667,399.521776,0.035714,0.002099
9607204,9607204,,8,8,16,8,8,16,0.001052,0.001274,0,3261,26,0.000025,4,0.414634,0.512255,31629.404446,0.104167,0.00284
2234,2234,,3,6,9,3,6,9,0.000001,0.000002,0,12531,23,0.000012,19,0.137462,0.1523,10498.061118,0.111111,0.000684
9904185,9904185,,1,1,2,1,1,2,0,0.000001,0,12530,23,0.000012,1,1,1,0.333333,0,0.000239
9904204,9904204,,5,3,8,5,3,8,0.00001,0.000004,0,12520,23,0.000015,4,0.485714,0.553922,127.900211,0.125,0.001189
9906146,9906146,,6,11,17,6,11,17,0.000019,0.000007,0,12529,23,0.000018,12,0.180824,0.204994,9811.100434,0.088235,0.001389
9207008,9207008,,16,0,16,16,0,16,0.000047,0,0,3636,23,0.000094,0,0,0,0,0.0375,0.004171
9502033,9502033,,8,8,16,8,8,16,0.000001,0.000004,0,4099,23,0.000025,3,0.733333,0.848485,18462.047669,0.083333,0.00195
9502137,9502137,,8,4,12,8,4,12,0.000044,0.001029,0,4829,4,0.00003,6,0.270217,0.31253,1402.509423,0.090909,0.001927
9703152,9703152,,7,4,11,7,4,11,0.000023,0.000006,0,6032,23,0.000024,13,0.15589,0.176581,448.828363,0.272727,0.00187
9704023,9704023,,8,12,20,8,12,20,0.000023,0.000019,0,6033,23,0.000028,13,0.166567,0.197988,22538.950094,0.160526,0.002111
9706133,9706133,,7,33,40,7,33,40,0.000006,0.000023,0,12527,23,0.000017,12,0.204033,0.251153,23193.313037,0.064744,0.001628
9803247,9803247,,3,13,16,3,13,16,0,0.000025,0,12528,23,0.000014,13,0.180768,0.212985,2455.906302,0.170833,0.000717
9906124,9906124,,9,9,18,9,9,18,0.000019,0.000012,0,12519,23,0.000023,11,0.194406,0.219941,19429.87912,0.071895,0.002133
2235,2235,,1,17,18,1,17,18,0.000162,0.015651,0,12532,1,0.00001,11,0.228092,0.25885,215.334503,0.320261,0.000226
2236,2236,,24,6,30,24,6,30,0.001124,0.001285,0,12167,30,0.000032,14,0.175573,0.190485,25616.29241,0.156322,0.009624
9503194,9503194,,8,6,14,8,6,14,0.000002,0.000021,0,4761,23,0.000022,6,0.262425,0.314268,4500.132245,0.236264,0.00211
2237,2237,,133,24,157,133,24,157,0.005551,0.003398,0,12194,3,0.000138,12,0.201375,0.222345,52315.870667,0.113098,0.067458
2238,2238,,1,3,4,1,3,4,0,0.000002,0,12533,26,0.000011,2,0.8,0.875,1,0.166667,0.000219
9302012,9302012,,4,0,4,4,0,4,0,0,0,10304,26,0.000031,0,0,0,0,0.083333,0.000891
9406140,9406140,,6,0,6,6,0,6,0.000005,0,0,2714,5,0.000022,0,0,0,0,0.166667,0.00154
2239,2239,,13,9,22,13,9,22,0.000001,0.000001,0,12534,5,0.000036,17,0.098662,0.109938,36364.404322,0.15368,0.003169
9312080,9312080,,12,0,12,12,0,12,0.000002,0,0,5622,5,0.000083,0,0,0,0,0.098485,0.003329
9511060,9511060,,15,7,22,15,7,22,0.000016,0.000002,0,5645,5,0.000066,3,0.545455,0.657407,10281.954412,0.11039,0.004272
9608192,9608192,,4,1,5,4,1,5,0.000001,0,0,5621,5,0.00002,1,1,1,10702,0.15,0.001145
2240,2240,,7,14,21,7,14,21,0.000428,0.00098,0,12535,0,0.000013,14,0.169113,0.195657,112.233503,0.178571,0.001593
9209059,9209059,,2,0,2,2,0,2,0.000044,0,0,778,0,0.000019,0,0,0,0,0.5,0.000747
9210053,9210053,,3,0,3,3,0,3,0.000001,0,0,777,0,0.000026,0,0,0,0,0.166667,0.000878
9402114,9402114,,10,8,18,10,8,18,0.000295,0.000257,0,783,0,0.000021,2,0.75,0.833333,8699.972638,0.205882,0.003019
2241,2241,,4,9,13,4,9,13,0.000121,0.000462,0,12536,0,0.000012,12,0.189137,0.210907,6684.668063,0.147436,0.00126
2242,2242,,15,41,56,15,41,56,0.000939,0.006337,0,11669,13,0.000023,11,0.211161,0.240018,55670.34892,0.077597,0.003887
9202075,9202075,,13,0,13,13,0,13,0.00003,0,0,213,5,0.000299,0,0,0,0,0.038462,0.004464
9503084,9503084,,2,9,11,2,9,11,0.000117,0.000747,0,1126,13,0.000019,7,0.2875,0.330715,104.106806,0.163636,0.001697
9506065,9506065,,7,35,42,7,35,42,0.000368,0.003316,0,1143,13,0.000038,6,0.346904,0.414914,80669.759704,0.065041,0.003862
9711042,9711042,,16,24,40,16,24,40,0.001548,0.002995,0,8356,13,0.000023,18,0.202266,0.242024,6851.635614,0.074359,0.006642
9802140,9802140,,4,20,24,4,20,24,0.000168,0.003318,0,7612,13,0.000012,14,0.182217,0.213594,217.416197,0.21558,0.00109
2243,2243,,2,3,5,2,3,5,0.000001,0,0,12546,22,0.000012,17,0.125704,0.134674,170.866259,0.15,0.000445
9405173,9405173,,8,0,8,8,0,8,0,0,0,7569,26,0.000098,0,0,0,0,0.178571,0.002033
9906189,9906189,,6,5,11,6,5,11,0,0.000013,0,12545,22,0.000029,16,0.143719,0.15742,31863.770548,0.245455,0.001381
9812147,9812147,,6,1,7,6,1,7,0,0.000005,0,12537,22,0.000031,2,0.571429,0.625,41.666667,0.357143,0.001448
9901100,9901100,,5,3,8,5,3,8,0,0,0,12538,22,0.000024,3,0.5,0.611111,30,0.357143,0.001196
9905077,9905077,,4,6,10,4,6,10,0,0.000003,0,12544,22,0.000021,20,0.102009,0.11644,480.835102,0.233333,0.000949
2244,2244,,14,40,54,14,40,54,0.00307,0.00704,0,11595,2,0.000018,16,0.216414,0.246445,89043.746017,0.08211,0.007534
9803069,9803069,,3,29,32,3,29,32,0.000201,0.003129,0,6944,4,0.000012,12,0.212359,0.245496,21807.93544,0.208669,0.00118
9907215,9907215,,8,28,36,8,28,36,0.000831,0.003811,0,11590,0,0.000017,13,0.201505,0.231336,16210.640694,0.12381,0.002789
9911113,9911113,,6,29,35,6,29,35,0.001169,0.003023,0,11588,0,0.000012,13,0.197226,0.221777,21144.238812,0.114286,0.002221
9912157,9912157,,15,26,41,15,26,41,0.001217,0.006762,0,11587,52,0.000016,12,0.206976,0.232158,9470.373611,0.115244,0.005364
9810213,9810213,,2,16,18,2,16,18,0.00008,0.002359,0,11589,0,0.000011,12,0.188488,0.212771,69.919755,0.24183,0.000504
2245,2245,,52,57,109,52,57,109,0.000471,0.000145,0,12233,23,0.000077,17,0.15919,0.194566,480867.802245,0.033469,0.012479
9306054,9306054,,14,0,14,14,0,14,0.000033,0,0,814,23,0.00019,0,0,0,0,0.164835,0.004473
9407129,9407129,,9,0,9,9,0,9,0.000025,0,0,2554,23,0.000042,0,0,0,0,0.208333,0.003154
9410190,9410190,,6,1,7,6,1,7,0.000005,0.000021,0,2601,23,0.000022,1,1,1,50.737855,0.02381,0.00182
9411202,9411202,,14,5,19,14,5,19,0.000017,0.000009,0,2561,23,0.00006,5,0.377193,0.449225,15982.164534,0.131579,0.004541
9502087,9502087,,2,2,4,2,2,4,0.000002,0,0,2581,23,0.000013,3,0.555556,0.666667,9622.868709,0.166667,0.000897
9504036,9504036,,4,8,12,4,8,12,0.000003,0.000023,0,2577,23,0.000014,6,0.354037,0.440351,3386.684977,0.174242,0.001396
9504037,9504037,,2,6,8,2,6,8,0.000002,0.000007,0,2576,23,0.000013,5,0.380952,0.447024,1663.073364,0.214286,0.000897
9509035,9509035,,14,17,31,14,17,31,0.000082,0.000025,0,2602,23,0.00004,9,0.255741,0.317822,100497.353285,0.127957,0.004262
9509047,9509047,,7,15,22,7,15,22,0.000017,0.000012,0,4103,23,0.000019,5,0.411392,0.525897,86732.305341,0.123377,0.002309
9510116,9510116,,3,5,8,3,5,8,0.000002,0.000015,0,11655,23,0.000013,7,0.337079,0.378294,425.593388,0.285714,0.001076
9510195,9510195,,6,12,18,6,12,18,0.000021,0.000117,0,4118,23,0.000018,8,0.267163,0.306798,26489.234363,0.215686,0.001839
9602163,9602163,,9,2,11,9,2,11,0.000023,0.000004,0,4117,23,0.000025,6,0.295455,0.345833,276.122049,0.172727,0.002674
9702042,9702042,,9,6,15,9,6,15,0.000009,0.000018,0,9462,23,0.000016,11,0.185978,0.225531,48.278377,0.247619,0.002533
9703017,9703017,,3,4,7,3,4,7,0.000002,0.000002,0,11657,23,0.000013,7,0.256098,0.323469,3205.275301,0.142857,0.001069
9708159,9708159,,5,9,14,5,9,14,0.000002,0.000006,0,12232,23,0.000019,5,0.377907,0.462051,2682.264896,0.104396,0.001467
9712125,9712125,,7,18,25,7,18,25,0.000201,0.00144,0,5564,23,0.000019,15,0.179337,0.217874,256639.456077,0.161667,0.002272
9712226,9712226,,28,19,47,28,19,47,0.000182,0.000085,0,9456,23,0.000045,16,0.158263,0.18955,87048.762198,0.114709,0.007383
9802027,9802027,,5,7,12,5,7,12,0.000034,0.000011,0,7381,23,0.000018,11,0.189895,0.21674,18892.738948,0.098485,0.001609
9802118,9802118,,6,16,22,6,16,22,0.000007,0.000043,0,9461,23,0.00002,14,0.173459,0.200461,77630.241658,0.090909,0.001812
9807016,9807016,,14,4,18,14,4,18,0.000028,0.00023,0,9457,23,0.000023,17,0.138707,0.160559,15720.855701,0.114379,0.003872
9811231,9811231,,5,8,13,5,8,13,0.000005,0.001356,0,11654,23,0.000015,15,0.188209,0.21985,20505.452822,0.115385,0.001534
9906115,9906115,,1,2,3,1,2,3,0.000002,0.000004,0,12231,23,0.000011,6,0.278195,0.334234,0,0.5,0.000571
9906121,9906121,,1,4,5,1,4,5,0.000002,0.000005,0,12230,23,0.000011,15,0.14799,0.164054,5298.558101,0.25,0.000571
9909223,9909223,,4,16,20,4,16,20,0.000002,0.000001,0,12228,23,0.000019,11,0.172512,0.241428,29156.838549,0.147368,0.001241
9910201,9910201,,6,14,20,6,14,20,0.000324,0.000016,0,11658,23,0.000014,18,0.130064,0.154652,61951.524561,0.110526,0.001855
9911092,9911092,,7,11,18,7,11,18,0.000005,0.000004,0,12226,23,0.000017,11,0.184383,0.233082,43272.0081,0.107843,0.001971
9912021,9912021,,4,18,22,4,18,22,0.00007,0.000237,0,12220,23,0.000013,16,0.161351,0.18474,25139.921297,0.132035,0.001282
9306135,9306135,,4,1,5,4,1,5,0.000004,0,0,2572,23,0.000018,1,1,1,4634.514859,0.05,0.001136
9307027,9307027,,13,1,14,13,1,14,0.000037,0,0,540,2,0.000073,1,1,1,12277.190347,0.010989,0.003388
9310123,9310123,,18,3,21,18,3,21,0.000016,0.000003,0,2562,23,0.000075,1,1,1,539.81157,0.088095,0.005077
9407061,9407061,,7,10,17,7,10,17,0.000003,0.000016,0,2571,23,0.000022,5,0.456522,0.558333,2068.379319,0.172794,0.001878
9404183,9404183,,2,1,3,2,1,3,0,0.000116,0,2560,23,0.000024,2,0.555556,0.6,573.186257,0.166667,0.000556
9210038,9210038,,12,0,12,12,0,12,0.000001,0,0,2243,23,0.000097,0,0,0,0,0.136364,0.002957
9402108,9402108,,7,3,10,7,3,10,0.000001,0,0,2580,23,0.000029,2,0.8,0.875,16585.56636,0.177778,0.001622
9307169,9307169,,13,2,15,13,2,15,0.000014,0.000002,0,2575,23,0.000026,1,1,1,19.200526,0.128571,0.003237
9312087,9312087,,9,3,12,9,3,12,0.000002,0.000002,0,2570,23,0.000021,1,1,1,67.541965,0.25,0.002247
9405133,9405133,,7,7,14,7,7,14,0.000002,0.000081,0,2568,23,0.000025,1,1,1,7909.500827,0.164835,0.001967
9503022,9503022,,8,11,19,8,11,19,0.000237,0.00258,0,1242,0,0.000028,8,0.240764,0.303045,12033.536398,0.143275,0.002674
9304007,9304007,,9,1,10,9,1,10,0.000001,0.000001,0,4102,23,0.000021,1,1,1,6.951149,0.155556,0.00219
9310179,9310179,,15,6,21,15,6,21,0.000006,0.000081,0,4101,23,0.000032,1,1,1,4735.060875,0.111905,0.003539
9405064,9405064,,2,0,2,2,0,2,0,0,0,4100,23,0.00002,0,0,0,0,0,0.000495
9209099,9209099,,21,1,22,21,1,22,0.00017,0.000021,0,521,3,0.000057,1,1,1,29.642842,0.071429,0.006066
9406095,9406095,,3,3,6,3,3,6,0.000129,0.000069,0,4476,3,0.000012,2,0.8,0.875,67.365571,0.2,0.001115
9505156,9505156,,9,14,23,9,14,23,0.000012,0.000013,0,4464,23,0.000023,7,0.243312,0.312603,18851.468525,0.173913,0.002318
9512032,9512032,,2,6,8,2,6,8,0.000002,0.000042,0,4456,9,0.000012,8,0.257862,0.333479,47066.806565,0.232143,0.000549
9304035,9304035,,3,0,3,3,0,3,0.000013,0,0,4121,23,0.000015,0,0,0,0,0.333333,0.00085
9604025,9604025,,14,13,27,14,13,27,0.000035,0.00002,0,4120,23,0.000043,9,0.227874,0.259529,22069.079389,0.109687,0.003554
9605218,9605218,,3,6,9,3,6,9,0.000021,0.000002,0,4116,23,0.000014,8,0.230769,0.259898,69634.120587,0.083333,0.000851
9510167,9510167,,17,1,18,17,1,18,0.000075,0,0,1547,23,0.000055,1,1,1,1302.084073,0.127451,0.004384
9707063,9707063,,10,15,25,10,15,25,0.000569,0.002874,0,5546,2,0.000018,12,0.208693,0.240689,36317.908789,0.148333,0.002661
9709021,9709021,,12,5,17,12,5,17,0.000069,0.000138,0,9450,23,0.000031,11,0.185051,0.206923,8939.16343,0.191176,0.003473
9604002,9604002,,10,2,12,10,2,12,0.000046,0.000001,0,5026,23,0.000036,8,0.216,0.24087,11552.599716,0.098485,0.002426
9210084,9210084,,1,0,1,1,0,1,0.000001,0,0,9460,23,0.000011,0,0,0,0,0,0.000265
9406103,9406103,,7,1,8,7,1,8,0.000122,0.000011,0,2619,4,0.000021,1,1,1,103.112171,0.107143,0.002084
9412164,9412164,,3,2,5,3,2,5,0.000001,0,0,3843,23,0.000015,1,1,1,24140,0.15,0.000727
9808055,9808055,,6,7,13,6,7,13,0.000064,0.00006,0,7738,10,0.000015,15,0.171525,0.192928,79788.670692,0.102564,0.001492
9810183,9810183,,1,2,3,1,2,3,0,0.000004,0,12229,26,0.000012,1,1,1,87.558101,0.166667,0.000231
9709184,9709184,,2,1,3,2,1,3,0,0.000005,0,10198,23,0.000012,5,0.324074,0.364762,109.974928,0,0.000491
9905193,9905193,,3,7,10,3,7,10,0,0.000002,0,12227,23,0.000013,11,0.163645,0.20748,1629.297597,0.255556,0.000695
9804153,9804153,,3,9,12,3,9,12,0.000001,0.000027,0,11656,23,0.000012,17,0.139192,0.164478,8669.710618,0.212121,0.00075
9507104,9507104,,12,0,12,12,0,12,0.000003,0,0,5047,23,0.00003,0,0,0,0,0.121212,0.002866
9507105,9507105,,19,0,19,19,0,19,0.000005,0,0,5046,23,0.000053,0,0,0,0,0.090643,0.004558
9708140,9708140,,12,8,20,12,8,20,0.000003,0.000001,0,12223,23,0.000044,8,0.216561,0.255504,13058.577929,0.123684,0.0029
9709003,9709003,,1,0,1,1,0,1,0,0,0,12225,23,0.000011,0,0,0,0,0,0.000271
9810235,9810235,,8,1,9,8,1,9,0.000002,0,0,12224,23,0.000023,9,0.178441,0.198029,170.5,0.180556,0.001897
9906209,9906209,,1,14,15,1,14,15,0,0.000022,0,12221,23,0.000011,11,0.171415,0.240037,56.362384,0.133333,0.000271
2246,2246,,0,11,11,0,11,11,0,0.000497,0,12547,0,0.00001,14,0.176939,0.202223,0,0.181818,0
2247,2247,,1,13,14,1,13,14,0,0.000444,0,12550,22,0.000014,11,0.211844,0.240357,7805.33392,0.159341,0.000252
9310115,9310115,,3,5,8,3,5,8,0.00001,0.00004,0,10156,22,0.000015,3,0.642857,0.759259,133.403656,0.071429,0.000705
9404089,9404089,,11,1,12,11,1,12,0.000088,0,0,7883,22,0.000039,2,0.666667,0.75,2.838387,0.227273,0.002762
9601020,9601020,,8,9,17,8,9,17,0.000016,0.000039,0,10155,22,0.000027,5,0.382979,0.469753,3925.663189,0.084559,0.001861
9603174,9603174,,13,4,17,13,4,17,0.000018,0.000008,0,10153,22,0.000037,5,0.338235,0.448551,3306.790877,0.154412,0.003119
9607114,9607114,,12,9,21,12,9,21,0.000012,0.000007,0,10308,22,0.000032,6,0.338462,0.474621,3688.274261,0.145238,0.002771
9609133,9609133,,6,6,12,6,6,12,0.000216,0.000004,0,10157,22,0.000021,6,0.3125,0.391389,6687.524632,0.219697,0.001435
9709141,9709141,,4,2,6,4,2,6,0.000017,0,0,6484,22,0.000019,3,0.470588,0.5625,5459.726767,0.066667,0.000979
9801148,9801148,,2,11,13,2,11,13,0.00001,0.000004,0,12549,22,0.000012,6,0.335878,0.422538,287.42252,0.153846,0.000445
9805020,9805020,,6,8,14,6,8,14,0.000008,0.00044,0,10159,22,0.000034,11,0.210219,0.236886,72980.663237,0.126374,0.001411
9210133,9210133,,5,0,5,5,0,5,0.00014,0,0,8166,22,0.000028,0,0,0,0,0.1,0.001173
9310177,9310177,,3,4,7,3,4,7,0.000002,0.00005,0,2926,2,0.000022,3,0.529412,0.666667,431.851179,0.119048,0.000821
9412100,9412100,,2,0,2,2,0,2,0.000006,0,0,10154,22,0.000016,0,0,0,0,0.5,0.000532
9406089,9406089,,17,1,18,17,1,18,0.000071,0,0,10307,22,0.000045,2,0.666667,0.75,449.310866,0.084967,0.004038
9409169,9409169,,11,4,15,11,4,15,0.000067,0.000001,0,10306,22,0.000025,2,0.833333,0.9,5642.033333,0.157143,0.002624
9408027,9408027,,7,1,8,7,1,8,0.000007,0.000001,0,4149,28,0.000043,2,0.666667,0.75,45.991871,0.303571,0.002279
9403109,9403109,,7,1,8,7,1,8,0.000003,0,0,5487,22,0.000053,1,1,1,11160.24794,0.142857,0.002032
9412022,9412022,,5,2,7,5,2,7,0.000001,0.000002,0,12548,22,0.000019,2,0.75,0.833333,1895.909973,0.238095,0.001191
9605186,9605186,,1,5,6,1,5,6,0.000005,0.000004,0,10158,22,0.000014,6,0.299492,0.368927,471.924108,0.366667,0.000259
2248,2248,,0,3,3,0,3,3,0,0.000006,0,12552,23,0.00001,17,0.097038,0.103752,0,0.5,0
9907182,9907182,,17,6,23,17,6,23,0.00008,0.000006,0,12551,23,0.000031,16,0.107406,0.116758,9730.204221,0.166008,0.004072
2249,2249,,0,13,13,0,13,13,0,0.012963,0,12553,1,0.00001,13,0.194008,0.216696,0,0.301282,0
2250,2250,,2,25,27,2,25,27,0.000279,0.011788,0,12210,30,0.000011,14,0.236704,0.268816,12429.355439,0.233618,0.000615
9807192,9807192,,6,2,8,6,2,8,0.00045,0.000005,0,7885,2,0.000014,6,0.288066,0.323571,41785.798621,0.107143,0.001755
2251,2251,,3,2,5,3,2,5,0,0,0,12557,22,0.000015,17,0.12625,0.135251,393.59636,0.25,0.000664
9910103,9910103,,2,6,8,2,6,8,0,0,0,12556,22,0.000018,17,0.126569,0.136484,118.432738,0.392857,0.000464
9908131,9908131,,2,6,8,2,6,8,0,0,0,12555,22,0.000014,17,0.126684,0.136967,174.738767,0.357143,0.000458
2252,2252,,0,6,6,0,6,6,0,0.000224,0,12558,13,0.00001,14,0.182179,0.203021,0,0.433333,0
9703188,9703188,,4,15,19,4,15,19,0.000239,0.000087,0,6144,10,0.000015,10,0.187789,0.220316,35816.832126,0.070175,0.001167
2254,2254,,3,5,8,3,5,8,0,0.000006,0,12559,20,0.000014,13,0.163614,0.176168,4047.651518,0.160714,0.000658
2255,2255,,1,16,17,1,16,17,0.000072,0.018539,0,12560,1,0.00001,12,0.225226,0.25607,728.774183,0.3125,0.000813
2256,2256,,14,15,29,14,15,29,0.002114,0.001172,0,11626,1,0.000017,13,0.187981,0.210388,35506.522278,0.238916,0.003719
9206044,9206044,,49,0,49,49,0,49,0.001723,0,0,1647,5,0.000073,0,0,0,0,0.034014,0.013089
9410041,9410041,,26,12,38,26,12,38,0.002348,0.000546,0,8154,5,0.000033,6,0.4,0.504722,9765.169254,0.071835,0.007259
9610201,9610201,,11,15,26,11,15,26,0.000831,0.000142,0,8322,5,0.000019,6,0.31699,0.377518,13143.0674,0.08,0.003162
9810251,9810251,,38,7,45,38,7,45,0.003858,0.013203,0,8155,1,0.000043,13,0.189709,0.214039,11275.887185,0.132828,0.010208
9910065,9910065,,29,26,55,29,26,55,0.003109,0.01722,0,11611,1,0.00003,12,0.208301,0.235054,86919.800172,0.113131,0.007617
9910076,9910076,,21,23,44,21,23,44,0.001917,0.009734,0,11618,1,0.000022,13,0.197993,0.227639,62006.18304,0.134778,0.005501
9910220,9910220,,5,13,18,5,13,18,0.00023,0.006145,0,11625,1,0.000016,13,0.185842,0.206522,46245.180569,0.173203,0.001248
9203050,9203050,,12,0,12,12,0,12,0.000358,0,0,6537,5,0.000035,0,0,0,0,0.037879,0.00318
9305107,9305107,,9,2,11,9,2,11,0.000363,0.000132,0,8153,13,0.000039,1,1,1,24.499886,0.036364,0.002255
9312171,9312171,,10,12,22,10,12,22,0.000677,0.000206,0,8152,5,0.000025,5,0.469697,0.623118,737.199968,0.056277,0.002867
9501016,9501016,,18,0,18,18,0,18,0.000396,0,0,2549,5,0.000051,0,0,0,0,0.111111,0.004827
9505136,9505136,,13,3,16,13,3,16,0.000219,0.000007,0,3840,5,0.000029,2,0.8,0.875,15619.71377,0.158333,0.003271
9506128,9506128,,7,5,12,7,5,12,0.000005,0.000035,0,6245,5,0.000018,6,0.296424,0.336057,648.657597,0.25,0.001747
9510109,9510109,,20,11,31,20,11,31,0.000805,0.000066,0,2610,5,0.000027,5,0.387097,0.471296,21298.364314,0.104301,0.005796
9506212,9506212,,2,0,2,2,0,2,0.000037,0,0,6631,1,0.000019,0,0,0,0,0,0.001198
9803083,9803083,,5,12,17,5,12,17,0.000739,0.002221,0,6587,1,0.000016,14,0.176358,0.203979,185.562618,0.268382,0.002038
9802158,9802158,,14,10,24,14,10,24,0.00064,0.000058,0,8211,5,0.000026,7,0.255747,0.288115,51538.999545,0.141304,0.00382
9811059,9811059,,10,10,20,10,10,20,0.00108,0.000034,0,8321,5,0.000018,13,0.176417,0.205134,76290.667657,0.163158,0.002979
9811122,9811122,,7,11,18,7,11,18,0.000507,0.016153,0,8162,1,0.000017,13,0.18488,0.210631,13079.487315,0.218954,0.002345
9810169,9810169,,21,1,22,21,1,22,0.002874,0.000468,0,8331,8,0.000029,1,1,1,10.71923,0.199134,0.010641
9901087,9901087,,9,21,30,9,21,30,0.001127,0.002712,0,8329,1,0.000015,13,0.195583,0.228909,113059.373584,0.129885,0.002654
9202086,9202086,,3,0,3,3,0,3,0.000441,0,0,6096,15,0.000014,0,0,0,0,0,0.001237
9909180,9909180,,7,19,26,7,19,26,0.000942,0.009283,0,11610,1,0.000014,12,0.214289,0.244352,20147.020709,0.113846,0.002036
9906187,9906187,,6,13,19,6,13,19,0.000761,0.000269,0,11617,5,0.000013,12,0.180064,0.201313,35560.219564,0.061404,0.001715
9903136,9903136,,7,0,7,7,0,7,0.000148,0,0,11623,1,0.000043,0,0,0,0,0.119048,0.001628
9907065,9907065,,4,1,5,4,1,5,0.000145,0.000002,0,11624,1,0.00002,1,1,1,0.5,0.25,0.000931
9908180,9908180,,6,9,15,6,9,15,0.000223,0.00003,0,11622,41,0.000023,12,0.179611,0.198563,17026.599389,0.047619,0.001458
2258,2258,,0,15,15,0,15,15,0,0.005027,0,12561,13,0.00001,11,0.229433,0.261267,0,0.166667,0
9408003,9408003,,2,1,3,2,1,3,0.000063,0.000001,0,3739,3,0.000014,1,1,1,1813.175442,0,0.000621
9701122,9701122,,11,3,14,11,3,14,0.000763,0.000038,0,4930,2,0.000028,6,0.220159,0.259839,3816.847659,0.148352,0.003328
2259,2259,,0,1,1,0,1,1,0,0,0,12566,26,0.00001,4,0.342857,0.402778,0,0,0
9811236,9811236,,3,3,6,3,3,6,0,0,0,12565,26,0.000022,3,0.478261,0.575758,22,0.1,0.000658
9801197,9801197,,3,2,5,3,2,5,0,0,0,12564,26,0.000023,1,1,1,7,0.2,0.000677
9809110,9809110,,2,0,2,2,0,2,0,0,0,12562,26,0.000018,0,0,0,0,0.5,0.000458
3001,3001,,2,7,9,2,7,9,0,0.000026,0,12570,26,0.000014,16,0.14729,0.164299,663.514387,0.083333,0.000445
9310055,9310055,,8,2,10,8,2,10,0.000004,0.000003,0,2861,26,0.000019,1,1,1,554.640453,0.055556,0.001941
9502104,9502104,,1,10,11,1,10,11,0,0.000008,0,12569,26,0.000012,4,0.486486,0.592593,61.789286,0.054545,0.000232
9903153,9903153,,7,15,22,7,15,22,0.001045,0.000113,0,11079,26,0.000016,15,0.167028,0.189181,57459.961413,0.11039,0.001808
9211045,9211045,,6,0,6,6,0,6,0.000249,0,0,2860,26,0.000035,0,0,0,0,0.066667,0.00167
9211052,9211052,,9,0,9,9,0,9,0.000003,0,0,2859,6,0.000106,0,0,0,0,0.041667,0.002322
9309017,9309017,,2,0,2,2,0,2,0,0,0,12568,26,0.000013,0,0,0,0,0,0.000445
9312155,9312155,,1,0,1,1,0,1,0,0,0,12567,26,0.000011,0,0,0,0,0,0.000226
9408095,9408095,,3,0,3,3,0,3,0.000063,0,0,4023,26,0.000013,0,0,0,0,0,0.000927
9411223,9411223,,6,10,16,6,10,16,0.000175,0.000171,0,2867,26,0.000018,4,0.5,0.632716,74986.896803,0.05,0.001525
9306161,9306161,,19,0,19,19,0,19,0.00022,0,0,6064,26,0.000121,0,0,0,0,0.070175,0.005167
9503232,9503232,,20,9,29,20,9,29,0.000157,0.000117,0,2868,28,0.000056,6,0.346237,0.398965,108291.035877,0.121921,0.005468
9208040,9208040,,8,0,8,8,0,8,0.000004,0,0,3923,26,0.000032,0,0,0,0,0.089286,0.002135
9602029,9602029,,11,21,32,11,21,32,0.000003,0.000024,0,7307,26,0.000025,8,0.233158,0.289082,83769.206264,0.073589,0.002587
9609155,9609155,,5,2,7,5,2,7,0.000003,0.000012,0,7927,26,0.000017,8,0.217514,0.239709,5931.28375,0.238095,0.001252
9709097,9709097,,12,6,18,12,6,18,0.00024,0.000021,0,7239,26,0.000023,15,0.126397,0.146307,5497.208712,0.160131,0.002979
9806133,9806133,,23,16,39,23,16,39,0.002653,0.009684,0,11076,26,0.000028,14,0.18621,0.213519,10723.311934,0.195682,0.00618
9807022,9807022,,9,7,16,9,7,16,0.000889,0.000086,0,11075,26,0.000017,15,0.158216,0.176021,15278.660389,0.1875,0.002381
9808120,9808120,,18,23,41,18,23,41,0.001665,0.010081,0,11077,26,0.000022,14,0.195258,0.225238,24827.005571,0.159756,0.004782
3002,3002,,10,6,16,10,6,16,0.000518,0.001311,0,12090,25,0.000018,17,0.187672,0.207108,412.193916,0.220833,0.00346
3003,3003,,3,5,8,3,5,8,0,0.000067,0,12573,2,0.000014,17,0.135838,0.153543,189.668695,0.232143,0.000677
9812004,9812004,,2,3,5,2,3,5,0.000007,0.001868,0,12571,2,0.000014,14,0.149254,0.172596,1096.642838,0.1,0.000512
9906079,9906079,,8,11,19,8,11,19,0.000086,0.000515,0,12572,2,0.000021,16,0.151843,0.173984,9722.93099,0.146199,0.001889
9702065,9702065,,12,7,19,12,7,19,0.000181,0.000588,0,5153,2,0.000022,12,0.194136,0.22166,4054.29801,0.201754,0.003142
3004,3004,,18,2,20,18,2,20,0.001328,0.000297,0,12574,8,0.000033,13,0.170604,0.182858,27062.601899,0.039474,0.004554
3005,3005,,12,5,17,12,5,17,0.000719,0.005804,0,12575,8,0.00005,13,0.183678,0.207839,53809.509942,0.073529,0.003151
3006,3006,,28,14,42,28,14,42,0.001318,0.000626,0,12576,30,0.000038,14,0.177441,0.195103,127985.500719,0.056911,0.008843
3007,3007,,40,44,84,40,44,84,0.001445,0.010068,0,12168,30,0.000049,13,0.217422,0.243135,201916.662742,0.111159,0.016809
9412129,9412129,,3,2,5,3,2,5,0.000001,0,0,7021,26,0.00002,3,0.425,0.480392,65.816313,0.3,0.000767
9507088,9507088,,3,4,7,3,4,7,0.000011,0.000001,0,7013,26,0.000019,2,0.75,0.833333,281.213216,0.119048,0.000826
3008,3008,,3,2,5,3,2,5,0.000013,0.000001,0,12578,25,0.000029,4,0.375,0.490741,2107.707361,0.05,0.000679
9411092,9411092,,4,0,4,4,0,4,0,0,0,12577,17,0.000043,0,0,0,0,0,0.000896
9307148,9307148,,4,2,6,4,2,6,0,0,0,4180,17,0.000057,2,0.625,0.7,868.121894,0.166667,0.001096
3009,3009,,4,22,26,4,22,26,0,0.000008,0,12579,17,0.000012,12,0.151776,0.193913,1017.058813,0.349231,0.000985
3010,3010,,5,2,7,5,2,7,0,0,0,12581,23,0.000023,2,0.75,0.833333,14.333333,0.071429,0.001109
9912289,9912289,,5,0,5,5,0,5,0,0,0,12580,23,0.000032,0,0,0,0,0.15,0.001142
3012,3012,,20,17,37,20,17,37,0.0011,0.002878,0,12583,30,0.000026,13,0.205957,0.227812,18358.979187,0.153904,0.008193
9812143,9812143,,6,35,41,6,35,41,0.000324,0.007194,0,12582,30,0.000014,13,0.198107,0.227306,1892.405822,0.162195,0.001858
9712090,9712090,,10,15,25,10,15,25,0.000315,0.002483,0,6853,26,0.000022,15,0.172836,0.202132,224073.307432,0.103333,0.00297
3013,3013,,5,1,6,5,1,6,0.000096,0,0,12584,10,0.000031,5,0.297872,0.344048,4755.462289,0.133333,0.001217
9508176,9508176,,5,6,11,5,6,11,0.00003,0.000002,0,11761,41,0.000044,4,0.409091,0.512346,3728.002341,0.018182,0.001163
9301113,9301113,,5,2,7,5,2,7,0,0,0,10079,41,0.000033,1,1,1,1464.845285,0.071429,0.001191
3014,3014,,6,2,8,6,2,8,0.000081,0.000002,0,12586,8,0.000021,3,0.571429,0.708333,9.990909,0.339286,0.001422
9305052,9305052,,25,0,25,25,0,25,0.000133,0,0,12585,8,0.000095,0,0,0,0,0.091667,0.006048
9305011,9305011,,9,1,10,9,1,10,0,0,0,2648,22,0.000193,1,1,1,5756.315823,0.144444,0.002578
3015,3015,,0,2,2,0,2,2,0,0,0,12592,23,0.00001,3,0.5,0.611111,0,0,0
9712094,9712094,,2,0,2,2,0,2,0.000003,0,0,12591,23,0.000015,0,0,0,0,0,0.000445
9812064,9812064,,4,2,6,4,2,6,0,0,0,12590,23,0.000031,2,0.666667,0.75,15,0.1,0.000883
9608033,9608033,,3,2,5,3,2,5,0,0,0,12588,23,0.000038,1,1,1,9,0.2,0.000703
9705184,9705184,,3,2,5,3,2,5,0,0,0,12589,23,0.000027,2,0.75,0.833333,9,0.2,0.00069
3016,3016,,3,1,4,3,1,4,0.000239,0.00001,0,12105,0,0.000015,3,0.444444,0.541667,26.228518,0.083333,0.001525
3017,3017,,6,21,27,6,21,27,0.00145,0.019483,0,12593,1,0.000012,13,0.223733,0.255638,29763.742174,0.205128,0.001612
9712176,9712176,,7,7,14,7,7,14,0.000685,0.000433,0,6142,0,0.000015,13,0.171424,0.196414,9704.45956,0.164835,0.001916
3018,3018,,5,5,10,5,5,10,0.000106,0.001034,0,12594,30,0.000017,13,0.186779,0.20236,21070.075606,0.133333,0.001554
9401112,9401112,,5,2,7,5,2,7,0.000022,0.000005,0,5442,15,0.000018,1,1,1,319.803293,0.119048,0.001202
9208006,9208006,,27,0,27,27,0,27,0.000002,0,0,3083,15,0.000115,0,0,0,0,0.018519,0.006392
9210141,9210141,,42,0,42,42,0,42,0.000381,0,0,3078,15,0.000289,0,0,0,0,0.022067,0.010522
9311112,9311112,,4,2,6,4,2,6,0,0.000005,0,5493,15,0.000019,2,0.75,0.833333,2119.105948,0.233333,0.001002
9402037,9402037,,13,3,16,13,3,16,0.000047,0.000005,0,5491,15,0.000044,1,1,1,5640.513945,0.070833,0.003352
9402060,9402060,,3,10,13,3,10,13,0,0.000012,0,3800,15,0.00003,2,0.857143,0.916667,40875.27,0.064103,0.000875
3019,3019,,0,31,31,0,31,31,0,0.008849,0,12595,0,0.00001,11,0.25326,0.290987,0,0.105376,0
9807188,9807188,,3,26,29,3,26,29,0.000358,0.005028,0,8045,4,0.000012,11,0.21491,0.249892,13268.8366,0.105911,0.000761
9410142,9410142,,10,13,23,10,13,23,0.00021,0.000779,0,514,13,0.000043,6,0.337637,0.388431,24557.250473,0.077075,0.004241
9411195,9411195,,8,20,28,8,20,28,0.000202,0.00116,0,3367,13,0.000015,7,0.303437,0.369304,33890.414943,0.078042,0.002109
9408178,9408178,,5,4,9,5,4,9,0.000088,0.000015,0,2892,0,0.000022,1,1,1,685.68937,0.180556,0.001226
9503106,9503106,,20,14,34,20,14,34,0.000362,0.003137,0,3297,4,0.00004,8,0.239394,0.292155,2130.699055,0.058824,0.005027
9507040,9507040,,17,8,25,17,8,25,0.00064,0.002562,0,3298,4,0.000028,9,0.202586,0.239272,5242.340086,0.175,0.004563
9508159,9508159,,11,11,22,11,11,22,0.000352,0.001075,0,5391,4,0.000029,10,0.216778,0.266963,12013.208257,0.123377,0.002817
9711115,9711115,,12,17,29,12,17,29,0.00041,0.001742,0,8042,4,0.000022,13,0.196879,0.229751,12239.972373,0.116995,0.002886
9802063,9802063,,10,10,20,10,10,20,0.000164,0.002115,0,8043,4,0.000019,15,0.191117,0.219131,2926.470695,0.197368,0.002348
3020,3020,,42,38,80,42,38,80,0.002122,0.004133,0,12102,25,0.000076,16,0.199424,0.224074,52101.109547,0.129272,0.015801
3021,3021,,0,5,5,0,5,5,0,0,0,12596,26,0.00001,12,0.142929,0.170504,0,0.4,0
9407028,9407028,,3,1,4,3,1,4,0,0,0,8014,26,0.000033,1,1,1,147.202614,0,0.000762
3023,3023,,1,7,8,1,7,8,0.000054,0.00147,0,12109,0,0.00001,14,0.166936,0.18968,775.008177,0.232143,0.000296
9302073,9302073,,10,1,11,10,1,11,0.000318,0.000005,0,3335,28,0.000024,1,1,1,79.098229,0.063636,0.003386
9406093,9406093,,4,7,11,4,7,11,0.000104,0.000103,0,1245,13,0.000028,5,0.319693,0.369867,5874.854208,0.109091,0.001199
9607236,9607236,,12,13,25,12,13,25,0.000574,0.00187,0,7051,13,0.00003,10,0.22291,0.256482,19611.680388,0.07,0.004033
9612218,9612218,,18,12,30,18,12,30,0.000154,0.000703,0,4688,28,0.000025,10,0.198493,0.22498,21122.100633,0.133333,0.004956
3024,3024,,41,24,65,41,24,65,0.002772,0.003594,0,12201,0,0.000027,12,0.210144,0.234663,77439.329891,0.132933,0.016546
9909167,9909167,,7,16,23,7,16,23,0.000233,0.002684,0,12200,2,0.000016,14,0.196817,0.225527,6100.720247,0.225296,0.00197
3025,3025,,35,48,83,35,48,83,0.00267,0.005042,0,12440,0,0.000026,11,0.223956,0.253947,126822.717349,0.056715,0.01035
9908075,9908075,,13,19,32,13,19,32,0.000807,0.001763,0,12439,4,0.000017,11,0.20935,0.239587,53682.188394,0.126008,0.004387
9912101,9912101,,8,17,25,8,17,25,0.000558,0.003093,0,12422,2,0.000014,13,0.189073,0.217596,21781.652464,0.093333,0.002191
9511213,9511213,,7,37,44,7,37,44,0.000753,0.010205,0,1437,0,0.000027,10,0.239664,0.291794,9064.317817,0.129493,0.00341
9602112,9602112,,2,4,6,2,4,6,0.000203,0.001934,0,1685,0,0.000017,9,0.207527,0.241375,6.6126,0.233333,0.001344
9604164,9604164,,9,23,32,9,23,32,0.000665,0.00446,0,2327,0,0.000017,9,0.234583,0.271319,24007.92958,0.165323,0.003407
9612219,9612219,,1,5,6,1,5,6,0.000041,0.000006,0,5585,22,0.000011,3,0.625,0.733333,53915.619437,0.166667,0.000258
9705099,9705099,,6,6,12,6,6,12,0.00018,0.000558,0,5576,0,0.000015,8,0.244094,0.289174,6545.775792,0.098485,0.001608
9711157,9711157,,8,40,48,8,40,48,0.000779,0.010685,0,5029,4,0.000015,15,0.204843,0.244188,79313.689126,0.12633,0.002533
9506170,9506170,,22,5,27,22,5,27,0.00063,0.000004,0,4356,22,0.000036,3,0.625,0.733333,16107.338535,0.074074,0.006715
9808111,9808111,,22,22,44,22,22,44,0.001091,0.004316,0,8538,4,0.000024,13,0.215577,0.249384,114734.695325,0.105708,0.006491
9903005,9903005,,27,4,31,27,4,31,0.001818,0.000211,0,11080,26,0.000028,13,0.171083,0.192293,41799.348193,0.065591,0.008659
9904118,9904118,,9,9,18,9,9,18,0.000315,0.001637,0,12424,4,0.000016,14,0.20934,0.239262,6647.493197,0.20915,0.0028
9904181,9904181,,9,20,29,9,20,29,0.000349,0.003626,0,12437,4,0.000015,15,0.206404,0.239666,69642.748211,0.124384,0.002705
9908006,9908006,,9,22,31,9,22,31,0.000306,0.003835,0,12438,4,0.000015,15,0.198367,0.228643,6640.424792,0.139785,0.002644
9806228,9806228,,10,0,10,10,0,10,0.000038,0,0,12421,6,0.000041,0,0,0,0,0.166667,0.002402
3026,3026,,4,13,17,4,13,17,0.00082,0.016988,0,12597,1,0.000011,12,0.19841,0.219963,42.936831,0.3125,0.001368
3027,3027,,3,14,17,3,14,17,0.000001,0.000007,0,12613,9,0.000012,6,0.308962,0.39313,62.537009,0.095588,0.000664
9201026,9201026,,44,0,44,44,0,44,0.000127,0,0,449,9,0.000307,0,0,0,0,0.02537,0.011086
9201057,9201057,,4,0,4,4,0,4,0.000001,0,0,12612,9,0.000013,0,0,0,0,0.333333,0.000969
9202072,9202072,,23,0,23,23,0,23,0.00014,0,0,1468,22,0.000081,0,0,0,0,0.059289,0.006434
9205102,9205102,,17,0,17,17,0,17,0.000003,0,0,7519,9,0.000038,0,0,0,0,0.117647,0.004058
9206098,9206098,,21,0,21,21,0,21,0.000007,0,0,1055,9,0.000071,0,0,0,0,0.057143,0.005529
9211113,9211113,,19,0,19,19,0,19,0.000283,0,0,3188,9,0.000079,0,0,0,0,0.081871,0.004916
9301074,9301074,,6,1,7,6,1,7,0.000011,0.000003,0,6995,9,0.000021,1,1,1,2684.129512,0.214286,0.001488
9408127,9408127,,7,8,15,7,8,15,0.000001,0.000006,0,12514,23,0.000015,2,0.785714,0.863636,265.366457,0.166667,0.001687
9411125,9411125,,10,5,15,10,5,15,0.000001,0.000014,0,12598,9,0.000027,5,0.329609,0.396893,916.490878,0.114286,0.002357
9412078,9412078,,9,10,19,9,10,19,0.000001,0.000005,0,12611,9,0.000023,3,0.606061,0.725,566.906714,0.140351,0.002104
9602173,9602173,,4,11,15,4,11,15,0.000001,0.000028,0,12606,9,0.000013,6,0.300341,0.391856,331.54216,0.104762,0.000962
9802083,9802083,,4,5,9,4,5,9,0,0,0,12602,9,0.000015,6,0.284615,0.346396,221.483333,0.138889,0.000943
9807077,9807077,,1,4,5,1,4,5,0,0.000002,0,12604,9,0.000011,7,0.230769,0.283059,12,0.05,0.000239
9302006,9302006,,39,1,40,39,1,40,0.000012,0,0,1050,9,0.000124,2,0.555556,0.6,9940.363485,0.050641,0.01047
9302110,9302110,,10,8,18,10,8,18,0.000339,0.000003,0,3189,9,0.000024,2,0.9,0.944444,11569.591502,0.042484,0.002462
9409016,9409016,,10,8,18,10,8,18,0.000005,0.000011,0,1448,9,0.000038,4,0.392,0.47619,59229.370591,0.153595,0.002646
9303071,9303071,,3,2,5,3,2,5,0,0.000003,0,12600,9,0.000015,1,1,1,15,0.2,0.000771
9312093,9312093,,6,1,7,6,1,7,0.000004,0.000001,0,12607,9,0.000017,1,1,1,81.12529,0.166667,0.001512
9405146,9405146,,9,1,10,9,1,10,0,0.000001,0,6959,9,0.00004,1,1,1,3.416667,0.155556,0.002229
9409024,9409024,,3,1,4,3,1,4,0,0.000001,0,12610,9,0.000018,1,1,1,0.166667,0.25,0.000731
9411184,9411184,,3,8,11,3,8,11,0,0.000002,0,12609,9,0.000013,2,0.785714,0.863636,98.019246,0.172727,0.000724
9208072,9208072,,6,0,6,6,0,6,0.000002,0,0,6001,6,0.000041,0,0,0,0,0.033333,0.001363
9304040,9304040,,3,0,3,3,0,3,0.000001,0,0,12605,6,0.000014,0,0,0,0,0.166667,0.000691
9307015,9307015,,5,9,14,5,9,14,0.000001,0.000026,0,12601,9,0.000021,4,0.454545,0.572222,289.595238,0.104396,0.001175
9209078,9209078,,3,0,3,3,0,3,0,0,0,7518,28,0.000017,0,0,0,0,0.166667,0.000697
9606163,9606163,,2,0,2,2,0,2,0.000145,0,0,12603,9,0.000013,0,0,0,0,0,0.000498
3028,3028,,0,2,2,0,2,2,0,0,0,12627,23,0.00001,14,0.136175,0.147816,0,0.5,0
9810199,9810199,,10,19,29,10,19,29,0.000001,0.000055,0,12626,23,0.000023,13,0.157587,0.177913,34237.603219,0.204434,0.002386
9507136,9507136,,19,0,19,19,0,19,0.000003,0,0,6737,23,0.000214,0,0,0,0,0.274854,0.006425
9509110,9509110,,19,2,21,19,2,21,0.000076,0.000003,0,6738,23,0.000148,5,0.3,0.341919,8510.315087,0.22381,0.006285
9411238,9411238,,14,4,18,14,4,18,0.000038,0,0,4744,23,0.000071,3,0.578947,0.666667,56217.519406,0.075163,0.004521
9709079,9709079,,13,6,19,13,6,19,0.000002,0.000007,0,9247,23,0.000027,6,0.271357,0.350926,35.647851,0.30117,0.003408
9710172,9710172,,2,4,6,2,4,6,0.000001,0.000006,0,12625,23,0.000011,7,0.230126,0.297446,0,0.366667,0.000513
9802071,9802071,,13,17,30,13,17,30,0.000032,0.000009,0,12624,23,0.000023,13,0.150892,0.16705,12280.812738,0.178161,0.003133
9805204,9805204,,12,10,22,12,10,22,0.000002,0.000008,0,9249,23,0.000026,13,0.150162,0.164169,41558.076995,0.287879,0.002926
9806047,9806047,,4,11,15,4,11,15,0.000001,0.000007,0,12622,23,0.000013,14,0.130628,0.141107,3715.069871,0.17619,0.000971
9808036,9808036,,2,9,11,2,9,11,0.000001,0.000002,0,12619,23,0.000011,14,0.143059,0.160623,10720.108058,0.163636,0.000513
9810044,9810044,,4,6,10,4,6,10,0.000026,0.000011,0,12617,23,0.000012,7,0.268456,0.352411,11756.156685,0.133333,0.000964
3029,3029,,28,21,49,28,21,49,0.000544,0.000328,0,12329,9,0.000023,16,0.176787,0.205012,2339.606055,0.251701,0.007648
9807091,9807091,,32,20,52,32,20,52,0.000961,0.000327,0,7719,9,0.000026,16,0.176744,0.204347,9778.096061,0.239442,0.009116
9810019,9810019,,11,1,12,11,1,12,0.000187,0,0,12283,9,0.000031,2,0.666667,0.75,2459.03992,0.05303,0.00293
9912143,9912143,,18,7,25,18,7,25,0.00086,0.000213,0,12327,9,0.000016,11,0.180579,0.199592,673.191279,0.335,0.005326
9501021,9501021,,2,2,4,2,2,4,0,0,0,3790,9,0.000014,1,1,1,12230.957831,0.333333,0.00071
9207031,9207031,,2,0,2,2,0,2,0.000011,0,0,2737,9,0.000017,0,0,0,0,0,0.001133
9207072,9207072,,5,0,5,5,0,5,0.000002,0,0,1491,9,0.000022,0,0,0,0,0.15,0.001885
9208069,9208069,,6,0,6,6,0,6,0.000002,0,0,1490,9,0.000025,0,0,0,0,0.1,0.002082
9302124,9302124,,19,6,25,19,6,25,0.000015,0,0,1046,9,0.00007,2,0.8,0.875,49611.756806,0.108333,0.006424
9303119,9303119,,2,1,3,2,1,3,0.000011,0,0,2736,9,0.000017,1,1,1,1719.040934,0,0.001133
9407068,9407068,,3,5,8,3,5,8,0.000001,0.000014,0,2734,9,0.00002,2,0.692308,0.777778,1243.91726,0.071429,0.00129
9407074,9407074,,5,6,11,5,6,11,0.000015,0.000012,0,2733,9,0.000021,4,0.424658,0.516129,5775.270297,0.072727,0.002031
9307183,9307183,,13,0,13,13,0,13,0.000127,0,0,2740,9,0.000052,0,0,0,0,0.230769,0.004553
9408173,9408173,,5,3,8,5,3,8,0.000004,0,0,3806,6,0.000018,2,0.636364,0.714286,6755.488821,0.107143,0.001249
9509137,9509137,,16,1,17,16,1,17,0.000069,0,0,3759,9,0.000041,1,1,1,12492,0.0625,0.004199
9408082,9408082,,3,9,12,3,9,12,0.000004,0.000007,0,3219,9,0.000013,4,0.393443,0.493056,51431.320935,0.05303,0.000938
9607036,9607036,,10,11,21,10,11,21,0.000122,0.000086,0,6304,9,0.000018,13,0.14789,0.165818,45168.440515,0.12619,0.002918
9507083,9507083,,4,1,5,4,1,5,0.000001,0.000001,0,2317,52,0.000043,1,1,1,38.014648,0.15,0.000988
3030,3030,,12,1,13,12,1,13,0.000003,0,0,12632,23,0.00002,15,0.128001,0.13983,0,0.230769,0.002921
9909011,9909011,,33,6,39,33,6,39,0.00002,0.000001,0,12631,23,0.000059,14,0.146691,0.165942,5898.544332,0.136302,0.008736
9511068,9511068,,13,2,15,13,2,15,0.000001,0.000001,0,5025,23,0.00005,1,1,1,306.716512,0.161905,0.003554
9712181,9712181,,8,2,10,8,2,10,0.000003,0.000009,0,12630,23,0.000026,13,0.15988,0.179179,2521.112053,0.2,0.002345
9802154,9802154,,4,3,7,4,3,7,0.000015,0.000001,0,12628,23,0.00003,8,0.201063,0.22554,3613.41255,0.166667,0.001225
9905109,9905109,,2,2,4,2,2,4,0,0,0,12629,23,0.00002,9,0.168142,0.185116,0,0.5,0.000755
3031,3031,,97,9,106,97,9,106,0.004265,0.000672,0,12195,3,0.000094,12,0.193343,0.210111,5103.77926,0.149236,0.052382
3032,3032,,17,57,74,17,57,74,0.004722,0.02758,0,12635,1,0.000018,11,0.234136,0.268684,58358.025238,0.123658,0.004729
9911172,9911172,,8,35,43,8,35,43,0.002091,0.022429,0,12634,1,0.000013,12,0.207892,0.234348,20042.03419,0.212625,0.002159
9309075,9309075,,79,4,83,79,4,83,0.002043,0.000091,0,343,3,0.00027,3,0.52381,0.636364,5265.842154,0.05789,0.029828
9802015,9802015,,28,2,30,28,2,30,0.000035,0.000002,0,9263,5,0.000145,1,1,1,3447.639548,0.118391,0.007634
9207074,9207074,,4,0,4,4,0,4,0.000001,0,0,9410,5,0.000039,0,0,0,0,0.25,0.001264
9805123,9805123,,4,38,42,4,38,42,0.000252,0.006777,0,8023,4,0.000012,13,0.213484,0.249168,1806.547081,0.25784,0.001084
9806165,9806165,,3,2,5,3,2,5,0.00036,0,0,8127,28,0.000012,10,0.153273,0.178318,40412.238368,0.05,0.000998
9811128,9811128,,6,31,37,6,31,37,0.001301,0.005925,0,8119,4,0.000011,12,0.211064,0.242864,31409.549217,0.142643,0.001967
9906211,9906211,,7,22,29,7,22,29,0.001563,0.02159,0,12633,1,0.000013,11,0.228897,0.259531,6552.946626,0.253695,0.00183
3033,3033,,15,45,60,15,45,60,0.001503,0.00787,0,12290,3,0.000015,11,0.223843,0.254675,56828.122612,0.140678,0.004698
9907094,9907094,,3,8,11,3,8,11,0.000172,0.001078,0,12288,3,0.000011,13,0.186203,0.20706,434.615018,0.227273,0.000918
9908121,9908121,,2,26,28,2,26,28,0.000103,0.002988,0,12289,3,0.000011,14,0.193686,0.220929,703.336639,0.191799,0.000584
9912090,9912090,,4,31,35,4,31,35,0.000237,0.003579,0,12287,3,0.000011,13,0.206745,0.232944,9597.7711,0.194958,0.001271
3034,3034,,2,1,3,2,1,3,0.000163,0.000041,0,12636,4,0.00001,15,0.162282,0.186522,4.985948,0.166667,0.000768
3035,3035,,5,12,17,5,12,17,0.000863,0.015512,0,12637,1,0.000013,12,0.19677,0.218988,6454.544023,0.202206,0.001518
3036,3036,,6,10,16,6,10,16,0.000719,0.000973,0,12638,1,0.000014,13,0.179202,0.197956,1138.499638,0.254167,0.001551
9211112,9211112,,3,0,3,3,0,3,0,0,0,6087,6,0.000026,0,0,0,0,0.166667,0.0008
9311167,9311167,,6,2,8,6,2,8,0.000019,0.000002,0,6086,6,0.000038,1,1,1,175.559195,0.214286,0.001684
9312040,9312040,,4,1,5,4,1,5,0.000019,0.000001,0,6085,9,0.000027,1,1,1,0,0.25,0.00117
3037,3037,,107,27,134,107,27,134,0.006996,0.003197,0,12155,52,0.00007,12,0.225724,0.256692,177559.212086,0.06217,0.033037
9409037,9409037,,17,2,19,17,2,19,0.000738,0.000053,0,518,13,0.000055,3,0.461538,0.583333,4512.640761,0.05848,0.005326
3038,3038,,13,21,34,13,21,34,0.002819,0.017944,0,12639,1,0.000014,13,0.201743,0.224402,1122.135995,0.261141,0.004798
3039,3039,,2,1,3,2,1,3,0.000059,0,0,12643,23,0.000011,18,0.123354,0.134859,6852.804104,0,0.000636
9811160,9811160,,1,3,4,1,3,4,0,0.000369,0,12642,23,0.00002,17,0.140669,0.158629,8198.804104,0,0.000235
9801188,9801188,,3,0,3,3,0,3,0.000004,0,0,12641,23,0.000029,0,0,0,0,0,0.000664
9806164,9806164,,1,1,2,1,1,2,0.000004,0,0,12640,23,0.000016,2,0.6,0.666667,907.872314,0,0.000226
3040,3040,,0,4,4,0,4,4,0,0.000002,0,12648,28,0.00001,11,0.179628,0.218735,0,0.083333,0
9803113,9803113,,2,2,4,2,2,4,0,0,0,12647,5,0.000015,4,0.473684,0.564815,9.5,0.166667,0.000438
9907208,9907208,,11,6,17,11,6,17,0.000003,0.000023,0,12646,5,0.00003,12,0.154614,0.188844,6976.610943,0.154412,0.002919
9701124,9701124,,4,5,9,4,5,9,0.000019,0.000005,0,9745,28,0.000017,2,0.647059,0.727273,6137.908152,0.222222,0.001104
9702092,9702092,,1,1,2,1,1,2,0.000001,0.000001,0,9743,28,0.000013,2,0.666667,0.75,0,0.5,0.00036
9510206,9510206,,4,6,10,4,6,10,0,0.000002,0,9748,5,0.000028,3,0.727273,0.854167,4784.085189,0.155556,0.001005
9901023,9901023,,20,5,25,20,5,25,0.000028,0.000025,0,12645,5,0.000057,7,0.216906,0.256565,360.667986,0.196667,0.005295
9906113,9906113,,4,0,4,4,0,4,0,0,0,12644,22,0.000028,0,0,0,0,0.166667,0.000968
3041,3041,,2,12,14,2,12,14,0.000264,0.016436,0,12649,1,0.00001,14,0.191455,0.214181,105.375981,0.230769,0.000533
3042,3042,,5,19,24,5,19,24,0.000938,0.009936,0,12650,1,0.000012,12,0.23439,0.265583,11189.602726,0.192029,0.001521
9404006,9404006,,5,4,9,5,4,9,0.00009,0.000259,0,353,13,0.000025,2,0.666667,0.75,7472.101627,0.194444,0.002237
9507005,9507005,,14,29,43,14,29,43,0.000187,0.003398,0,2155,13,0.000023,9,0.276496,0.338438,42945.063208,0.111296,0.003781
9507164,9507164,,20,14,34,20,14,34,0.00025,0.001677,0,2156,13,0.000033,10,0.237903,0.285843,7133.865284,0.122103,0.005199
9604071,9604071,,2,9,11,2,9,11,0.000043,0.000347,0,2157,13,0.000017,11,0.212339,0.256185,5834.12893,0.163636,0.000922
3043,3043,,3,7,10,3,7,10,0.000002,0.000059,0,12685,23,0.000016,16,0.1222,0.135461,607.418486,0.211111,0.000778
9809018,9809018,,13,9,22,13,9,22,0.00002,0.000078,0,12669,23,0.000031,14,0.151076,0.170329,12759.981946,0.186147,0.003254
9809183,9809183,,7,5,12,7,5,12,0.000017,0.000017,0,12671,23,0.000017,15,0.140653,0.156683,2316.763326,0.280303,0.001699
9812112,9812112,,7,13,20,7,13,20,0.000104,0.000101,0,12673,23,0.000017,15,0.146055,0.166094,6355.789667,0.205263,0.001729
9902177,9902177,,6,11,17,6,11,17,0.000038,0.000087,0,12674,23,0.000016,15,0.154344,0.178719,25168.65442,0.216912,0.001667
9908033,9908033,,5,20,25,5,20,25,0.000016,0.000042,0,12683,23,0.000015,15,0.136894,0.155666,8574.938806,0.15,0.001186
9911231,9911231,,2,10,12,2,10,12,0.000001,0.000018,0,12684,23,0.000013,16,0.12222,0.135872,24.749326,0.265152,0.000459
9605086,9605086,,28,3,31,28,3,31,0.000245,0.00002,0,4723,23,0.000067,3,0.526316,0.616667,14742.457856,0.096774,0.007208
9612109,9612109,,6,1,7,6,1,7,0.000017,0.000003,0,12651,23,0.000019,4,0.366667,0.424242,0,0.309524,0.001631
9707097,9707097,,8,9,17,8,9,17,0.000024,0.000017,0,12667,23,0.000021,13,0.151265,0.170925,29346.663091,0.172794,0.002216
9806153,9806153,,18,9,27,18,9,27,0.000119,0.000039,0,12668,23,0.000032,14,0.151036,0.170209,10313.019507,0.179487,0.004494
9805175,9805175,,15,9,24,15,9,24,0.000029,0.000037,0,11420,23,0.000062,13,0.163581,0.189081,14916.338074,0.07971,0.003555
9802050,9802050,,4,3,7,4,3,7,0.000002,0.000008,0,12672,23,0.000015,3,0.52381,0.606061,341.311716,0.261905,0.000999
9701083,9701083,,6,1,7,6,1,7,0.000001,0.000005,0,9610,23,0.000037,3,0.473684,0.518519,357.294948,0.190476,0.00145
9801024,9801024,,40,15,55,40,15,55,0.000125,0.001894,0,7140,23,0.000095,13,0.172133,0.20653,207267.876039,0.094276,0.010954
9906032,9906032,,6,21,27,6,21,27,0.000015,0.000043,0,12682,23,0.000017,15,0.136132,0.154418,14132.937287,0.143875,0.001424
9605214,9605214,,8,4,12,8,4,12,0.000016,0.000022,0,11418,23,0.000018,3,0.55,0.651515,5476.7,0.204545,0.001982
9909156,9909156,,3,2,5,3,2,5,0.000014,0.000002,0,12670,23,0.000013,15,0.131362,0.143339,0,0.35,0.000733
3044,3044,,2,7,9,2,7,9,0.00011,0.00003,0,12166,28,0.000011,15,0.160027,0.174841,8860.714525,0.361111,0.001277
9912183,9912183,,9,17,26,9,17,26,0.000253,0.000154,0,12163,28,0.000015,15,0.155037,0.169237,1864.101084,0.183077,0.003163
9610064,9610064,,8,14,22,8,14,22,0.000008,0.000026,0,11154,28,0.000016,6,0.287402,0.421005,6150.630097,0.279221,0.002189
9710067,9710067,,6,15,21,6,15,21,0.000007,0.000042,0,11158,28,0.000013,10,0.2,0.248931,208.978278,0.264286,0.001506
9802127,9802127,,11,13,24,11,13,24,0.00015,0.00004,0,11157,28,0.000017,13,0.166975,0.189064,29298.479242,0.235507,0.00345
9803144,9803144,,9,4,13,9,4,13,0.000008,0.000005,0,10040,28,0.000023,10,0.181532,0.211766,1819.332436,0.262821,0.002328
9806138,9806138,,6,9,15,6,9,15,0.000007,0.000009,0,10038,28,0.000015,11,0.169492,0.20858,6157.711332,0.295238,0.001592
9608022,9608022,,5,6,11,5,6,11,0.00005,0.000013,0,12162,28,0.000014,4,0.38835,0.464583,11945.341683,0.290909,0.001743
9610108,9610108,,12,22,34,12,22,34,0.000288,0.000053,0,4792,28,0.000028,6,0.291297,0.387297,94167.296916,0.106952,0.00369
3045,3045,,32,10,42,32,10,42,0.001461,0.001633,0,12103,25,0.000057,17,0.185357,0.204088,1424.946688,0.198606,0.012522
3046,3046,,6,3,9,6,3,9,0.000608,0.00011,0,12463,8,0.000014,12,0.185542,0.200971,1300.815753,0.208333,0.001788
9912119,9912119,,8,7,15,8,7,15,0.000503,0.015394,0,12462,8,0.000021,11,0.227158,0.256927,24947.619749,0.119048,0.00226
3047,3047,,0,13,13,0,13,13,0,0.015683,0,12688,1,0.00001,14,0.198725,0.225114,0,0.108974,0
9702143,9702143,,3,6,9,3,6,9,0.000267,0.000242,0,12687,0,0.000013,10,0.208004,0.237612,4984.17863,0.041667,0.000671
9201050,9201050,,18,0,18,18,0,18,0.000004,0,0,441,9,0.000097,0,0,0,0,0.153595,0.005048
9202060,9202060,,7,0,7,7,0,7,0.000001,0,0,440,9,0.000073,0,0,0,0,0.095238,0.002003
9209111,9209111,,19,1,20,19,1,20,0.000004,0.000021,0,443,9,0.000097,1,1,1,20.212789,0.165789,0.005295
9210134,9210134,,11,0,11,11,0,11,0.000001,0,0,447,9,0.000063,0,0,0,0,0.081818,0.00294
9212016,9212016,,8,0,8,8,0,8,0.000001,0,0,446,9,0.000048,0,0,0,0,0.089286,0.002256
9212017,9212017,,10,2,12,10,2,12,0.000001,0,0,445,9,0.000057,2,0.75,0.833333,818.363068,0.159091,0.002863
9212117,9212117,,13,4,17,13,4,17,0.000003,0.000021,0,444,9,0.000041,1,1,1,3347.679616,0.194853,0.003512
9201078,9201078,,11,0,11,11,0,11,0.000056,0,0,1578,22,0.000035,0,0,0,0,0.145455,0.002661
9205113,9205113,,10,0,10,10,0,10,0.000027,0,0,1575,22,0.000039,0,0,0,0,0.188889,0.002422
9210049,9210049,,9,0,9,9,0,9,0.000027,0,0,1574,22,0.000033,0,0,0,0,0.166667,0.002138
9210064,9210064,,3,0,3,3,0,3,0.000027,0,0,1584,22,0.000014,0,0,0,0,0.5,0.000729
9302071,9302071,,6,3,9,6,3,9,0.000027,0.000001,0,1579,22,0.000022,1,1,1,752.773729,0.305556,0.001453
9305093,9305093,,6,5,11,6,5,11,0.000027,0.000002,0,1580,22,0.000021,2,0.857143,0.916667,475.800677,0.236364,0.001406
9305094,9305094,,3,5,8,3,5,8,0.000027,0.000002,0,1585,22,0.000015,2,0.857143,0.916667,3.5,0.232143,0.000708
9306156,9306156,,2,8,10,2,8,10,0.000081,0.000003,0,1586,22,0.000012,2,0.9,0.944444,61264.573149,0.233333,0.001057
9310102,9310102,,7,1,8,7,1,8,0.000078,0,0,4998,6,0.00003,1,1,1,766.564388,0.071429,0.001627
9610013,9610013,,1,0,1,1,0,1,0.000003,0,0,12686,0,0.000012,0,0,0,0,0,0.000239
3048,3048,,8,7,15,8,7,15,0.000004,0.000888,0,12689,15,0.000026,13,0.17249,0.18668,26707.286972,0.090476,0.001834
9204074,9204074,,11,0,11,11,0,11,0.000012,0,0,2645,15,0.000103,0,0,0,0,0.081818,0.002634
9902204,9902204,,6,8,14,6,8,14,0.000054,0.000745,0,9342,15,0.000026,14,0.174356,0.195983,28834.940381,0.049451,0.001529
9903193,9903193,,6,2,8,6,2,8,0.000015,0.000014,0,9332,15,0.000026,2,0.625,0.7,51.5,0.196429,0.001483
9801037,9801037,,1,4,5,1,4,5,0.000009,0.00268,0,9341,2,0.000013,11,0.189337,0.211826,35.795381,0.3,0.000261
9902024,9902024,,16,6,22,16,6,22,0.000085,0.000019,0,9340,23,0.000046,17,0.157738,0.173829,56876.033846,0.095238,0.003792
3049,3049,,7,2,9,7,2,9,0,0,0,12690,6,0.000026,14,0.148069,0.176145,1967.462714,0.208333,0.00164
3050,3050,,16,39,55,16,39,55,0.002609,0.0226,0,12691,1,0.000015,11,0.235665,0.268919,40031.320803,0.139731,0.004539
3051,3051,,15,22,37,15,22,37,0.003008,0.009224,0,12692,1,0.000016,11,0.227453,0.260059,6359.255117,0.147147,0.004396
9408062,9408062,,6,1,7,6,1,7,0.000825,0,0,1025,1,0.000024,1,1,1,8595.061679,0.095238,0.001906
9401091,9401091,,9,0,9,9,0,9,0.000003,0,0,1024,28,0.000069,0,0,0,0,0.152778,0.002282
9802045,9802045,,4,9,13,4,9,13,0.000612,0.000509,0,8061,13,0.000012,13,0.189954,0.222001,479.925959,0.192308,0.001129
3052,3052,,105,27,132,105,27,132,0.013895,0.020046,0,12106,25,0.000081,16,0.202629,0.227918,99624.461821,0.079632,0.03627
9710241,9710241,,6,7,13,6,7,13,0.00021,0.000014,0,8692,20,0.000016,19,0.124545,0.153017,5972.764298,0.128205,0.001507
9810107,9810107,,6,11,17,6,11,17,0.000107,0.000016,0,8693,20,0.000015,13,0.133912,0.154899,90200.946632,0.088235,0.00152
3053,3053,,14,13,27,14,13,27,0.001071,0.001306,0,12693,1,0.000017,12,0.201931,0.224877,2343.570329,0.200855,0.004003
3054,3054,,47,8,55,47,8,55,0.003183,0.001498,0,12104,25,0.000067,17,0.184973,0.203367,1152.47486,0.160269,0.017127
3055,3055,,34,15,49,34,15,49,0.0061,0.018907,0,12696,1,0.000034,11,0.227181,0.257423,55464.734016,0.148384,0.01126
9911088,9911088,,8,23,31,8,23,31,0.002112,0.020637,0,12695,1,0.000015,11,0.229415,0.260335,10056.296991,0.201075,0.002424
9910089,9910089,,4,27,31,4,27,31,0.000771,0.006099,0,12694,1,0.000012,12,0.205881,0.231187,686.07295,0.147312,0.001028
3056,3056,,14,35,49,14,35,49,0.001605,0.020916,0,12698,8,0.000022,11,0.230303,0.262065,98462.062215,0.097789,0.004036
9308126,9308126,,6,1,7,6,1,7,0.000947,0,0,5471,41,0.000012,1,1,1,1704.717689,0.190476,0.001559
9809161,9809161,,5,11,16,5,11,16,0.000917,0.001207,0,12697,41,0.000013,17,0.143513,0.160003,1303.211572,0.154167,0.001285
9810194,9810194,,5,11,16,5,11,16,0.000897,0.018057,0,7597,1,0.000013,12,0.190119,0.213663,24745.868827,0.1875,0.001426
9812162,9812162,,3,9,12,3,9,12,0.000477,0.017198,0,9066,1,0.000012,14,0.178816,0.201459,1607.907211,0.189394,0.000836
9901069,9901069,,10,4,14,10,4,14,0.001089,0.000029,0,9377,15,0.000024,13,0.163514,0.185692,8537.869429,0.115385,0.00253
9204069,9204069,,4,0,4,4,0,4,0.000041,0,0,5470,41,0.000064,0,0,0,0,0,0.001054
3057,3057,,44,21,65,44,21,65,0.002725,0.019407,0,12198,52,0.000034,13,0.210082,0.234689,22323.40865,0.108894,0.014824
3058,3058,,8,5,13,8,5,13,0.000789,0.001153,0,12158,8,0.000036,14,0.159425,0.173035,27760.131134,0.179487,0.003114
3059,3059,,6,21,27,6,21,27,0.001455,0.020638,0,12700,1,0.000012,12,0.223982,0.254832,14931.919728,0.212251,0.001553
9909124,9909124,,4,10,14,4,10,14,0.000935,0.018514,0,12699,1,0.000012,11,0.225624,0.255021,2.927027,0.401099,0.001003
9306014,9306014,,5,1,6,5,1,6,0.000002,0.000019,0,10340,1,0.000029,1,1,1,0,0.3,0.001253
3060,3060,,0,6,6,0,6,6,0,0.00049,0,12701,0,0.00001,12,0.200357,0.225401,0,0.266667,0
3061,3061,,41,10,51,41,10,51,0.00224,0.001104,0,12130,25,0.000045,17,0.17608,0.192683,7237.799468,0.116471,0.011187
4004,4004,,6,15,21,6,15,21,0.00041,0.002444,0,12705,25,0.000012,18,0.184273,0.20641,1570.843973,0.147619,0.001537
9207079,9207079,,5,0,5,5,0,5,0.000092,0,0,12704,25,0.000014,0,0,0,0,0.25,0.001192
9211117,9211117,,5,0,5,5,0,5,0.000092,0,0,12703,25,0.000014,0,0,0,0,0.25,0.001192
9307042,9307042,,7,2,9,7,2,9,0.000121,0.000011,0,1162,25,0.000022,1,1,1,25120.472113,0.222222,0.001866
9307104,9307104,,5,2,7,5,2,7,0.000092,0.000011,0,12702,25,0.000014,1,1,1,0,0.357143,0.001192
9308030,9308030,,7,2,9,7,2,9,0.000092,0.000011,0,9781,25,0.000021,1,1,1,98.456614,0.208333,0.001643
3062,3062,,2,3,5,2,3,5,0.000004,0,0,12711,23,0.000012,12,0.154386,0.16842,5174.260653,0.4,0.000563
9905076,9905076,,10,3,13,10,3,13,0.000033,0.000003,0,12706,23,0.000027,11,0.175675,0.194413,23688.617535,0.070513,0.002492
9912248,9912248,,3,12,15,3,12,15,0,0.000009,0,12709,20,0.000022,12,0.150554,0.164831,8722.213382,0.128571,0.000707
9912278,9912278,,4,3,7,4,3,7,0.000004,0.000011,0,12710,23,0.000024,12,0.169225,0.189757,27864.98083,0.214286,0.001057
9709154,9709154,,10,2,12,10,2,12,0.000003,0,0,10707,23,0.000057,2,0.75,0.833333,6020.338668,0.068182,0.002445
9803212,9803212,,3,4,7,3,4,7,0.000012,0.000003,0,12708,20,0.000013,7,0.304688,0.386569,10.818138,0.309524,0.000678
9805118,9805118,,2,1,3,2,1,3,0,0,0,12707,22,0.000016,1,1,1,107.786871,0.166667,0.000458
3063,3063,,18,28,46,18,28,46,0.00104,0.005355,0,12713,13,0.000025,12,0.207517,0.233371,24190.738792,0.06087,0.005323
9811082,9811082,,2,9,11,2,9,11,0.000217,0.000603,0,12712,13,0.000011,14,0.181809,0.207294,378.244064,0.118182,0.000574
9906098,9906098,,18,10,28,18,10,28,0.000767,0.000818,0,12402,13,0.000031,14,0.171802,0.194013,52041.443718,0.100529,0.005045
9601004,9601004,,1,11,12,1,11,12,0.000128,0.000855,0,3504,13,0.000011,10,0.212916,0.249632,13.252133,0.227273,0.000374
3064,3064,,5,14,19,5,14,19,0.000117,0.000045,0,12720,4,0.000012,15,0.159699,0.180136,37590.902816,0.073099,0.001464
9208053,9208053,,22,1,23,22,1,23,0.000399,0,0,1215,4,0.00006,1,1,1,1400.793142,0.096838,0.007997
9502014,9502014,,9,2,11,9,2,11,0.000037,0.000007,0,3861,4,0.000019,3,0.545455,0.638889,143.465631,0.081818,0.002284
9602117,9602117,,4,8,12,4,8,12,0.000047,0.00002,0,6386,4,0.000014,5,0.45122,0.545946,3332.737867,0.143939,0.00175
9808043,9808043,,8,11,19,8,11,19,0.00006,0.000032,0,12719,26,0.000017,12,0.167806,0.204803,7067.730668,0.084795,0.002067
9902157,9902157,,23,21,44,23,21,44,0.000571,0.000089,0,10896,22,0.00003,13,0.174094,0.19855,100956.858512,0.058668,0.006438
9906130,9906130,,3,12,15,3,12,15,0.000033,0.000014,0,12716,17,0.000013,10,0.25875,0.339351,13556.080738,0.157143,0.000807
9907058,9907058,,13,12,25,13,12,25,0.000282,0.002182,0,12183,4,0.00002,14,0.174403,0.19736,23426.715522,0.145,0.003672
9211064,9211064,,8,0,8,8,0,8,0.000025,0,0,704,4,0.000056,0,0,0,0,0.071429,0.002516
9303093,9303093,,28,3,31,28,3,31,0.000602,0.00001,0,1217,4,0.000091,2,0.8,0.875,8946.719794,0.045161,0.008305
9506022,9506022,,6,8,14,6,8,14,0.000003,0.000073,0,6384,4,0.000017,2,0.625,0.7,483.543307,0.126374,0.00149
9410087,9410087,,3,8,11,3,8,11,0.000001,0.000145,0,12718,26,0.000013,3,0.62069,0.712963,2098.593807,0.081818,0.000726
9605013,9605013,,4,7,11,4,7,11,0.000035,0.000004,0,6390,4,0.000013,9,0.212302,0.251077,38229.337118,0.181818,0.000998
9604011,9604011,,4,6,10,4,6,10,0.000076,0.000012,0,6385,4,0.000015,5,0.4,0.487037,15159.301808,0.088889,0.001195
9306039,9306039,,19,1,20,19,1,20,0.000002,0,0,3743,22,0.000075,1,1,1,12407,0.031579,0.00473
9405008,9405008,,17,1,18,17,1,18,0.000018,0.000001,0,2068,22,0.000063,3,0.390244,0.427083,5989.742013,0.075163,0.004335
9503077,9503077,,9,0,9,9,0,9,0.000002,0,0,8687,22,0.000048,0,0,0,0,0.083333,0.002259
9510184,9510184,,10,4,14,10,4,14,0.000007,0.000021,0,10847,22,0.000027,4,0.447368,0.544118,575.015897,0.192308,0.002537
9512147,9512147,,8,17,25,8,17,25,0.000103,0.000038,0,2807,17,0.000019,16,0.174649,0.210633,147509.592059,0.06,0.002169
9607083,9607083,,4,10,14,4,10,14,0.000057,0.000006,0,2808,6,0.000014,17,0.153919,0.185622,128272.621264,0.126374,0.001158
9702066,9702066,,4,5,9,4,5,9,0.000005,0.000017,0,10895,22,0.000014,5,0.388889,0.489286,28.049914,0.25,0.001105
9806189,9806189,,5,7,12,5,7,12,0.000126,0.000033,0,10893,22,0.000014,17,0.149423,0.172651,2621.987248,0.19697,0.00135
9810211,9810211,,5,7,12,5,7,12,0.000069,0.000034,0,10894,22,0.000014,18,0.130275,0.147197,689.13561,0.257576,0.001327
9305041,9305041,,10,3,13,10,3,13,0.000001,0.000002,0,3002,17,0.000022,3,0.478261,0.575758,107.389398,0.134615,0.002373
9610037,9610037,,12,25,37,12,25,37,0.000266,0.000063,0,4254,17,0.00003,9,0.297209,0.404317,188785.496528,0.068318,0.003211
9811216,9811216,,2,8,10,2,8,10,0,0.000011,0,12714,17,0.000012,10,0.242158,0.307059,164.666232,0.277778,0.000473
9904058,9904058,,2,9,11,2,9,11,0.000033,0.000015,0,12715,17,0.000011,10,0.251834,0.322147,26.305159,0.218182,0.00046
3065,3065,,1,10,11,1,10,11,0.000047,0.003245,0,12721,30,0.00001,14,0.178377,0.195114,577.10607,0.136364,0.000235
3066,3066,,6,5,11,6,5,11,0.00025,0.002359,0,12722,25,0.000014,12,0.194158,0.21199,2031.756128,0.145455,0.001875
9312172,9312172,,71,15,86,71,15,86,0.002064,0.000185,0,866,3,0.000227,7,0.317647,0.415917,50238.654987,0.062107,0.026974
9507143,9507143,,66,5,71,66,5,71,0.00354,0.00286,0,1394,3,0.000097,8,0.244353,0.279119,5719.080289,0.118109,0.025098
9604047,9604047,,5,2,7,5,2,7,0.00008,0.000313,0,3424,13,0.000015,4,0.431034,0.476667,44.890254,0.071429,0.001205
3067,3067,,42,9,51,42,9,51,0.00383,0.001383,0,12088,25,0.00004,18,0.199006,0.223831,22178.657877,0.094902,0.014102
3068,3068,,5,22,27,5,22,27,0.001357,0.010237,0,12723,1,0.000013,11,0.2258,0.256555,6855.459255,0.223647,0.00172
3069,3069,,0,17,17,0,17,17,0,0.001753,0,12724,2,0.00001,12,0.19901,0.220327,0,0.176471,0
9904018,9904018,,3,27,30,3,27,30,0.000103,0.008937,0,11103,2,0.000011,14,0.186105,0.216052,773.53625,0.195402,0.000691
9609151,9609151,,8,13,21,8,13,21,0.00047,0.003888,0,6210,2,0.000014,12,0.20361,0.233531,889.311211,0.128571,0.002169
9707043,9707043,,4,6,10,4,6,10,0.000206,0.001943,0,6168,2,0.000014,15,0.167835,0.192302,8391.732443,0.266667,0.001223
9803218,9803218,,1,9,10,1,9,10,0.000079,0.0002,0,9102,23,0.00001,11,0.183299,0.210894,17997.361099,0.088889,0.00026
9608011,9608011,,3,11,14,3,11,14,0.000106,0.000039,0,4731,26,0.000015,8,0.207037,0.272378,18598.640767,0.076923,0.000791
9711100,9711100,,12,6,18,12,6,18,0.000382,0.002919,0,9107,3,0.000022,11,0.201622,0.227208,10364.907878,0.137255,0.003221
9807066,9807066,,7,6,13,7,6,13,0.000331,0.000085,0,9108,3,0.000018,12,0.169986,0.186836,5720.828131,0.147436,0.001975
3070,3070,,6,10,16,6,10,16,0.000308,0.000034,0,12726,28,0.000013,14,0.145894,0.164318,3864.094177,0.2,0.001533
9810161,9810161,,2,21,23,2,21,23,0.000001,0.000027,0,12725,28,0.000012,14,0.145507,0.165326,1154.499897,0.185771,0.000488
9404149,9404149,,1,13,14,1,13,14,0.000001,0.000357,0,4791,26,0.000011,5,0.384279,0.466098,12305.399791,0.142857,0.000311
9511197,9511197,,1,1,2,1,1,2,0.000001,0,0,4789,28,0.000011,2,0.666667,0.75,23118,0,0.000311
9804143,9804143,,18,6,24,18,6,24,0.000075,0.000002,0,10042,28,0.000034,10,0.179918,0.216056,8242.650395,0.07971,0.004381
9807072,9807072,,8,6,14,8,6,14,0.000031,0.000007,0,10039,28,0.000016,12,0.150366,0.184277,1342.961921,0.241758,0.002078
3071,3071,,4,12,16,4,12,16,0.000656,0.001378,0,12728,1,0.000011,13,0.178686,0.198888,1145.181325,0.058333,0.000932
9705094,9705094,,3,33,36,3,33,36,0.000041,0.002379,0,12727,13,0.000012,10,0.223736,0.272497,2077.506686,0.111905,0.000705
9208036,9208036,,11,1,12,11,1,12,0.000435,0.000468,0,4618,1,0.000041,1,1,1,0,0.121212,0.002961
9503089,9503089,,9,2,11,9,2,11,0.000097,0.000494,0,4728,1,0.000031,3,0.377358,0.408333,1232.300386,0.263636,0.002312
9502001,9502001,,22,11,33,22,11,33,0.000522,0.001736,0,968,13,0.000042,5,0.360947,0.443579,1497.112796,0.140152,0.006329
9607102,9607102,,6,10,16,6,10,16,0.000228,0.001137,0,3337,13,0.000016,11,0.205807,0.237146,2257.108288,0.158333,0.001725
9610170,9610170,,16,27,43,16,27,43,0.001095,0.003294,0,3338,13,0.00002,10,0.222691,0.264598,14691.961985,0.103544,0.005448
3072,3072,,7,18,25,7,18,25,0.000684,0.002471,0,12134,0,0.000013,12,0.212404,0.24921,15973.736348,0.096667,0.001837
9901028,9901028,,1,29,30,1,29,30,0.00004,0.004699,0,10577,0,0.00001,12,0.20291,0.234348,18003.005455,0.116092,0.000303
3073,3073,,2,7,9,2,7,9,0.000005,0.000044,0,12729,23,0.000013,23,0.111737,0.16402,1473.140589,0.152778,0.000464
9504031,9504031,,9,4,13,9,4,13,0.000058,0.00013,0,5355,23,0.000028,4,0.458333,0.598485,1296.632686,0.096154,0.002348
9303102,9303102,,3,0,3,3,0,3,0.000043,0,0,5360,23,0.000014,0,0,0,0,0.333333,0.000878
9509101,9509101,,2,6,8,2,6,8,0.000001,0.000357,0,5358,13,0.000013,9,0.206837,0.237911,5396.047603,0.089286,0.000584
3074,3074,,42,9,51,42,9,51,0.002352,0.001364,0,12108,25,0.000052,17,0.190515,0.21041,26756.810769,0.10549,0.013301
3075,3075,,113,19,132,113,19,132,0.015551,0.011133,0,11586,2,0.000084,13,0.216313,0.240411,235621.394512,0.051874,0.045827
3076,3076,,33,56,89,33,56,89,0.00246,0.022924,0,12107,25,0.000041,16,0.225695,0.261373,99775.777891,0.116445,0.013068
4028,4028,,29,12,41,29,12,41,0.001364,0.001639,0,12257,25,0.000051,17,0.185883,0.204687,3545.588632,0.184756,0.010746
3162,3162,,14,16,30,14,16,30,0.000369,0.001814,0,12124,25,0.000024,17,0.186619,0.205467,495.20011,0.22069,0.004826
4057,4057,,22,16,38,22,16,38,0.00208,0.000495,0,12258,25,0.000028,17,0.190217,0.209849,9900.710378,0.160028,0.007737
8151,8151,,26,69,95,26,69,95,0.002264,0.006747,0,12740,25,0.000029,14,0.210173,0.239201,167905.964165,0.093281,0.007477
3256,3256,,18,30,48,18,30,48,0.001119,0.00341,0,12114,0,0.000018,12,0.205078,0.234047,70760.247246,0.113475,0.005083
3269,3269,,11,35,46,11,35,46,0.000526,0.004572,0,12110,25,0.000022,17,0.200414,0.227182,121974.221324,0.076812,0.002798
3275,3275,,5,6,11,5,6,11,0.000154,0.007496,0,12739,25,0.000013,12,0.20551,0.224755,31720.919532,0.081818,0.001405
4005,4005,,41,13,54,41,13,54,0.002381,0.001982,0,12087,25,0.000043,12,0.198988,0.219649,18353.936262,0.122642,0.013699
4022,4022,,14,9,23,14,9,23,0.000932,0.001206,0,12263,25,0.000021,17,0.192604,0.212765,9720.234988,0.118577,0.004951
4056,4056,,34,22,56,34,22,56,0.003596,0.018293,0,12334,25,0.000031,17,0.199636,0.223978,10660.79791,0.143831,0.013094
4109,4109,,39,11,50,39,11,50,0.003058,0.001429,0,12262,25,0.00004,17,0.192148,0.212014,84953.279612,0.099184,0.011122
4126,4126,,48,20,68,48,20,68,0.003917,0.017962,0,12092,25,0.000045,11,0.206808,0.231488,26881.168743,0.112599,0.017415
4160,4160,,58,26,84,58,26,84,0.002995,0.011994,0,12119,25,0.000049,18,0.214766,0.251791,79704.467361,0.133964,0.018241
5013,5013,,6,12,18,6,12,18,0.000309,0.002794,0,12367,25,0.000014,11,0.20134,0.221575,4793.136502,0.196078,0.002552
5025,5025,,55,14,69,55,14,69,0.003302,0.002263,0,12336,25,0.000045,18,0.192352,0.215249,5751.978938,0.16624,0.018017
5032,5032,,65,32,97,65,32,97,0.003836,0.003771,0,12371,25,0.000051,17,0.201134,0.228758,32594.898198,0.102234,0.019607
5066,5066,,13,27,40,13,27,40,0.000838,0.002153,0,12368,25,0.000016,17,0.202141,0.226666,24979.935929,0.116026,0.003368
5139,5139,,19,14,33,19,14,33,0.002201,0.001204,0,12324,25,0.000024,17,0.186906,0.207675,3335.231965,0.154356,0.006357
5189,5189,,6,7,13,6,7,13,0.000323,0.000011,0,12730,5,0.000018,12,0.154449,0.177024,8360.808234,0.102564,0.001969
5193,5193,,8,7,15,8,7,15,0.000569,0.001584,0,12732,25,0.000015,17,0.191875,0.213019,791.46405,0.209524,0.002407
6030,6030,,25,27,52,25,27,52,0.001067,0.003117,0,12264,25,0.000032,17,0.196485,0.219259,53936.210826,0.110106,0.007482
7064,7064,,92,41,133,92,41,133,0.0127,0.014955,0,12337,25,0.000059,16,0.225823,0.260722,132475.560197,0.081454,0.030021
7065,7065,,24,6,30,24,6,30,0.001645,0.000372,0,12731,25,0.000031,18,0.178067,0.195379,18029.605164,0.109195,0.006684
7177,7177,,66,47,113,66,47,113,0.005405,0.004712,0,12374,25,0.000049,12,0.199992,0.223581,57607.697464,0.091735,0.02027
7254,7254,,10,15,25,10,15,25,0.001081,0.002184,0,12349,25,0.000017,12,0.200093,0.222477,7460.151197,0.151667,0.00327
8102,8102,,14,50,64,14,50,64,0.002002,0.012865,0,12350,25,0.000017,13,0.221603,0.25746,81343.57881,0.142361,0.004971
3077,3077,,2,2,4,2,2,4,0,0.000019,0,12741,23,0.000014,14,0.158578,0.16783,16894.889484,0.25,0.000458
3078,3078,,2,25,27,2,25,27,0.000084,0.002614,0,11578,0,0.000011,15,0.182218,0.21161,424.060316,0.260684,0.000534
9912150,9912150,,9,17,26,9,17,26,0.000303,0.00256,0,11577,0,0.000016,15,0.176862,0.202783,4114.127887,0.209231,0.002457
9706035,9706035,,1,7,8,1,7,8,0.000025,0.001195,0,7670,0,0.000017,13,0.183692,0.209497,8787.580367,0.25,0.00083
9803254,9803254,,2,15,17,2,15,17,0.000058,0.001214,0,11576,0,0.000011,15,0.184086,0.216312,648.856619,0.242647,0.000518
9903028,9903028,,21,15,36,21,15,36,0.000757,0.003015,0,11311,0,0.000024,15,0.183679,0.212954,9140.465515,0.146825,0.006571
3080,3080,,0,2,2,0,2,2,0,0,2,12744,12,0.00001,1,1,1,0,0,0
9901090,9901090,,1,0,1,1,0,1,0,0,2,12743,12,0.000014,0,0,0,0,0,0.000219
9911024,9911024,,1,0,1,1,0,1,0,0,2,12742,12,0.000014,0,0,0,0,0,0.000219
3081,3081,,2,11,13,2,11,13,0.000035,0.001934,0,12745,3,0.000012,11,0.226913,0.256843,16011.223246,0.083333,0.000509
9805081,9805081,,14,11,25,14,11,25,0.00171,0.000162,0,7483,5,0.000021,15,0.140788,0.158983,65215.418487,0.178333,0.005092
9901026,9901026,,5,3,8,5,3,8,0.000604,0.000045,0,9061,5,0.000013,16,0.122456,0.134619,68.287673,0.232143,0.00135
9401131,9401131,,11,9,20,11,9,20,0.000378,0.000267,0,863,13,0.000115,3,0.59375,0.710526,5582.603341,0.071053,0.004197
9503024,9503024,,5,0,5,5,0,5,0.000001,0,0,1423,5,0.000036,0,0,0,0,0,0.001246
9505021,9505021,,5,5,10,5,5,10,0.000166,0.00005,0,1422,5,0.000043,7,0.298932,0.341681,24291.146253,0.144444,0.002065
9407173,9407173,,6,12,18,6,12,18,0.000092,0.000282,0,1016,5,0.000029,7,0.325648,0.411968,13585.345617,0.117647,0.002455
9403018,9403018,,26,3,29,26,3,29,0.000644,0.00002,0,7480,5,0.000062,2,0.714286,0.8,279.340184,0.102217,0.007183
9802160,9802160,,5,3,8,5,3,8,0.000279,0.000027,0,7464,5,0.000018,14,0.15686,0.175404,27426.124386,0.267857,0.001518
9804033,9804033,,11,5,16,11,5,16,0.001144,0.00005,0,7475,5,0.000021,15,0.139303,0.156957,83592.354128,0.1625,0.00364
3082,3082,,5,1,6,5,1,6,0.000021,0,0,12747,26,0.000018,17,0.122968,0.131145,12.087179,0.233333,0.001141
9802120,9802120,,11,5,16,11,5,16,0.000019,0.000017,0,12746,26,0.00006,16,0.140171,0.153052,33638.481522,0.079167,0.002542
9710240,9710240,,14,9,23,14,9,23,0.000678,0.00056,0,7241,26,0.000037,15,0.162588,0.182209,67618.626064,0.171937,0.004174
3083,3083,,0,7,7,0,7,7,0,0.000041,0,12751,4,0.00001,14,0.178386,0.200605,0,0.47619,0
9906154,9906154,,5,23,28,5,23,28,0.000043,0.018823,0,12750,4,0.000013,13,0.198234,0.227729,9724.253051,0.12037,0.001142
9403031,9403031,,11,1,12,11,1,12,0.000051,0,0,1755,26,0.000141,1,1,1,1829.694626,0.121212,0.003094
9407175,9407175,,13,0,13,13,0,13,0.000117,0,0,1757,26,0.000055,0,0,0,0,0.128205,0.003593
9503184,9503184,,10,1,11,10,1,11,0.000069,0.000833,0,3289,26,0.000046,7,0.222031,0.252787,843.471142,0.1,0.002737
9505144,9505144,,8,10,18,8,10,18,0.000067,0.000009,0,3295,26,0.000035,8,0.199726,0.266406,55759.597454,0.133987,0.002266
9306130,9306130,,5,1,6,5,1,6,0.000029,0.000001,0,2891,0,0.000027,1,1,1,59.516882,0.266667,0.001239
9901066,9901066,,1,11,12,1,11,12,0.000221,0.000953,0,12749,13,0.00001,11,0.198674,0.224808,277.748532,0.159091,0.000252
3084,3084,,0,8,8,0,8,8,0,0.00001,0,12754,28,0.00001,14,0.148087,0.173465,0,0.160714,0
9603152,9603152,,9,3,12,9,3,12,0.000012,0.000003,0,11357,28,0.000061,3,0.625,0.766667,4138.539863,0.05303,0.00208
9603189,9603189,,3,0,3,3,0,3,0,0,0,12752,28,0.000016,0,0,0,0,0.333333,0.00067
9702097,9702097,,5,1,6,5,1,6,0.000003,0.000002,0,10058,28,0.000016,1,1,1,0.333333,0.266667,0.001215
9703144,9703144,,2,5,7,2,5,7,0,0.000008,0,12753,28,0.000014,5,0.392157,0.5225,14.5,0.142857,0.000438
9709077,9709077,,6,14,20,6,14,20,0.000001,0.000026,0,10095,28,0.000017,13,0.135919,0.156969,10107.581509,0.139474,0.001375
9711084,9711084,,11,29,40,11,29,40,0.000125,0.000178,0,10073,28,0.00003,13,0.174736,0.217631,38882.78687,0.051282,0.002516
4132,4132,,0,3,3,0,3,3,0,0,0,12755,28,0.00001,6,0.323077,0.430952,0,0.333333,0
9412188,9412188,,6,2,8,6,2,8,0,0.000004,0,7290,28,0.000049,2,0.75,0.833333,738.524127,0.125,0.001435
9507021,9507021,,3,0,3,3,0,3,0.000075,0,0,11356,28,0.000037,0,0,0,0,0,0.000717
9302074,9302074,,22,0,22,22,0,22,0.000006,0,0,2865,5,0.000136,0,0,0,0,0.051948,0.005353
9401057,9401057,,10,2,12,10,2,12,0.000003,0,0,10061,28,0.000031,1,1,1,47.835022,0.098485,0.002358
9505065,9505065,,13,5,18,13,5,18,0.000128,0.000003,0,10066,28,0.000023,1,1,1,1463.157874,0.114379,0.003044
9512200,9512200,,5,3,8,5,3,8,0.000126,0.000008,0,10072,28,0.000014,1,1,1,9.507826,0.285714,0.001229
9605195,9605195,,8,3,11,8,3,11,0.000127,0.000007,0,10071,28,0.000021,2,0.8,0.875,14.547436,0.236364,0.001965
9611138,9611138,,1,7,8,1,7,8,0,0.000004,0,10094,28,0.000011,5,0.328358,0.435606,2637.378119,0.107143,0.000259
9612168,9612168,,8,7,15,8,7,15,0.000308,0.000004,0,10091,28,0.000017,12,0.15328,0.173725,18227.151272,0.095238,0.001921
9707248,9707248,,6,3,9,6,3,9,0.000001,0.000005,0,10088,28,0.000016,3,0.6,0.722222,7.666667,0.263889,0.001407
9207077,9207077,,12,1,13,12,1,13,0.000476,0.00001,0,85,5,0.000027,1,1,1,8.507499,0.198718,0.003789
9306097,9306097,,3,14,17,3,14,17,0.000005,0.000086,0,1990,5,0.000012,2,0.791667,0.868421,6579.387793,0.095588,0.000764
9308019,9308019,,11,3,14,11,3,14,0.000005,0.000006,0,3646,5,0.000049,1,1,1,9350.677903,0.153846,0.002924
9312164,9312164,,16,1,17,16,1,17,0.000004,0.000002,0,10059,28,0.000053,1,1,1,4.088871,0.143382,0.003927
9408101,9408101,,3,7,10,3,7,10,0.000002,0.000008,0,10060,5,0.000014,3,0.6875,0.80303,195.735075,0.122222,0.000757
9411012,9411012,,13,0,13,13,0,13,0.000195,0,0,3650,5,0.000025,0,0,0,0,0.089744,0.003573
9411216,9411216,,3,2,5,3,2,5,0.000002,0.000002,0,10064,28,0.000016,1,1,1,0,0.5,0.000824
9412149,9412149,,5,4,9,5,4,9,0.000003,0.000005,0,10068,28,0.000016,1,1,1,273.837668,0.222222,0.00123
9511059,9511059,,7,5,12,7,5,12,0.000126,0.000008,0,10069,28,0.000018,2,0.857143,0.916667,35.397581,0.204545,0.001689
9602110,9602110,,6,5,11,6,5,11,0.000003,0.000007,0,10063,28,0.000024,2,0.777778,0.857143,15.166667,0.172727,0.001402
9603172,9603172,,4,6,10,4,6,10,0.000002,0.000007,0,10062,28,0.000014,4,0.533333,0.651042,57.9,0.222222,0.000964
9606051,9606051,,1,5,6,1,5,6,0.000002,0.00001,0,10070,28,0.000011,2,0.666667,0.75,13.25,0.2,0.000292
9609018,9609018,,1,8,9,1,8,9,0.000002,0.00001,0,10067,28,0.000011,5,0.44898,0.6,0,0.319444,0.000292
9701032,9701032,,3,16,19,3,16,19,0.000005,0.000126,0,6540,5,0.000014,5,0.464286,0.564615,18234.72112,0.096491,0.000838
3085,3085,,25,29,54,25,29,54,0.001296,0.004058,0,12293,52,0.000022,11,0.208804,0.235276,44105.221051,0.165269,0.008793
9903056,9903056,,12,30,42,12,30,42,0.000626,0.003997,0,8640,52,0.000018,12,0.203494,0.232174,14911.099956,0.112079,0.003467
9906031,9906031,,12,40,52,12,40,52,0.000911,0.006035,0,11660,52,0.000014,12,0.219785,0.252392,6391.69165,0.1727,0.003284
9909125,9909125,,12,24,36,12,24,36,0.000842,0.004538,0,11661,52,0.000015,12,0.211894,0.241537,4037.957136,0.199206,0.003242
9911114,9911114,,13,29,42,13,29,42,0.000673,0.003941,0,11662,52,0.000016,12,0.209918,0.238457,78217.999546,0.149245,0.00406
9912273,9912273,,4,15,19,4,15,19,0.000387,0.002022,0,12292,52,0.000011,12,0.190778,0.213804,185.869174,0.295322,0.00113
9604104,9604104,,5,7,12,5,7,12,0.000315,0.000005,0,8347,52,0.000022,3,0.558824,0.657895,14385.481757,0.128788,0.001412
9306072,9306072,,6,0,6,6,0,6,0.000545,0,0,4033,52,0.000021,0,0,0,0,0.1,0.001745
9801171,9801171,,9,2,11,9,2,11,0.000342,0.000004,0,7818,52,0.000022,6,0.293532,0.334463,271.898513,0.2,0.002566
3086,3086,,14,58,72,14,58,72,0.001141,0.006494,0,12758,0,0.000022,17,0.225232,0.259471,58358.735395,0.049491,0.004136
9803120,9803120,,12,28,40,12,28,40,0.00123,0.006273,0,6422,2,0.000019,13,0.209403,0.245872,21836.381499,0.150641,0.003454
9903039,9903039,,7,16,23,7,16,23,0.000397,0.003181,0,9088,2,0.000012,15,0.198065,0.223484,5102.632619,0.116601,0.001814
9910161,9910161,,4,25,29,4,25,29,0.000252,0.002467,0,12112,0,0.000012,13,0.199066,0.22704,4201.244738,0.189655,0.001066
9911117,9911117,,7,23,30,7,23,30,0.000341,0.004267,0,12757,0,0.000016,11,0.214241,0.248347,5777.301065,0.141379,0.001968
9911217,9911217,,6,8,14,6,8,14,0.000329,0.001737,0,12113,0,0.000013,15,0.196385,0.222446,6825.824529,0.291209,0.001608
3117,3117,,67,2,69,67,2,69,0.005459,0.00022,0,11682,25,0.000068,16,0.175601,0.190231,6546.551476,0.073103,0.021021
3148,3148,,10,20,30,10,20,30,0.001156,0.016997,0,12302,25,0.000017,16,0.206887,0.231031,11277.399036,0.143678,0.003396
3197,3197,,36,14,50,36,14,50,0.003329,0.003062,0,12150,25,0.000038,16,0.195981,0.217896,40639.722153,0.096735,0.012284
3237,3237,,63,11,74,63,11,74,0.009733,0.017495,0,12123,25,0.000051,17,0.193409,0.216155,15752.497776,0.077934,0.018382
3248,3248,,31,5,36,31,5,36,0.002592,0.001411,0,12305,25,0.000032,17,0.190166,0.209164,7570.642935,0.073016,0.008898
9908100,9908100,,3,22,25,3,22,25,0.000109,0.002903,0,11310,0,0.000011,15,0.195896,0.227959,4868.175354,0.261667,0.000853
4003,4003,,17,22,39,17,22,39,0.002616,0.018869,0,11686,25,0.00002,11,0.216808,0.241692,125127.901857,0.126181,0.005471
3136,3136,,178,83,261,178,83,261,0.030041,0.04184,0,11598,1,0.000126,15,0.244672,0.28492,1207177.994726,0.038417,0.066044
3236,3236,,42,12,54,42,12,54,0.004772,0.008509,0,11628,25,0.000039,16,0.206805,0.230933,29744.753816,0.102027,0.016881
9905114,9905114,,4,3,7,4,3,7,0.000352,0.000017,0,11685,15,0.000013,16,0.151417,0.165267,8757.648667,0.166667,0.001234
4094,4094,,2,12,14,2,12,14,0.000117,0.000256,0,12759,0,0.00001,14,0.190446,0.215669,625.051907,0.32967,0.000603
4097,4097,,66,10,76,66,10,76,0.009977,0.001875,0,12303,25,0.000044,16,0.19577,0.215559,10751.168792,0.107018,0.021939
9906144,9906144,,18,7,25,18,7,25,0.000401,0.000033,0,11411,5,0.000042,13,0.185178,0.206017,82456.508267,0.055,0.004781
3103,3103,,20,19,39,20,19,39,0.003117,0.016101,0,11631,1,0.000022,13,0.196076,0.220206,12741.640029,0.163968,0.007095
4095,4095,,5,24,29,5,24,29,0.000334,0.00312,0,11684,25,0.000012,15,0.204459,0.231673,3431.809189,0.110837,0.001519
4103,4103,,45,43,88,45,43,88,0.00396,0.015383,0,11635,0,0.000034,16,0.216086,0.248655,103660.732991,0.077717,0.016875
9910251,9910251,,4,14,18,4,14,18,0.000362,0.00077,0,11681,41,0.000012,12,0.194557,0.214702,16733.225752,0.186275,0.001222
4155,4155,,13,22,35,13,22,35,0.000689,0.005389,0,12760,25,0.000016,18,0.203003,0.228092,4312.139134,0.15042,0.003401
5028,5028,,19,16,35,19,16,35,0.001109,0.001544,0,12301,2,0.000021,12,0.220393,0.248942,69335.933409,0.07395,0.005195
9611151,9611151,,5,36,41,5,36,41,0.000311,0.005367,0,12300,13,0.000014,12,0.221826,0.270553,9660.752329,0.109756,0.001253
9705185,9705185,,8,0,8,8,0,8,0.000687,0,0,6426,2,0.000015,0,0,0,0,0.303571,0.002479
9707167,9707167,,8,4,12,8,4,12,0.000716,0.000586,0,8437,2,0.000015,13,0.188052,0.211562,119.504383,0.19697,0.002507
9904094,9904094,,5,23,28,5,23,28,0.000402,0.003588,0,9089,2,0.000014,13,0.204736,0.230599,38799.033651,0.142857,0.001459
9911004,9911004,,12,20,32,12,20,32,0.001685,0.02063,0,12298,1,0.000015,11,0.23296,0.264421,98712.088029,0.166331,0.003431
4067,4067,,38,18,56,38,18,56,0.001807,0.010214,0,12118,25,0.000036,17,0.216741,0.250765,46531.870655,0.179545,0.012348
4166,4166,,74,19,93,74,19,93,0.003982,0.005301,0,12335,25,0.000063,18,0.193866,0.216235,16617.908583,0.117812,0.022658
5212,5212,,35,12,47,35,12,47,0.001411,0.004241,0,12765,0,0.00004,18,0.195707,0.221252,64282.036763,0.084181,0.010333
4039,4039,,10,24,34,10,24,34,0.001576,0.009235,0,12764,13,0.000016,17,0.206508,0.233549,22172.350611,0.108734,0.002603
9402088,9402088,,6,1,7,6,1,7,0.000105,0,0,12763,0,0.000016,1,1,1,1560.091321,0.166667,0.00171
9511075,9511075,,7,1,8,7,1,8,0.00016,0,0,12762,0,0.000021,1,1,1,1595.908679,0.214286,0.002079
5239,5239,,45,19,64,45,19,64,0.002492,0.002772,0,12372,25,0.000036,17,0.191297,0.212674,2123.255273,0.181052,0.013241
5248,5248,,12,14,26,12,14,26,0.001556,0.003809,0,12281,25,0.000019,11,0.202134,0.223118,15302.363176,0.150769,0.004
6044,6044,,7,30,37,7,30,37,0.000477,0.00482,0,12369,25,0.000013,17,0.206666,0.232365,8159.609478,0.122372,0.001654
3109,3109,,10,15,25,10,15,25,0.000629,0.002161,0,12129,25,0.000015,13,0.189988,0.208733,20894.594454,0.161667,0.003087
4134,4134,,42,10,52,42,10,52,0.003098,0.003057,0,11634,25,0.000055,16,0.204722,0.227363,116217.193535,0.048265,0.013285
5014,5014,,10,27,37,10,27,37,0.000284,0.002907,0,12366,25,0.000015,17,0.200843,0.225677,18314.878212,0.124625,0.002545
5206,5206,,9,21,30,9,21,30,0.000282,0.002698,0,12359,25,0.000015,17,0.18965,0.210629,655.330247,0.209195,0.002398
5276,5276,,28,31,59,28,31,59,0.002311,0.008689,0,11640,25,0.000041,17,0.21176,0.246297,132245.248677,0.055815,0.008288
6069,6069,,8,26,34,8,26,34,0.00084,0.003807,0,12373,25,0.000016,17,0.199251,0.224771,3486.079779,0.2041,0.002628
6139,6139,,53,19,72,53,19,72,0.003732,0.004102,0,12122,25,0.000051,13,0.203316,0.226161,85176.74042,0.111111,0.016069
4133,4133,,60,28,88,60,28,88,0.004106,0.002926,0,12091,25,0.000054,11,0.205768,0.228558,59624.049981,0.07837,0.018033
4165,4165,,42,21,63,42,21,63,0.003573,0.00381,0,12121,0,0.000031,12,0.199458,0.224173,60994.191108,0.109063,0.016749
4206,4206,,17,19,36,17,19,36,0.001906,0.002523,0,12120,25,0.000021,11,0.202793,0.224096,17398.562246,0.161905,0.005588
5001,5001,,13,17,30,13,17,30,0.001469,0.001631,0,12117,25,0.000019,12,0.203051,0.224985,50765.473401,0.16092,0.003962
6164,6164,,2,11,13,2,11,13,0.000299,0.003151,0,12766,25,0.000011,13,0.194392,0.215517,266.355724,0.211538,0.001074
6204,6204,,22,55,77,22,55,77,0.001066,0.020087,0,12478,0,0.000021,11,0.222974,0.254922,100037.036708,0.063055,0.007536
3198,3198,,63,40,103,63,40,103,0.003573,0.004854,0,11639,0,0.000045,13,0.198956,0.226956,86742.728635,0.075005,0.024708
5121,5121,,5,31,36,5,31,36,0.000449,0.00356,0,12477,0,0.000012,13,0.209822,0.238202,28813.779174,0.138095,0.002168
6066,6066,,56,41,97,56,41,97,0.011927,0.006224,0,12416,1,0.000033,12,0.214125,0.241629,142552.157541,0.084622,0.01819
6232,6232,,40,29,69,40,29,69,0.005185,0.018476,0,12325,25,0.000029,11,0.214656,0.240271,111522.476548,0.118926,0.012191
5127,5127,,32,33,65,32,33,65,0.005641,0.004178,0,12304,25,0.000026,11,0.211723,0.236094,59226.209983,0.11226,0.011275
5217,5217,,28,51,79,28,51,79,0.002966,0.009586,0,12276,25,0.000028,11,0.215886,0.244728,77694.815693,0.120902,0.009495
5230,5230,,10,47,57,10,47,57,0.001898,0.024906,0,12297,25,0.000014,10,0.236324,0.269033,46528.97465,0.14787,0.003223
6110,6110,,1,17,18,1,17,18,0.000217,0.001184,0,12323,25,0.000011,12,0.205347,0.227395,69113.767315,0.04902,0.000525
7014,7014,,2,39,41,2,39,41,0.000121,0.007642,0,12767,25,0.00001,17,0.213865,0.248806,1493.885997,0.115244,0.00046
3299,3299,,5,20,25,5,20,25,0.000191,0.003737,0,12116,25,0.000015,17,0.201402,0.227417,48956.213609,0.13,0.001318
9910077,9910077,,13,18,31,13,18,31,0.001928,0.001435,0,11600,13,0.000016,13,0.198217,0.22791,8095.071506,0.108602,0.00349
9910086,9910086,,11,8,19,11,8,19,0.001819,0.000996,0,11601,13,0.000014,17,0.176103,0.197637,12466.748921,0.128655,0.003015
9911253,9911253,,23,37,60,23,37,60,0.003415,0.013918,0,11602,13,0.000028,18,0.189888,0.228546,62884.911719,0.068362,0.00961
7044,7044,,93,36,129,93,36,129,0.007709,0.005246,0,12151,25,0.000082,11,0.211563,0.238377,159860.07691,0.055899,0.026926
4093,4093,,47,21,68,47,21,68,0.005012,0.003793,0,12137,25,0.000041,11,0.202993,0.225306,47425.280999,0.09482,0.013677
4111,4111,,63,47,110,63,47,110,0.006949,0.022933,0,12149,25,0.000047,14,0.214123,0.246684,187189.555657,0.073728,0.018907
7018,7018,,158,60,218,158,60,218,0.018305,0.023791,0,11630,1,0.000144,16,0.23363,0.273068,668830.78526,0.03619,0.056814
7060,7060,,11,7,18,11,7,18,0.000741,0.006347,0,12333,25,0.000021,12,0.196314,0.216343,2589.320548,0.156863,0.004051
7120,7120,,40,35,75,40,35,75,0.004701,0.015727,0,12256,25,0.000033,13,0.213861,0.241839,201956.522679,0.087748,0.011956
3286,3286,,48,22,70,48,22,70,0.00617,0.002068,0,11632,1,0.000042,13,0.193236,0.217099,30926.950632,0.072257,0.016481
6085,6085,,54,16,70,54,16,70,0.005348,0.00317,0,12255,30,0.000039,14,0.19539,0.215039,205145.983224,0.115321,0.018927
7159,7159,,9,11,20,9,11,20,0.000212,0.000336,0,12773,0,0.000015,14,0.190411,0.215433,17341.33402,0.176316,0.002225
3139,3139,,24,5,29,24,5,29,0.000805,0.000452,0,12768,0,0.000068,12,0.197719,0.221892,38597.367999,0.118227,0.006462
4149,4149,,3,38,41,3,38,41,0.000049,0.001878,0,12772,0,0.000013,14,0.197207,0.22726,24828.313496,0.154878,0.000787
6171,6171,,14,1,15,14,1,15,0.000656,0.000009,0,12769,0,0.000027,13,0.165098,0.178379,0,0.185714,0.003873
6191,6191,,10,30,40,10,30,40,0.000619,0.004696,0,12360,25,0.000017,11,0.204065,0.226618,24103.958487,0.149359,0.003042
7178,7178,,0,7,7,0,7,7,0,0.000053,0,12775,26,0.00001,11,0.177894,0.216532,0,0.214286,0
9412182,9412182,,4,0,4,4,0,4,0.000014,0,0,5418,26,0.000016,0,0,0,0,0.166667,0.000897
9508015,9508015,,2,3,5,2,3,5,0.000001,0.000004,0,12774,26,0.000012,5,0.341772,0.416049,40.666667,0.1,0.000438
9612018,9612018,,9,8,17,9,8,17,0.000011,0.00006,0,4805,26,0.00002,10,0.208886,0.261875,58440.930317,0.169118,0.002098
9707081,9707081,,10,9,19,10,9,19,0.000013,0.000186,0,12004,26,0.000021,11,0.175717,0.214904,1187.836449,0.239766,0.002318
7223,7223,,2,15,17,2,15,17,0.000092,0.002489,0,12777,25,0.000011,12,0.201318,0.223622,703.34198,0.172794,0.000452
5068,5068,,11,24,35,11,24,35,0.000455,0.00186,0,12776,0,0.000016,13,0.212363,0.240189,17819.737379,0.092437,0.002812
5185,5185,,11,35,46,11,35,46,0.001512,0.004537,0,12273,25,0.000015,11,0.22021,0.247637,26182.087653,0.117391,0.003187
7239,7239,,14,31,45,14,31,45,0.000943,0.003447,0,12453,25,0.000016,12,0.200723,0.222939,23128.563352,0.172727,0.003722
6007,6007,,37,13,50,37,13,50,0.001509,0.002208,0,12452,25,0.000032,17,0.191345,0.21217,2757.201961,0.179592,0.010436
6115,6115,,27,20,47,27,20,47,0.001816,0.017251,0,12451,25,0.000026,12,0.20639,0.230898,101159.324295,0.117484,0.007111
6146,6146,,25,20,45,25,20,45,0.000988,0.002575,0,12450,25,0.000024,17,0.189441,0.210331,12022.463938,0.210101,0.007203
7203,7203,,17,17,34,17,17,34,0.00093,0.003876,0,12447,25,0.000021,13,0.189518,0.211034,4776.967943,0.193405,0.004595
8008,8008,,15,14,29,15,14,29,0.00112,0.001375,0,11677,0,0.000018,13,0.182117,0.204107,14497.991867,0.230296,0.005097
8087,8087,,14,18,32,14,18,32,0.000743,0.003365,0,12351,25,0.000018,13,0.192231,0.212501,2152.35543,0.177419,0.00359
6093,6093,,16,12,28,16,12,28,0.000551,0.002324,0,12136,25,0.000023,12,0.203144,0.2249,17531.21483,0.165344,0.005341
6203,6203,,38,17,55,38,17,55,0.001187,0.002518,0,12145,25,0.000044,12,0.205272,0.228694,88057.729473,0.118855,0.010578
6251,6251,,47,20,67,47,20,67,0.002317,0.003819,0,12259,25,0.000043,13,0.19994,0.221807,42769.386823,0.109905,0.01273
8079,8079,,25,7,32,25,7,32,0.001108,0.001252,0,12147,25,0.000026,13,0.186176,0.20387,2589.734484,0.15121,0.006616
7205,7205,,12,34,46,12,34,46,0.001714,0.018651,0,12338,25,0.000016,14,0.21244,0.2398,28719.382463,0.124638,0.004053
8188,8188,,40,23,63,40,23,63,0.002047,0.005924,0,12778,25,0.000031,14,0.208218,0.236884,102468.813493,0.109575,0.011301
7029,7029,,34,35,69,34,35,69,0.00408,0.002931,0,12307,25,0.000033,13,0.213008,0.238704,91771.886193,0.111893,0.009933
8190,8190,,28,23,51,28,23,51,0.002156,0.002151,0,12341,25,0.000025,16,0.198548,0.223715,71178.957378,0.134902,0.008348
4124,4124,,38,21,59,38,21,59,0.002273,0.003902,0,12089,25,0.000036,16,0.207983,0.232833,24759.644593,0.118936,0.012357
6213,6213,,13,4,17,13,4,17,0.000766,0.000097,0,12340,25,0.000034,13,0.178045,0.192256,10683.729757,0.044118,0.003621
8074,8074,,35,29,64,35,29,64,0.002721,0.017972,0,12332,25,0.000027,14,0.20816,0.234913,98230.869383,0.103671,0.010531
8134,8134,,5,20,25,5,20,25,0.000111,0.001512,0,12261,25,0.000013,15,0.192947,0.214697,17090.006325,0.248333,0.001487
9706179,9706179,,9,3,12,9,3,12,0.000105,0.000008,0,12086,25,0.000021,10,0.198994,0.225618,10582.595254,0.068182,0.002631
8192,8192,,33,24,57,33,24,57,0.001891,0.004612,0,12779,25,0.000029,14,0.202623,0.227925,26969.39673,0.139724,0.009456
8193,8193,,1,15,16,1,15,16,0.000026,0.003139,0,12780,25,0.00001,12,0.194349,0.215188,134.440407,0.183333,0.000286
8197,8197,,3,7,10,3,7,10,0.000214,0.00149,0,12781,25,0.000011,12,0.197707,0.217489,425.494762,0.222222,0.000764
6068,6068,,26,10,36,26,10,36,0.000947,0.003449,0,12280,25,0.000035,11,0.198646,0.218823,10626.94608,0.084127,0.007099
8245,8245,,4,12,16,4,12,16,0.000156,0.012919,0,12783,25,0.000012,15,0.196846,0.220267,2558.829533,0.108333,0.000917
6226,6226,,16,24,40,16,24,40,0.001785,0.005101,0,12295,25,0.000021,14,0.211248,0.237922,87234.46917,0.116026,0.005906
7233,7233,,8,6,14,8,6,14,0.001182,0.0006,0,12782,25,0.000013,14,0.196345,0.216979,1981.032389,0.258242,0.002349
9006,9006,,0,19,19,0,19,19,0,0.017686,0,12784,25,0.00001,12,0.208974,0.233845,0,0.222222,0
9010,9010,,17,14,31,17,14,31,0.000573,0.001587,0,12785,25,0.00002,15,0.186267,0.207114,10630.903737,0.290323,0.004937
9056,9056,,20,24,44,20,24,44,0.000934,0.001585,0,12791,25,0.00002,15,0.194879,0.218485,21034.616723,0.162791,0.005482
8185,8185,,16,5,21,16,5,21,0.00052,0.001293,0,12790,25,0.000021,15,0.187166,0.206706,10318.658477,0.107143,0.004332
9032,9032,,9,27,36,9,27,36,0.000899,0.002198,0,12789,25,0.000015,15,0.197389,0.220477,24631.805357,0.123016,0.002567
9059,9059,,9,42,51,9,42,51,0.001995,0.019383,0,12454,25,0.000013,14,0.215665,0.244071,84119.267729,0.156863,0.003136
8015,8015,,57,45,102,57,45,102,0.007228,0.015034,0,12446,2,0.000034,13,0.240156,0.276387,163460.692077,0.056882,0.01638
8133,8133,,11,26,37,11,26,37,0.0012,0.004566,0,12378,25,0.000016,15,0.202393,0.228969,60718.924727,0.090841,0.002862
9022,9022,,23,39,62,23,39,62,0.002498,0.006782,0,12345,25,0.000018,17,0.198659,0.228841,89324.949836,0.165785,0.006609
9064,9064,,2,6,8,2,6,8,0.000058,0.001575,0,12476,25,0.000011,11,0.190887,0.20845,3108.354055,0.232143,0.000615
5226,5226,,4,6,10,4,6,10,0.000066,0.001526,0,12475,25,0.000017,11,0.194805,0.213362,1151.351346,0.133333,0.000905
9083,9083,,29,9,38,29,9,38,0.002766,0.001686,0,12793,25,0.00003,12,0.179416,0.195885,9241.392532,0.130868,0.007626
9909144,9909144,,13,3,16,13,3,16,0.000531,0.000068,0,12792,0,0.000029,17,0.156214,0.174355,871.658558,0.183333,0.003552
9087,9087,,9,23,32,9,23,32,0.001849,0.0094,0,12465,25,0.000015,15,0.217126,0.250336,74801.615195,0.154234,0.002625
3291,3291,,3,8,11,3,8,11,0.000319,0.007174,0,12464,1,0.000011,12,0.224403,0.253381,832.228141,0.254545,0.000773
5062,5062,,4,4,8,4,4,8,0.000233,0.000019,0,12461,0,0.000017,3,0.555556,0.666667,1098.617127,0.142857,0.00179
7041,7041,,3,18,21,3,18,21,0.000719,0.021527,0,12460,1,0.000011,17,0.216607,0.250768,1240.640693,0.261905,0.00084
9039,9039,,12,11,23,12,11,23,0.002834,0.019627,0,12459,1,0.000017,11,0.22787,0.257721,11793.179575,0.231225,0.003438
9122,9122,,19,8,27,19,8,27,0.001687,0.001537,0,12794,25,0.000019,17,0.184745,0.206223,3099.682686,0.166667,0.005423
9127,9127,,18,13,31,18,13,31,0.001539,0.001654,0,12481,25,0.000046,14,0.197787,0.219236,40449.289175,0.129032,0.004607
8128,8128,,27,34,61,27,34,61,0.002381,0.006475,0,12344,25,0.000026,12,0.204463,0.229562,23590.123175,0.162568,0.007591
9132,9132,,2,27,29,2,27,29,0.000724,0.001665,0,12800,25,0.00001,12,0.200645,0.222848,5657.90196,0.134236,0.000472
4021,4021,,6,10,16,6,10,16,0.000264,0.001647,0,12138,25,0.000012,19,0.193369,0.215586,1485.523855,0.229167,0.001518
7039,7039,,2,9,11,2,9,11,0.000035,0.001341,0,12799,25,0.000011,11,0.199008,0.218062,63.021223,0.336364,0.000452
8164,8164,,15,34,49,15,34,49,0.000798,0.00764,0,12798,0,0.000018,13,0.192623,0.218047,31490.169642,0.170068,0.003755
9160,9160,,19,22,41,19,22,41,0.001837,0.003062,0,12801,25,0.000019,12,0.194602,0.215375,4406.646913,0.209756,0.005616
9167,9167,,23,18,41,23,18,41,0.002326,0.002042,0,12803,25,0.000023,14,0.201757,0.225829,14226.801992,0.143293,0.006271
8112,8112,,36,47,83,36,47,83,0.003279,0.020781,0,12802,25,0.00003,14,0.223139,0.260003,103410.527333,0.107552,0.010994
9175,9175,,10,28,38,10,28,38,0.000561,0.004861,0,12804,25,0.000014,18,0.207482,0.233759,8803.161268,0.140825,0.002587
9180,9180,,2,14,16,2,14,16,0.00003,0.001815,0,12806,30,0.000013,12,0.206705,0.226997,6288.375607,0.104167,0.000501
9507150,9507150,,19,5,24,19,5,24,0.000025,0.000002,0,2701,30,0.000068,3,0.6,0.694444,2551.267055,0.074275,0.004757
9910064,9910064,,2,7,9,2,7,9,0.000161,0.001636,0,12805,2,0.000011,13,0.190407,0.209435,262.537495,0.152778,0.000452
9183,9183,,19,20,39,19,20,39,0.002146,0.003294,0,12807,25,0.000021,15,0.195063,0.221865,21433.876211,0.072874,0.005125
5137,5137,,17,27,44,17,27,44,0.001844,0.012203,0,12483,1,0.000021,13,0.199806,0.225175,18062.794826,0.14482,0.005417
7109,7109,,10,54,64,10,54,64,0.000879,0.004684,0,12786,1,0.000018,13,0.214468,0.248482,31876.130146,0.080109,0.003431
7209,7209,,30,59,89,30,59,89,0.003139,0.023033,0,12484,25,0.000027,14,0.212887,0.24524,87566.787218,0.073544,0.008477
8050,8050,,28,20,48,28,20,48,0.001993,0.002278,0,12787,25,0.000028,14,0.199435,0.223693,52618.847519,0.078014,0.007196
9184,9184,,4,24,28,4,24,28,0.000641,0.003007,0,12809,25,0.000011,14,0.202315,0.227829,3024.082714,0.109788,0.000986
9703063,9703063,,5,9,14,5,9,14,0.000272,0.001481,0,12808,13,0.000013,10,0.207177,0.233492,402.29511,0.153846,0.001281
9199,9199,,12,40,52,12,40,52,0.002379,0.006947,0,12810,0,0.000013,18,0.197489,0.229275,79170.865083,0.210784,0.003241
6059,6059,,17,12,29,17,12,29,0.001986,0.00162,0,12277,25,0.000017,12,0.192743,0.211374,19068.301156,0.288177,0.005752
6215,6215,,16,36,52,16,36,52,0.001992,0.006275,0,12278,25,0.000018,12,0.207461,0.233661,30173.022948,0.180618,0.005245
8041,8041,,12,36,48,12,36,48,0.00169,0.007428,0,12342,0,0.000015,12,0.205612,0.23142,6940.752518,0.234486,0.003913
9207,9207,,1,19,20,1,19,20,0.000019,0.004603,0,12811,25,0.00001,13,0.205402,0.228101,2888.161896,0.131579,0.000245
4136,4136,,3,27,30,3,27,30,0.000091,0.001101,0,12364,25,0.000012,12,0.196253,0.223728,6582.216211,0.109195,0.000797
5204,5204,,102,20,122,102,20,122,0.005912,0.002533,0,12239,30,0.000087,15,0.198685,0.22013,166495.18809,0.076819,0.040635
9212,9212,,22,11,33,22,11,33,0.001801,0.008385,0,12812,25,0.000022,14,0.197501,0.22032,9542.363922,0.109848,0.005274
6192,6192,,18,27,45,18,27,45,0.001853,0.023322,0,12358,25,0.000028,18,0.211748,0.241051,50784.491227,0.083838,0.005113
9247,9247,,15,32,47,15,32,47,0.002245,0.011763,0,12813,25,0.000015,19,0.207636,0.241101,114873.887396,0.075393,0.005198
5067,5067,,68,88,156,68,88,156,0.003681,0.011429,0,12294,0,0.000039,13,0.229683,0.267402,231754.531039,0.070802,0.024147
6047,6047,,42,28,70,42,28,70,0.001849,0.001957,0,11675,52,0.000032,12,0.210701,0.236436,118813.467623,0.117391,0.016487
7206,7206,,13,9,22,13,9,22,0.00103,0.001136,0,11641,25,0.000022,17,0.190639,0.212821,19131.398693,0.073593,0.004422
10063,10063,,23,16,39,23,16,39,0.000773,0.001946,0,12814,25,0.000025,16,0.180986,0.20281,8223.585818,0.238192,0.006388
10093,10093,,17,34,51,17,34,51,0.001542,0.00361,0,12815,25,0.000018,17,0.194549,0.221317,8707.561853,0.140784,0.005124
9176,9176,,29,33,62,29,33,62,0.003818,0.006088,0,12132,25,0.000031,14,0.205121,0.230635,116285.563445,0.090428,0.009789
9510027,9510027,,6,8,14,6,8,14,0.000282,0.000362,0,4534,0,0.000016,7,0.257812,0.292504,386.335402,0.126374,0.001633
9307059,9307059,,11,1,12,11,1,12,0.000462,0.000002,0,5124,2,0.000023,3,0.454545,0.5,162.997837,0.136364,0.00277
9712202,9712202,,15,36,51,15,36,51,0.001561,0.007457,0,5125,2,0.000021,14,0.205301,0.24204,80007.10634,0.10549,0.004933
9908102,9908102,,7,29,36,7,29,36,0.000331,0.003281,0,12111,0,0.000013,13,0.211106,0.245924,6000.708063,0.134921,0.001875
9907207,9907207,,1,2,3,1,2,3,0.00014,0.000001,0,10237,0,0.00001,14,0.155368,0.169215,16197.488672,0,0.000321
9707001,9707001,,1,17,18,1,17,18,0.00005,0.004182,0,12756,0,0.00001,11,0.20956,0.242375,0,0.19281,0.00027
3087,3087,,1,6,7,1,6,7,0,0.000001,0,12816,26,0.000012,11,0.156423,0.185049,291.24329,0.333333,0.000219
3089,3089,,0,2,2,0,2,2,0,0,0,12820,28,0.00001,3,0.448276,0.512821,0,0.5,0
9506146,9506146,,4,6,10,4,6,10,0,0.000019,0,12818,28,0.000021,2,0.6875,0.772727,16.75,0.166667,0.000883
9712100,9712100,,1,3,4,1,3,4,0,0,0,12819,28,0.000014,2,0.571429,0.625,3.333333,0.25,0.000219
9501002,9501002,,2,4,6,2,4,6,0,0.000024,0,12817,28,0.000015,1,1,1,1.666667,0.2,0.000491
3090,3090,,0,7,7,0,7,7,0,0.001261,0,12822,26,0.00001,12,0.191064,0.209139,0,0.309524,0
9803027,9803027,,25,12,37,25,12,37,0.00195,0.002343,0,11073,26,0.000032,14,0.188643,0.21587,32101.964633,0.180931,0.006781
9811083,9811083,,15,12,27,15,12,27,0.001033,0.007039,0,11083,26,0.000021,14,0.184726,0.209165,1803.599884,0.240741,0.003799
9906087,9906087,,19,28,47,19,28,47,0.002589,0.021231,0,11089,26,0.000025,11,0.232793,0.265451,218330.368358,0.112396,0.004661
9911243,9911243,,15,16,31,15,16,31,0.000779,0.007099,0,12821,26,0.000022,14,0.186534,0.210963,1425.046841,0.197849,0.003552
9307080,9307080,,7,1,8,7,1,8,0.000031,0.000015,0,3917,26,0.000019,1,1,1,103.187204,0.053571,0.001929
9307146,9307146,,8,0,8,8,0,8,0.000094,0,0,1775,26,0.000068,0,0,0,0,0.214286,0.002611
9405176,9405176,,24,2,26,24,2,26,0.000099,0.000008,0,3906,26,0.000068,1,1,1,184.704657,0.084615,0.006685
9504026,9504026,,7,13,20,7,13,20,0.000057,0.000039,0,3910,26,0.000021,6,0.282609,0.414744,70095.498452,0.128947,0.00205
9612021,9612021,,15,16,31,15,16,31,0.001164,0.0027,0,7240,26,0.000029,11,0.188902,0.21631,12682.742473,0.153763,0.004349
9705242,9705242,,8,10,18,8,10,18,0.001037,0.002083,0,11072,26,0.000019,15,0.164412,0.188223,4344.109625,0.212418,0.002573
9507062,9507062,,12,11,23,12,11,23,0.000819,0.000155,0,6852,26,0.000023,8,0.243484,0.285845,25766.583675,0.100791,0.00333
9809165,9809165,,9,17,26,9,17,26,0.000826,0.009391,0,11082,26,0.000017,14,0.198719,0.227863,13355.357486,0.227692,0.002486
9606157,9606157,,6,17,23,6,17,23,0.000676,0.001285,0,11085,26,0.000013,8,0.243226,0.295695,7127.121937,0.140316,0.001641
9802037,9802037,,11,15,26,11,15,26,0.00062,0.003598,0,11088,2,0.000026,15,0.186103,0.214754,14256.164707,0.087692,0.002689
9807035,9807035,,5,8,13,5,8,13,0.000829,0.002973,0,11070,26,0.000013,15,0.173781,0.195724,7953.546341,0.185897,0.001586
9810158,9810158,,2,19,21,2,19,21,0.000566,0.002883,0,11087,26,0.000011,15,0.178896,0.203479,7736.151898,0.214286,0.000643
9811254,9811254,,13,22,35,13,22,35,0.00111,0.002912,0,11086,26,0.00002,14,0.180313,0.20511,32172.779077,0.164706,0.003392
3091,3091,,0,4,4,0,4,4,0,0.000001,0,12825,26,0.00001,11,0.152568,0.167577,0,0.333333,0
9703074,9703074,,2,1,3,2,1,3,0,0,0,12823,26,0.000015,2,0.666667,0.75,0,0.5,0.000451
9903133,9903133,,2,4,6,2,4,6,0.000001,0.000001,0,12824,26,0.000013,10,0.179525,0.200955,821.434017,0.2,0.000451
3092,3092,,5,4,9,5,4,9,0.000011,0.000002,0,12828,2,0.000014,14,0.158519,0.174825,635.524667,0.194444,0.001162
9707204,9707204,,19,4,23,19,4,23,0.000041,0.000002,0,11791,2,0.000043,8,0.258339,0.288279,6883.041156,0.124506,0.004722
9710199,9710199,,9,5,14,9,5,14,0.000017,0.000116,0,11794,2,0.000028,13,0.186289,0.211583,19069.867873,0.17033,0.002145
9904203,9904203,,11,3,14,11,3,14,0.000034,0.000002,0,12827,23,0.00003,14,0.159445,0.176385,7709.105124,0.104396,0.002669
9407022,9407022,,13,5,18,13,5,18,0.000012,0.000076,0,4462,23,0.000045,6,0.263052,0.305344,10316.113079,0.091503,0.003535
9511129,9511129,,14,1,15,14,1,15,0.000031,0.000006,0,11790,2,0.000041,7,0.327239,0.360295,4596.060739,0.152381,0.003489
9706103,9706103,,4,5,9,4,5,9,0,0,0,11789,26,0.000024,8,0.228426,0.268523,2195.447809,0.180556,0.001034
9709105,9709105,,3,15,18,3,15,18,0.000017,0.000013,0,11792,23,0.000016,16,0.121591,0.152444,1117.79373,0.176471,0.000766
9710060,9710060,,3,15,18,3,15,18,0.000014,0.000522,0,11793,2,0.000017,13,0.188609,0.217378,2577.417809,0.137255,0.000791
9502042,9502042,,12,1,13,12,1,13,0.000134,0,0,11797,23,0.000047,3,0.5,0.583333,2652.693845,0.051282,0.002928
9805109,9805109,,25,25,50,25,25,50,0.000064,0.000513,0,12826,2,0.000052,13,0.189475,0.219916,100119.885275,0.063265,0.006066
3093,3093,,28,10,38,28,10,38,0.001431,0.004162,0,12829,30,0.000022,13,0.194852,0.213772,3294.014761,0.215505,0.008384
105085,105085,,17,21,38,17,21,38,0.000592,0.002618,0,13070,30,0.000016,13,0.202979,0.224204,3713.721585,0.20697,0.004636
3160,3160,,242,34,276,242,34,276,0.010864,0.002903,0,12170,30,0.00022,14,0.199208,0.221233,339595.455725,0.037299,0.094935
3231,3231,,26,19,45,26,19,45,0.001138,0.002803,0,12238,30,0.000031,12,0.211031,0.233356,17719.009729,0.163131,0.009377
5199,5199,,22,5,27,22,5,27,0.001021,0.001062,0,12939,30,0.000024,13,0.193172,0.210938,6510.353296,0.264957,0.008653
6091,6091,,43,26,69,43,26,69,0.002034,0.00506,0,13054,30,0.000046,13,0.204751,0.230616,102405.398547,0.082481,0.015534
6246,6246,,43,9,52,43,9,52,0.001262,0.001639,0,13069,30,0.000054,12,0.196325,0.214323,46310.405488,0.092006,0.013158
7140,7140,,24,41,65,24,41,65,0.000782,0.004162,0,12945,30,0.000026,14,0.211348,0.237439,59128.751817,0.109856,0.009356
7204,7204,,63,10,73,63,10,73,0.004111,0.001419,0,12938,30,0.00005,14,0.189883,0.207431,8146.600194,0.103501,0.027074
8092,8092,,26,34,60,26,34,60,0.001566,0.003662,0,13066,30,0.00002,14,0.202537,0.226957,43921.453869,0.088418,0.007659
9142,9142,,77,41,118,77,41,118,0.003792,0.005426,0,12952,30,0.000055,15,0.21204,0.238208,211996.590543,0.090903,0.028529
10006,10006,,30,26,56,30,26,56,0.001526,0.004012,0,12940,30,0.000025,14,0.202536,0.22618,11011.010721,0.140909,0.009569
10017,10017,,28,34,62,28,34,62,0.001442,0.005457,0,12953,30,0.000023,16,0.212725,0.240596,74416.905883,0.124273,0.010007
10060,10060,,110,51,161,110,51,161,0.004953,0.004757,0,12989,30,0.000078,12,0.217992,0.242868,442838.223128,0.076786,0.043492
10090,10090,,84,21,105,84,21,105,0.004395,0.003642,0,13020,30,0.000058,16,0.205576,0.228671,93809.23064,0.08315,0.029731
11095,11095,,46,81,127,46,81,127,0.002037,0.010693,0,13055,30,0.000038,13,0.226001,0.25759,210069.867424,0.073553,0.016158
102182,102182,,18,18,36,18,18,36,0.001102,0.002174,0,13063,30,0.000022,13,0.201101,0.221738,21174.688536,0.170635,0.006518
3094,3094,,0,1,1,0,1,1,0,0,0,13073,20,0.00001,2,0.666667,0.75,0,0,0
9810138,9810138,,4,1,5,4,1,5,0,0,0,13072,20,0.000048,1,1,1,5,0,0.000883
9710220,9710220,,1,0,1,1,0,1,0,0,0,13071,20,0.000053,0,0,0,0,0,0.000245
3095,3095,,1,6,7,1,6,7,0,0.000001,0,13074,26,0.000011,15,0.137092,0.146526,0.72619,0.309524,0.000219
3096,3096,,25,36,61,25,36,61,0.004883,0.020445,0,12958,1,0.00002,14,0.205796,0.232176,5385.799361,0.231148,0.008486
3097,3097,,2,8,10,2,8,10,0.000024,0.001997,0,13076,4,0.000012,14,0.149786,0.167531,598.23514,0.144444,0.000478
9708061,9708061,,5,2,7,5,2,7,0.000052,0.00186,0,13075,4,0.000016,6,0.263804,0.29832,68.707545,0.285714,0.001162
3098,3098,,3,5,8,3,5,8,0.000389,0.00599,0,13079,1,0.000013,12,0.192082,0.210911,4588.355561,0.178571,0.000701
9906035,9906035,,3,4,7,3,4,7,0.000489,0.011271,0,13077,1,0.000015,15,0.176457,0.198577,98.487765,0.214286,0.000736
9908140,9908140,,8,10,18,8,10,18,0.001377,0.017873,0,13078,1,0.000022,10,0.226577,0.255821,25884.169711,0.173203,0.002255
3099,3099,,13,8,21,13,8,21,0.000312,0.001578,0,12894,30,0.000022,14,0.188112,0.205908,36838.776654,0.109524,0.003748
9811169,9811169,,40,7,47,40,7,47,0.000567,0.000074,0,12893,30,0.000053,15,0.145942,0.165285,13263.309515,0.145698,0.011154
9409193,9409193,,4,3,7,4,3,7,0.000006,0.000014,0,6825,30,0.000015,1,1,1,163.713647,0.142857,0.001311
9412185,9412185,,20,2,22,20,2,22,0.000009,0.000003,0,2691,30,0.000213,1,1,1,749.376221,0.140693,0.005907
9507147,9507147,,2,2,4,2,2,4,0.000001,0.000005,0,6318,30,0.000016,1,1,1,1994.753417,0.083333,0.000748
9507148,9507148,,1,2,3,1,2,3,0.000001,0.000005,0,6831,30,0.000012,1,1,1,315.071832,0.166667,0.000511
9510217,9510217,,9,3,12,9,3,12,0.0002,0.000005,0,6172,30,0.000063,1,1,1,12833.198642,0.128788,0.003417
9606056,9606056,,10,6,16,10,6,16,0.000046,0.000341,0,6819,30,0.00004,10,0.192542,0.212493,27945.041136,0.095833,0.002856
9610035,9610035,,11,7,18,11,7,18,0.000214,0.000057,0,6830,30,0.000029,11,0.163912,0.179567,35570.094404,0.117647,0.003034
9612228,9612228,,7,14,21,7,14,21,0.000007,0.000067,0,6826,30,0.000022,11,0.164104,0.182765,26346.210976,0.171429,0.002084
9401048,9401048,,11,0,11,11,0,11,0.000006,0,0,2693,30,0.000066,0,0,0,0,0.127273,0.002957
9503152,9503152,,4,0,4,4,0,4,0.000005,0,0,7065,5,0.000023,0,0,0,0,0.25,0.00124
9503153,9503153,,1,1,2,1,1,2,0.000001,0.00001,0,7064,30,0.000011,1,1,1,2.854313,0,0.000309
9503180,9503180,,4,0,4,4,0,4,0.000003,0,0,6821,30,0.000017,0,0,0,0,0.5,0.001139
9605129,9605129,,5,2,7,5,2,7,0.000003,0.000031,0,6820,30,0.000019,3,0.5,0.595238,0.642857,0.428571,0.001417
9607005,9607005,,3,7,10,3,7,10,0.000002,0.000044,0,6855,30,0.000016,2,0.594595,0.659091,271.13973,0.311111,0.000848
9612149,9612149,,5,6,11,5,6,11,0.000075,0.000016,0,6822,30,0.000017,11,0.162694,0.176858,1407.23631,0.218182,0.001434
9701081,9701081,,15,7,22,15,7,22,0.000034,0.00005,0,6856,30,0.000032,11,0.162987,0.178022,5993.026013,0.149351,0.00358
9701179,9701179,,8,9,17,8,9,17,0.000184,0.000058,0,6835,30,0.000023,11,0.164546,0.182412,27742.374167,0.150735,0.002272
9706105,9706105,,12,16,28,12,16,28,0.000082,0.00007,0,6857,30,0.000025,11,0.16474,0.184431,7930.092157,0.141534,0.002999
9603071,9603071,,13,4,17,13,4,17,0.000163,0.000062,0,12892,30,0.00003,10,0.199037,0.222768,188.278628,0.297794,0.004195
9605003,9605003,,31,6,37,31,6,37,0.000539,0.000061,0,5490,30,0.000064,14,0.171316,0.199747,483581.495915,0.135886,0.009598
9611058,9611058,,10,1,11,10,1,11,0.00002,0.000031,0,12891,30,0.000032,1,1,1,6.732961,0.209091,0.003332
3100,3100,,18,31,49,18,31,49,0.000596,0.016324,0,12101,0,0.000045,13,0.17884,0.204574,55596.642976,0.185374,0.004929
3101,3101,,106,25,131,106,25,131,0.00503,0.001895,0,12196,3,0.000095,12,0.202225,0.223634,317674.384998,0.087434,0.050978
9802061,9802061,,22,5,27,22,5,27,0.000305,0.000007,0,12188,6,0.000032,11,0.182497,0.224743,6485.470505,0.138177,0.006939
9909216,9909216,,16,10,26,16,10,26,0.000231,0.000054,0,12189,6,0.000024,13,0.170923,0.186538,240788.504846,0.129231,0.005274
9204049,9204049,,3,0,3,3,0,3,0.000003,0,0,479,5,0.000045,0,0,0,0,0,0.001892
9204084,9204084,,8,0,8,8,0,8,0.000265,0,0,730,5,0.000058,0,0,0,0,0.214286,0.00375
9211057,9211057,,14,0,14,14,0,14,0.000016,0,0,394,5,0.000095,0,0,0,0,0.071429,0.005165
3102,3102,,3,17,20,3,17,20,0.000398,0.01838,0,13080,1,0.000012,15,0.213092,0.248752,5009.13666,0.186842,0.000664
9811234,9811234,,1,3,4,1,3,4,0.000239,0.000983,0,8360,2,0.00001,10,0.19323,0.214738,66.115225,0.166667,0.000409
3105,3105,,0,1,1,0,1,1,0,0,0,13081,26,0.00001,17,0.122968,0.131145,0,0,0
3106,3106,,1,22,23,1,22,23,0.00003,0.000949,0,12144,2,0.000012,13,0.211714,0.24145,34262.15778,0.096838,0.000496
9901045,9901045,,22,32,54,22,32,54,0.001084,0.004917,0,12143,13,0.00002,11,0.222459,0.259457,35088.890823,0.084556,0.006179
9910025,9910025,,3,1,4,3,1,4,0.000011,0,0,12142,9,0.000015,1,1,1,3809,0.083333,0.000674
9910175,9910175,,1,24,25,1,24,25,0.000011,0.002714,0,12140,2,0.00001,12,0.200529,0.224749,3608.524729,0.12,0.00023
9707130,9707130,,17,7,24,17,7,24,0.001041,0.000513,0,5912,13,0.000022,12,0.200073,0.224827,16784.357904,0.155797,0.005603
9710189,9710189,,5,9,14,5,9,14,0.000259,0.002063,0,5913,13,0.000014,13,0.194238,0.222689,647.774677,0.214286,0.001615
9806050,9806050,,1,13,14,1,13,14,0.000032,0.000602,0,10124,0,0.00001,17,0.179706,0.209889,8379.171186,0.208791,0.000292
9310081,9310081,,1,0,1,1,0,1,0,0,0,12141,9,0.000023,0,0,0,0,0,0.000239
3108,3108,,3,7,10,3,7,10,0.000001,0.00002,0,13082,22,0.000013,2,0.64,0.71875,1313.288995,0.244444,0.000708
9305129,9305129,,8,4,12,8,4,12,0.000001,0,0,9995,22,0.000024,1,1,1,1229.777365,0.174242,0.00205
9309059,9309059,,12,0,12,12,0,12,0.000001,0,0,10320,22,0.000076,0,0,0,0,0.136364,0.00284
9212157,9212157,,10,1,11,10,1,11,0.00001,0,0,9993,22,0.000038,1,1,1,29.178438,0.145455,0.002527
9611171,9611171,,1,15,16,1,15,16,0.000025,0.000044,0,12128,5,0.000011,7,0.260739,0.324886,16117.879142,0.0375,0.000296
9206056,9206056,,13,0,13,13,0,13,0.000096,0,0,409,5,0.000043,0,0,0,0,0.051282,0.00341
9307052,9307052,,1,11,12,1,11,12,0.000001,0.000062,0,12127,5,0.00001,2,0.703704,0.789474,4043.614261,0.037879,0.000227
9310156,9310156,,4,21,25,4,21,25,0.000007,0.000084,0,1962,5,0.000017,2,0.83871,0.903846,1104.368543,0.071667,0.001137
9505159,9505159,,3,3,6,3,3,6,0.000001,0.000044,0,6444,5,0.000022,6,0.316186,0.363492,1661.13763,0.1,0.000741
9510107,9510107,,1,1,2,1,1,2,0.000001,0,0,12125,5,0.00001,7,0.240952,0.262498,0,0.5,0.000227
3110,3110,,22,34,56,22,34,56,0.000599,0.001572,0,12197,52,0.000028,12,0.206373,0.23177,162306.889463,0.112662,0.007928
9805101,9805101,,10,9,19,10,9,19,0.000175,0.000014,0,12193,6,0.000016,12,0.184365,0.236902,37155.30677,0.134503,0.002674
9410042,9410042,,13,4,17,13,4,17,0.000001,0.000002,0,2347,6,0.000037,2,0.833333,0.9,13054.109731,0.125,0.003426
9306103,9306103,,8,2,10,8,2,10,0.000002,0,0,7784,6,0.000018,1,1,1,1102.316473,0.1,0.002038
9606003,9606003,,5,12,17,5,12,17,0.000001,0.000012,0,12192,6,0.000014,8,0.239466,0.305569,22283.632452,0.161765,0.001345
3111,3111,,1,5,6,1,5,6,0,0.000013,0,13085,23,0.000012,17,0.146073,0.156212,163.916667,0.1,0.000239
9711064,9711064,,2,1,3,2,1,3,0,0,0,13084,23,0.000014,1,1,1,0,0.333333,0.000445
9908208,9908208,,9,1,10,9,1,10,0.000184,0.000003,0,13083,1,0.000049,16,0.170801,0.186331,17067.464048,0.1,0.002257
3112,3112,,4,4,8,4,4,8,0.000001,0,0,12448,22,0.000029,8,0.213115,0.286783,9460.270465,0.053571,0.00092
9602151,9602151,,1,7,8,1,7,8,0,0,0,8899,22,0.000013,7,0.241509,0.337016,38686.125846,0.214286,0.000281
3113,3113,,61,15,76,61,15,76,0.004948,0.001506,0,12164,30,0.000064,13,0.194854,0.214725,33904.575691,0.145789,0.03066
9602055,9602055,,3,4,7,3,4,7,0.000083,0.000094,0,5522,28,0.000016,5,0.282051,0.343939,206.562234,0.238095,0.001604
3114,3114,,12,4,16,12,4,16,0.000138,0.001568,0,13086,23,0.00005,13,0.194342,0.21233,99248.513396,0.075,0.002856
3115,3115,,6,22,28,6,22,28,0.000859,0.01467,0,13087,1,0.000013,12,0.204524,0.228326,1034.43259,0.222222,0.001485
3116,3116,,20,25,45,20,25,45,0.004519,0.019314,0,12415,1,0.000017,12,0.209562,0.234295,46081.527339,0.211616,0.006726
9809047,9809047,,1,0,1,1,0,1,0.000227,0,0,12414,1,0.00001,0,0,0,0,0,0.000381
9403071,9403071,,1,0,1,1,0,1,0.000018,0,0,11134,25,0.000014,0,0,0,0,0,0.000464
9609024,9609024,,4,0,4,4,0,4,0.000252,0,0,2489,0,0.000036,0,0,0,0,0,0.001227
3119,3119,,0,41,41,0,41,41,0,0.024115,0,13088,1,0.00001,11,0.230587,0.263643,0,0.215854,0
9610144,9610144,,4,18,22,4,18,22,0.000292,0.000149,0,7368,26,0.000014,11,0.188851,0.229936,28079.310863,0.119048,0.000911
9307173,9307173,,1,6,7,1,6,7,0.000002,0.000166,0,7367,26,0.000011,1,1,1,0.963492,0.119048,0.000246
9404136,9404136,,5,4,9,5,4,9,0.000006,0.000024,0,3601,26,0.000015,4,0.526316,0.658333,63.380159,0.166667,0.001237
9405080,9405080,,7,10,17,7,10,17,0.000013,0.000005,0,5083,4,0.000018,5,0.467532,0.577315,19123.262094,0.110294,0.001731
9606117,9606117,,7,14,21,7,14,21,0.000247,0.000089,0,7366,26,0.000016,9,0.201026,0.248818,1093.590369,0.159524,0.001627
9607013,9607013,,2,10,12,2,10,12,0.000002,0.000031,0,7363,26,0.000014,9,0.210667,0.256846,2377.938228,0.128788,0.000465
3120,3120,,18,11,29,18,11,29,0.002586,0.017933,0,13089,1,0.000041,11,0.222509,0.252947,90559.781115,0.130542,0.004256
3121,3121,,8,14,22,8,14,22,0.000336,0.003617,0,13090,2,0.000015,12,0.212117,0.234925,6834.236747,0.123377,0.002149
9908153,9908153,,5,24,29,5,24,29,0.001351,0.016729,0,12154,2,0.000013,19,0.194556,0.224205,68487.362351,0.173645,0.002014
9906044,9906044,,1,76,77,1,76,77,0.000227,0.037479,0,10222,2,0.00001,11,0.242802,0.283649,737.559092,0.110902,0.000275
9906137,9906137,,2,14,16,2,14,16,0.000351,0.021628,0,10221,1,0.00001,11,0.229543,0.260321,1640.324539,0.295833,0.000544
3122,3122,,79,43,122,79,43,122,0.003754,0.007694,0,12216,3,0.000062,12,0.23465,0.26642,160048.108966,0.098225,0.034779
9909214,9909214,,41,20,61,41,20,61,0.002724,0.005416,0,12215,30,0.000033,12,0.221916,0.250776,46879.925173,0.122131,0.016558
9610060,9610060,,4,5,9,4,5,9,0.000349,0.000271,0,3322,13,0.000015,13,0.169836,0.191791,10602.684403,0.180556,0.001412
9612027,9612027,,5,10,15,5,10,15,0.000521,0.003415,0,3316,2,0.000016,11,0.202786,0.23129,29127.859245,0.138095,0.002349
3123,3123,,6,15,21,6,15,21,0.000704,0.0174,0,13097,1,0.000014,11,0.230873,0.25994,24049.743617,0.183333,0.001923
9811108,9811108,,11,3,14,11,3,14,0.000238,0.002329,0,13096,28,0.000036,15,0.172222,0.193508,11417.395311,0.082418,0.002564
9910188,9910188,,17,20,37,17,20,37,0.000746,0.000819,0,13095,3,0.000036,13,0.18866,0.207211,125652.618809,0.046547,0.004315
9211139,9211139,,6,0,6,6,0,6,0.00003,0,0,3256,3,0.000025,0,0,0,0,0.066667,0.002409
9304131,9304131,,18,0,18,18,0,18,0.000877,0,0,6535,3,0.000066,0,0,0,0,0.091503,0.004431
9412132,9412132,,13,3,16,13,3,16,0.000724,0.000012,0,11293,3,0.000046,2,0.666667,0.75,7210.772961,0.108333,0.003325
9509142,9509142,,18,2,20,18,2,20,0.000125,0,0,1614,0,0.000089,2,0.666667,0.75,22982.329001,0.052632,0.004987
9610152,9610152,,4,6,10,4,6,10,0.000012,0.00002,0,13094,3,0.000015,9,0.202833,0.227572,3200.198631,0.2,0.001084
9701171,9701171,,10,4,14,10,4,14,0.000281,0.000134,0,12847,3,0.000026,12,0.152468,0.198123,3407.47176,0.104396,0.002602
9702141,9702141,,3,2,5,3,2,5,0.000011,0.000019,0,13093,3,0.000014,3,0.466667,0.571429,0,0.45,0.000858
9710249,9710249,,6,5,11,6,5,11,0.000169,0.000212,0,13091,3,0.000017,12,0.197857,0.219903,13332.328054,0.145455,0.001517
9804012,9804012,,4,8,12,4,8,12,0.000015,0.00018,0,13092,3,0.000015,13,0.174805,0.197285,4588.131508,0.121212,0.001057
3124,3124,,28,28,56,28,28,56,0.001595,0.002512,0,12856,3,0.000027,12,0.199231,0.222212,20555.723195,0.157468,0.011755
9304006,9304006,,2,0,2,2,0,2,0.000001,0,0,1413,3,0.00002,0,0,0,0,0.5,0.000575
3125,3125,,1,3,4,1,3,4,0.000061,0.000073,0,13098,4,0.00001,7,0.2176,0.250805,0,0.5,0.000219
9412208,9412208,,11,1,12,11,1,12,0.000597,0.000058,0,6019,4,0.000037,7,0.215088,0.239623,36.674671,0.159091,0.002769
9602088,9602088,,10,3,13,10,3,13,0.000607,0.00011,0,6020,4,0.000026,7,0.217042,0.250194,65.16231,0.179487,0.002507
3126,3126,,0,2,2,0,2,2,0,0,0,13099,22,0.00001,12,0.157699,0.183377,0,0.5,0
3127,3127,,1,6,7,1,6,7,0.000068,0.000003,0,13112,22,0.00001,5,0.394366,0.515476,4.616667,0.285714,0.000232
9308027,9308027,,28,1,29,28,1,29,0.000003,0,0,7120,21,0.000147,1,1,1,345.271007,0.034483,0.006627
9609083,9609083,,4,1,5,4,1,5,0,0,0,13106,22,0.000018,1,1,1,0.25,0.45,0.000963
9612068,9612068,,5,6,11,5,6,11,0,0.000001,0,13108,22,0.000019,4,0.45,0.587963,2399.889391,0.154545,0.001203
9707227,9707227,,6,5,11,6,5,11,0.000077,0.000002,0,13110,22,0.000018,5,0.392857,0.512879,52.188034,0.154545,0.001367
9902175,9902175,,4,6,10,4,6,10,0.000069,0.000002,0,13109,22,0.000014,5,0.4,0.535606,23.083333,0.2,0.000916
9903106,9903106,,3,9,12,3,9,12,0.000068,0.000014,0,13111,22,0.000013,5,0.435484,0.584568,25.083333,0.174242,0.000677
9206113,9206113,,4,0,4,4,0,4,0,0,0,5377,21,0.000154,0,0,0,0,0.083333,0.00113
9501085,9501085,,6,0,6,6,0,6,0,0,0,13105,22,0.000041,0,0,0,0,0.2,0.001429
9402100,9402100,,2,0,2,2,0,2,0,0,0,8207,22,0.000014,0,0,0,0,0,0.000486
9507016,9507016,,10,2,12,10,2,12,0.00006,0.000002,0,13103,22,0.000068,3,0.5,0.633333,2811.65995,0.121212,0.002537
9512020,9512020,,4,0,4,4,0,4,0,0,0,13107,22,0.000022,0,0,0,0,0.166667,0.000965
9705049,9705049,,7,1,8,7,1,8,0.000069,0.000001,0,13104,22,0.000035,4,0.375,0.472222,13.8,0.160714,0.001628
3128,3128,,12,10,22,12,10,22,0.000024,0.000005,0,13123,23,0.000023,14,0.14278,0.173004,1521.905067,0.227273,0.002876
9412136,9412136,,19,1,20,19,1,20,0.000214,0,0,4504,23,0.000089,1,1,1,10872.332279,0.184211,0.005389
9503204,9503204,,11,4,15,11,4,15,0.000013,0.000001,0,13115,23,0.000033,3,0.636364,0.761905,2432.037454,0.185714,0.003008
9509028,9509028,,16,2,18,16,2,18,0.000031,0.000003,0,13117,23,0.000046,1,1,1,9.590909,0.189542,0.004206
9509159,9509159,,7,3,10,7,3,10,0.000012,0.000003,0,13120,23,0.000021,1,1,1,0.590909,0.377778,0.001895
9608110,9608110,,9,6,15,9,6,15,0.00001,0.000001,0,10196,23,0.000026,3,0.727273,0.854167,83.716667,0.185714,0.002411
9808040,9808040,,11,6,17,11,6,17,0.000022,0.000004,0,13119,23,0.000022,4,0.5,0.614035,13.734774,0.338235,0.002837
9902146,9902146,,9,10,19,9,10,19,0.000022,0.000004,0,13121,23,0.000018,13,0.161389,0.194641,1461.911254,0.277778,0.002303
9903121,9903121,,14,12,26,14,12,26,0.000089,0.00001,0,13122,23,0.000023,13,0.165833,0.211531,4716.89167,0.201538,0.003443
9502081,9502081,,4,2,6,4,2,6,0,0.000003,0,8384,23,0.000027,1,1,1,4.5,0.366667,0.001045
9502082,9502082,,2,2,4,2,2,4,0,0,0,13114,23,0.000019,2,0.75,0.833333,1149.844322,0.083333,0.000524
9711056,9711056,,14,4,18,14,4,18,0.000015,0.000003,0,13118,23,0.000029,4,0.529412,0.675926,35.324456,0.238562,0.003503
9408090,9408090,,7,0,7,7,0,7,0.000001,0,0,8890,23,0.000031,0,0,0,0,0.095238,0.001773
9810212,9810212,,4,14,18,4,14,18,0.00001,0.000047,0,13116,23,0.000016,12,0.189758,0.240256,9744.396301,0.071895,0.001103
3129,3129,,4,14,18,4,14,18,0.00093,0.019208,0,13124,1,0.000011,14,0.228182,0.2586,11788.376774,0.248366,0.001127
3130,3130,,5,5,10,5,5,10,0.000162,0.00006,0,13125,30,0.000014,13,0.1694,0.182558,6671.484521,0.166667,0.001349
3131,3131,,3,54,57,3,54,57,0.000143,0.007505,0,13059,30,0.000012,13,0.224412,0.253446,23416.044357,0.089599,0.00083
9904200,9904200,,2,6,8,2,6,8,0.000169,0.000394,0,13057,4,0.00001,15,0.167403,0.184212,271.006738,0.107143,0.000497
9211074,9211074,,3,0,3,3,0,3,0.000002,0,0,2866,6,0.000017,0,0,0,0,0,0.000706
9805102,9805102,,4,9,13,4,9,13,0.000013,0.001033,0,8271,26,0.000023,14,0.132966,0.149882,35580.249635,0.083333,0.001001
3132,3132,,0,4,4,0,4,4,0,0.002943,0,13126,2,0.00001,12,0.210925,0.242076,0,0.25,0
3133,3133,,1,9,10,1,9,10,0.000001,0.000055,0,13128,25,0.000012,8,0.244969,0.277124,1108.817622,0.055556,0.000279
9501045,9501045,,2,14,16,2,14,16,0.000002,0.000095,0,6512,5,0.000012,8,0.300184,0.379886,417.074104,0.133333,0.000453
9504109,9504109,,1,9,10,1,9,10,0.000001,0.000061,0,13127,5,0.000011,2,0.666667,0.75,58.699927,0.133333,0.000227
9705224,9705224,,10,0,10,10,0,10,0.00009,0,0,9403,25,0.000033,0,0,0,0,0.155556,0.002497
9411020,9411020,,12,46,58,12,46,58,0.000476,0.001392,0,1011,5,0.000024,7,0.409091,0.552587,110245.301251,0.073503,0.003635
9202035,9202035,,9,0,9,9,0,9,0.00001,0,0,991,5,0.000047,0,0,0,0,0.111111,0.002749
9207108,9207108,,6,0,6,6,0,6,0.000008,0,0,257,5,0.000039,0,0,0,0,0,0.001951
9307140,9307140,,3,6,9,3,6,9,0.00001,0.000189,0,989,5,0.00002,3,0.575758,0.649123,385.54668,0.138889,0.001148
9405119,9405119,,19,5,24,19,5,24,0.000239,0.000012,0,5294,5,0.000052,3,0.588235,0.716667,9290.619694,0.103261,0.005188
3134,3134,,3,1,4,3,1,4,0,0,0,13129,23,0.000023,4,0.354839,0.409091,53.666667,0.25,0.00069
9811235,9811235,,6,2,8,6,2,8,0.000026,0,0,12734,22,0.000045,3,0.5,0.566667,2169.845461,0.107143,0.001428
9405166,9405166,,15,1,16,15,1,16,0.000005,0,0,4639,22,0.000099,1,1,1,30.799027,0.141667,0.003707
9608025,9608025,,2,7,9,2,7,9,0,0.000003,0,12733,22,0.000037,2,0.818182,0.888889,1321.307319,0.222222,0.000499
3135,3135,,3,9,12,3,9,12,0.000001,0.000014,0,13133,23,0.000013,17,0.14686,0.167637,5746.850709,0.174242,0.00069
9710162,9710162,,7,7,14,7,7,14,0.000004,0.000017,0,13130,23,0.000014,12,0.197611,0.245116,349.774163,0.236264,0.001647
9805030,9805030,,6,7,13,6,7,13,0.000006,0.000019,0,13132,23,0.000014,13,0.182988,0.235219,987.318293,0.173077,0.001408
9807210,9807210,,5,19,24,5,19,24,0.000001,0.000041,0,13131,23,0.000014,16,0.15654,0.187062,9493.799695,0.201087,0.001155
9204045,9204045,,11,0,11,11,0,11,0.000021,0,0,6605,23,0.000056,0,0,0,0,0.090909,0.002965
9711191,9711191,,10,6,16,10,6,16,0.000361,0.000012,0,6606,23,0.000021,8,0.202935,0.232232,12231.409922,0.075,0.002613
9804013,9804013,,8,10,18,8,10,18,0.000002,0.000015,0,11032,23,0.000035,11,0.186278,0.229361,5913.135404,0.120915,0.001974
9909213,9909213,,6,18,24,6,18,24,0.00184,0.007257,0,11584,2,0.000014,19,0.181818,0.207762,44325.769161,0.186594,0.004105
9910250,9910250,,2,18,20,2,18,20,0.00079,0.004687,0,11582,4,0.000012,14,0.191318,0.216411,3479.13738,0.134211,0.00224
9409099,9409099,,3,10,13,3,10,13,0.000185,0.000276,0,3561,0,0.000014,6,0.289583,0.36235,5015.753765,0.115385,0.001167
9611097,9611097,,12,9,21,12,9,21,0.000823,0.000674,0,4012,4,0.000015,11,0.184116,0.20635,120.12316,0.27619,0.003933
9701045,9701045,,10,33,43,10,33,43,0.000582,0.004431,0,4019,4,0.000013,13,0.185221,0.2189,12117.959959,0.219823,0.003299
9706076,9706076,,9,35,44,9,35,44,0.00071,0.004404,0,4856,4,0.000013,12,0.220875,0.258987,14347.650376,0.197146,0.00287
9802092,9802092,,9,15,24,9,15,24,0.000219,0.000628,0,6366,4,0.000016,14,0.185512,0.213778,54392.622587,0.130435,0.002444
9807203,9807203,,6,10,16,6,10,16,0.000391,0.000555,0,9414,25,0.000015,15,0.178128,0.202935,929.604487,0.383333,0.002274
9807207,9807207,,3,8,11,3,8,11,0.000096,0.000498,0,9423,25,0.000012,14,0.18011,0.201191,437.667585,0.336364,0.000913
9812010,9812010,,2,7,9,2,7,9,0.000075,0.002473,0,9409,25,0.000012,15,0.180747,0.211646,1171.732773,0.180556,0.000807
3137,3137,,30,24,54,30,24,54,0.001182,0.001311,0,12171,30,0.000025,13,0.193042,0.211625,8625.669764,0.173655,0.010057
3138,3138,,7,4,11,7,4,11,0.000001,0.000008,0,13135,23,0.000031,15,0.144935,0.160937,7887.179165,0.081818,0.001614
9910101,9910101,,8,3,11,8,3,11,0.000022,0.000052,0,13134,23,0.000034,14,0.164252,0.183121,21269.580385,0.154545,0.001866
9401051,9401051,,1,0,1,1,0,1,0,0,0,4772,23,0.000011,0,0,0,0,0,0.000285
9504130,9504130,,32,1,33,32,1,33,0.000149,0.000003,0,4746,23,0.000083,2,0.666667,0.75,4.423918,0.09375,0.008557
9507152,9507152,,4,0,4,4,0,4,0.000001,0,0,4770,23,0.000028,0,0,0,0,0.333333,0.000996
9512101,9512101,,5,2,7,5,2,7,0.000001,0.000004,0,4771,23,0.000024,7,0.200348,0.226315,295.161346,0.166667,0.001182
9604149,9604149,,3,4,7,3,4,7,0.000005,0.000006,0,4769,28,0.000014,5,0.393443,0.480556,4.666667,0.404762,0.00083
9605116,9605116,,5,1,6,5,1,6,0.000002,0,0,4768,23,0.000039,1,1,1,1582.575596,0.166667,0.001265
9608072,9608072,,1,6,7,1,6,7,0,0.00001,0,4727,23,0.000011,6,0.242063,0.328142,21497.935165,0.095238,0.000285
3140,3140,,4,4,8,4,4,8,0,0.000003,0,13136,6,0.00002,15,0.129882,0.150779,60.864358,0.160714,0.000936
9808145,9808145,,1,5,6,1,5,6,0,0,0,9816,20,0.000019,1,1,1,540.896886,0.166667,0.000269
3141,3141,,3,9,12,3,9,12,0.000029,0.000238,0,13137,23,0.000013,14,0.172482,0.186873,13151.200141,0.098485,0.000738
9305014,9305014,,5,0,5,5,0,5,0.000003,0,0,7012,26,0.000025,0,0,0,0,0.1,0.001186
9206005,9206005,,3,0,3,3,0,3,0,0,0,533,26,0.000047,0,0,0,0,0,0.000788
9210069,9210069,,9,0,9,9,0,9,0.000014,0,0,7010,26,0.000129,0,0,0,0,0.138889,0.002334
3142,3142,,10,12,22,10,12,22,0.001202,0.017552,0,13138,4,0.000018,15,0.192731,0.222056,4072.027025,0.205628,0.00296
3143,3143,,6,11,17,6,11,17,0.000001,0.000003,0,13141,5,0.000015,14,0.153441,0.167592,33752.250608,0.176471,0.001388
9710183,9710183,,6,1,7,6,1,7,0.000015,0,0,9272,5,0.000021,1,1,1,273.147322,0.095238,0.001497
9811164,9811164,,5,3,8,5,3,8,0.000001,0.000002,0,9519,5,0.000016,4,0.392523,0.440476,13006.804341,0.25,0.001254
9907076,9907076,,9,9,18,9,9,18,0.000058,0.000054,0,13140,5,0.000023,13,0.180215,0.201203,61764.734448,0.101307,0.002302
9501064,9501064,,4,0,4,4,0,4,0,0,0,5626,5,0.000037,0,0,0,0,0.25,0.001512
9502015,9502015,,12,8,20,12,8,20,0.000031,0.000001,0,5629,5,0.000083,1,1,1,24651.227704,0.078947,0.003731
9508088,9508088,,14,6,20,14,6,20,0.000001,0.000002,0,5634,5,0.000072,2,0.615385,0.6875,10503.309572,0.136842,0.004
9605026,9605026,,6,3,9,6,3,9,0.000001,0.000002,0,5642,5,0.000033,3,0.6,0.722222,3200.364287,0.125,0.001965
9602113,9602113,,6,3,9,6,3,9,0.000006,0.000001,0,5644,5,0.000023,9,0.171988,0.195174,24619.505371,0.041667,0.001605
9608189,9608189,,3,11,14,3,11,14,0.000003,0.000003,0,5647,5,0.000015,9,0.193788,0.232749,77776.638322,0.120879,0.000867
9604143,9604143,,16,0,16,16,0,16,0,0,0,9265,5,0.000104,0,0,0,0,0.041667,0.003709
9501122,9501122,,4,0,4,4,0,4,0.000001,0,0,9225,5,0.00003,0,0,0,0,0.083333,0.001228
9709084,9709084,,4,2,6,4,2,6,0,0,0,9224,5,0.000038,3,0.538462,0.619048,1789.045289,0.133333,0.001248
9809081,9809081,,7,6,13,7,6,13,0.000001,0.000001,0,9271,5,0.000021,10,0.169251,0.202177,3612.054364,0.102564,0.001678
9712019,9712019,,4,8,12,4,8,12,0.000001,0.000003,0,13139,5,0.000017,3,0.615385,0.729167,3224.552789,0.098485,0.000972
9802010,9802010,,15,55,70,15,55,70,0.000746,0.003093,0,8161,5,0.000028,13,0.204453,0.244278,130532.827595,0.087164,0.003769
3144,3144,,17,9,26,17,9,26,0.000005,0.000019,0,13147,5,0.000041,13,0.141281,0.1787,4259.824439,0.163077,0.004256
9610054,9610054,,4,2,6,4,2,6,0.000002,0.000001,0,13146,26,0.000017,3,0.458333,0.530303,814.637849,0.266667,0.001001
9912283,9912283,,11,4,15,11,4,15,0.000035,0.000008,0,13142,5,0.000031,8,0.180501,0.214216,30.273918,0.219048,0.002796
9404143,9404143,,3,5,8,3,5,8,0.000002,0.000003,0,13145,26,0.00002,2,0.692308,0.777778,680.514593,0.035714,0.000692
9408120,9408120,,9,0,9,9,0,9,0.000074,0,0,12990,26,0.000042,0,0,0,0,0.208333,0.003061
3145,3145,,53,29,82,53,29,82,0.003662,0.020355,0,12165,30,0.000056,13,0.207161,0.231497,71257.963593,0.148148,0.026523
9706115,9706115,,2,20,22,2,20,22,0.000269,0.005589,0,5779,2,0.000017,13,0.195334,0.231084,24328.671917,0.121212,0.001337
9905043,9905043,,7,4,11,7,4,11,0.000543,0.000022,0,9864,3,0.000015,12,0.168059,0.182701,8169.992018,0.145455,0.002389
9604037,9604037,,4,10,14,4,10,14,0.000222,0.006197,0,3761,2,0.000012,13,0.181604,0.222754,1358.192896,0.126374,0.001526
9703066,9703066,,3,13,16,3,13,16,0.000183,0.001863,0,5778,2,0.000011,11,0.206696,0.235771,7420.826029,0.1125,0.000696
9712220,9712220,,4,18,22,4,18,22,0.000068,0.000003,0,6805,6,0.000019,10,0.227171,0.303085,405460.997088,0.095238,0.001873
9805119,9805119,,4,0,4,4,0,4,0.000022,0,0,9105,3,0.000017,0,0,0,0,0.083333,0.001184
3146,3146,,3,13,16,3,13,16,0.000044,0.000081,0,13151,22,0.000025,14,0.160114,0.172449,81168.778335,0.041667,0.000783
9807211,9807211,,5,0,5,5,0,5,0.000001,0,0,13150,21,0.000019,0,0,0,0,0.05,0.001123
9811229,9811229,,2,13,15,2,13,15,0.000012,0.000003,0,13149,22,0.000012,7,0.286689,0.410828,4864.984206,0.07619,0.000466
9908028,9908028,,8,12,20,8,12,20,0.000366,0.000032,0,13148,3,0.000021,13,0.176438,0.197723,11687.15071,0.105263,0.002007
9601065,9601065,,4,1,5,4,1,5,0,0,0,3719,22,0.000024,1,1,1,0,0.4,0.001017
9510002,9510002,,6,2,8,6,2,8,0,0,0,3725,22,0.000026,2,0.75,0.833333,32819.959348,0.107143,0.001475
9803221,9803221,,9,6,15,9,6,15,0.000024,0.000013,0,10291,22,0.000023,6,0.277457,0.364931,1023.494102,0.166667,0.002379
9905219,9905219,,6,15,21,6,15,21,0.00097,0.017674,0,10529,1,0.000017,14,0.195245,0.220668,1593.340565,0.197619,0.001695
3149,3149,,1,2,3,1,2,3,0,0,3,13154,14,0.000013,1,1,1,0,0.333333,0.000219
9912034,9912034,,2,0,2,2,0,2,0,0,3,13153,14,0.000019,0,0,0,0,0.5,0.000445
9912046,9912046,,2,0,2,2,0,2,0,0,3,13152,14,0.000019,0,0,0,0,0.5,0.000445
3150,3150,,1,2,3,1,2,3,0.000339,0.000003,0,13156,4,0.00001,14,0.154747,0.169358,4.302632,0,0.000226
9803075,9803075,,2,0,2,2,0,2,0.000004,0,0,13155,4,0.000019,0,0,0,0,0,0.000445
3151,3151,,15,20,35,15,20,35,0.002946,0.019292,0,13157,1,0.000016,12,0.210367,0.235027,7167.641677,0.17563,0.005399
3152,3152,,2,25,27,2,25,27,0.000145,0.003184,0,12275,0,0.000011,14,0.1853,0.211552,11280.436417,0.219373,0.000689
9205011,9205011,,18,0,18,18,0,18,0.000207,0,0,2673,0,0.000059,0,0,0,0,0.140523,0.005143
9404033,9404033,,3,4,7,3,4,7,0.000022,0.000113,0,8079,0,0.000014,2,0.7,0.785714,29.787438,0.095238,0.000813
9410023,9410023,,6,1,7,6,1,7,0.000085,0.000002,0,8075,0,0.000018,1,1,1,1.5,0.166667,0.001433
9606189,9606189,,2,13,15,2,13,15,0.000051,0.004431,0,8078,0,0.000012,10,0.197792,0.227521,17768.859615,0.07619,0.000529
3153,3153,,4,13,17,4,13,17,0.000028,0.001145,0,12322,25,0.000016,12,0.197327,0.218494,6020.77938,0.0625,0.000894
9406027,9406027,,12,4,16,12,4,16,0.00006,0.000011,0,3654,5,0.000027,2,0.7,0.785714,3645.11367,0.0625,0.002919
9610006,9610006,,6,4,10,6,4,10,0.000015,0.00001,0,12085,20,0.000029,10,0.197064,0.222979,6551.365359,0.055556,0.001448
9612135,9612135,,3,0,3,3,0,3,0.000028,0,0,12320,25,0.000013,0,0,0,0,0.166667,0.000727
9906004,9906004,,6,4,10,6,4,10,0.000049,0.010615,0,12319,0,0.000025,14,0.20292,0.232701,10452.676365,0.055556,0.00148
9909106,9909106,,8,0,8,8,0,8,0.000048,0,0,12321,5,0.000021,0,0,0,0,0.071429,0.001832
9211008,9211008,,6,0,6,6,0,6,0.000003,0,0,3652,5,0.000025,0,0,0,0,0.2,0.001485
9604076,9604076,,2,0,2,2,0,2,0.00004,0,0,12084,20,0.000017,0,0,0,0,0,0.000486
9402154,9402154,,8,4,12,8,4,12,0.000008,0.000023,0,3648,5,0.000034,2,0.75,0.833333,1647.59843,0.121212,0.002048
3154,3154,,2,11,13,2,11,13,0.000003,0.000548,0,13162,28,0.000012,12,0.201019,0.221156,11662.335349,0.070513,0.000465
9404098,9404098,,17,3,20,17,3,20,0.000143,0.000014,0,1597,28,0.000039,3,0.470588,0.604167,10314.580722,0.071053,0.004122
9504077,9504077,,5,6,11,5,6,11,0.000036,0.000023,0,9660,28,0.000015,5,0.378571,0.444025,1764.395948,0.054545,0.001174
9602038,9602038,,2,4,6,2,4,6,0.000007,0.000021,0,13159,28,0.000012,12,0.184356,0.210311,264.965957,0.166667,0.000458
9604186,9604186,,4,9,13,4,9,13,0.000013,0.000536,0,9662,28,0.000015,7,0.29735,0.343737,18428.544093,0.083333,0.000969
9608131,9608131,,1,9,10,1,9,10,0.000006,0.000027,0,13161,28,0.000011,12,0.18855,0.220195,224.181006,0.088889,0.000232
9412032,9412032,,5,1,6,5,1,6,0.000013,0.000002,0,1595,28,0.000022,1,1,1,15.454029,0.166667,0.001233
9504007,9504007,,4,12,16,4,12,16,0.000061,0.00066,0,13158,41,0.000014,4,0.4,0.470528,490.674708,0.070833,0.000937
9406062,9406062,,3,1,4,3,1,4,0.000008,0,0,9661,28,0.000016,1,1,1,292.01406,0.166667,0.000757
9502073,9502073,,6,6,12,6,6,12,0.00001,0.000057,0,9318,28,0.000017,7,0.241176,0.286852,1672.206062,0.227273,0.001402
9302091,9302091,,9,4,13,9,4,13,0.000038,0.000011,0,1799,28,0.000034,1,1,1,17514.763638,0.064103,0.002545
9601173,9601173,,1,9,10,1,9,10,0,0.00006,0,13160,28,0.000011,8,0.218239,0.269898,104.636525,0.177778,0.000226
9311032,9311032,,2,0,2,2,0,2,0,0,0,10862,52,0.000023,0,0,0,0,0,0.000529
9709173,9709173,,10,2,12,10,2,12,0.000001,0.000001,0,10861,52,0.00004,1,1,1,5986.386765,0.227273,0.002361
3155,3155,,7,3,10,7,3,10,0.000128,0.000349,0,13164,4,0.000015,10,0.198027,0.225097,27.039557,0.166667,0.00166
9906093,9906093,,8,1,9,8,1,9,0.000124,0.000076,0,13163,4,0.000021,10,0.197418,0.221755,60.230758,0.166667,0.001939
3156,3156,,1,18,19,1,18,19,0.000038,0.001413,0,13168,4,0.00001,14,0.174625,0.200986,303.070948,0.149123,0.000232
9712245,9712245,,1,8,9,1,8,9,0.000017,0.000182,0,13167,4,0.00001,12,0.173666,0.199784,82.727579,0.222222,0.000226
9912141,9912141,,2,6,8,2,6,8,0.000017,0,0,13165,20,0.000011,17,0.135089,0.148301,562.374628,0.232143,0.000472
9604112,9604112,,11,26,37,11,26,37,0.00036,0.001087,0,4407,0,0.000018,10,0.226093,0.268385,5851.925605,0.127628,0.002912
9712219,9712219,,1,2,3,1,2,3,0.000002,0.000008,0,13166,4,0.000011,12,0.157472,0.172416,0,0.5,0.000226
9305054,9305054,,11,0,11,11,0,11,0.00011,0,0,2496,23,0.000059,0,0,0,0,0.009091,0.0026
9310045,9310045,,1,0,1,1,0,1,0.000109,0,0,12067,4,0.000011,0,0,0,0,0,0.000293
3157,3157,,2,12,14,2,12,14,0.000021,0.000993,0,13169,13,0.000011,12,0.181873,0.201594,5464.263945,0.197802,0.000561
3158,3158,,2,5,7,2,5,7,0.000015,0.000018,0,13172,5,0.000012,14,0.158136,0.172571,71609.363111,0.142857,0.000492
9904193,9904193,,2,2,4,2,2,4,0,0.000015,0,13171,5,0.000014,1,1,1,1877.625689,0,0.000459
9803009,9803009,,3,0,3,3,0,3,0.000382,0,0,13170,4,0.000016,0,0,0,0,0,0.000711
3159,3159,,1,16,17,1,16,17,0,0.000004,0,13173,17,0.00001,12,0.148373,0.186076,6.132488,0.231618,0.000219
9209083,9209083,,10,0,10,10,0,10,0.000144,0,0,705,4,0.000045,0,0,0,0,0.077778,0.003107
4147,4147,,84,77,161,84,77,161,0.005167,0.008274,0,12865,30,0.000066,12,0.219287,0.248737,185305.626536,0.076087,0.030447
3176,3176,,39,31,70,39,31,70,0.002125,0.002265,0,12172,30,0.000032,13,0.201522,0.223787,31659.284276,0.186128,0.016074
3180,3180,,55,47,102,55,47,102,0.003941,0.00388,0,12169,30,0.000051,14,0.20711,0.232377,243498.474109,0.125413,0.025833
3215,3215,,51,43,94,51,43,94,0.00372,0.00547,0,12173,30,0.000049,14,0.21022,0.236553,64591.916858,0.151567,0.023417
3227,3227,,28,21,49,28,21,49,0.002187,0.004001,0,12174,30,0.000026,15,0.201153,0.223824,23613.820888,0.176871,0.013702
4013,4013,,45,36,81,45,36,81,0.002676,0.005061,0,12175,30,0.000044,14,0.202907,0.22564,41456.366479,0.159414,0.018557
4038,4038,,27,43,70,27,43,70,0.002316,0.024237,0,12187,30,0.000023,15,0.217317,0.244955,38756.306409,0.146791,0.01013
4072,4072,,30,20,50,30,20,50,0.003052,0.004983,0,12398,2,0.000028,14,0.215968,0.243048,51520.348529,0.089796,0.011416
4074,4074,,42,49,91,42,49,91,0.00357,0.018981,0,12159,2,0.000058,14,0.222774,0.254052,432921.837901,0.057143,0.017219
4080,4080,,25,31,56,25,31,56,0.001838,0.00335,0,12177,30,0.000022,15,0.214048,0.238634,29316.239117,0.201299,0.011029
4085,4085,,16,43,59,16,43,59,0.001245,0.004422,0,12179,30,0.000017,14,0.212834,0.237726,14359.551522,0.232613,0.007098
9805077,9805077,,4,1,5,4,1,5,0.000099,0.000031,0,12864,30,0.000015,1,1,1,0.174963,0.2,0.001616
9912130,9912130,,18,21,39,18,21,39,0.001052,0.005513,0,12863,30,0.000018,13,0.202801,0.225277,10231.659392,0.167341,0.006211
9912272,9912272,,10,44,54,10,44,54,0.00072,0.010806,0,12862,30,0.000015,13,0.216553,0.248464,20726.616156,0.148847,0.004074
3161,3161,,9,21,30,9,21,30,0.00161,0.009935,0,12157,2,0.000014,13,0.191173,0.218175,8095.166717,0.252874,0.002971
9901034,9901034,,6,8,14,6,8,14,0.001055,0.016996,0,7760,2,0.000012,14,0.180776,0.203253,181.48257,0.357143,0.00177
9904042,9904042,,6,22,28,6,22,28,0.001335,0.011261,0,11091,2,0.000012,13,0.192612,0.220035,442.842665,0.27381,0.001981
3163,3163,,3,18,21,3,18,21,0.000324,0.015719,0,13174,1,0.000012,12,0.198552,0.221033,1603.452373,0.197619,0.000671
9812199,9812199,,2,1,3,2,1,3,0.000368,0,0,8441,1,0.000012,1,1,1,8004,0.166667,0.00065
9303030,9303030,,28,2,30,28,2,30,0.00012,0.000007,0,1464,22,0.000074,1,1,1,1797.07286,0.08046,0.007311
9310181,9310181,,32,8,40,32,8,40,0.000017,0.000019,0,1469,22,0.000081,2,0.9,0.944444,23615.510788,0.112179,0.008558
9709059,9709059,,1,0,1,1,0,1,0,0,0,8440,1,0.000021,0,0,0,0,0,0.000235
9908045,9908045,,1,10,11,1,10,11,0.000207,0.001118,0,11015,41,0.00001,13,0.197997,0.223058,2612.128981,0.190909,0.000293
3164,3164,,0,7,7,0,7,7,0,0.00005,0,13175,0,0.00001,15,0.175754,0.198746,0,0.190476,0
9805058,9805058,,3,38,41,3,38,41,0.000008,0.026191,0,12964,0,0.000013,14,0.212716,0.256217,13309.644759,0.089634,0.000727
3165,3165,,0,6,6,0,6,6,0,0.000046,0,13176,0,0.00001,15,0.175748,0.198658,0,0.233333,0
3166,3166,,9,18,27,9,18,27,0.000255,0.000589,0,12965,52,0.000013,15,0.192566,0.221641,8348.10011,0.206553,0.002816
3167,3167,,0,3,3,0,3,3,0,0,3,13177,14,0.00001,1,1,1,0,0.333333,0
3168,3168,,0,25,25,0,25,25,0,0.002611,0,13178,0,0.00001,15,0.180893,0.210133,0,0.28,0
3169,3169,,6,49,55,6,49,55,0.000783,0.004183,0,13180,2,0.000014,12,0.218745,0.25002,39700.306367,0.09899,0.001533
9912214,9912214,,10,13,23,10,13,23,0.000262,0.006466,0,13179,2,0.000017,15,0.178397,0.206983,8242.729379,0.160079,0.002514
9612059,9612059,,10,5,15,10,5,15,0.000166,0.000236,0,3395,2,0.000025,10,0.166133,0.191374,5999.423932,0.214286,0.003587
9605118,9605118,,5,11,16,5,11,16,0.000183,0.001597,0,2462,4,0.000022,11,0.205417,0.239448,8695.151655,0.125,0.001663
9603094,9603094,,5,14,19,5,14,19,0.000371,0.002728,0,6884,0,0.000014,9,0.219708,0.254868,3234.125945,0.114035,0.001335
9708053,9708053,,1,10,11,1,10,11,0.000041,0.000723,0,6840,2,0.00001,12,0.194372,0.219174,16.747531,0.290909,0.000327
9608118,9608118,,2,22,24,2,22,24,0.000193,0.010111,0,3420,2,0.000011,9,0.22359,0.264029,43.75983,0.25,0.000633
3170,3170,,1,6,7,1,6,7,0.000003,0.000016,0,13181,23,0.00001,18,0.137697,0.156981,9.752645,0.309524,0.000259
9910177,9910177,,7,11,18,7,11,18,0.000018,0.000037,0,12245,23,0.000022,17,0.159069,0.18759,16354.660674,0.202614,0.001709
9805199,9805199,,8,12,20,8,12,20,0.000014,0.000149,0,12243,0,0.000019,12,0.188683,0.213603,5816.919282,0.331579,0.002002
9811180,9811180,,12,7,19,12,7,19,0.000044,0.000139,0,12244,0,0.000021,12,0.17309,0.193881,6852.813488,0.239766,0.002917
3171,3171,,3,12,15,3,12,15,0.000309,0.000035,0,13182,28,0.000011,15,0.15234,0.164658,8094.924641,0.257143,0.000922
3173,3173,,17,16,33,17,16,33,0.002165,0.007977,0,12156,2,0.00002,14,0.221598,0.247815,46262.991835,0.125947,0.007053
9309115,9309115,,12,14,26,12,14,26,0.000516,0.000046,0,1956,5,0.000021,3,0.76,0.859649,26434.236837,0.026154,0.003159
9504091,9504091,,9,5,14,9,5,14,0.00075,0.000115,0,1957,5,0.000017,6,0.2893,0.319102,6348.890039,0.17033,0.002571
9603096,9603096,,2,8,10,2,8,10,0.000451,0.002796,0,6182,2,0.000011,10,0.21972,0.253565,1159.99747,0.188889,0.00083
3174,3174,,4,16,20,4,16,20,0.000183,0.002012,0,12115,25,0.000012,16,0.199648,0.222348,2402.076268,0.15,0.001128
3175,3175,,8,28,36,8,28,36,0.000987,0.007159,0,13185,0,0.000013,12,0.207713,0.233886,13371.843829,0.050794,0.002567
9702096,9702096,,2,0,2,2,0,2,0.000084,0,0,13184,0,0.000019,0,0,0,0,0,0.000501
9907225,9907225,,6,39,45,6,39,45,0.000252,0.002988,0,13183,4,0.000016,15,0.194062,0.223592,36280.972829,0.138889,0.001473
9510121,9510121,,7,0,7,7,0,7,0.00012,0,0,4059,4,0.000018,0,0,0,0,0.190476,0.001933
9608147,9608147,,8,15,23,8,15,23,0.00014,0.000441,0,3678,4,0.00002,11,0.17711,0.219633,22270.358564,0.294466,0.002643
9703159,9703159,,5,20,25,5,20,25,0.000088,0.000831,0,4056,4,0.000014,13,0.178772,0.205929,2947.506695,0.305,0.001402
9801007,9801007,,3,7,10,3,7,10,0.000059,0.000662,0,6358,4,0.000012,13,0.158936,0.197563,20.950451,0.344444,0.000826
9802125,9802125,,4,12,16,4,12,16,0.000098,0.000432,0,8088,4,0.000013,13,0.184786,0.213006,10186.191262,0.2,0.001171
9605119,9605119,,3,5,8,3,5,8,0.000067,0.000182,0,4060,4,0.000011,10,0.177629,0.215168,2388.066596,0.25,0.000843
3177,3177,,10,22,32,10,22,32,0.000062,0.00076,0,13186,13,0.000018,14,0.168522,0.200917,13463.954518,0.225806,0.002317
3178,3178,,6,10,16,6,10,16,0.000034,0.000128,0,13187,13,0.000013,15,0.164152,0.187451,1674.986589,0.225,0.001394
9201025,9201025,,6,0,6,6,0,6,0.00003,0,0,850,9,0.000064,0,0,0,0,0,0.001923
9203075,9203075,,3,0,3,3,0,3,0,0,0,848,9,0.000053,0,0,0,0,0,0.001219
9510103,9510103,,4,15,19,4,15,19,0.000029,0.000758,0,2810,13,0.000014,9,0.230878,0.288235,1018.628199,0.236842,0.00119
9706199,9706199,,7,18,25,7,18,25,0.00008,0.000289,0,5837,13,0.000013,15,0.169412,0.202363,10143.185769,0.315,0.001781
9707194,9707194,,5,29,34,5,29,34,0.000047,0.000898,0,5843,13,0.000012,15,0.170364,0.20935,6060.05016,0.277184,0.001272
9710037,9710037,,7,21,28,7,21,28,0.000062,0.000286,0,5839,13,0.000013,15,0.177867,0.210968,22815.526987,0.22619,0.001774
3179,3179,,7,26,33,7,26,33,0.001575,0.019132,0,13188,1,0.000014,15,0.204594,0.229899,17904.261185,0.147727,0.001836
9207097,9207097,,15,0,15,15,0,15,0.00004,0,0,706,17,0.000061,0,0,0,0,0.090476,0.004246
9403122,9403122,,2,3,5,2,3,5,0.000001,0.000069,0,1563,17,0.000014,2,0.8,0.875,75.492552,0.1,0.000617
9412120,9412120,,7,5,12,7,5,12,0.000009,0.000042,0,2786,17,0.000017,5,0.40678,0.515278,0.333333,0.409091,0.001799
9412212,9412212,,6,6,12,6,6,12,0.000075,0.000054,0,2785,17,0.000016,4,0.473684,0.597222,3236.210051,0.212121,0.001583
9501135,9501135,,9,4,13,9,4,13,0.000191,0.000031,0,2784,17,0.000018,2,0.75,0.833333,1012.052283,0.205128,0.002261
9404128,9404128,,7,1,8,7,1,8,0.000036,0.000003,0,5765,28,0.00002,1,1,1,0,0.357143,0.001733
9503040,9503040,,7,2,9,7,2,9,0.000026,0.000009,0,5764,28,0.000021,4,0.367089,0.413793,713.443125,0.361111,0.001713
9602026,9602026,,3,9,12,3,9,12,0.000002,0.000056,0,12161,28,0.000014,4,0.419355,0.521368,323.866882,0.234848,0.000714
9211078,9211078,,2,1,3,2,1,3,0.000021,0.000003,0,8992,28,0.000013,1,1,1,675.85022,0.166667,0.000544
3181,3181,,0,3,3,0,3,3,0,0.00006,0,13189,2,0.00001,16,0.135736,0.154225,0,0.5,0
9208048,9208048,,7,0,7,7,0,7,0.000006,0,0,2372,6,0.000039,0,0,0,0,0.047619,0.001797
9405095,9405095,,14,19,33,14,19,33,0.000022,0.000007,0,3185,9,0.000041,4,0.448485,0.557432,90210.956677,0.072917,0.003802
9406054,9406054,,9,3,12,9,3,12,0.000003,0.000001,0,3186,9,0.000027,5,0.317797,0.366222,6632.582249,0.151515,0.002413
9704068,9704068,,1,5,6,1,5,6,0.000001,0.000048,0,8915,2,0.000012,10,0.210798,0.239234,1411.807367,0.166667,0.00025
9704133,9704133,,1,9,10,1,9,10,0.000001,0.00007,0,8914,9,0.000012,14,0.164977,0.19347,63058.845081,0.2,0.00025
3182,3182,,0,6,6,0,6,6,0,0.0001,0,13190,2,0.00001,13,0.177122,0.199415,0,0.133333,0
3183,3183,,28,48,76,28,48,76,0.004342,0.016272,0,12912,1,0.000022,12,0.232849,0.267048,96958.792122,0.117193,0.010797
9912266,9912266,,24,29,53,24,29,53,0.003623,0.012452,0,11581,1,0.000032,11,0.234806,0.269689,55098.678734,0.102322,0.009939
9905094,9905094,,22,43,65,22,43,65,0.003456,0.013313,0,9866,13,0.000021,14,0.21184,0.254422,33394.741185,0.12524,0.00787
9911042,9911042,,34,13,47,34,13,47,0.004972,0.008499,0,11580,1,0.000031,14,0.206062,0.235952,19686.566473,0.091119,0.012475
3184,3184,,20,50,70,20,50,70,0.000628,0.003372,0,12330,9,0.000017,12,0.214615,0.241712,37235.925386,0.165631,0.005481
9511130,9511130,,5,2,7,5,2,7,0.000429,0.000004,0,2732,9,0.000018,1,1,1,23626.592899,0.166667,0.002248
9802102,9802102,,13,12,25,13,12,25,0.00069,0.000245,0,7723,9,0.000014,16,0.175468,0.199948,9466.821075,0.29,0.003781
9803071,9803071,,8,17,25,8,17,25,0.00013,0.000291,0,7720,9,0.000013,10,0.210093,0.240889,944.404567,0.293333,0.002391
9803092,9803092,,12,25,37,12,25,37,0.001005,0.000455,0,7106,9,0.000013,12,0.205765,0.236885,75923.34684,0.253754,0.003624
9808068,9808068,,8,8,16,8,8,16,0.000616,0.000257,0,7724,9,0.000012,14,0.167864,0.187249,3784.988211,0.3,0.002372
9902104,9902104,,5,16,21,5,16,21,0.00073,0.011345,0,7698,9,0.000011,13,0.188415,0.212412,18762.154054,0.207143,0.001659
9911163,9911163,,17,21,38,17,21,38,0.000818,0.016545,0,12328,9,0.000015,12,0.208061,0.233359,5050.059166,0.240398,0.004961
9305133,9305133,,14,0,14,14,0,14,0.00033,0,0,2731,8,0.000081,0,0,0,0,0.082418,0.003411
9307161,9307161,,6,0,6,6,0,6,0,0,0,1449,9,0.000031,0,0,0,0,0.066667,0.001487
9401124,9401124,,8,2,10,8,2,10,0.000958,0.000212,0,3057,9,0.000021,2,0.6,0.666667,583.694413,0.177778,0.002624
9605211,9605211,,14,9,23,14,9,23,0.000615,0.00009,0,3805,9,0.000049,11,0.20145,0.228199,124634.623506,0.073123,0.004007
9304081,9304081,,10,1,11,10,1,11,0.000196,0.000001,0,3290,52,0.000055,1,1,1,273.588977,0.1,0.00267
9608031,9608031,,5,2,7,5,2,7,0.000067,0.000435,0,7722,52,0.000014,6,0.240713,0.268827,78.740593,0.285714,0.001333
9604157,9604157,,3,7,10,3,7,10,0.000016,0.000004,0,7105,9,0.000012,3,0.592593,0.697917,9438.586929,0.211111,0.00079
9711155,9711155,,12,26,38,12,26,38,0.000359,0.000444,0,7694,9,0.000021,16,0.198536,0.235721,18847.997152,0.247511,0.003455
9607037,9607037,,16,8,24,16,8,24,0.00036,0.000006,0,3124,52,0.00003,4,0.482143,0.592593,115636.093703,0.099638,0.004528
9901043,9901043,,4,17,21,4,17,21,0.001288,0.014277,0,7710,1,0.000011,13,0.197389,0.223925,23882.592943,0.209524,0.00154
9903041,9903041,,1,14,15,1,14,15,0.000325,0.016439,0,7690,1,0.00001,12,0.187017,0.211811,2507.005073,0.242857,0.000424
3185,3185,,4,34,38,4,34,38,0.00047,0.002522,0,13191,0,0.000011,12,0.211061,0.241191,16031.881407,0.125178,0.001666
9209045,9209045,,10,1,11,10,1,11,0.000047,0,0,608,5,0.000219,1,1,1,4727.074382,0.127273,0.003175
9211049,9211049,,11,4,15,11,4,15,0.000079,0.000002,0,610,5,0.000179,2,0.833333,0.9,24880.494866,0.057143,0.00347
9310033,9310033,,5,3,8,5,3,8,0.00005,0.000001,0,611,5,0.000024,2,0.666667,0.75,3838.144783,0.125,0.001987
3186,3186,,0,4,4,0,4,4,0,0,0,13194,28,0.00001,3,0.529412,0.666667,0,0,0
9604028,9604028,,6,0,6,6,0,6,0.000005,0,0,13193,28,0.000022,0,0,0,0,0.033333,0.001409
9605056,9605056,,2,0,2,2,0,2,0,0,0,13192,28,0.000015,0,0,0,0,0,0.000438
9607124,9607124,,7,0,7,7,0,7,0,0,0,11359,28,0.000066,0,0,0,0,0.142857,0.001675
3187,3187,,81,65,146,81,65,146,0.004009,0.007591,0,12199,52,0.000055,15,0.231286,0.26622,540394.201402,0.056448,0.024425
9601169,9601169,,9,18,27,9,18,27,0.000227,0.000024,0,5484,30,0.000027,9,0.230139,0.280408,700349.980184,0.041311,0.003103
9310148,9310148,,5,0,5,5,0,5,0.000001,0,0,5396,30,0.000022,0,0,0,0,0.05,0.001225
9401136,9401136,,10,1,11,10,1,11,0.000026,0.000003,0,5483,30,0.000036,1,1,1,160.181567,0.045455,0.002412
9410199,9410199,,4,1,5,4,1,5,0.000004,0.00001,0,5482,30,0.000017,1,1,1,1.25,0.15,0.000957
9411127,9411127,,3,1,4,3,1,4,0,0.00001,0,5399,30,0.000017,1,1,1,0.75,0.25,0.000752
9502017,9502017,,1,4,5,1,4,5,0,0.000014,0,5481,30,0.000011,2,0.833333,0.9,395.36218,0.15,0.000293
9506171,9506171,,4,78,82,4,78,82,0.00001,0.001722,0,5480,15,0.000028,8,0.289338,0.385931,763259.190057,0.012195,0.001004
9506183,9506183,,3,3,6,3,3,6,0.000001,0,0,5400,30,0.000013,3,0.571429,0.666667,1142.863507,0.166667,0.000731
9511011,9511011,,1,1,2,1,1,2,0,0,0,5398,30,0.000011,4,0.375,0.416667,395.529092,0,0.000293
9601120,9601120,,2,3,5,2,3,5,0.000013,0,0,5397,30,0.000013,3,0.5,0.583333,136.773426,0.15,0.000528
9307012,9307012,,5,0,5,5,0,5,0.000221,0,0,9003,30,0.000021,0,0,0,0,0.05,0.002529
3188,3188,,29,4,33,29,4,33,0.000804,0.000021,0,13195,22,0.00004,18,0.124495,0.134119,4745.946316,0.113636,0.006881
3189,3189,,3,3,6,3,3,6,0,0,4,13199,16,0.000036,1,1,1,15,0.1,0.000677
9906135,9906135,,2,0,2,2,0,2,0,0,4,13197,16,0.00003,0,0,0,0,0.5,0.000465
9906136,9906136,,2,0,2,2,0,2,0,0,4,13196,16,0.00003,0,0,0,0,0.5,0.000465
9908210,9908210,,1,2,3,1,2,3,0,0,4,13198,16,0.000021,1,1,1,0,0.333333,0.000239
3190,3190,,1,134,135,1,134,135,0,0.004638,0,13242,52,0.000011,16,0.207303,0.259689,7274.173371,0.012548,0.000219
9210009,9210009,,16,0,16,16,0,16,0.000277,0,0,2532,6,0.000045,0,0,0,0,0.029167,0.004106
9211003,9211003,,13,0,13,13,0,13,0.000094,0,0,1866,4,0.000082,0,0,0,0,0.064103,0.003829
9212121,9212121,,3,0,3,3,0,3,0.000055,0,0,10023,22,0.000023,0,0,0,0,0,0.000703
9302068,9302068,,4,0,4,4,0,4,0.000128,0,0,3777,3,0.000025,0,0,0,0,0,0.001367
9304019,9304019,,4,1,5,4,1,5,0.000055,0,0,10657,9,0.000014,1,1,1,1,0.15,0.000931
9307110,9307110,,1,0,1,1,0,1,0.000054,0,0,13241,52,0.00001,0,0,0,0,0,0.000226
9307170,9307170,,9,3,12,9,3,12,0.000056,0.00001,0,1479,9,0.000021,3,0.555556,0.633333,23.933333,0.219697,0.002407
9311069,9311069,,5,0,5,5,0,5,0.000075,0,0,5465,22,0.000024,0,0,0,0,0.05,0.001136
9402091,9402091,,5,0,5,5,0,5,0.000083,0,0,5981,4,0.000026,0,0,0,0,0.25,0.001215
9403163,9403163,,5,6,11,5,6,11,0.000055,0.000007,0,6299,9,0.000018,4,0.465116,0.591667,16883.76968,0.090909,0.001266
9404012,9404012,,4,1,5,4,1,5,0.000086,0.000001,0,6337,4,0.000013,1,1,1,4633.651772,0.25,0.000976
9406196,9406196,,9,1,10,9,1,10,0.000055,0.000004,0,6498,15,0.000044,3,0.44,0.484848,7158.857821,0.066667,0.002202
9407154,9407154,,10,1,11,10,1,11,0.000058,0.000001,0,2801,4,0.00002,1,1,1,804.81454,0.109091,0.002393
9407186,9407186,,5,5,10,5,5,10,0.000081,0.000003,0,3836,52,0.000016,4,0.444444,0.567708,17718.796562,0.066667,0.001278
9412128,9412128,,15,9,24,15,9,24,0.00009,0.000002,0,2401,6,0.000035,3,0.652174,0.777778,48533.929818,0.067029,0.003762
9506198,9506198,,3,1,4,3,1,4,0.000055,0,0,13230,6,0.000013,2,0.571429,0.625,5.833333,0.166667,0.000691
9602074,9602074,,21,5,26,21,5,26,0.000088,0.000002,0,4074,6,0.000045,6,0.266881,0.337349,32184.93027,0.116923,0.005137
9606095,9606095,,9,7,16,9,7,16,0.000088,0.000003,0,4076,6,0.000017,7,0.225131,0.305759,3426.264005,0.183333,0.002119
9707159,9707159,,8,5,13,8,5,13,0.000079,0,0,11344,6,0.00002,10,0.193303,0.238694,9558.922117,0.064103,0.001893
9708114,9708114,,1,5,6,1,5,6,0.000054,0.000001,0,13240,6,0.00001,7,0.227068,0.279549,38.833333,0.133333,0.000226
9710002,9710002,,2,0,2,2,0,2,0.000073,0,0,13236,23,0.000011,0,0,0,0,0,0.000511
9710099,9710099,,9,10,19,9,10,19,0.000055,0.000004,0,13204,6,0.000018,9,0.174476,0.221765,1211.48645,0.152047,0.002045
9805216,9805216,,2,8,10,2,8,10,0.000055,0.000003,0,13235,6,0.000011,10,0.156646,0.202475,8.937302,0.222222,0.000458
9808144,9808144,,2,5,7,2,5,7,0.000055,0.000001,0,13234,26,0.000012,3,0.642857,0.759259,21.166667,0.166667,0.000445
9810184,9810184,,3,2,5,3,2,5,0.000055,0,0,13220,6,0.000016,13,0.174241,0.198562,1629.309652,0.1,0.000691
9903068,9903068,,12,29,41,12,29,41,0.00096,0.002715,0,10897,4,0.000012,12,0.20163,0.235549,7800.786007,0.195732,0.003283
9904082,9904082,,4,10,14,4,10,14,0.000055,0.000002,0,13231,6,0.000013,7,0.272727,0.341905,366.142124,0.076923,0.000923
9905214,9905214,,3,4,7,3,4,7,0.000087,0.000001,0,13229,6,0.000011,14,0.161493,0.184469,2472.778906,0.047619,0.000697
9906036,9906036,,9,10,19,9,10,19,0.000056,0.000007,0,13214,6,0.000019,9,0.197211,0.255288,1171.940501,0.061404,0.0021
9906185,9906185,,2,8,10,2,8,10,0.000055,0.000017,0,13213,9,0.000012,5,0.390805,0.513725,19,0.144444,0.000445
9907060,9907060,,9,17,26,9,17,26,0.00038,0.000081,0,13212,4,0.000014,16,0.159248,0.180112,4104.798861,0.058462,0.003138
9908176,9908176,,1,5,6,1,5,6,0.000054,0.000065,0,13211,52,0.00001,6,0.281849,0.324867,17.137869,0.233333,0.000226
9910156,9910156,,9,39,48,9,39,48,0.000274,0.002147,0,12286,9,0.000019,16,0.169955,0.192105,96436.60345,0.047429,0.002521
9910226,9910226,,3,29,32,3,29,32,0.000075,0.000026,0,13210,6,0.000012,12,0.182409,0.211991,3776.356466,0.058468,0.000678
9911030,9911030,,5,1,6,5,1,6,0.000055,0,0,13203,6,0.000046,8,0.186937,0.229762,260.291438,0.166667,0.001174
9911187,9911187,,3,3,6,3,3,6,0.000082,0.00001,0,13202,52,0.000011,1,1,1,1445.035014,0.066667,0.00086
9912084,9912084,,9,7,16,9,7,16,0.000084,0.000059,0,13200,52,0.000018,16,0.141145,0.154992,1397.077905,0.2875,0.002139
9206075,9206075,,14,0,14,14,0,14,0.000027,0,0,1483,9,0.000066,0,0,0,0,0.06044,0.003617
9204093,9204093,,1,0,1,1,0,1,0.000002,0,0,1222,4,0.00002,0,0,0,0,0,0.000978
9206090,9206090,,5,0,5,5,0,5,0.000008,0,0,1221,4,0.000026,0,0,0,0,0.15,0.001895
9210072,9210072,,4,1,5,4,1,5,0.000068,0.000017,0,1220,4,0.000022,1,1,1,0.501111,0.15,0.001686
9301004,9301004,,4,1,5,4,1,5,0.000003,0.000001,0,1219,4,0.000023,1,1,1,3.910714,0.1,0.00171
9303127,9303127,,9,4,13,9,4,13,0.000009,0.000007,0,1209,17,0.000039,2,0.833333,0.9,28578.364143,0.044872,0.002912
9212104,9212104,,11,1,12,11,1,12,0.000003,0,0,453,9,0.000042,1,1,1,16441.690732,0.219697,0.003235
9204098,9204098,,4,0,4,4,0,4,0,0,0,1486,9,0.000033,0,0,0,0,0,0.001097
9309146,9309146,,1,3,4,1,3,4,0,0.000001,0,6298,9,0.000013,2,0.714286,0.8,118.031237,0.166667,0.000254
9312016,9312016,,5,4,9,5,4,9,0.000002,0.00001,0,3167,9,0.00002,3,0.5,0.648148,464.735354,0.138889,0.001444
9307190,9307190,,9,5,14,9,5,14,0.000003,0.00001,0,1476,9,0.000028,4,0.421053,0.513889,6015.778237,0.21978,0.002633
9312049,9312049,,9,9,18,9,9,18,0.000002,0.00001,0,1478,9,0.000027,3,0.491525,0.597701,11311.890894,0.156863,0.002701
9402001,9402001,,11,2,13,11,2,13,0.000005,0.000011,0,1461,22,0.000036,1,1,1,577.650708,0.211538,0.003236
9209043,9209043,,12,0,12,12,0,12,0.000004,0,0,1730,52,0.000054,0,0,0,0,0.098485,0.003248
9301127,9301127,,3,1,4,3,1,4,0,0.000004,0,4665,52,0.000018,1,1,1,515.015148,0.166667,0.000844
9304106,9304106,,1,0,1,1,0,1,0,0,0,4664,52,0.000012,0,0,0,0,0,0.000314
9402027,9402027,,4,4,8,4,4,8,0.000015,0.000002,0,1731,52,0.000015,1,1,1,12168.572897,0.142857,0.001201
9403088,9403088,,6,0,6,6,0,6,0.000124,0,0,2318,52,0.000027,0,0,0,0,0.1,0.001523
9306118,9306118,,5,0,5,5,0,5,0.000015,0,0,3834,52,0.000026,0,0,0,0,0.15,0.001276
9402153,9402153,,3,2,5,3,2,5,0,0.000002,0,3833,52,0.000016,3,0.526316,0.583333,3602.264086,0.15,0.00072
9407013,9407013,,3,4,7,3,4,7,0.000015,0.000002,0,3835,52,0.000014,3,0.56,0.630952,2266.755344,0.190476,0.000753
9201049,9201049,,5,0,5,5,0,5,0.000486,0,0,1589,41,0.000022,0,0,0,0,0.3,0.002365
9204013,9204013,,4,0,4,4,0,4,0.000066,0,0,1588,17,0.000013,0,0,0,0,0.083333,0.001523
9208039,9208039,,3,0,3,3,0,3,0.000055,0,0,1587,41,0.000019,0,0,0,0,0.166667,0.001333
9309125,9309125,,5,14,19,5,14,19,0.000056,0.000006,0,460,9,0.00005,3,0.636364,0.738095,186927.006982,0.122807,0.002482
9311021,9311021,,1,8,9,1,8,9,0.000054,0.000002,0,1583,22,0.000011,2,0.9,0.944444,69683.931651,0.236111,0.000808
9401013,9401013,,1,0,1,1,0,1,0.000054,0,0,1573,5,0.000011,0,0,0,0,0,0.000808
9403086,9403086,,7,6,13,7,6,13,0.000114,0.000027,0,1338,9,0.000017,5,0.368421,0.437202,3542.370595,0.307692,0.002315
9407052,9407052,,7,1,8,7,1,8,0.000065,0.000001,0,1561,9,0.000019,5,0.284848,0.322695,16.084199,0.178571,0.002204
9408005,9408005,,5,5,10,5,5,10,0.000094,0.000068,0,1560,5,0.000019,4,0.331081,0.406463,51678.377294,0.088889,0.001928
9408007,9408007,,5,4,9,5,4,9,0.000106,0.00002,0,1556,9,0.000014,5,0.375,0.426543,12868.778835,0.222222,0.001746
9410164,9410164,,7,6,13,7,6,13,0.000149,0.000014,0,1553,4,0.000016,2,0.65,0.730769,60173.959311,0.070513,0.002245
9209009,9209009,,9,0,9,9,0,9,0.000002,0,0,1895,6,0.000035,0,0,0,0,0.041667,0.002189
9405058,9405058,,10,3,13,10,3,13,0.000001,0,0,2391,6,0.000039,1,1,1,525.874999,0.108974,0.00253
9402017,9402017,,1,1,2,1,1,2,0,0,0,4656,15,0.000019,1,1,1,9240.675284,0,0.000283
9305110,9305110,,16,3,19,16,3,19,0,0,0,2399,6,0.000124,1,1,1,12763.309519,0.04386,0.004267
9501087,9501087,,1,0,1,1,0,1,0,0,0,3758,9,0.000047,0,0,0,0,0,0.000332
9503141,9503141,,7,7,14,7,7,14,0.000021,0.000005,0,6341,52,0.000024,3,0.6,0.711111,8444.521513,0.126374,0.001898
9210002,9210002,,5,0,5,5,0,5,0.000006,0,0,6768,9,0.000016,0,0,0,0,0.05,0.001226
9312208,9312208,,10,3,13,10,3,13,0.00001,0.000019,0,1462,22,0.00003,1,1,1,73.988728,0.198718,0.00271
9403047,9403047,,7,7,14,7,7,14,0.000046,0.000056,0,1068,0,0.000017,4,0.446809,0.587302,2819.550401,0.181319,0.001926
9412187,9412187,,5,17,22,5,17,22,0.000011,0.000263,0,4081,0,0.000014,6,0.361635,0.449565,44265.977308,0.088745,0.001385
9512150,9512150,,6,6,12,6,6,12,0.000014,0.000004,0,8796,22,0.000015,5,0.445946,0.531313,799.841591,0.212121,0.001582
9601114,9601114,,4,4,8,4,4,8,0,0.000012,0,7820,52,0.000024,5,0.397436,0.471505,8495.87791,0.053571,0.001029
9306162,9306162,,14,7,21,14,7,21,0.000047,0.000013,0,3832,52,0.00006,2,0.888889,0.9375,29926.238561,0.019048,0.003575
9408033,9408033,,13,8,21,13,8,21,0.000015,0.000042,0,3171,9,0.000024,4,0.401274,0.466931,6212.023489,0.102381,0.003221
9412009,9412009,,2,1,3,2,1,3,0.000005,0,0,6319,52,0.000014,2,0.555556,0.6,405.171877,0.166667,0.000506
9507047,9507047,,3,1,4,3,1,4,0.000005,0,0,6307,52,0.000015,1,1,1,2567.893399,0.166667,0.000728
9511143,9511143,,3,2,5,3,2,5,0.000005,0.000006,0,5513,9,0.000016,2,0.625,0.7,771.689121,0.15,0.000755
9601068,9601068,,3,8,11,3,8,11,0.000039,0.000142,0,6340,41,0.000012,6,0.271468,0.337415,3018.363411,0.054545,0.00072
9601070,9601070,,5,5,10,5,5,10,0.000008,0.00002,0,2921,52,0.000018,6,0.264379,0.302354,11377.136876,0.144444,0.001326
9604094,9604094,,4,10,14,4,10,14,0.000008,0.000279,0,6339,4,0.000019,15,0.148752,0.17946,38778.018308,0.082418,0.000972
9606175,9606175,,6,5,11,6,5,11,0.000005,0.000001,0,6334,52,0.000037,3,0.551724,0.635417,29082.301615,0.063636,0.001442
9612178,9612178,,1,19,20,1,19,20,0.000005,0.00001,0,6312,52,0.00001,14,0.141202,0.168992,121688.216667,0.055263,0.000269
9302002,9302002,,4,0,4,4,0,4,0,0,0,11343,9,0.00003,0,0,0,0,0.25,0.00095
9503070,9503070,,11,8,19,11,8,19,0.000025,0.000004,0,10656,6,0.000025,7,0.256711,0.318161,18470.756887,0.105263,0.002725
9207101,9207101,,10,0,10,10,0,10,0.000045,0,0,2804,6,0.000033,0,0,0,0,0.144444,0.002471
9406215,9406215,,11,2,13,11,2,13,0,0.000001,0,13238,6,0.000028,1,1,1,40.99344,0.173077,0.002602
9510131,9510131,,9,8,17,9,8,17,0,0.000002,0,13239,6,0.000018,6,0.273723,0.336556,622.396634,0.194853,0.002077
9607177,9607177,,8,6,14,8,6,14,0.000034,0.000003,0,4075,6,0.000018,7,0.224543,0.299945,48.216796,0.181319,0.001945
9609135,9609135,,2,3,5,2,3,5,0,0.000002,0,10717,6,0.000016,7,0.221636,0.279507,1026.265647,0.25,0.000506
9607156,9607156,,14,2,16,14,2,16,0,0,0,7570,26,0.000076,2,0.75,0.833333,448.452008,0.125,0.003333
9707035,9707035,,9,3,12,9,3,12,0,0,0,7572,26,0.000042,3,0.625,0.766667,11077.443053,0.174242,0.002118
9804094,9804094,,6,4,10,6,4,10,0,0,0,13233,26,0.000033,3,0.666667,0.805556,33.210684,0.2,0.001381
9808001,9808001,,4,2,6,4,2,6,0,0,0,13232,26,0.000021,3,0.545455,0.638889,3.566667,0.266667,0.000896
9310022,9310022,,16,3,19,16,3,19,0.000001,0.000012,0,1473,6,0.000071,1,1,1,5510.279758,0.01462,0.004265
9512085,9512085,,2,10,12,2,10,12,0,0.001037,0,13219,6,0.000018,6,0.278415,0.328027,1146.71974,0.136364,0.000472
9809178,9809178,,6,6,12,6,6,12,0.000004,0.000003,0,13218,6,0.000024,12,0.189404,0.218614,3191.910216,0.234848,0.001463
9808156,9808156,,13,16,29,13,16,29,0.00137,0.002918,0,8809,4,0.000013,12,0.198449,0.231076,9285.309413,0.273399,0.003723
9412108,9412108,,28,17,45,28,17,45,0.000002,0.000002,0,2041,6,0.000048,5,0.364261,0.462107,29155.122081,0.114141,0.006862
9802169,9802169,,1,11,12,1,11,12,0,0.001865,0,13228,22,0.000012,11,0.189503,0.233323,2317.021469,0.204545,0.000239
9804080,9804080,,1,4,5,1,4,5,0,0.000003,0,13227,6,0.000012,3,0.6,0.703704,111.62549,0,0.000239
9811023,9811023,,1,3,4,1,3,4,0,0.000001,0,13226,6,0.000012,14,0.15143,0.170683,147.381818,0.083333,0.000239
9302115,9302115,,4,1,5,4,1,5,0,0.000002,0,10654,6,0.000022,1,1,1,4.278207,0.2,0.001026
9402061,9402061,,7,3,10,7,3,10,0.000001,0.000004,0,2426,6,0.000024,1,1,1,606.136159,0.088889,0.001817
9209100,9209100,,2,1,3,2,1,3,0.000002,0.000004,0,5975,4,0.000012,1,1,1,0.867022,0.333333,0.000683
9503028,9503028,,4,5,9,4,5,9,0.000036,0.000023,0,3764,22,0.000013,4,0.385714,0.444444,2081.77071,0.083333,0.001048
9503143,9503143,,5,7,12,5,7,12,0.000032,0.000467,0,1031,13,0.000023,6,0.314791,0.366198,29920.856228,0.151515,0.001592
9309076,9309076,,5,0,5,5,0,5,0.000027,0,0,6302,9,0.000028,0,0,0,0,0.3,0.001284
9309159,9309159,,4,1,5,4,1,5,0.000027,0,0,6303,9,0.000015,1,1,1,0,0.3,0.001037
9401166,9401166,,2,0,2,2,0,2,0.000025,0,0,12285,9,0.000011,0,0,0,0,0,0.000504
9406211,9406211,,1,0,1,1,0,1,0.000025,0,0,12284,9,0.00001,0,0,0,0,0,0.000285
9305146,9305146,,7,2,9,7,2,9,0.000035,0,0,1892,6,0.00002,1,1,1,498.660722,0.069444,0.001604
9412207,9412207,,1,4,5,1,4,5,0,0.000004,0,13209,4,0.00001,4,0.428571,0.538889,96.657937,0.05,0.000239
9508016,9508016,,5,2,7,5,2,7,0.000002,0,0,2773,6,0.000014,5,0.316667,0.358333,236.263474,0.190476,0.001252
9509037,9509037,,14,2,16,14,2,16,0.000048,0.000001,0,4070,6,0.000043,6,0.246377,0.296569,1677.93078,0.1,0.003742
9610094,9610094,,4,9,13,4,9,13,0,0.000008,0,4088,6,0.000014,9,0.224272,0.281667,48580.836549,0.153846,0.00094
9612233,9612233,,1,20,21,1,20,21,0,0.002797,0,13208,6,0.00001,11,0.199858,0.230223,2544.412329,0.057143,0.000239
9805008,9805008,,16,6,22,16,6,22,0.000052,0.000003,0,10693,6,0.000038,7,0.256452,0.300479,5532.86202,0.106061,0.003996
9203004,9203004,,9,0,9,9,0,9,0.000001,0,0,3831,52,0.000045,0,0,0,0,0.097222,0.002215
9612159,9612159,,2,1,3,2,1,3,0,0,0,13201,52,0.000015,1,1,1,0,0.333333,0.000461
3191,3191,,8,5,13,8,5,13,0.000053,0.00001,0,12250,23,0.000013,12,0.15942,0.190972,2366.741864,0.192308,0.00186
9210070,9210070,,10,0,10,10,0,10,0.000018,0,0,10192,23,0.000032,0,0,0,0,0.133333,0.002367
3192,3192,,9,14,23,9,14,23,0.000066,0.000028,0,12249,23,0.000014,18,0.125616,0.147843,13483.544571,0.164032,0.002127
9211046,9211046,,2,0,2,2,0,2,0.000001,0,0,12248,23,0.000012,0,0,0,0,0,0.000505
9510100,9510100,,5,2,7,5,2,7,0.000206,0.002531,0,1442,0,0.000023,8,0.221546,0.251135,1291.300763,0.095238,0.002322
3193,3193,,5,3,8,5,3,8,0.000004,0.000007,0,13243,23,0.000012,12,0.15623,0.181019,0,0.303571,0.001129
9709040,9709040,,3,3,6,3,3,6,0.000022,0,0,6611,30,0.000015,3,0.482759,0.559524,7262.434331,0.1,0.000732
3194,3194,,2,7,9,2,7,9,0,0.000021,0,13244,25,0.000017,10,0.170843,0.199562,3311.706685,0.069444,0.000458
9306098,9306098,,7,1,8,7,1,8,0.000001,0,0,7126,21,0.000035,1,1,1,342.43161,0.125,0.001675
9705183,9705183,,10,5,15,10,5,15,0.000023,0,0,7132,21,0.000058,3,0.533333,0.625,90982.57432,0.109524,0.002597
9706167,9706167,,4,7,11,4,7,11,0.000023,0,0,7135,21,0.000022,9,0.183351,0.207905,41835.58627,0.136364,0.001199
9710058,9710058,,8,1,9,8,1,9,0.000023,0.000066,0,8730,25,0.000043,7,0.242697,0.265862,375.821401,0.208333,0.002036
9801075,9801075,,7,2,9,7,2,9,0.000014,0.000066,0,8731,25,0.00003,7,0.243547,0.269245,518.163094,0.208333,0.001741
9306066,9306066,,11,0,11,11,0,11,0,0,0,6180,21,0.000098,0,0,0,0,0.045455,0.002664
9310185,9310185,,14,0,14,14,0,14,0.000001,0,0,7119,21,0.000084,0,0,0,0,0.093407,0.003382
9408096,9408096,,6,3,9,6,3,9,0.000001,0,0,7127,21,0.000033,2,0.8,0.875,21735.104888,0.166667,0.001453
9508165,9508165,,7,7,14,7,7,14,0.000003,0,0,7131,21,0.000034,2,0.684211,0.769231,32916.804852,0.071429,0.001657
9609089,9609089,,9,4,13,9,4,13,0.000006,0,0,7123,21,0.000058,2,0.833333,0.9,14613.8,0.083333,0.002145
9611081,9611081,,2,1,3,2,1,3,0,0.000013,0,7133,13,0.000016,8,0.215853,0.239456,4098.224607,0.166667,0.000469
3195,3195,,4,4,8,4,4,8,0.000013,0.000005,0,13246,26,0.000024,9,0.225323,0.258756,1305.5,0.142857,0.000916
9609061,9609061,,7,5,12,7,5,12,0.000238,0.000016,0,13245,26,0.000025,8,0.219015,0.245896,7617.125175,0.121212,0.00166
9202012,9202012,,25,0,25,25,0,25,0.000044,0,0,1463,22,0.000116,0,0,0,0,0.058333,0.007489
9407194,9407194,,14,13,27,14,13,27,0.000007,0.000245,0,3920,26,0.000045,6,0.296089,0.394497,4248.771953,0.065527,0.00358
9503220,9503220,,14,2,16,14,2,16,0.000006,0,0,7293,26,0.000071,1,1,1,9134.410474,0.116667,0.0037
9602063,9602063,,9,2,11,9,2,11,0.000014,0,0,10938,26,0.000039,8,0.178478,0.205121,3448.849605,0.1,0.002132
3196,3196,,1,5,6,1,5,6,0.000055,0.001228,0,13248,25,0.00001,12,0.188272,0.204202,4.125,0.166667,0.000232
9808163,9808163,,3,1,4,3,1,4,0.000034,0.000002,0,13247,25,0.000015,1,1,1,5,0,0.000664
9609191,9609191,,7,9,16,7,9,16,0.000106,0.000002,0,3974,9,0.000019,6,0.273427,0.327934,376420.72057,0.15,0.002221
3199,3199,,9,6,15,9,6,15,0.00012,0.00001,0,12247,23,0.000014,12,0.160392,0.195,3052.161845,0.195238,0.002086
3200,3200,,5,56,61,5,56,61,0.000181,0.006865,0,13058,30,0.000013,13,0.22511,0.254344,37327.138864,0.072404,0.001452
9705137,9705137,,7,21,28,7,21,28,0.001016,0.006275,0,7360,2,0.000016,14,0.198406,0.23441,34180.627329,0.154762,0.003111
3201,3201,,1,1,2,1,1,2,0.00001,0.000002,0,13249,6,0.00001,6,0.328571,0.38913,90.138472,0,0.000247
3202,3202,,1,9,10,1,9,10,0.000001,0.000063,0,13252,22,0.00001,14,0.14705,0.161256,2817.582326,0.2,0.000299
9906111,9906111,,3,4,7,3,4,7,0.000002,0.000013,0,13251,22,0.000014,17,0.141149,0.15349,2340.6054,0.404762,0.000758
9911071,9911071,,1,0,1,1,0,1,0.000001,0,0,13250,22,0.000011,0,0,0,0,0,0.000227
3203,3203,,33,58,91,33,58,91,0.006901,0.025228,0,12959,1,0.00002,12,0.230507,0.266445,30145.489708,0.155311,0.010298
3204,3204,,5,34,39,5,34,39,0.000253,0.00496,0,13253,30,0.000012,13,0.202893,0.225753,2911.141552,0.187584,0.001465
3205,3205,,8,11,19,8,11,19,0.00142,0.003211,0,13254,1,0.000014,13,0.188093,0.208239,9981.617626,0.154971,0.001869
3206,3206,,5,9,14,5,9,14,0.000037,0.000075,0,13255,0,0.000018,14,0.180915,0.204032,2210.217023,0.010989,0.001123
9803121,9803121,,8,2,10,8,2,10,0.000058,0.000012,0,7485,0,0.000049,3,0.5,0.633333,0,0.4,0.002177
3208,3208,,36,42,78,36,42,78,0.001542,0.00424,0,12185,30,0.000035,13,0.210685,0.23639,115083.496485,0.100733,0.011165
9704149,9704149,,3,2,5,3,2,5,0.000084,0.000028,0,9419,4,0.000012,10,0.1625,0.183027,6260.812306,0.05,0.000966
9903216,9903216,,4,5,9,4,5,9,0.000176,0.00228,0,12184,30,0.000012,11,0.216437,0.245126,4833.335576,0.319444,0.001435
9911170,9911170,,9,15,24,9,15,24,0.00033,0.002865,0,12182,30,0.000014,12,0.200219,0.221454,11957.032588,0.302536,0.002851
9503064,9503064,,6,0,6,6,0,6,0.000068,0,0,9418,0,0.000017,0,0,0,0,0.266667,0.001597
9703073,9703073,,4,17,21,4,17,21,0.000196,0.008138,0,6215,2,0.000014,15,0.187004,0.220403,1576.792069,0.188095,0.001288
9703109,9703109,,4,3,7,4,3,7,0.00015,0.000002,0,6213,22,0.000016,8,0.192287,0.212008,9199.448376,0.095238,0.001161
9505127,9505127,,9,13,22,9,13,22,0.000115,0.000136,0,3149,4,0.000017,6,0.289082,0.341631,54406.101613,0.077922,0.002169
9910118,9910118,,7,19,26,7,19,26,0.000866,0.018217,0,12181,1,0.000013,11,0.232976,0.264584,39284.01219,0.213846,0.001969
3210,3210,,6,10,16,6,10,16,0.000001,0.000008,0,13262,9,0.000017,10,0.178621,0.229609,1264.910704,0.2375,0.001389
9602101,9602101,,12,2,14,12,2,14,0.000003,0.000005,0,13256,9,0.000042,1,1,1,2.833333,0.307692,0.003065
9605099,9605099,,11,3,14,11,3,14,0.000215,0.000003,0,11785,9,0.000027,2,0.8,0.875,8501.978205,0.120879,0.002804
9610202,9610202,,11,2,13,11,2,13,0.000002,0.000002,0,13257,9,0.000029,2,0.75,0.833333,62.991523,0.307692,0.00274
9704069,9704069,,6,3,9,6,3,9,0,0.000002,0,13260,9,0.000017,2,0.8,0.875,0.75,0.388889,0.001428
9907050,9907050,,7,12,19,7,12,19,0.000002,0.000012,0,13258,9,0.000019,9,0.212855,0.280047,1394.356536,0.169591,0.001701
9910046,9910046,,12,10,22,12,10,22,0.000003,0.000011,0,13259,9,0.000036,9,0.210008,0.270619,5572.232968,0.170996,0.002859
9910206,9910206,,4,8,12,4,8,12,0,0.000002,0,13261,9,0.000014,10,0.177931,0.224685,171.079543,0.310606,0.000957
9301045,9301045,,2,0,2,2,0,2,0,0,0,11784,6,0.00002,0,0,0,0,0,0.000522
9407116,9407116,,9,1,10,9,1,10,0.000005,0.000003,0,11783,9,0.000029,1,1,1,65.244802,0.155556,0.002257
9201062,9201062,,2,0,2,2,0,2,0,0,0,2410,26,0.000013,0,0,0,0,0,0.000499
3211,3211,,8,37,45,8,37,45,0.000657,0.007625,0,12234,2,0.000014,12,0.218379,0.24726,236139.510711,0.089899,0.002406
9807113,9807113,,3,14,17,3,14,17,0.000126,0.001045,0,8931,2,0.000012,13,0.187553,0.210246,7557.293238,0.143382,0.00079
9809043,9809043,,1,20,21,1,20,21,0.00009,0.004773,0,12219,13,0.00001,18,0.186291,0.216935,881.697353,0.114286,0.00028
9405070,9405070,,4,3,7,4,3,7,0.000045,0.000636,0,513,13,0.000025,4,0.324468,0.367486,369.064077,0.095238,0.001443
9410069,9410069,,1,4,5,1,4,5,0.000019,0.000163,0,515,13,0.00002,2,0.75,0.833333,2.020301,0.2,0.000619
9502146,9502146,,2,1,3,2,1,3,0.000079,0.000007,0,3372,13,0.000011,2,0.6,0.666667,250.015097,0,0.000554
3212,3212,,0,2,2,0,2,2,0,0,0,13265,6,0.00001,2,0.666667,0.75,0,0,0
9201031,9201031,,4,0,4,4,0,4,0,0,0,1188,6,0.000033,0,0,0,0,0,0.000925
9603162,9603162,,1,2,3,1,2,3,0,0,0,13264,6,0.000014,1,1,1,2,0,0.000219
9212105,9212105,,2,0,2,2,0,2,0,0,0,13263,6,0.000018,0,0,0,0,0,0.000445
9305015,9305015,,3,0,3,3,0,3,0,0,0,1840,6,0.000028,0,0,0,0,0,0.000743
3213,3213,,7,30,37,7,30,37,0.001266,0.020114,0,11629,1,0.000014,11,0.229712,0.263658,13580.647764,0.182432,0.003077
3214,3214,,0,9,9,0,9,9,0,0.002006,0,13266,4,0.00001,7,0.260679,0.307153,0,0.152778,0
9305028,9305028,,13,0,13,13,0,13,0.000519,0,0,3024,4,0.000054,0,0,0,0,0.294872,0.004057
9404115,9404115,,22,1,23,22,1,23,0.000999,0.000006,0,3025,4,0.000031,1,1,1,105.475639,0.173913,0.006133
3216,3216,,23,21,44,23,21,44,0.001337,0.00258,0,12176,30,0.00002,15,0.196205,0.217053,2670.39824,0.209831,0.009769
3217,3217,,4,18,22,4,18,22,0.000001,0.000014,0,13285,6,0.000012,13,0.147157,0.171244,8773.400581,0.0671,0.000949
9906069,9906069,,3,19,22,3,19,22,0,0.000005,0,13284,6,0.000012,12,0.161938,0.183989,7769.135797,0.088745,0.000717
9911105,9911105,,4,17,21,4,17,21,0.000008,0.000017,0,13268,6,0.000012,12,0.158977,0.177645,6307.249521,0.05,0.00093
9403105,9403105,,1,0,1,1,0,1,0,0,0,1965,6,0.000024,0,0,0,0,0,0.000495
9404038,9404038,,4,1,5,4,1,5,0,0,0,10692,6,0.000031,1,1,1,271.826797,0,0.000994
9812091,9812091,,4,2,6,4,2,6,0,0.000001,0,10690,6,0.000021,6,0.266932,0.315672,29.225322,0.266667,0.001133
9309022,9309022,,16,1,17,16,1,17,0.000001,0.000001,0,2346,6,0.000058,1,1,1,16.368532,0.099265,0.003947
9705187,9705187,,7,2,9,7,2,9,0,0.000003,0,13273,6,0.000022,4,0.391304,0.444444,86.908583,0.25,0.001702
9707155,9707155,,1,2,3,1,2,3,0,0,0,13283,6,0.00001,5,0.307692,0.367857,0,0.333333,0.000239
9803118,9803118,,6,6,12,6,6,12,0.000004,0.000003,0,13274,6,0.000014,5,0.347368,0.456061,793.682641,0.143939,0.001462
9807065,9807065,,7,13,20,7,13,20,0,0.000004,0,13282,6,0.000017,7,0.258427,0.383204,7332.898548,0.118421,0.001597
9808012,9808012,,4,1,5,4,1,5,0,0.000001,0,13276,6,0.000018,1,1,1,6.8,0.2,0.00095
9812009,9812009,,7,6,13,7,6,13,0.000004,0.000003,0,13272,6,0.000016,13,0.138366,0.15551,7128.965715,0.224359,0.001694
9903066,9903066,,4,10,14,4,10,14,0.000008,0.000003,0,13279,6,0.000013,7,0.257862,0.36536,155.927083,0.131868,0.000923
9903137,9903137,,3,11,14,3,11,14,0.000004,0.000007,0,13275,6,0.000012,14,0.127992,0.151137,1444.405257,0.181319,0.000738
9905202,9905202,,3,4,7,3,4,7,0,0.000001,0,13269,6,0.000012,4,0.388889,0.457143,142.226302,0.119048,0.00073
9211133,9211133,,6,0,6,6,0,6,0.000001,0,0,1876,6,0.000185,0,0,0,0,0.033333,0.001609
9306036,9306036,,2,0,2,2,0,2,0,0,0,10666,6,0.000013,0,0,0,0,0.5,0.000499
9407032,9407032,,6,2,8,6,2,8,0,0,0,10665,6,0.000025,2,0.625,0.7,208.502337,0.089286,0.001428
9407135,9407135,,2,0,2,2,0,2,0,0,0,13267,6,0.000012,0,0,0,0,0,0.000465
9408006,9408006,,5,6,11,5,6,11,0.000003,0,0,10667,6,0.000017,3,0.477273,0.579365,11111.138157,0.1,0.001194
9606116,9606116,,8,5,13,8,5,13,0.000044,0.000004,0,10663,6,0.000023,9,0.179034,0.216344,5436.773731,0.057692,0.001854
3218,3218,,19,35,54,19,35,54,0.003891,0.019353,0,13286,1,0.000016,11,0.205544,0.230128,16463.53781,0.233054,0.005979
3219,3219,,10,47,57,10,47,57,0.000784,0.00426,0,12913,3,0.000014,13,0.222332,0.252915,60335.574356,0.106203,0.002963
9908182,9908182,,9,16,25,9,16,25,0.000542,0.003438,0,12906,3,0.000014,16,0.166542,0.192611,4008.717439,0.13,0.002477
9903012,9903012,,6,6,12,6,6,12,0.000212,0.001216,0,12904,3,0.000015,13,0.178177,0.200859,4975.447544,0.166667,0.001693
9905153,9905153,,10,11,21,10,11,21,0.000819,0.001003,0,12905,3,0.000017,15,0.181152,0.206228,20606.346548,0.152381,0.003431
3220,3220,,64,12,76,64,12,76,0.00312,0.000957,0,12849,3,0.000066,12,0.193812,0.211923,16171.265555,0.19386,0.033918
9309095,9309095,,4,4,8,4,4,8,0.000001,0,0,461,9,0.000054,3,0.636364,0.761905,14744.611658,0.089286,0.001701
3221,3221,,71,31,102,71,31,102,0.003162,0.005238,0,12217,3,0.000057,12,0.209494,0.235835,108313.30214,0.107552,0.031084
3222,3222,,1,7,8,1,7,8,0,0.000027,0,13288,10,0.00001,18,0.1585,0.178292,1100.76811,0.214286,0.000226
9903260,9903260,,3,13,16,3,13,16,0.000012,0.002517,0,13287,10,0.000014,14,0.179475,0.208475,1113.902267,0.166667,0.000701
9805122,9805122,,2,16,18,2,16,18,0.000014,0.001703,0,7737,0,0.000013,14,0.195635,0.225023,55454.109995,0.084967,0.00048
3223,3223,,15,9,24,15,9,24,0.00085,0.003037,0,12186,30,0.000018,12,0.198245,0.216181,8495.112096,0.297101,0.004325
3224,3224,,5,2,7,5,2,7,0.00001,0.00007,0,13289,25,0.000016,13,0.141896,0.153911,85.794906,0.142857,0.001216
3225,3225,,2,8,10,2,8,10,0.000026,0.002857,0,13292,0,0.000014,14,0.17562,0.204818,10377.355909,0.122222,0.000445
9701047,9701047,,5,6,11,5,6,11,0.000128,0.001209,0,13291,0,0.000016,12,0.189014,0.21644,567.45245,0.163636,0.001123
9509118,9509118,,2,7,9,2,7,9,0.000079,0.002949,0,13290,0,0.000013,10,0.205004,0.236721,125.753344,0.152778,0.000478
3226,3226,,8,24,32,8,24,32,0.000974,0.002379,0,12911,3,0.000013,12,0.206138,0.233831,9745.503037,0.153226,0.002407
9906160,9906160,,13,11,24,13,11,24,0.000604,0.000476,0,12907,13,0.00002,16,0.162129,0.185379,14052.067985,0.13587,0.003683
9911007,9911007,,9,22,31,9,22,31,0.000466,0.008222,0,12908,13,0.000016,12,0.20178,0.228182,7891.238757,0.139785,0.002711
9603154,9603154,,4,0,4,4,0,4,0.00002,0,0,9916,0,0.000026,0,0,0,0,0.083333,0.001015
9410215,9410215,,18,5,23,18,5,23,0.000403,0.000339,0,1079,5,0.000031,8,0.236162,0.286589,1257.594003,0.086957,0.006179
9212035,9212035,,14,2,16,14,2,16,0.000614,0.000113,0,1115,13,0.000044,1,1,1,117.154687,0.05,0.004299
9910098,9910098,,6,34,40,6,34,40,0.000989,0.010571,0,11606,13,0.000013,11,0.221787,0.252204,11887.080953,0.128846,0.002109
3228,3228,,6,3,9,6,3,9,0.000019,0.000046,0,13293,2,0.000021,16,0.155661,0.176304,2195.799225,0.319444,0.001503
3229,3229,,3,3,6,3,3,6,0,0.000001,0,13294,5,0.000014,4,0.407407,0.459596,31.434524,0.1,0.000677
3230,3230,,10,35,45,10,35,45,0.002397,0.022766,0,13295,1,0.000013,12,0.22371,0.257659,16847.675103,0.177778,0.002817
3232,3232,,8,27,35,8,27,35,0.000171,0.002218,0,13299,30,0.000015,13,0.194419,0.214468,8647.852575,0.094958,0.001982
9902138,9902138,,21,3,24,21,3,24,0.000576,0.000041,0,12408,30,0.00003,1,1,1,177.429668,0.153986,0.006247
9910129,9910129,,31,11,42,31,11,42,0.00059,0.00011,0,13296,30,0.000034,15,0.152973,0.176556,3344.180172,0.196283,0.008755
9912050,9912050,,24,10,34,24,10,34,0.000413,0.00012,0,13298,30,0.000024,15,0.152111,0.174028,4079.561683,0.176471,0.006597
9903112,9903112,,10,7,17,10,7,17,0.00036,0.000061,0,13297,30,0.000019,15,0.150342,0.170503,4215.732711,0.161765,0.003026
3233,3233,,2,14,16,2,14,16,0.000065,0.002419,0,13300,0,0.000011,15,0.169636,0.193265,1752.887735,0.2625,0.000594
3234,3234,,1,18,19,1,18,19,0.000038,0.002985,0,13302,30,0.00001,13,0.190134,0.209418,795.873655,0.21345,0.000269
9411140,9411140,,3,0,3,3,0,3,0.000074,0,0,13301,23,0.000013,0,0,0,0,0.166667,0.000714
9801079,9801079,,6,9,15,6,9,15,0.00009,0.000121,0,8782,10,0.000016,12,0.18447,0.206632,4130.627046,0.185714,0.001514
9603143,9603143,,3,7,10,3,7,10,0.000037,0.000009,0,9581,15,0.000012,3,0.525,0.626984,11802.708918,0.111111,0.000768
3235,3235,,1,23,24,1,23,24,0.000299,0.012165,0,13303,1,0.00001,11,0.233714,0.264484,1274.377349,0.197464,0.000581
9904172,9904172,,2,5,7,2,5,7,0.000154,0.000094,0,8643,4,0.000017,15,0.127469,0.143246,1661.178653,0.190476,0.000931
3239,3239,,6,1,7,6,1,7,0.000066,0.00001,0,13304,4,0.000021,13,0.150662,0.165337,105.275907,0.119048,0.001856
3240,3240,,2,26,28,2,26,28,0.000048,0.006552,0,13306,2,0.000011,14,0.19259,0.221963,3333.639039,0.240741,0.000493
9812188,9812188,,2,35,37,2,35,37,0.000086,0.003248,0,13305,2,0.000011,12,0.216697,0.250326,549.521869,0.143393,0.000452
3241,3241,,0,20,20,0,20,20,0,0.01179,0,13308,0,0.00001,12,0.202857,0.229665,0,0.115789,0
9703070,9703070,,6,18,24,6,18,24,0.00111,0.00342,0,7649,0,0.000012,11,0.223022,0.256496,7716.735377,0.164855,0.001836
9912184,9912184,,6,23,29,6,23,29,0.000472,0.012282,0,13307,13,0.000014,11,0.234079,0.271381,20020.226172,0.123153,0.001693
9611110,9611110,,5,41,46,5,41,46,0.000159,0.012272,0,7648,0,0.000014,11,0.23448,0.280833,4361.847505,0.105797,0.001272
9710026,9710026,,6,6,12,6,6,12,0.00049,0.0017,0,4981,2,0.000016,16,0.187818,0.212082,2749.363312,0.181818,0.002629
3242,3242,,29,26,55,29,26,55,0.001215,0.001281,0,11645,52,0.000025,12,0.202294,0.228132,24214.059389,0.163636,0.011254
9306157,9306157,,9,0,9,9,0,9,0.000017,0,0,643,0,0.000028,0,0,0,0,0.152778,0.002552
9307040,9307040,,13,0,13,13,0,13,0.00002,0,0,220,0,0.000038,0,0,0,0,0.102564,0.003667
9406045,9406045,,4,5,9,4,5,9,0.000053,0.000029,0,792,0,0.000014,2,0.857143,0.916667,1650.810574,0.069444,0.001402
9407009,9407009,,3,5,8,3,5,8,0.000006,0.000007,0,4078,0,0.000013,5,0.352941,0.477778,563.496355,0.267857,0.000922
9408121,9408121,,4,5,9,4,5,9,0.000058,0.000393,0,4077,0,0.000013,3,0.517241,0.622222,736.771488,0.152778,0.001141
9511229,9511229,,4,3,7,4,3,7,0.000034,0.000006,0,5514,9,0.000014,7,0.352071,0.3991,42769.822752,0.071429,0.001232
3243,3243,,12,5,17,12,5,17,0.000456,0.000006,0,13322,6,0.000032,18,0.128296,0.144548,16159.533449,0.095588,0.00284
9410115,9410115,,5,0,5,5,0,5,0.000006,0,0,6331,6,0.000037,0,0,0,0,0.05,0.001286
9712119,9712119,,9,2,11,9,2,11,0.000377,0,0,13321,6,0.000026,2,0.75,0.833333,57.5,0.118182,0.002151
9810080,9810080,,4,9,13,4,9,13,0.000003,0.000011,0,13319,6,0.000024,17,0.141663,0.157638,45641.181106,0.076923,0.001083
9404028,9404028,,3,1,4,3,1,4,0,0,0,13320,6,0.000027,1,1,1,25.333333,0.166667,0.000718
9406118,9406118,,13,2,15,13,2,15,0.000273,0.000001,0,3828,6,0.000041,1,1,1,10842.306671,0.095238,0.003334
9408035,9408035,,12,10,22,12,10,22,0.000001,0.00001,0,1299,9,0.000047,3,0.568182,0.673333,108921.30473,0.058442,0.003061
9506016,9506016,,7,1,8,7,1,8,0.000132,0.000001,0,5813,6,0.000034,1,1,1,5629.153949,0.053571,0.001735
9710234,9710234,,2,4,6,2,4,6,0.000037,0.000002,0,8789,6,0.000014,12,0.138656,0.166313,15486.016793,0.133333,0.000533
9507029,9507029,,2,4,6,2,4,6,0,0.000002,0,13318,52,0.00002,1,1,1,2864.652964,0.066667,0.000522
9809017,9809017,,7,8,15,7,8,15,0.000006,0.000001,0,13315,6,0.000019,16,0.16146,0.181212,84379.057119,0.1,0.00167
3244,3244,,1,7,8,1,7,8,0.000003,0.000063,0,13323,0,0.00001,12,0.197633,0.221734,24.71349,0.214286,0.000226
9804106,9804106,,12,7,19,12,7,19,0.000117,0.000024,0,7489,0,0.00003,2,0.818182,0.888889,3174.541376,0.225146,0.003072
9803178,9803178,,3,4,7,3,4,7,0.000001,0.000019,0,7487,0,0.000021,3,0.583333,0.738095,0,0.5,0.00085
9803210,9803210,,11,6,17,11,6,17,0.000113,0.000023,0,7488,0,0.000037,2,0.8,0.875,3256.275877,0.235294,0.002946
3245,3245,,1,31,32,1,31,32,0.000059,0.020002,0,13324,4,0.00001,14,0.205538,0.233946,1003.811794,0.092742,0.000268
3246,3246,,7,7,14,7,7,14,0.000003,0.000015,0,13325,6,0.000024,4,0.527778,0.649123,102.907576,0.126374,0.001573
9702095,9702095,,4,3,7,4,3,7,0,0.000009,0,9690,6,0.000021,2,0.666667,0.75,3.666667,0.333333,0.00098
9805215,9805215,,6,4,10,6,4,10,0.000002,0.000009,0,9691,6,0.000022,2,0.7,0.785714,65.95,0.211111,0.00143
3247,3247,,1,5,6,1,5,6,0.000007,0.00005,0,13326,52,0.000011,8,0.187261,0.240339,16.141618,0.333333,0.000397
9608040,9608040,,7,6,13,7,6,13,0.000045,0.000003,0,6987,52,0.00002,6,0.24902,0.301575,18938.225529,0.173077,0.001648
9710229,9710229,,1,4,5,1,4,5,0.000001,0.000004,0,9121,52,0.000012,7,0.207455,0.2508,226.58144,0.25,0.000264
9802077,9802077,,3,2,5,3,2,5,0.000215,0.000006,0,9120,52,0.000014,3,0.533333,0.604167,465.404115,0.15,0.000808
3249,3249,,16,11,27,16,11,27,0.001088,0.016206,0,13329,26,0.000022,12,0.201602,0.224676,5753.301224,0.173789,0.003791
9909220,9909220,,6,6,12,6,6,12,0.000589,0.001476,0,13328,2,0.000016,15,0.170398,0.190524,290.878279,0.25,0.00151
9910222,9910222,,11,64,75,11,64,75,0.001056,0.026934,0,13327,26,0.000019,11,0.241858,0.280678,62284.213524,0.090631,0.002665
9509027,9509027,,16,9,25,16,9,25,0.000426,0.000053,0,4439,26,0.000045,6,0.264822,0.380846,14419.010963,0.143333,0.004266
9805188,9805188,,7,14,21,7,14,21,0.00052,0.000169,0,11081,26,0.000015,15,0.167191,0.186462,9042.4048,0.233333,0.00184
3250,3250,,0,5,5,0,5,5,0,0.000002,0,13333,26,0.00001,10,0.173102,0.199207,0,0.3,0
9403175,9403175,,6,5,11,6,5,11,0.000009,0.000204,0,4790,26,0.000023,5,0.333333,0.390338,4391.278298,0.172727,0.0014
9609196,9609196,,3,6,9,3,6,9,0.000032,0.000078,0,13330,26,0.000016,9,0.206801,0.24506,506.25671,0.305556,0.000664
9811144,9811144,,1,2,3,1,2,3,0,0.000057,0,13332,23,0.000012,2,0.666667,0.75,3,0,0.000219
9901113,9901113,,1,3,4,1,3,4,0,0.000002,0,13331,26,0.000012,10,0.171972,0.194747,0,0.5,0.000219
9212042,9212042,,4,0,4,4,0,4,0.000005,0,0,3471,26,0.000037,0,0,0,0,0.083333,0.000977
9604053,9604053,,2,11,13,2,11,13,0.000002,0.000248,0,6351,26,0.000016,9,0.207901,0.251759,22306.537088,0.198718,0.000495
3251,3251,,2,20,22,2,20,22,0.000423,0.011465,0,12443,1,0.000011,16,0.228398,0.262902,11140.478837,0.138528,0.000894
3252,3252,,4,5,9,4,5,9,0.000001,0.000026,0,13335,23,0.00002,13,0.153406,0.170183,7203.750175,0.083333,0.00091
9610141,9610141,,7,5,12,7,5,12,0.000553,0.000302,0,5323,4,0.00002,8,0.204196,0.249519,6518.295767,0.151515,0.001863
9704073,9704073,,10,0,10,10,0,10,0.000012,0,0,13334,23,0.000048,0,0,0,0,0.088889,0.002317
9507173,9507173,,6,0,6,6,0,6,0.000069,0,0,3939,4,0.000047,0,0,0,0,0.133333,0.001586
9609136,9609136,,2,3,5,2,3,5,0.000042,0.00003,0,5322,4,0.000014,8,0.197279,0.228251,2352.596782,0.25,0.000557
9603065,9603065,,4,1,5,4,1,5,0.000033,0.000001,0,4962,23,0.000026,1,1,1,80.497203,0.15,0.001062
3253,3253,,4,3,7,4,3,7,0.000087,0.000001,0,13343,28,0.000026,10,0.18243,0.213305,1295.506917,0.095238,0.00089
9809101,9809101,,4,12,16,4,12,16,0,0.000015,0,13342,28,0.000036,10,0.191505,0.235236,1763.409479,0.075,0.000903
9811184,9811184,,2,2,4,2,2,4,0,0,0,13340,28,0.000021,5,0.384615,0.495,50.7,0.083333,0.000464
9801105,9801105,,13,2,15,13,2,15,0.000379,0.000013,0,13341,28,0.000032,2,0.666667,0.75,40.80305,0.304762,0.003275
9303098,9303098,,10,0,10,10,0,10,0,0,0,11759,26,0.000067,0,0,0,0,0.033333,0.00229
9810049,9810049,,2,3,5,2,3,5,0,0,0,13339,8,0.00002,4,0.5,0.635417,46.7,0.15,0.000492
3254,3254,,2,1,3,2,1,3,0,0,0,13344,20,0.00002,1,1,1,11,0,0.000458
3255,3255,,6,16,22,6,16,22,0.000081,0.000006,0,13367,8,0.000021,6,0.357513,0.491304,630.478979,0.11039,0.001422
9409004,9409004,,6,2,8,6,2,8,0.000001,0.000002,0,13360,8,0.000021,3,0.571429,0.708333,37.333333,0.160714,0.001422
9411081,9411081,,2,5,7,2,5,7,0,0.000003,0,13362,8,0.000012,3,0.666667,0.791667,37.42381,0.190476,0.000492
9412042,9412042,,2,3,5,2,3,5,0,0.000002,0,13366,8,0.000012,3,0.625,0.766667,1.333333,0.3,0.000479
9511010,9511010,,2,1,3,2,1,3,0,0,0,13365,8,0.000012,1,1,1,7.57619,0.166667,0.000492
9512097,9512097,,6,0,6,6,0,6,0.000119,0,0,13347,8,0.000023,0,0,0,0,0.166667,0.001442
9706070,9706070,,11,2,13,11,2,13,0.000024,0.000001,0,13338,8,0.000042,3,0.571429,0.708333,61.9,0.089744,0.002558
9706193,9706193,,5,1,6,5,1,6,0,0.000001,0,13337,8,0.000022,3,0.5,0.611111,8.233333,0.2,0.001177
9708032,9708032,,2,2,4,2,2,4,0,0.000002,0,13336,8,0.000017,3,0.571429,0.708333,12.233333,0.25,0.000492
9708121,9708121,,1,0,1,1,0,1,0,0,0,13364,8,0.000011,0,0,0,0,0,0.000259
9711061,9711061,,2,13,15,2,13,15,0,0.000003,0,13363,8,0.000012,5,0.398693,0.505191,426.830098,0.095238,0.000479
9712134,9712134,,2,5,7,2,5,7,0,0.000002,0,13348,8,0.000012,4,0.403509,0.507246,12.386111,0.285714,0.000492
9206039,9206039,,14,0,14,14,0,14,0.000002,0,0,2655,22,0.000295,0,0,0,0,0.043956,0.003704
9405009,9405009,,3,1,4,3,1,4,0,0,0,2644,22,0.000029,1,1,1,13414.598571,0.083333,0.000859
9210104,9210104,,3,0,3,3,0,3,0,0,0,13361,8,0.000032,0,0,0,0,0,0.000685
9412050,9412050,,4,0,4,4,0,4,0,0,0,9429,22,0.000049,0,0,0,0,0.083333,0.000966
9511105,9511105,,5,0,5,5,0,5,0,0,0,6262,26,0.000036,0,0,0,0,0.15,0.00129
9605181,9605181,,7,0,7,7,0,7,0,0,0,13349,8,0.000039,0,0,0,0,0.261905,0.001681
9607074,9607074,,6,2,8,6,2,8,0,0,0,13350,8,0.000031,2,0.625,0.7,98.666667,0.160714,0.001408
9609109,9609109,,2,3,5,2,3,5,0,0.000002,0,13359,8,0.000013,3,0.5,0.6,99.460546,0.15,0.000465
9611143,9611143,,5,5,10,5,5,10,0,0.000002,0,13352,8,0.000016,3,0.555556,0.7,60.75,0.188889,0.001182
9707231,9707231,,1,1,2,1,1,2,0,0.000001,0,13358,8,0.000011,3,0.5,0.611111,0,0.5,0.000233
9710061,9710061,,4,5,9,4,5,9,0,0.000003,0,13346,8,0.000015,3,0.5,0.592593,96.577778,0.152778,0.000917
9710087,9710087,,3,8,11,3,8,11,0,0.000002,0,13357,8,0.000013,4,0.46875,0.572222,232.724542,0.190909,0.000678
9908013,9908013,,2,35,37,2,35,37,0.000036,0.001746,0,11309,0,0.000012,15,0.200703,0.23487,4229.014018,0.260511,0.00048
3257,3257,,1,5,6,1,5,6,0,0.000004,0,13371,20,0.000011,2,0.777778,0.857143,1.583333,0.233333,0.000219
9401020,9401020,,8,0,8,8,0,8,0.000002,0,0,12956,20,0.000076,0,0,0,0,0.089286,0.001949
9903070,9903070,,7,0,7,7,0,7,0.000151,0,0,12954,20,0.000059,0,0,0,0,0.238095,0.001652
9904047,9904047,,9,1,10,9,1,10,0.000152,0.000002,0,12955,20,0.000037,1,1,1,3966.583333,0.2,0.00206
9909142,9909142,,4,2,6,4,2,6,0.000046,0.000002,0,12957,20,0.000016,2,0.75,0.833333,11062.808727,0.233333,0.001077
9910151,9910151,,2,4,6,2,4,6,0,0.000004,0,13370,20,0.000015,2,0.833333,0.9,3.333333,0.233333,0.000445
9812138,9812138,,4,1,5,4,1,5,0,0,0,13368,20,0.000023,1,1,1,4,0.15,0.000929
9906002,9906002,,2,3,5,2,3,5,0,0.000004,0,13369,20,0.000015,2,0.8,0.875,0,0.35,0.000464
3258,3258,,1,1,2,1,1,2,0,0,0,13372,23,0.000015,4,0.363636,0.4375,64,0,0.000259
9503112,9503112,,2,2,4,2,2,4,0,0,0,8519,6,0.000031,3,0.5,0.595238,1967.6762,0.083333,0.000465
9402144,9402144,,17,4,21,17,4,21,0.000037,0,0,3854,6,0.000052,2,0.75,0.833333,13336.872126,0.054762,0.004176
3259,3259,,1,5,6,1,5,6,0,0.000005,0,13376,23,0.000011,15,0.138352,0.14988,67.426425,0.233333,0.000226
9808058,9808058,,5,3,8,5,3,8,0.000001,0.000005,0,13374,23,0.000018,9,0.186408,0.212609,63.663788,0.232143,0.001129
9907091,9907091,,1,4,5,1,4,5,0,0.000003,0,13375,23,0.000012,16,0.113821,0.130683,295.195788,0.15,0.000226
9901051,9901051,,5,3,8,5,3,8,0.000203,0.000005,0,13373,23,0.000014,9,0.186408,0.212609,207.498068,0.125,0.001129
3261,3261,,21,26,47,21,26,47,0.000996,0.002306,0,13377,13,0.000027,14,0.181267,0.212215,38420.540365,0.078168,0.005405
9911082,9911082,,32,16,48,32,16,48,0.004472,0.02056,0,12093,8,0.000036,12,0.198527,0.224002,4011.391122,0.14539,0.015549
3262,3262,,8,20,28,8,20,28,0.000847,0.001678,0,12331,9,0.000013,12,0.209113,0.232842,27826.489739,0.171958,0.00263
9612251,9612251,,7,24,31,7,24,31,0.000661,0.008181,0,3331,2,0.00002,12,0.206401,0.241515,15748.668341,0.217204,0.00277
9703209,9703209,,4,39,43,4,39,43,0.000418,0.008612,0,5735,2,0.000012,13,0.203962,0.239139,30669.518033,0.160022,0.001437
9806013,9806013,,3,5,8,3,5,8,0.000144,0.000733,0,7716,15,0.000013,16,0.164952,0.18424,4525.424236,0.25,0.000995
9510153,9510153,,4,4,8,4,4,8,0.000325,0.00056,0,3321,13,0.000015,10,0.185854,0.207514,1285.106866,0.214286,0.000984
9907141,9907141,,2,12,14,2,12,14,0.000015,0.000363,0,9698,9,0.000011,12,0.203344,0.226504,414.62188,0.274725,0.000616
3263,3263,,59,26,85,59,26,85,0.002512,0.003302,0,11663,52,0.000035,12,0.207045,0.233015,91264.457709,0.120588,0.019213
3264,3264,,6,10,16,6,10,16,0.000013,0.00003,0,13379,6,0.000019,15,0.153775,0.172597,47338.231259,0.091667,0.001429
9503078,9503078,,26,14,40,26,14,40,0.001072,0.002041,0,1111,13,0.000066,7,0.2747,0.329076,34123.491816,0.090385,0.006976
9703096,9703096,,2,9,11,2,9,11,0.000033,0.000014,0,13378,6,0.000012,12,0.156362,0.179714,207.822963,0.2,0.000485
9411118,9411118,,4,1,5,4,1,5,0.000218,0.000014,0,1110,13,0.000019,3,0.415584,0.442708,22.183686,0.15,0.001484
9503154,9503154,,8,8,16,8,8,16,0.000219,0.000692,0,1948,13,0.000019,8,0.23553,0.2838,1213.022289,0.2,0.002122
9506037,9506037,,14,21,35,14,21,35,0.000268,0.005457,0,1949,13,0.000022,8,0.248669,0.305556,12880.938643,0.135294,0.003542
3265,3265,,9,19,28,9,19,28,0.00045,0.000561,0,13380,4,0.000013,13,0.188389,0.211805,1739.617391,0.296296,0.002235
3266,3266,,0,1,1,0,1,1,0,0.00002,0,13381,22,0.00001,2,0.538462,0.571429,0,0,0
3267,3267,,6,1,7,6,1,7,0.000081,0.000002,0,13382,8,0.000021,1,1,1,0.333333,0.404762,0.001422
3268,3268,,1,13,14,1,13,14,0.000013,0.000057,0,13408,22,0.00001,14,0.174717,0.190316,90.45545,0.137363,0.000226
9307075,9307075,,8,1,9,8,1,9,0.000015,0,0,6977,22,0.00003,1,1,1,33.329784,0.194444,0.00188
9311111,9311111,,10,3,13,10,3,13,0.000015,0.000003,0,13392,22,0.00003,1,1,1,58,0.083333,0.002316
9401093,9401093,,7,8,15,7,8,15,0.000031,0.000019,0,8184,22,0.000019,2,0.9,0.944444,18082.37086,0.038095,0.001632
9411027,9411027,,5,2,7,5,2,7,0.000015,0,0,13389,22,0.000015,2,0.75,0.833333,14,0.285714,0.001161
9412017,9412017,,5,2,7,5,2,7,0.000014,0,0,13407,22,0.000018,2,0.625,0.7,8.5,0.238095,0.001142
9510082,9510082,,6,6,12,6,6,12,0.000035,0.000002,0,13393,22,0.000015,7,0.232,0.315846,198.556818,0.174242,0.001355
9510189,9510189,,2,7,9,2,7,9,0.000014,0.000003,0,13406,22,0.000011,2,0.705882,0.791667,7.833333,0.111111,0.000451
9603064,9603064,,4,0,4,4,0,4,0.000015,0,0,13388,22,0.000013,0,0,0,0,0.25,0.000903
9709047,9709047,,1,7,8,1,7,8,0.000001,0.000012,0,13404,22,0.000011,8,0.226955,0.263337,195.880768,0.232143,0.000226
9908106,9908106,,7,26,33,7,26,33,0.000832,0.005451,0,13384,30,0.000014,15,0.198991,0.227305,31734.882052,0.078598,0.002092
9302111,9302111,,10,0,10,10,0,10,0,0,0,10101,22,0.000084,0,0,0,0,0.033333,0.002383
9208028,9208028,,6,0,6,6,0,6,0.000001,0,0,3206,22,0.00002,0,0,0,0,0.033333,0.001388
9301128,9301128,,1,0,1,1,0,1,0,0,0,8183,22,0.000012,0,0,0,0,0,0.000266
9204092,9204092,,5,0,5,5,0,5,0.000001,0,0,1500,9,0.000023,0,0,0,0,0.05,0.001156
9312019,9312019,,4,2,6,4,2,6,0.000013,0,0,13405,22,0.000022,1,1,1,5.166667,0.1,0.000936
9408001,9408001,,4,1,5,4,1,5,0.000021,0.000001,0,13391,22,0.000016,1,1,1,12,0.15,0.000943
9407081,9407081,,4,0,4,4,0,4,0.000061,0,0,13390,4,0.000027,0,0,0,0,0.083333,0.000917
9303091,9303091,,2,2,4,2,2,4,0.000001,0,0,13401,22,0.000012,1,1,1,7,0.166667,0.000451
9706176,9706176,,1,15,16,1,15,16,0,0.000034,0,13403,22,0.000011,8,0.266228,0.32593,376.374458,0.054167,0.000226
9706156,9706156,,4,19,23,4,19,23,0.000194,0.008564,0,6440,2,0.000013,15,0.194997,0.234332,29559.089655,0.118577,0.001051
9802018,9802018,,3,11,14,3,11,14,0.000066,0.000115,0,8783,10,0.000013,13,0.178462,0.202868,2144.816604,0.181319,0.000785
9903254,9903254,,7,5,12,7,5,12,0.000175,0.000037,0,13383,30,0.00002,14,0.163316,0.180961,6481.644936,0.136364,0.001891
9905092,9905092,,8,33,41,8,33,41,0.000773,0.00371,0,12390,2,0.000013,13,0.191881,0.221475,18383.150585,0.12439,0.002497
9804063,9804063,,2,9,11,2,9,11,0.000054,0,0,12100,6,0.000011,3,0.666667,0.797619,28018.718993,0.090909,0.000515
9310089,9310089,,1,3,4,1,3,4,0,0,0,12099,6,0.000011,1,1,1,0,0.25,0.000233
9402053,9402053,,7,2,9,7,2,9,0,0,0,12098,6,0.00002,2,0.666667,0.75,7553.536813,0.097222,0.001601
9409153,9409153,,3,5,8,3,5,8,0,0,0,12094,6,0.000015,1,1,1,140.914204,0.214286,0.000678
9706086,9706086,,1,3,4,1,3,4,0,0,0,12095,6,0.000011,2,0.666667,0.75,0,0.416667,0.000233
3270,3270,,2,11,13,2,11,13,0.000013,0.001764,0,13409,30,0.000014,13,0.191711,0.209977,43762.486371,0.083333,0.000484
9204054,9204054,,4,2,6,4,2,6,0,0,0,4818,15,0.000033,1,1,1,3039.265099,0.233333,0.000944
9311114,9311114,,5,4,9,5,4,9,0,0,0,4819,15,0.000036,1,1,1,16941.621146,0.097222,0.001237
9602159,9602159,,2,5,7,2,5,7,0.000001,0.000001,0,6610,30,0.000017,3,0.590909,0.679487,4811.065557,0.071429,0.000518
3271,3271,,9,8,17,9,8,17,0.001201,0.002253,0,13411,1,0.000015,13,0.18,0.200013,15882.180284,0.113971,0.002264
9912045,9912045,,5,8,13,5,8,13,0.000356,0.001097,0,13410,1,0.000014,12,0.188465,0.205519,7949.076768,0.147436,0.001246
9211063,9211063,,6,0,6,6,0,6,0.000012,0,0,825,0,0.00003,0,0,0,0,0.1,0.001504
3273,3273,,21,10,31,21,10,31,0.00087,0.000272,0,13412,2,0.000023,13,0.192512,0.214512,24412.313233,0.197849,0.00572
9811094,9811094,,4,5,9,4,5,9,0.000108,0.000011,0,12737,5,0.000016,16,0.143068,0.156166,5938.154108,0.208333,0.000953
9908156,9908156,,4,8,12,4,8,12,0.000186,0.000013,0,12738,5,0.000015,16,0.143341,0.157266,14136.79459,0.128788,0.000927
9610136,9610136,,5,3,8,5,3,8,0.000006,0.00009,0,6531,5,0.000024,7,0.215873,0.247987,4820.854624,0.214286,0.001434
9703092,9703092,,3,3,6,3,3,6,0,0,0,12736,5,0.000016,9,0.207447,0.231461,3870.041976,0.3,0.000718
9812019,9812019,,3,2,5,3,2,5,0.000026,0,0,12735,22,0.000016,3,0.5,0.560606,2019.736993,0.2,0.00073
3276,3276,,2,10,12,2,10,12,0,0.000004,0,13413,6,0.000013,14,0.125312,0.145296,1861.4044,0.136364,0.000451
9308053,9308053,,6,1,7,6,1,7,0,0,0,5000,6,0.000018,1,1,1,1.953968,0.166667,0.001383
9309118,9309118,,7,1,8,7,1,8,0.000001,0,0,4071,6,0.000043,1,1,1,69.330665,0.071429,0.0018
9502060,9502060,,12,4,16,12,4,16,0.000001,0.000001,0,4087,6,0.000027,4,0.39759,0.467172,822.131741,0.0875,0.002773
9601051,9601051,,4,16,20,4,16,20,0.000055,0.000008,0,10872,6,0.000013,7,0.3,0.404286,10221.600192,0.126316,0.000962
9409138,9409138,,17,7,24,17,7,24,0.000086,0.000031,0,4085,6,0.000041,3,0.571429,0.6875,4381.641571,0.077899,0.004325
9410208,9410208,,1,1,2,1,1,2,0,0,0,4084,6,0.000016,1,1,1,0,0.5,0.000416
9409130,9409130,,7,6,13,7,6,13,0,0.000003,0,2350,6,0.000021,3,0.611111,0.742424,22479.062004,0.115385,0.001667
9506074,9506074,,2,6,8,2,6,8,0,0,0,7813,6,0.000013,4,0.421053,0.5,784.232895,0.107143,0.000486
9507070,9507070,,7,6,13,7,6,13,0.00009,0.000004,0,3092,6,0.000023,4,0.469388,0.568841,139212.079344,0.102564,0.001985
9507118,9507118,,9,22,31,9,22,31,0.000004,0.000008,0,7811,6,0.000026,6,0.371981,0.529221,42793.130217,0.080645,0.002134
9508080,9508080,,3,7,10,3,7,10,0,0.000007,0,7814,6,0.000015,7,0.283582,0.355353,8982.579804,0.177778,0.000751
9401008,9401008,,13,1,14,13,1,14,0.000005,0,0,2415,6,0.000041,2,0.666667,0.75,274.560494,0.120879,0.003618
9505124,9505124,,6,7,13,6,7,13,0.000004,0.000004,0,13216,6,0.00002,5,0.442857,0.547849,134.389024,0.185897,0.001518
9803136,9803136,,4,11,15,4,11,15,0,0.000013,0,13271,6,0.000016,13,0.151139,0.173403,13156.273636,0.095238,0.000978
3277,3277,,8,10,18,8,10,18,0.000004,0.000133,0,13419,22,0.000021,14,0.176378,0.196771,55040.778557,0.098039,0.002033
9404061,9404061,,14,2,16,14,2,16,0.000028,0.000001,0,4278,22,0.000038,1,1,1,90.397122,0.166667,0.003386
9405051,9405051,,1,3,4,1,3,4,0.000002,0.000001,0,13418,22,0.000012,1,1,1,1.433333,0.333333,0.000275
9608048,9608048,,9,1,10,9,1,10,0.000002,0,0,13417,6,0.00007,5,0.318182,0.42619,89.366667,0.1,0.002147
9905135,9905135,,11,2,13,11,2,13,0.000015,0.00002,0,11044,22,0.000029,2,0.5625,0.611111,4023.450646,0.153846,0.002661
9601088,9601088,,4,2,6,4,2,6,0,0,0,13416,22,0.000086,4,0.4,0.555556,108.666667,0.166667,0.000992
9612122,9612122,,3,1,4,3,1,4,0.000015,0,0,11043,22,0.000026,1,1,1,146.553405,0.083333,0.000752
9411104,9411104,,17,0,17,17,0,17,0.000482,0,0,11045,0,0.000028,0,0,0,0,0.198529,0.00462
3278,3278,,37,24,61,37,24,61,0.0011,0.002035,0,12857,3,0.000052,15,0.200034,0.222723,64769.125928,0.18224,0.022036
3280,3280,,24,42,66,24,42,66,0.002325,0.006133,0,12394,2,0.000021,12,0.213605,0.243078,81296.011743,0.082284,0.00723
9908169,9908169,,10,7,17,10,7,17,0.001034,0.003144,0,10136,0,0.000015,15,0.195004,0.2256,3823.062867,0.143382,0.002939
9912225,9912225,,6,18,24,6,18,24,0.000481,0.004661,0,12153,0,0.000014,15,0.191663,0.220897,45671.974701,0.13587,0.002043
9905071,9905071,,1,8,9,1,8,9,0.000065,0.003865,0,9480,2,0.000011,13,0.18371,0.209107,3075.735887,0.208333,0.000696
3281,3281,,11,21,32,11,21,32,0.001159,0.019079,0,12355,1,0.000017,13,0.205211,0.232745,13961.180695,0.082661,0.00313
9709174,9709174,,4,13,17,4,13,17,0.000317,0.004095,0,5528,13,0.000013,13,0.199101,0.232691,3536.225373,0.139706,0.001166
3282,3282,,3,1,4,3,1,4,0.000327,0.000001,0,13422,0,0.000012,15,0.144893,0.154848,4221.99911,0.083333,0.000892
9911029,9911029,,6,5,11,6,5,11,0.000099,0.000088,0,13421,0,0.000023,14,0.169418,0.186067,8719.552628,0.145455,0.001478
9905122,9905122,,7,13,20,7,13,20,0.000014,0.000154,0,13420,0,0.000019,14,0.173721,0.195101,5283.95503,0.194737,0.001697
3283,3283,,1,1,2,1,1,2,0,0,0,13424,9,0.000012,1,1,1,0,0.5,0.000219
9911219,9911219,,3,0,3,3,0,3,0,0,0,13423,9,0.000028,0,0,0,0,0.333333,0.00067
3284,3284,,5,36,41,5,36,41,0.000906,0.019599,0,13426,1,0.000012,12,0.215661,0.244285,5322.087726,0.15,0.001305
9909071,9909071,,4,31,35,4,31,35,0.000842,0.021184,0,13425,1,0.000011,12,0.212969,0.241433,1889.214739,0.165546,0.001029
9502119,9502119,,6,10,16,6,10,16,0.00033,0.001318,0,1127,13,0.000028,7,0.275301,0.323418,294.698251,0.204167,0.003263
9509090,9509090,,7,7,14,7,7,14,0.000204,0.000475,0,1406,13,0.000029,9,0.234089,0.269351,7123.258428,0.214286,0.002249
9605050,9605050,,3,8,11,3,8,11,0.000341,0.001726,0,2886,0,0.000015,10,0.216376,0.249672,36450.845162,0.081818,0.001362
9811170,9811170,,6,31,37,6,31,37,0.000442,0.008666,0,8792,2,0.000013,12,0.202927,0.234953,4187.626912,0.144895,0.001536
9903002,9903002,,11,17,28,11,17,28,0.001089,0.000617,0,8810,4,0.000013,12,0.189281,0.215075,33901.874969,0.232804,0.003074
3285,3285,,8,18,26,8,18,26,0.000568,0.00179,0,13427,41,0.000014,14,0.178402,0.200131,11058.899458,0.195385,0.002052
9703174,9703174,,5,22,27,5,22,27,0.000496,0.010484,0,6460,13,0.000015,11,0.216912,0.258372,7477.648039,0.111111,0.001353
9210110,9210110,,4,1,5,4,1,5,0,0,0,6044,15,0.000032,1,1,1,517.221796,0,0.001004
9305156,9305156,,2,0,2,2,0,2,0.000001,0,0,6042,41,0.000017,0,0,0,0,0.5,0.00056
9601137,9601137,,1,2,3,1,2,3,0,0.000019,0,6899,41,0.000018,5,0.350877,0.4225,18,0.333333,0.000305
9405183,9405183,,7,0,7,7,0,7,0.000483,0,0,6459,52,0.000026,0,0,0,0,0,0.001714
9402040,9402040,,1,0,1,1,0,1,0.00001,0,0,11217,41,0.000011,0,0,0,0,0,0.000283
9609001,9609001,,2,6,8,2,6,8,0.000015,0.000024,0,11216,41,0.000012,7,0.222741,0.269647,7593.566852,0.071429,0.000516
3287,3287,,0,1,1,0,1,1,0,0,0,13428,26,0.00001,2,0.666667,0.75,0,0,0
3288,3288,,2,13,15,2,13,15,0.000003,0.000217,0,13433,23,0.000012,15,0.170114,0.190153,5420.80694,0.157143,0.000603
9702062,9702062,,2,0,2,2,0,2,0.000003,0,0,13432,21,0.000012,0,0,0,0,0,0.00046
9712088,9712088,,13,9,22,13,9,22,0.000058,0.003334,0,6717,23,0.000042,16,0.186787,0.213571,127430.613819,0.121212,0.003302
9807086,9807086,,1,3,4,1,3,4,0.000003,0.000127,0,13431,2,0.000011,15,0.17353,0.193563,2430.208755,0.083333,0.000234
9809123,9809123,,9,4,13,9,4,13,0.000311,0.000009,0,9339,23,0.000027,17,0.157599,0.173294,6613.523111,0.237179,0.002271
9811150,9811150,,6,10,16,6,10,16,0.000003,0.000475,0,13429,23,0.000017,14,0.175408,0.197041,23234.695106,0.175,0.00139
9911235,9911235,,2,7,9,2,7,9,0.000003,0.00002,0,13430,23,0.000012,15,0.159702,0.17582,2.166667,0.333333,0.00046
4083,4083,,4,6,10,4,6,10,0.000048,0.000017,0,13435,23,0.000015,17,0.157747,0.17374,10847.018137,0.166667,0.001139
9311059,9311059,,4,0,4,4,0,4,0.00004,0,0,13434,23,0.000016,0,0,0,0,0.25,0.00094
9202056,9202056,,14,0,14,14,0,14,0.000069,0,0,2946,15,0.000265,0,0,0,0,0.049451,0.003585
9212005,9212005,,6,2,8,6,2,8,0,0.000001,0,2947,15,0.000064,1,1,1,10826.21497,0.214286,0.001493
9405001,9405001,,6,2,8,6,2,8,0.00004,0.000014,0,3175,23,0.000041,3,0.555556,0.666667,111.689569,0.178571,0.001496
9709089,9709089,,3,10,13,3,10,13,0.000139,0.00303,0,8036,2,0.000014,13,0.194006,0.220853,127427.402529,0.121795,0.000813
9801115,9801115,,5,5,10,5,5,10,0.000006,0,0,9337,23,0.000032,2,0.857143,0.916667,11129.553357,0.066667,0.001366
9803165,9803165,,4,3,7,4,3,7,0.000006,0.000009,0,9338,23,0.000019,17,0.157572,0.173124,317.680086,0.357143,0.000979
3289,3289,,8,42,50,8,42,50,0.001716,0.022331,0,13015,1,0.000013,11,0.23166,0.265196,25583.80173,0.136327,0.002164
9709038,9709038,,3,21,24,3,21,24,0.00038,0.009547,0,5269,2,0.000011,12,0.199711,0.232335,83.929206,0.248188,0.000752
3290,3290,,10,14,24,10,14,24,0.000348,0.000136,0,13446,5,0.000018,15,0.15161,0.171435,4762.344636,0.224638,0.002586
9701060,9701060,,29,8,37,29,8,37,0.000073,0.000077,0,8532,5,0.000078,11,0.164706,0.182841,34586.224674,0.096096,0.007321
9801122,9801122,,12,7,19,12,7,19,0.000352,0.000127,0,7481,5,0.000023,18,0.147243,0.177161,826.732931,0.280702,0.003555
9803184,9803184,,13,2,15,13,2,15,0.000004,0.000002,0,13443,5,0.000038,12,0.141556,0.15218,771.592844,0.261905,0.003313
9803200,9803200,,10,3,13,10,3,13,0.000004,0.000001,0,13444,5,0.000026,12,0.14196,0.153558,3145.086955,0.282051,0.002636
9904146,9904146,,8,36,44,8,36,44,0.000446,0.000448,0,13442,5,0.000017,14,0.172805,0.200366,53025.798022,0.143763,0.002312
9909086,9909086,,20,11,31,20,11,31,0.000817,0.000118,0,13445,5,0.000034,15,0.151572,0.171074,34113.690039,0.143011,0.005107
9407104,9407104,,11,3,14,11,3,14,0.000259,0.000011,0,6246,5,0.00002,3,0.521739,0.597222,172.795791,0.115385,0.003057
9606098,9606098,,8,11,19,8,11,19,0.000038,0.000074,0,6515,5,0.000018,9,0.252177,0.286493,35774.836361,0.137427,0.00215
9611219,9611219,,1,15,16,1,15,16,0.000002,0.000083,0,6521,5,0.000012,10,0.244392,0.28468,16560.751698,0.1625,0.000365
9704014,9704014,,6,11,17,6,11,17,0.000227,0.000078,0,6518,5,0.000015,10,0.217846,0.257268,4731.892344,0.088235,0.001532
9206087,9206087,,15,1,16,15,1,16,0.00029,0.00001,0,88,5,0.000031,1,1,1,1.001543,0.129167,0.004543
9207046,9207046,,15,0,15,15,0,15,0.000732,0,0,3655,5,0.000029,0,0,0,0,0.066667,0.004014
9208015,9208015,,19,0,19,19,0,19,0.00064,0,0,6509,5,0.000062,0,0,0,0,0.096491,0.00533
9301106,9301106,,7,9,16,7,9,16,0.000413,0.000055,0,6526,5,0.000022,1,1,1,13744.541833,0.079167,0.002025
9304091,9304091,,11,10,21,11,10,21,0.000635,0.000059,0,6524,5,0.000021,2,0.916667,0.954545,4220.47399,0.090476,0.003093
9412138,9412138,,24,25,49,24,25,49,0.001392,0.000494,0,1012,5,0.000045,6,0.382629,0.472086,25018.247107,0.072279,0.006971
9412139,9412139,,4,1,5,4,1,5,0.000015,0.000001,0,6523,5,0.000014,2,0.666667,0.75,4456.824858,0.25,0.001319
9308028,9308028,,4,0,4,4,0,4,0.000057,0,0,3308,30,0.000053,0,0,0,0,0.083333,0.001011
9710171,9710171,,17,4,21,17,4,21,0.000043,0.000022,0,9284,5,0.000041,12,0.142017,0.154749,4347.147586,0.2,0.004215
9405007,9405007,,5,8,13,5,8,13,0.000108,0.000069,0,1994,5,0.000019,2,0.564516,0.614286,14831.42657,0.064103,0.001773
9607226,9607226,,25,5,30,25,5,30,0.000548,0.000029,0,8195,5,0.000029,5,0.372414,0.435802,6581.619331,0.106897,0.006492
9707115,9707115,,11,23,34,11,23,34,0.0003,0.000192,0,8196,5,0.000022,19,0.148477,0.197133,8907.885067,0.096257,0.002939
9709074,9709074,,4,3,7,4,3,7,0.00001,0.000005,0,8231,5,0.000013,2,0.6,0.666667,2257.335,0.166667,0.001112
9807122,9807122,,7,12,19,7,12,19,0.000221,0.000099,0,8198,5,0.000014,20,0.130374,0.165362,10236.263751,0.131579,0.00193
9809168,9809168,,11,20,31,11,20,31,0.000274,0.000137,0,8229,5,0.000023,16,0.185535,0.214958,175414.751684,0.104301,0.002798
9712015,9712015,,4,23,27,4,23,27,0.000011,0.000268,0,7460,5,0.000017,18,0.151018,0.197605,3123.002243,0.139601,0.001067
9802139,9802139,,8,22,30,8,22,30,0.000698,0.000224,0,7463,5,0.000019,13,0.185482,0.21788,28557.904098,0.137931,0.002117
9803081,9803081,,3,15,18,3,15,18,0.000408,0.000154,0,13440,5,0.000011,13,0.160866,0.183195,8897.193132,0.140523,0.000878
9812164,9812164,,4,14,18,4,14,18,0.000408,0.000207,0,13436,5,0.000016,15,0.176354,0.198243,11101.423139,0.300654,0.001117
9902035,9902035,,5,18,23,5,18,23,0.000416,0.000215,0,13441,5,0.000012,15,0.168967,0.192219,1742.157189,0.247036,0.001331
3292,3292,,2,5,7,2,5,7,0.000193,0.000066,0,13447,2,0.000011,14,0.173688,0.186934,60.211544,0.357143,0.000459
9501141,9501141,,7,1,8,7,1,8,0.000003,0.000007,0,5559,2,0.000038,1,1,1,2.5,0.178571,0.001788
9507125,9507125,,9,1,10,9,1,10,0.000122,0.000007,0,5558,2,0.00004,1,1,1,0,0.2,0.00228
3293,3293,,1,1,2,1,1,2,0,0,0,13448,23,0.000013,1,1,1,1,0,0.000219
9204070,9204070,,5,0,5,5,0,5,0.000001,0,0,7292,52,0.000063,0,0,0,0,0.1,0.001228
3294,3294,,19,4,23,19,4,23,0.000769,0.002527,0,12889,30,0.000022,13,0.191617,0.210417,3812.651667,0.136364,0.006643
3295,3295,,15,7,22,15,7,22,0.001488,0.015275,0,13449,1,0.000031,12,0.1987,0.220153,2256.484138,0.251082,0.004017
3296,3296,,1,10,11,1,10,11,0,0.000007,0,13450,22,0.000013,17,0.12667,0.137204,72.235119,0.236364,0.000219
9609222,9609222,,2,2,4,2,2,4,0,0,0,7768,23,0.000027,1,1,1,325.402293,0.166667,0.000492
9610025,9610025,,4,4,8,4,4,8,0.000001,0.000025,0,12539,22,0.000019,3,0.588235,0.683333,77.929701,0.178571,0.000994
9808071,9808071,,6,2,8,6,2,8,0.000002,0.000013,0,12543,22,0.000024,19,0.112756,0.12767,1761.772007,0.214286,0.001546
9810238,9810238,,1,4,5,1,4,5,0,0.000005,0,12554,23,0.000012,8,0.193939,0.241257,218.152259,0.15,0.000232
3297,3297,,5,9,14,5,9,14,0.000015,0.000003,0,13452,23,0.00002,16,0.148782,0.164143,13102.999394,0.192308,0.001115
9901010,9901010,,8,2,10,8,2,10,0.000016,0.000001,0,11374,23,0.000026,16,0.149075,0.160252,2872.39935,0.255556,0.001894
9909033,9909033,,9,4,13,9,4,13,0.00002,0.000002,0,11375,23,0.000023,16,0.149145,0.160651,21417.797739,0.217949,0.002209
9909221,9909221,,5,6,11,5,6,11,0.000016,0.000055,0,13451,23,0.000017,15,0.168101,0.186836,20445.439641,0.272727,0.001141
3298,3298,,20,34,54,20,34,54,0.000728,0.004152,0,11644,52,0.000018,14,0.200101,0.229154,32501.336634,0.131027,0.006751
9505059,9505059,,8,0,8,8,0,8,0.000058,0,0,5812,52,0.000065,0,0,0,0,0.071429,0.002119
9705018,9705018,,3,1,4,3,1,4,0.000001,0,0,8638,52,0.000016,4,0.369565,0.411765,541.933722,0.083333,0.000787
3301,3301,,7,3,10,7,3,10,0.000094,0.000061,0,13454,26,0.000016,16,0.151504,0.165521,6422.937491,0.111111,0.001698
9807151,9807151,,4,5,9,4,5,9,0.000531,0.015409,0,13453,1,0.000024,15,0.178494,0.202298,12008.378536,0.236111,0.001048
4002,4002,,3,28,31,3,28,31,0.00003,0.002515,0,13457,30,0.000011,13,0.20435,0.22566,8777.330872,0.145161,0.000711
9912124,9912124,,3,28,31,3,28,31,0.000126,0.003613,0,13456,4,0.000011,17,0.191795,0.225172,10304.966949,0.201075,0.000728
9205006,9205006,,8,1,9,8,1,9,0.000001,0,0,4178,17,0.000054,1,1,1,7606.739728,0.055556,0.002077
9507167,9507167,,2,9,11,2,9,11,0.000001,0.000071,0,6023,0,0.000018,7,0.238961,0.295432,2828.339578,0.2,0.000668
9510014,9510014,,2,7,9,2,7,9,0.000002,0.000027,0,6021,23,0.000017,2,0.818182,0.888889,28483.384011,0.097222,0.000729
9603188,9603188,,2,30,32,2,30,32,0.000001,0.003502,0,6018,4,0.00002,11,0.214668,0.264828,48282.684915,0.113911,0.000707
9609205,9609205,,3,10,13,3,10,13,0.000001,0.000014,0,6038,23,0.00002,7,0.224204,0.283915,24979.684876,0.044872,0.000822
9704136,9704136,,5,6,11,5,6,11,0.000027,0.000006,0,6035,23,0.000019,13,0.162769,0.186749,56.724855,0.309091,0.001319
9801130,9801130,,2,0,2,2,0,2,0.000106,0,0,10880,4,0.00001,0,0,0,0,0.5,0.000487
9912088,9912088,,8,53,61,8,53,61,0.00051,0.004375,0,13455,4,0.000013,18,0.196117,0.238629,6226.11492,0.17459,0.00221
4006,4006,,2,7,9,2,7,9,0.000007,0.000154,0,13458,4,0.000011,13,0.182597,0.207798,1.515335,0.263889,0.000458
9602160,9602160,,8,11,19,8,11,19,0.000014,0.000079,0,7599,4,0.000018,8,0.237832,0.306401,10383.004277,0.111111,0.001927
201211,201211,,2,13,15,2,13,15,0.000067,0.00007,0,13459,4,0.000011,13,0.170295,0.192162,594.886487,0.07619,0.000458
9402054,9402054,,1,0,1,1,0,1,0.000001,0,0,7598,4,0.000011,0,0,0,0,0,0.000273
9511185,9511185,,3,3,6,3,3,6,0.00008,0.000034,0,2876,4,0.000015,11,0.180714,0.200093,399.483449,0.266667,0.001534
4007,4007,,0,2,2,0,2,2,0,0,0,13460,23,0.00001,2,0.75,0.833333,0,0.5,0
9904107,9904107,,14,2,16,14,2,16,0,0,0,12079,23,0.000048,1,1,1,1724.533333,0.208333,0.003395
9307117,9307117,,7,0,7,7,0,7,0,0,0,12078,23,0.000053,0,0,0,0,0.166667,0.001784
4008,4008,,0,2,2,0,2,2,0,0,0,13464,20,0.00001,4,0.461538,0.597222,0,0,0
9612110,9612110,,4,2,6,4,2,6,0,0,0,13463,20,0.000018,3,0.571429,0.708333,45.346825,0.033333,0.000949
9612111,9612111,,4,0,4,4,0,4,0,0,0,13461,20,0.000018,0,0,0,0,0,0.000949
9606160,9606160,,1,2,3,1,2,3,0,0.000001,0,13462,20,0.000018,2,0.75,0.833333,9.47619,0.166667,0.000246
4009,4009,,7,36,43,7,36,43,0.001672,0.026691,0,11608,1,0.000014,11,0.236616,0.272569,11822.665993,0.115172,0.003185
9710169,9710169,,1,2,3,1,2,3,0.000085,0.000003,0,5657,41,0.000011,10,0.153409,0.177594,185153.436093,0,0.000318
9711082,9711082,,6,56,62,6,56,62,0.000822,0.016958,0,5859,2,0.000013,15,0.203031,0.245338,7177.762588,0.131676,0.001715
9709033,9709033,,8,43,51,8,43,51,0.00113,0.010404,0,4880,13,0.000017,17,0.221793,0.269167,37557.027791,0.105098,0.003089
9812126,9812126,,1,15,16,1,15,16,0.00028,0.003973,0,8300,4,0.000011,14,0.205937,0.235337,259.32513,0.2125,0.000699
4010,4010,,4,12,16,4,12,16,0,0,0,13468,22,0.000014,8,0.195467,0.243713,564.245238,0.241667,0.000929
9611004,9611004,,7,3,10,7,3,10,0,0,0,9018,22,0.000026,3,0.571429,0.666667,0,0.344444,0.001806
9801168,9801168,,5,0,5,5,0,5,0,0,0,13466,22,0.000016,0,0,0,0,0.25,0.001162
9904206,9904206,,2,5,7,2,5,7,0,0.000009,0,13467,22,0.000012,9,0.165301,0.199717,42.102778,0.190476,0.000465
9908032,9908032,,5,3,8,5,3,8,0,0,0,13465,22,0.000015,9,0.16361,0.191994,44.316667,0.303571,0.001175
4153,4153,,4,1,5,4,1,5,0,0,0,13469,22,0.000014,9,0.159136,0.178249,0,0.5,0.000929
9307055,9307055,,1,0,1,1,0,1,0,0,0,9028,22,0.00004,0,0,0,0,0,0.000317
9606018,9606018,,5,0,5,5,0,5,0,0,0,9027,22,0.000044,0,0,0,0,0.5,0.001246
9806248,9806248,,2,3,5,2,3,5,0,0,0,9031,22,0.000016,10,0.140187,0.16287,193.747502,0.25,0.000488
4011,4011,,16,25,41,16,25,41,0.001879,0.011524,0,12910,30,0.000016,11,0.238449,0.269381,62355.286179,0.145122,0.004834
9911119,9911119,,3,21,24,3,21,24,0.000406,0.005236,0,12909,2,0.000011,14,0.193932,0.2222,11713.562817,0.163043,0.00078
9908154,9908154,,4,13,17,4,13,17,0.000456,0.001527,0,11652,2,0.000011,15,0.195312,0.220492,4652.968842,0.216912,0.001175
4012,4012,,1,8,9,1,8,9,0,0.000022,0,13473,23,0.000015,14,0.147892,0.161763,11776.659359,0.111111,0.000259
9309060,9309060,,1,0,1,1,0,1,0,0,0,13472,23,0.000012,0,0,0,0,0,0.000226
9312173,9312173,,2,0,2,2,0,2,0,0,0,13470,23,0.00003,0,0,0,0,0.5,0.000458
9606053,9606053,,2,1,3,2,1,3,0,0,0,13471,23,0.00002,1,1,1,1,0.166667,0.000445
9805201,9805201,,3,4,7,3,4,7,0.000044,0.000033,0,9604,4,0.000015,15,0.148027,0.162719,7.56923,0.333333,0.000875
9809002,9809002,,3,0,3,3,0,3,0.000063,0,0,11128,25,0.000017,0,0,0,0,0.333333,0.001294
4015,4015,,49,12,61,49,12,61,0.002243,0.001236,0,12850,3,0.00005,13,0.183024,0.201555,1262.998838,0.203825,0.025881
4017,4017,,5,14,19,5,14,19,0.000187,0.00064,0,13474,1,0.000014,12,0.2005,0.223906,4785.742822,0.187135,0.00113
9209058,9209058,,29,4,33,29,4,33,0.000632,0.000035,0,341,5,0.000155,1,1,1,7805.845354,0.054924,0.008793
4018,4018,,2,1,3,2,1,3,0.000002,0.000003,0,13475,15,0.000013,14,0.168346,0.179092,614.338659,0.166667,0.000471
4019,4019,,11,14,25,11,14,25,0.000623,0.000284,0,13476,1,0.000022,12,0.213733,0.237572,74944.067832,0.071667,0.002691
4020,4020,,2,3,5,2,3,5,0.000033,0.000003,0,13477,5,0.000011,4,0.394366,0.46131,28.900702,0.2,0.000466
9501048,9501048,,3,1,4,3,1,4,0.000002,0.000001,0,5632,5,0.000209,1,1,1,94.223954,0.083333,0.00111
9506204,9506204,,6,0,6,6,0,6,0,0,0,5631,5,0.000049,0,0,0,0,0.166667,0.001713
9507096,9507096,,5,3,8,5,3,8,0,0.000001,0,5630,5,0.000045,2,0.571429,0.625,87.773071,0.25,0.001489
9601006,9601006,,4,7,11,4,7,11,0,0.000007,0,5636,5,0.000038,3,0.568182,0.633333,1113.361827,0.154545,0.001155
4023,4023,,1,10,11,1,10,11,0.000099,0.003875,0,13479,2,0.000011,13,0.185346,0.211843,691.772581,0.181818,0.000219
9909119,9909119,,2,27,29,2,27,29,0.000105,0.010974,0,13478,2,0.000011,13,0.19496,0.224355,537.890603,0.199507,0.000477
4024,4024,,15,8,23,15,8,23,0.000562,0.001792,0,12895,30,0.000023,14,0.190655,0.20884,13273.066459,0.227273,0.005631
4025,4025,,5,10,15,5,10,15,0.000381,0.000873,0,13481,52,0.000011,14,0.174277,0.19655,2606.02811,0.17619,0.001211
9912104,9912104,,5,38,43,5,38,43,0.000234,0.013261,0,13480,2,0.000012,13,0.195565,0.2305,4061.790866,0.124585,0.001205
9702197,9702197,,2,4,6,2,4,6,0.000302,0.000149,0,6102,0,0.00001,11,0.193842,0.216297,3.344038,0.2,0.00055
4026,4026,,1,15,16,1,15,16,0.000026,0.000072,0,13482,26,0.000011,16,0.162478,0.181718,6547.71324,0.2375,0.000279
4027,4027,,11,11,22,11,11,22,0.000284,0.012057,0,13486,5,0.000017,14,0.17657,0.199989,13197.191698,0.140693,0.00275
9811246,9811246,,4,7,11,4,7,11,0.000383,0.000062,0,11616,5,0.000013,7,0.256906,0.300043,461.526009,0.190909,0.001223
9911091,9911091,,10,23,33,10,23,33,0.000565,0.014118,0,13485,13,0.000018,13,0.198651,0.229142,33944.148727,0.114583,0.00248
9302144,9302144,,6,7,13,6,7,13,0.00001,0.000051,0,412,5,0.000017,1,1,1,44.043967,0.102564,0.001695
9910244,9910244,,6,31,37,6,31,37,0.000661,0.00647,0,13484,13,0.000013,13,0.19296,0.221329,8724.637562,0.09009,0.00161
4030,4030,,8,29,37,8,29,37,0.002229,0.023152,0,13487,1,0.000012,14,0.223656,0.256894,4487.823974,0.22973,0.002218
4031,4031,,0,4,4,0,4,4,0,0.000071,0,13488,2,0.00001,14,0.170717,0.189503,0,0,0
9407103,9407103,,3,2,5,3,2,5,0.00004,0.000006,0,7514,23,0.000015,3,0.545455,0.638889,34.51543,0.1,0.000692
9310121,9310121,,5,2,7,5,2,7,0.000002,0.000002,0,5677,6,0.000019,1,1,1,383.263675,0.095238,0.001188
9312085,9312085,,3,0,3,3,0,3,0.000001,0,0,5676,6,0.000015,0,0,0,0,0.166667,0.000743
4032,4032,,10,13,23,10,13,23,0.000409,0.000604,0,13492,1,0.000023,12,0.168437,0.183839,99493.231229,0.039526,0.002354
9204057,9204057,,23,0,23,23,0,23,0.00026,0,0,13491,30,0.000044,0,0,0,0,0.071146,0.006663
9309147,9309147,,5,0,5,5,0,5,0.000035,0,0,12317,5,0.000017,0,0,0,0,0.05,0.001235
9606162,9606162,,1,0,1,1,0,1,0.000007,0,0,13490,1,0.000011,0,0,0,0,0,0.000286
9709135,9709135,,2,5,7,2,5,7,0.000074,0.003042,0,13489,4,0.000012,10,0.204841,0.231846,2911.081398,0.071429,0.000512
9709205,9709205,,3,1,4,3,1,4,0.000056,0.000001,0,10867,5,0.000015,11,0.17489,0.192544,6932.7441,0,0.000751
5122,5122,,14,8,22,14,8,22,0.00025,0.000036,0,13493,22,0.000027,13,0.144826,0.155024,48858.6995,0.125541,0.00348
9511072,9511072,,15,5,20,15,5,20,0.000037,0.000013,0,4280,22,0.000046,5,0.326241,0.396377,8462.289098,0.139474,0.003925
9711170,9711170,,4,5,9,4,5,9,0.00003,0.000003,0,10295,22,0.000017,8,0.22211,0.260747,3519.325247,0.097222,0.001017
4036,4036,,9,5,14,9,5,14,0.000327,0.000223,0,13494,2,0.000022,14,0.176812,0.196965,11690.414471,0.071429,0.002135
4037,4037,,1,30,31,1,30,31,0.000205,0.013339,0,13496,13,0.00001,13,0.234057,0.272308,1336.406539,0.137634,0.000246
9511067,9511067,,2,6,8,2,6,8,0.000168,0.000554,0,13495,13,0.000011,4,0.363636,0.440476,55.073217,0.089286,0.00046
9904011,9904011,,7,35,42,7,35,42,0.00087,0.019554,0,11619,13,0.000012,13,0.200554,0.239739,16613.326751,0.123113,0.001861
9711093,9711093,,2,32,34,2,32,34,0.000288,0.00947,0,8215,13,0.000011,14,0.214984,0.25915,2288.710869,0.14082,0.000511
9804064,9804064,,6,9,15,6,9,15,0.00079,0.001524,0,6570,13,0.000012,14,0.176004,0.204794,297.030168,0.171429,0.001523
9806182,9806182,,1,22,23,1,22,23,0.000076,0.019172,0,13483,2,0.00001,13,0.196452,0.225631,397.79767,0.124506,0.000262
9402049,9402049,,3,0,3,3,0,3,0.00032,0,0,6941,4,0.000013,0,0,0,0,0.333333,0.000967
9811177,9811177,,3,14,17,3,14,17,0.000308,0.003419,0,8571,4,0.000012,14,0.183262,0.213235,1849.065689,0.198529,0.000785
9711025,9711025,,6,10,16,6,10,16,0.000103,0.000151,0,9827,0,0.000015,12,0.190566,0.215759,3525.560155,0.295833,0.001523
4040,4040,,4,30,34,4,30,34,0.000935,0.022858,0,13497,1,0.000012,12,0.213175,0.241751,3362.988653,0.179144,0.001109
9812165,9812165,,3,20,23,3,20,23,0.000548,0.020072,0,12209,1,0.000011,12,0.197075,0.225593,634.579782,0.136364,0.000863
9605017,9605017,,2,15,17,2,15,17,0.000191,0.004511,0,2099,13,0.000011,10,0.226543,0.259289,152.935393,0.286765,0.000798
4041,4041,,1,11,12,1,11,12,0,0.000078,0,13499,5,0.000014,14,0.164777,0.182054,6759.616667,0.159091,0.000219
9902057,9902057,,2,8,10,2,8,10,0.000001,0.000003,0,13498,5,0.000015,4,0.461538,0.550926,38.216667,0.2,0.000445
9405043,9405043,,3,1,4,3,1,4,0,0,0,9217,20,0.000025,1,1,1,0,0.25,0.000772
4043,4043,,5,2,7,5,2,7,0.000056,0.000015,0,13500,2,0.000022,18,0.122413,0.135973,9389.684691,0.047619,0.001212
4044,4044,,3,4,7,3,4,7,0.000171,0.000008,0,13505,22,0.000013,13,0.157597,0.174915,5812.859859,0.071429,0.000721
9204001,9204001,,4,0,4,4,0,4,0.000075,0,0,2250,15,0.000044,0,0,0,0,0.083333,0.001116
9611051,9611051,,3,16,19,3,16,19,0.000215,0.00563,0,7345,22,0.000014,10,0.216566,0.24988,82408.253171,0.084795,0.000742
9911051,9911051,,5,3,8,5,3,8,0.000003,0.000005,0,13504,23,0.000022,12,0.178174,0.196938,18321.069626,0.178571,0.001234
9312200,9312200,,8,0,8,8,0,8,0.000067,0,0,7336,22,0.00004,0,0,0,0,0.267857,0.001895
9409164,9409164,,5,5,10,5,5,10,0.000066,0.000003,0,7337,22,0.000024,4,0.42623,0.509615,5205.672426,0.222222,0.00119
9511167,9511167,,5,11,16,5,11,16,0.000177,0.000011,0,7342,22,0.000029,5,0.377551,0.523423,20224.429059,0.091667,0.001163
9601156,9601156,,3,2,5,3,2,5,0.000066,0.000002,0,7338,22,0.000015,5,0.310345,0.365432,0,0.45,0.000698
9603141,9603141,,2,5,7,2,5,7,0.000177,0.000004,0,7344,22,0.000011,5,0.354545,0.436752,4066.386613,0.309524,0.000459
9603146,9603146,,1,4,5,1,4,5,0.000066,0.000004,0,7343,22,0.000011,5,0.351351,0.423932,0,0.45,0.00024
9809085,9809085,,4,9,13,4,9,13,0.000003,0.006192,0,13501,23,0.000025,11,0.213331,0.244712,64314.715518,0.070513,0.000984
9812108,9812108,,1,4,5,1,4,5,0,0.000005,0,13503,52,0.000017,12,0.178177,0.19705,2447.114229,0.15,0.000253
4046,4046,,1,9,10,1,9,10,0,0.000001,0,13514,23,0.000011,13,0.14876,0.167756,327.509994,0.055556,0.000226
9703020,9703020,,19,3,22,19,3,22,0.000071,0.000001,0,9100,23,0.000059,8,0.186785,0.224328,1400.617427,0.041126,0.004419
9911141,9911141,,1,3,4,1,3,4,0,0.000008,0,13513,23,0.000011,12,0.159407,0.18882,19.529374,0.083333,0.000226
9911143,9911143,,2,3,5,2,3,5,0,0.000008,0,13512,23,0.000011,12,0.158111,0.174831,124.339828,0.1,0.000458
9911144,9911144,,1,2,3,1,2,3,0,0.000001,0,13511,23,0.000011,9,0.159188,0.185871,0.5,0.166667,0.000226
9912197,9912197,,1,1,2,1,1,2,0,0.000001,0,13510,23,0.000011,9,0.158289,0.180371,0,0.5,0.000226
9912198,9912198,,1,3,4,1,3,4,0,0,0,13509,23,0.000011,6,0.279661,0.326263,27.619466,0.166667,0.000226
9912199,9912199,,1,2,3,1,2,3,0,0.000003,0,13508,23,0.000011,12,0.160638,0.185229,7.6523,0.166667,0.000226
9912200,9912200,,1,7,8,1,7,8,0,0.00005,0,13507,23,0.000011,12,0.172814,0.197269,1339.192536,0.071429,0.000226
9912201,9912201,,3,5,8,3,5,8,0.000011,0.000007,0,13506,23,0.000012,12,0.161557,0.183895,1714.478222,0.089286,0.000719
102118,102118,,0,3,3,0,3,3,0,0.000001,0,13515,23,0.00001,9,0.160085,0.191299,0,0,0
9408044,9408044,,7,0,7,7,0,7,0.000005,0,0,9099,23,0.000048,0,0,0,0,0.119048,0.00177
4047,4047,,0,1,1,0,1,1,0,0.000001,0,13516,23,0.00001,9,0.158289,0.180371,0,0,0
4048,4048,,7,13,20,7,13,20,0.000119,0.001119,0,13518,23,0.000018,17,0.176729,0.198974,12658.410511,0.139474,0.001671
9611114,9611114,,9,0,9,9,0,9,0.000063,0,0,11945,23,0.000018,0,0,0,0,0.097222,0.002242
9611115,9611115,,6,0,6,6,0,6,0.000025,0,0,11944,23,0.000016,0,0,0,0,0.133333,0.001525
9611116,9611116,,8,0,8,8,0,8,0.000159,0,0,4879,23,0.000017,0,0,0,0,0.071429,0.002033
9701128,9701128,,21,35,56,21,35,56,0.001486,0.0033,0,5138,4,0.000022,13,0.184285,0.220975,29992.436113,0.11461,0.005413
9811191,9811191,,5,12,17,5,12,17,0.000139,0.000032,0,13517,23,0.000013,14,0.158964,0.182603,2314.304579,0.161765,0.001257
9310111,9310111,,4,2,6,4,2,6,0.000046,0.000002,0,3637,23,0.000032,1,1,1,4166.008161,0.2,0.001209
9503201,9503201,,21,5,26,21,5,26,0.001034,0.00229,0,3023,4,0.000026,6,0.2673,0.30736,15.278509,0.301538,0.006347
9508162,9508162,,10,13,23,10,13,23,0.000281,0.002485,0,4837,4,0.000017,6,0.299839,0.351072,2078.870622,0.233202,0.002794
9509048,9509048,,3,5,8,3,5,8,0.000012,0.00001,0,11946,23,0.000011,5,0.353982,0.435833,7.664569,0.232143,0.000786
9801173,9801173,,8,51,59,8,51,59,0.000228,0.004731,0,8282,4,0.000014,11,0.19312,0.22668,19111.524832,0.161309,0.00213
9803087,9803087,,9,16,25,9,16,25,0.000237,0.000745,0,8283,4,0.000015,15,0.160997,0.183181,14081.182226,0.23,0.002283
9810253,9810253,,1,5,6,1,5,6,0.000043,0.000222,0,9600,4,0.00001,18,0.131528,0.158087,77.849604,0.333333,0.0004
9811132,9811132,,1,8,9,1,8,9,0.000043,0.000236,0,9599,4,0.00001,13,0.180338,0.20568,290.690325,0.25,0.0004
4049,4049,,7,35,42,7,35,42,0.00029,0.004168,0,12251,23,0.000015,13,0.203267,0.230666,138431.000403,0.103368,0.002084
9912052,9912052,,7,15,22,7,15,22,0.000128,0.000083,0,12246,23,0.000017,14,0.176487,0.199119,52382.372221,0.181818,0.001681
9910048,9910048,,3,22,25,3,22,25,0.000023,0.006944,0,9467,2,0.000013,12,0.20282,0.22602,29456.798469,0.106667,0.00083
4050,4050,,0,3,3,0,3,3,0,0.000023,0,13519,26,0.00001,15,0.147686,0.158299,0,0.166667,0
4051,4051,,4,9,13,4,9,13,0.000015,0.000001,0,13521,5,0.000012,15,0.134032,0.144805,8355.924741,0.141026,0.000929
9804103,9804103,,2,5,7,2,5,7,0,0.000003,0,13520,5,0.000013,10,0.153948,0.180422,498.369715,0.214286,0.000491
4052,4052,,2,26,28,2,26,28,0.000017,0.002275,0,13523,0,0.000011,15,0.188399,0.219727,3829.566544,0.223545,0.000452
9705244,9705244,,7,7,14,7,7,14,0.000056,0.000121,0,9954,0,0.000017,14,0.185676,0.210063,1490.240241,0.203297,0.001757
9804135,9804135,,6,13,19,6,13,19,0.000649,0.000301,0,11488,0,0.000013,14,0.205908,0.240442,12284.836902,0.137427,0.001421
9805111,9805111,,9,6,15,9,6,15,0.000069,0.000032,0,13522,0,0.000017,15,0.158853,0.175312,35.384151,0.242857,0.002145
9301079,9301079,,5,1,6,5,1,6,0.000023,0.000062,0,9955,0,0.000016,1,1,1,2.061111,0.2,0.001279
9706125,9706125,,7,15,22,7,15,22,0.00115,0.004476,0,7150,9,0.000014,14,0.220097,0.255948,26362.741482,0.160173,0.001921
9708164,9708164,,1,93,94,1,93,94,0.000092,0.023013,0,7664,13,0.000011,11,0.240794,0.295654,14181.383657,0.065202,0.000357
4053,4053,,1,3,4,1,3,4,0,0.000102,0,13524,25,0.000015,18,0.137369,0.151317,8624,0,0.000226
9504059,9504059,,1,0,1,1,0,1,0,0,0,10296,22,0.000012,0,0,0,0,0,0.00025
9707070,9707070,,6,7,13,6,7,13,0.000021,0.000003,0,10293,22,0.000021,6,0.286885,0.370476,1605.736003,0.108974,0.001519
9712097,9712097,,2,4,6,2,4,6,0,0.001066,0,10292,22,0.000015,12,0.19749,0.223638,24404.478835,0.066667,0.000469
4054,4054,,1,7,8,1,7,8,0,0.000065,0,13525,4,0.000013,15,0.149064,0.169618,3299.743661,0.339286,0.000226
9708004,9708004,,6,14,20,6,14,20,0.000018,0.000433,0,9982,4,0.000027,15,0.18658,0.219604,34684.577238,0.113158,0.001355
9902111,9902111,,5,14,19,5,14,19,0.00006,0.000971,0,11833,4,0.000014,14,0.161326,0.183428,8338.493386,0.172515,0.001158
9604138,9604138,,6,1,7,6,1,7,0.000029,0.000158,0,3380,4,0.000028,10,0.175521,0.20851,1956.725567,0.047619,0.00162
9203046,9203046,,20,0,20,20,0,20,0.000006,0,0,4397,22,0.000137,0,0,0,0,0.105263,0.004924
9511201,9511201,,7,9,16,7,9,16,0.000029,0.000002,0,9981,22,0.000021,3,0.62963,0.745098,16402.858249,0.175,0.001654
9707117,9707117,,1,0,1,1,0,1,0.000005,0,0,9975,4,0.000012,0,0,0,0,0,0.000259
9801091,9801091,,5,2,7,5,2,7,0.000493,0.000035,0,9385,4,0.000016,13,0.153218,0.170505,15.431793,0.166667,0.001226
9801092,9801092,,1,4,5,1,4,5,0.000011,0.000072,0,11832,4,0.000011,13,0.156109,0.178439,0,0.45,0.000252
4055,4055,,0,4,4,0,4,4,0,0.000007,0,13526,52,0.00001,6,0.306452,0.366667,0,0.166667,0
9306018,9306018,,13,0,13,13,0,13,0.000047,0,0,1260,52,0.000106,0,0,0,0,0.057692,0.004155
9412202,9412202,,2,3,5,2,3,5,0.000001,0.000005,0,4910,52,0.000021,1,1,1,1883.597406,0.1,0.000552
4058,4058,,1,1,2,1,1,2,0.000003,0.000927,0,13527,2,0.000011,12,0.187088,0.202299,73.489923,0,0.000219
4059,4059,,3,1,4,3,1,4,0.000015,0,0,13528,26,0.000017,3,0.411765,0.47619,4832.712349,0,0.000671
4060,4060,,2,2,4,2,2,4,0,0,0,13534,18,0.000027,2,0.625,0.7,10,0.166667,0.000445
9907122,9907122,,2,2,4,2,2,4,0,0.000001,0,13531,18,0.000034,1,1,1,9,0.166667,0.000465
9912099,9912099,,2,2,4,2,2,4,0,0,0,13533,18,0.000026,2,0.666667,0.75,6,0.083333,0.000451
9809131,9809131,,3,0,3,3,0,3,0,0,0,13529,18,0.000061,0,0,0,0,0.166667,0.000698
9903035,9903035,,3,1,4,3,1,4,0.000111,0,0,13530,18,0.000026,1,1,1,3370,0.083333,0.00078
9512172,9512172,,2,0,2,2,0,2,0,0,0,13532,18,0.000031,0,0,0,0,0,0.000451
4061,4061,,14,8,22,14,8,22,0.000541,0.002123,0,12488,30,0.000022,13,0.195265,0.213364,16144.603739,0.125541,0.004426
9704125,9704125,,8,12,20,8,12,20,0.000369,0.005365,0,9106,2,0.000017,11,0.216943,0.250423,5080.712352,0.097368,0.002063
9811063,9811063,,2,0,2,2,0,2,0.000058,0,0,9868,2,0.000012,0,0,0,0,0,0.000511
9906237,9906237,,9,9,18,9,9,18,0.001755,0.00171,0,9867,2,0.000012,15,0.179811,0.205596,3712.403972,0.25817,0.002647
4062,4062,,14,9,23,14,9,23,0.000919,0.002787,0,12867,30,0.00002,16,0.188779,0.206885,15611.323618,0.187747,0.004548
4063,4063,,60,25,85,60,25,85,0.012122,0.020579,0,12265,1,0.000036,13,0.211501,0.237879,23805.277152,0.103221,0.019642
4064,4064,,3,2,5,3,2,5,0.000024,0.00095,0,13535,25,0.000017,12,0.186359,0.20211,7768.217569,0.15,0.000719
4065,4065,,2,1,3,2,1,3,0,0,0,13537,4,0.000015,1,1,1,0,0.5,0.000474
9910265,9910265,,5,0,5,5,0,5,0.000001,0,0,13536,4,0.000032,0,0,0,0,0.2,0.001145
4066,4066,,0,15,15,0,15,15,0,0.000005,0,13557,6,0.00001,16,0.152259,0.182963,0,0.119048,0
9408086,9408086,,19,8,27,19,8,27,0.000004,0.000002,0,2030,6,0.000028,3,0.490566,0.596154,29948.211018,0.183761,0.005072
9508079,9508079,,5,26,31,5,26,31,0.000001,0.000001,0,6802,6,0.000014,6,0.319605,0.413746,2804.729637,0.201075,0.001221
9512182,9512182,,7,15,22,7,15,22,0.000003,0.000005,0,13554,6,0.000014,7,0.274301,0.351237,1564.487844,0.181818,0.001697
9610084,9610084,,9,47,56,9,47,56,0.000006,0.000266,0,11548,9,0.000017,12,0.207646,0.2501,18849.067999,0.071104,0.002166
9701043,9701043,,10,9,19,10,9,19,0.000061,0.000017,0,11549,9,0.00002,13,0.17286,0.196685,5384.804088,0.201754,0.002344
9702026,9702026,,2,14,16,2,14,16,0,0.000002,0,13556,6,0.000012,7,0.25935,0.316801,959.271636,0.258333,0.000485
9704111,9704111,,5,15,20,5,15,20,0.000003,0.000142,0,11550,9,0.000013,13,0.193493,0.22743,3427.06435,0.173684,0.001189
9805179,9805179,,8,13,21,8,13,21,0.00006,0.000002,0,13549,9,0.000016,15,0.15543,0.179834,12323.652022,0.119048,0.001825
9807144,9807144,,1,2,3,1,2,3,0,0.000001,0,13553,6,0.00001,5,0.341085,0.381439,25.57619,0,0.000219
9907171,9907171,,2,16,18,2,16,18,0,0.000009,0,13551,9,0.000011,16,0.147102,0.173637,752.959802,0.150327,0.000438
9302001,9302001,,5,3,8,5,3,8,0.000001,0.000006,0,2019,6,0.000029,1,1,1,27611.78408,0.071429,0.001603
9304056,9304056,,14,11,25,14,11,25,0,0.000059,0,1982,6,0.00005,3,0.655172,0.77193,11083.886065,0.15,0.004396
9304150,9304150,,6,4,10,6,4,10,0,0,0,1978,6,0.00004,4,0.5,0.618056,14759.41205,0.2,0.002052
9307056,9307056,,7,5,12,7,5,12,0.000001,0.000002,0,2016,6,0.00002,3,0.541667,0.653846,1867.271242,0.234848,0.002105
9401154,9401154,,18,1,19,18,1,19,0.000003,0.00001,0,2014,6,0.000069,1,1,1,58.321576,0.119883,0.00509
9210007,9210007,,6,0,6,6,0,6,0,0,0,2029,6,0.000017,0,0,0,0,0.233333,0.001662
9301084,9301084,,3,2,5,3,2,5,0.000003,0.000008,0,2040,22,0.000015,1,1,1,283.247778,0.1,0.000988
9407191,9407191,,11,4,15,11,4,15,0.000001,0.000002,0,2027,6,0.000027,3,0.545455,0.638889,1274.156936,0.22381,0.003163
9412030,9412030,,20,19,39,20,19,39,0.000002,0.000004,0,2036,6,0.000032,4,0.574713,0.671667,27616.497169,0.169366,0.005355
9412054,9412054,,5,9,14,5,9,14,0,0.000005,0,2022,6,0.000016,4,0.408537,0.478856,2571.978588,0.236264,0.0015
9404116,9404116,,5,11,16,5,11,16,0,0.000002,0,2035,6,0.000015,3,0.493827,0.5875,65919.798496,0.175,0.001376
9408136,9408136,,13,5,18,13,5,18,0.000001,0,0,2026,6,0.000031,4,0.4375,0.502381,1154.241104,0.248366,0.00358
9410033,9410033,,5,3,8,5,3,8,0,0.000002,0,6798,6,0.000014,3,0.52381,0.606061,1.207578,0.410714,0.001298
9411009,9411009,,11,11,22,11,11,22,0,0.000004,0,2028,6,0.000024,3,0.488095,0.581301,43736.590054,0.214286,0.002884
9412199,9412199,,4,9,13,4,9,13,0,0.000002,0,2074,6,0.000014,6,0.296399,0.381308,67.393839,0.294872,0.001089
9501088,9501088,,6,4,10,6,4,10,0,0,0,2077,6,0.000015,4,0.432432,0.492188,5732.222807,0.366667,0.001515
9501134,9501134,,7,24,31,7,24,31,0,0.000003,0,2075,6,0.000016,5,0.352113,0.455667,141386.674914,0.2,0.001818
9502118,9502118,,6,7,13,6,7,13,0,0,0,6799,6,0.000014,6,0.282528,0.348904,126.556082,0.371795,0.001549
9504052,9504052,,6,8,14,6,8,14,0,0.000002,0,2043,6,0.000015,6,0.286842,0.361315,1758.029588,0.192308,0.001604
9505083,9505083,,5,11,16,5,11,16,0,0.000002,0,2076,6,0.000014,6,0.294455,0.36829,218737.761001,0.175,0.001261
9507072,9507072,,4,28,32,4,28,32,0,0.000003,0,6800,6,0.000013,6,0.313214,0.424913,10138.634542,0.173387,0.001016
9508050,9508050,,9,23,32,9,23,32,0.000001,0,0,6801,6,0.000018,6,0.304416,0.398273,43618.231535,0.216734,0.002321
9412104,9412104,,8,0,8,8,0,8,0.000046,0,0,4438,26,0.000027,0,0,0,0,0.142857,0.002144
9510168,9510168,,5,22,27,5,22,27,0,0,0,6804,6,0.000015,6,0.293769,0.386785,50845.879669,0.239316,0.001283
9207078,9207078,,4,2,6,4,2,6,0.000004,0,0,11526,5,0.000017,1,1,1,17.213131,0.033333,0.00097
9304123,9304123,,7,2,9,7,2,9,0.000004,0,0,7528,9,0.000027,2,0.75,0.833333,1892.655317,0.097222,0.001804
9310076,9310076,,9,2,11,9,2,11,0.000011,0.000005,0,1038,9,0.000018,2,0.6,0.666667,12.645711,0.227273,0.002267
9410109,9410109,,1,8,9,1,8,9,0.000003,0.000026,0,11547,9,0.00001,5,0.440299,0.511017,72.405121,0.111111,0.00028
9412198,9412198,,7,7,14,7,7,14,0.000007,0.000158,0,3170,9,0.000017,5,0.383459,0.434477,5364.98114,0.181319,0.001799
9512092,9512092,,3,16,19,3,16,19,0.000004,0.000056,0,11546,9,0.000013,6,0.312749,0.395223,242.113471,0.116959,0.000785
9512189,9512189,,11,14,25,11,14,25,0.000053,0.000116,0,4195,28,0.000022,6,0.330629,0.396728,5215.841253,0.18,0.003106
9603088,9603088,,5,14,19,5,14,19,0.000027,0.000003,0,10658,9,0.000022,8,0.270315,0.328959,21335.735515,0.032164,0.001238
9604105,9604105,,10,18,28,10,18,28,0.000007,0.000114,0,7502,9,0.000021,10,0.203867,0.237545,68633.21824,0.125661,0.002542
9604176,9604176,,9,11,20,9,11,20,0.000009,0.000011,0,11545,9,0.000017,6,0.298305,0.389205,85.307572,0.189474,0.002233
9609004,9609004,,6,21,27,6,21,27,0.000103,0.002178,0,4691,28,0.000015,12,0.211634,0.249805,14223.265409,0.115385,0.001592
9607168,9607168,,5,21,26,5,21,26,0.000013,0.000037,0,13555,6,0.000012,6,0.311765,0.377044,10384.999955,0.090769,0.001313
9210129,9210129,,7,0,7,7,0,7,0,0,0,1974,6,0.000128,0,0,0,0,0.238095,0.002479
9309074,9309074,,5,0,5,5,0,5,0.000214,0,0,5899,6,0.000016,0,0,0,0,0.15,0.001294
9310070,9310070,,14,1,15,14,1,15,0.00018,0,0,2412,6,0.000073,1,1,1,648.131568,0.033333,0.003618
9502071,9502071,,1,7,8,1,7,8,0,0.000005,0,5898,22,0.000011,4,0.470588,0.557292,51802.316381,0.017857,0.000306
9612049,9612049,,3,15,18,3,15,18,0,0.000026,0,5894,6,0.000015,11,0.18941,0.215227,125682.843932,0.140523,0.00081
9211122,9211122,,1,0,1,1,0,1,0,0,0,13548,9,0.000011,0,0,0,0,0,0.000272
9407057,9407057,,5,0,5,5,0,5,0.000001,0,0,7503,9,0.000018,0,0,0,0,0.3,0.001343
9712182,9712182,,8,11,19,8,11,19,0.000015,0.000101,0,8882,28,0.000017,15,0.160084,0.181316,5829.609658,0.178363,0.002082
9803022,9803022,,3,5,8,3,5,8,0,0.000003,0,13547,9,0.000013,12,0.14809,0.163556,33.953583,0.214286,0.00073
9801035,9801035,,3,0,3,3,0,3,0.000023,0,0,13552,6,0.000016,0,0,0,0,0,0.00074
9803024,9803024,,2,6,8,2,6,8,0.000021,0.000003,0,13550,9,0.000011,12,0.148104,0.163868,86.927459,0.25,0.000451
9812192,9812192,,2,11,13,2,11,13,0,0.000019,0,13546,9,0.000011,14,0.168129,0.189552,836.189815,0.070513,0.000458
4068,4068,,19,36,55,19,36,55,0.002485,0.012249,0,12444,2,0.000019,16,0.223166,0.253831,45100.314691,0.083165,0.006499
9901072,9901072,,4,7,11,4,7,11,0.000402,0.007796,0,9360,2,0.000012,14,0.186697,0.210997,4600.61529,0.154545,0.001274
9911136,9911136,,37,41,78,37,41,78,0.004726,0.010488,0,11653,2,0.000022,12,0.233503,0.266229,73257.950631,0.097403,0.010884
9912241,9912241,,2,23,25,2,23,25,0.000215,0.021973,0,12442,2,0.000011,11,0.232294,0.264359,3818.268747,0.193333,0.000642
9711044,9711044,,5,11,16,5,11,16,0.000067,0.005202,0,5327,10,0.000016,14,0.19504,0.228349,97485.991279,0.175,0.001514
4069,4069,,2,1,3,2,1,3,0.000073,0,0,12413,28,0.000012,3,0.444444,0.541667,12178.301459,0.166667,0.000888
9901049,9901049,,3,1,4,3,1,4,0,0,0,12412,28,0.000032,2,0.6,0.666667,7894.884793,0.166667,0.00069
9701087,9701087,,8,2,10,8,2,10,0,0.000002,0,10086,26,0.000094,1,1,1,4405.340288,0.011111,0.001853
4070,4070,,2,32,34,2,32,34,0.000051,0.004263,0,13558,0,0.000011,13,0.203084,0.233479,7972.647553,0.137255,0.000458
9908137,9908137,,4,23,27,4,23,27,0.000518,0.002313,0,10140,13,0.000012,14,0.18106,0.220214,18205.816691,0.202279,0.001085
4071,4071,,20,7,27,20,7,27,0.000697,0.000426,0,12890,30,0.000023,14,0.183666,0.198785,1014.523829,0.185185,0.007435
9206037,9206037,,12,0,12,12,0,12,0.000145,0,0,803,4,0.00004,0,0,0,0,0.030303,0.003541
9209040,9209040,,3,0,3,3,0,3,0.000051,0,0,834,6,0.000015,0,0,0,0,0,0.000888
4073,4073,,8,17,25,8,17,25,0.000297,0.00299,0,13559,0,0.000013,15,0.19131,0.217064,3140.30672,0.166667,0.002185
9902029,9902029,,14,4,18,14,4,18,0.000352,0.000117,0,10163,4,0.000025,13,0.171002,0.189872,6880.572772,0.232026,0.004519
9304037,9304037,,15,0,15,15,0,15,0.001024,0,0,864,5,0.000077,0,0,0,0,0.090476,0.005319
4075,4075,,2,16,18,2,16,18,0.000139,0.018436,0,12279,2,0.000014,13,0.197182,0.225363,4890.61888,0.189542,0.001159
9412159,9412159,,5,22,27,5,22,27,0.000044,0.001214,0,1017,5,0.000023,6,0.406326,0.48503,35559.567188,0.166667,0.001767
9706083,9706083,,2,10,12,2,10,12,0.000282,0.006768,0,5061,2,0.000014,12,0.202228,0.231638,4005.606879,0.204545,0.000928
9904083,9904083,,1,10,11,1,10,11,0.000231,0.020259,0,11090,2,0.00001,14,0.185915,0.209791,111.777971,0.209091,0.000309
9901016,9901016,,4,11,15,4,11,15,0.000391,0.005724,0,8425,22,0.000016,14,0.178818,0.200496,136333.969435,0.104762,0.001113
4076,4076,,13,15,28,13,15,28,0.000414,0.001149,0,13560,30,0.000017,12,0.202688,0.223499,29035.204007,0.255291,0.003445
9411194,9411194,,1,0,1,1,0,1,0.000006,0,0,1368,4,0.000013,0,0,0,0,0,0.000502
9908201,9908201,,5,29,34,5,29,34,0.001109,0.01273,0,12180,1,0.000012,11,0.235894,0.269384,6727.521338,0.168449,0.001374
4077,4077,,10,42,52,10,42,52,0.001879,0.01034,0,11627,13,0.000016,13,0.204737,0.237709,158355.643116,0.089744,0.004368
9205095,9205095,,6,0,6,6,0,6,0.000044,0,0,58,13,0.000026,0,0,0,0,0.1,0.001615
9401110,9401110,,15,1,16,15,1,16,0.000485,0,0,2247,5,0.000043,2,0.555556,0.6,22916.825279,0.045833,0.00569
9805099,9805099,,1,21,22,1,21,22,0.000193,0.019947,0,7048,1,0.00001,11,0.218845,0.252421,3624.898486,0.155844,0.000494
4078,4078,,5,14,19,5,14,19,0.000114,0.001281,0,13565,52,0.000012,14,0.159975,0.181608,764.787497,0.163743,0.001172
9510192,9510192,,7,0,7,7,0,7,0.000234,0,0,3763,52,0.000016,0,0,0,0,0.214286,0.001969
9610057,9610057,,6,17,23,6,17,23,0.000111,0.000016,0,8177,52,0.000015,3,0.569444,0.678862,4394.250451,0.092885,0.001507
9611107,9611107,,8,10,18,8,10,18,0.000208,0.003019,0,8182,52,0.000016,11,0.206963,0.24337,37994.961376,0.166667,0.002017
9703071,9703071,,5,6,11,5,6,11,0.000195,0.000026,0,13562,52,0.000012,5,0.330033,0.384667,1311.245698,0.236364,0.001233
9710179,9710179,,9,17,26,9,17,26,0.000278,0.001132,0,8537,52,0.000015,14,0.182301,0.214184,34004.567246,0.089231,0.002329
9811006,9811006,,5,19,24,5,19,24,0.000106,0.010187,0,13564,52,0.000012,13,0.18341,0.211018,10881.872109,0.103261,0.00124
9304014,9304014,,2,0,2,2,0,2,0,0,0,3120,52,0.000014,0,0,0,0,0.5,0.000597
9403104,9403104,,15,4,19,15,4,19,0.00004,0.000003,0,3119,22,0.000041,4,0.464286,0.583333,14616.513746,0.05848,0.003843
9406213,9406213,,14,7,21,14,7,21,0.000099,0.000005,0,2659,22,0.000031,3,0.5625,0.666667,68188.650641,0.085714,0.003691
9507137,9507137,,5,2,7,5,2,7,0.000049,0.000001,0,8181,52,0.00002,1,1,1,976.479035,0.071429,0.001236
9506038,9506038,,3,0,3,3,0,3,0.000127,0,0,13561,1,0.000013,0,0,0,0,0.166667,0.000705
9301036,9301036,,2,0,2,2,0,2,0.000013,0,0,8185,52,0.000012,0,0,0,0,0.5,0.000539
9702088,9702088,,5,8,13,5,8,13,0.000539,0.000013,0,8186,52,0.000012,12,0.17781,0.20146,98813.279666,0.128205,0.001528
9701033,9701033,,3,0,3,3,0,3,0.000284,0,0,13563,17,0.000013,0,0,0,0,0,0.001084
4079,4079,,0,2,2,0,2,2,0,0,0,13566,5,0.00001,15,0.141532,0.151954,0,0.5,0
4081,4081,,6,15,21,6,15,21,0,0.000007,0,13567,17,0.000015,12,0.163976,0.200354,4472.469161,0.266667,0.001464
5077,5077,,5,18,23,5,18,23,0.000008,0.000004,0,13569,17,0.000013,12,0.150528,0.189279,3529.713235,0.280632,0.001185
4119,4119,,8,27,35,8,27,35,0.000003,0.000007,0,13568,17,0.000014,12,0.15151,0.197204,4026.767882,0.266387,0.001862
9610225,9610225,,2,3,5,2,3,5,0.000001,0.000023,0,10442,17,0.000012,4,0.5,0.598485,385.566634,0.2,0.000631
9807070,9807070,,1,17,18,1,17,18,0,0.000006,0,10467,17,0.000012,12,0.172052,0.212915,392.806902,0.281046,0.000299
4082,4082,,1,3,4,1,3,4,0.000017,0.000116,0,13571,23,0.00001,3,0.428571,0.5,1589.403535,0,0.000226
9503187,9503187,,2,2,4,2,2,4,0.000001,0.000012,0,13570,5,0.000016,2,0.55,0.590909,31.5,0,0.000445
9503188,9503188,,2,0,2,2,0,2,0.000001,0,0,9737,23,0.000019,0,0,0,0,0,0.000452
4084,4084,,10,4,14,10,4,14,0.000001,0.000004,0,13576,23,0.000046,16,0.134189,0.14727,35957.735795,0.054945,0.002311
9907180,9907180,,19,9,28,19,9,28,0.000029,0.000008,0,13575,23,0.000044,14,0.141633,0.157643,29612.148362,0.12963,0.004565
9906129,9906129,,9,11,20,9,11,20,0.000033,0.001051,0,13574,23,0.000024,17,0.138666,0.168275,21055.218227,0.236842,0.002644
4086,4086,,4,13,17,4,13,17,0.000663,0.002241,0,12795,2,0.000012,12,0.199995,0.222875,3839.751233,0.128676,0.001249
9606190,9606190,,9,1,10,9,1,10,0.000122,0.000072,0,3884,0,0.000028,10,0.184606,0.202327,1435.62623,0.188889,0.002487
9612208,9612208,,6,3,9,6,3,9,0.000281,0.000211,0,3883,0,0.000018,10,0.206577,0.235669,8999.709302,0.222222,0.001631
4087,4087,,8,37,45,8,37,45,0.000492,0.003831,0,13580,4,0.000015,12,0.195873,0.22391,28145.189261,0.117677,0.002388
9604096,9604096,,1,10,11,1,10,11,0.000045,0.000607,0,13579,0,0.00001,10,0.193527,0.225364,384.139311,0.1,0.00028
9909073,9909073,,8,31,39,8,31,39,0.000562,0.003471,0,13578,4,0.000013,14,0.187236,0.215448,8957.514247,0.103239,0.00204
9911112,9911112,,4,30,34,4,30,34,0.000161,0.017829,0,13577,4,0.000012,12,0.211499,0.240005,21942.892555,0.138146,0.001081
9706095,9706095,,10,21,31,10,21,31,0.001037,0.003875,0,4496,4,0.000016,12,0.200103,0.230974,27105.602663,0.12043,0.002698
9607123,9607123,,1,5,6,1,5,6,0.000076,0.000055,0,4824,4,0.00001,5,0.301124,0.3449,38083.787381,0.133333,0.000521
9706060,9706060,,5,6,11,5,6,11,0.000181,0.000005,0,4851,23,0.000021,13,0.189137,0.217196,156281.842767,0.081818,0.001401
9410146,9410146,,2,2,4,2,2,4,0.000055,0.000001,0,10873,6,0.000012,2,0.75,0.833333,348.140516,0.166667,0.000534
9503168,9503168,,4,5,9,4,5,9,0.000277,0.000003,0,10874,6,0.000011,4,0.431034,0.523333,1692.400884,0.111111,0.001126
9808083,9808083,,1,6,7,1,6,7,0.000055,0.000006,0,10871,6,0.00001,9,0.209866,0.264589,1067.982513,0.095238,0.000285
9808134,9808134,,1,43,44,1,43,44,0.000055,0.007022,0,10870,4,0.00001,12,0.225303,0.262093,4314.948232,0.136364,0.000285
4088,4088,,3,3,6,3,3,6,0.000082,0.000009,0,13581,2,0.000015,16,0.14298,0.156865,8.694888,0.366667,0.000677
4089,4089,,12,14,26,12,14,26,0.000028,0.000006,0,13582,6,0.000016,16,0.149302,0.167757,1341.938003,0.178462,0.002915
9212135,9212135,,8,0,8,8,0,8,0.000069,0,0,3468,6,0.000041,0,0,0,0,0.071429,0.002123
9703055,9703055,,6,2,8,6,2,8,0.000005,0.000001,0,7783,6,0.000014,9,0.16763,0.222095,395.482942,0.214286,0.001501
9612133,9612133,,5,8,13,5,8,13,0.000001,0,0,9302,6,0.000013,11,0.163347,0.224606,163.261746,0.25641,0.00118
9801167,9801167,,2,0,2,2,0,2,0,0,0,9300,6,0.000012,0,0,0,0,0.5,0.00051
4090,4090,,13,18,31,13,18,31,0.000767,0.000702,0,12797,0,0.000017,13,0.194087,0.215818,13753.147146,0.17957,0.003528
4091,4091,,0,4,4,0,4,4,0,0,0,13583,26,0.00001,12,0.143195,0.168346,0,0.25,0
4092,4092,,3,26,29,3,26,29,0.000321,0.003169,0,13586,4,0.000011,12,0.204698,0.232678,3612.56809,0.220443,0.000846
9906020,9906020,,7,12,19,7,12,19,0.000389,0.001023,0,12423,4,0.000014,12,0.184226,0.207122,902.382583,0.280702,0.002077
9910184,9910184,,4,23,27,4,23,27,0.000296,0.003466,0,13584,4,0.000012,12,0.197212,0.229185,3546.388789,0.133903,0.001069
9911094,9911094,,8,16,24,8,16,24,0.00056,0.001505,0,13585,4,0.000013,13,0.182727,0.212632,3266.425749,0.235507,0.002232
9701101,9701101,,2,8,10,2,8,10,0.000135,0.000004,0,4091,6,0.000012,10,0.21721,0.283091,255074.37255,0.133333,0.001272
9401053,9401053,,2,1,3,2,1,3,0.000015,0,0,6607,23,0.000013,1,1,1,174.116427,0.166667,0.000722
4096,4096,,2,12,14,2,12,14,0.000004,0.000187,0,13587,0,0.000012,12,0.202406,0.229028,241.99822,0.175824,0.000478
9907067,9907067,,9,26,35,9,26,35,0.000122,0.000438,0,10236,0,0.00002,13,0.183895,0.208686,17748.954924,0.14874,0.002094
9706040,9706040,,3,43,46,3,43,46,0.000051,0.004256,0,7632,0,0.000016,14,0.198831,0.242764,26141.722262,0.078744,0.001103
9707062,9707062,,5,13,18,5,13,18,0.000073,0.000746,0,8090,0,0.000015,15,0.190558,0.226214,14159.701261,0.114379,0.001308
9710161,9710161,,11,7,18,11,7,18,0.0003,0.001236,0,5961,4,0.000019,13,0.173199,0.197669,5462.460849,0.189542,0.002962
9711150,9711150,,13,14,27,13,14,27,0.000855,0.001486,0,5963,4,0.000019,13,0.165303,0.192159,10942.774454,0.132479,0.003408
9706049,9706049,,4,9,13,4,9,13,0.000145,0.000141,0,10235,0,0.000011,8,0.231911,0.272422,37.836349,0.275641,0.001115
4098,4098,,7,25,32,7,25,32,0.002218,0.005135,0,13588,13,0.000013,15,0.23003,0.266779,47237.510031,0.104839,0.002123
4099,4099,,0,9,9,0,9,9,0,0.000001,0,13591,6,0.00001,15,0.133695,0.149362,0,0.180556,0
9907103,9907103,,1,5,6,1,5,6,0,0.000016,0,13590,6,0.000011,14,0.146936,0.164159,3329.833331,0,0.000219
9701160,9701160,,5,3,8,5,3,8,0,0,0,10940,23,0.000033,9,0.179005,0.203275,7353.832046,0.089286,0.001188
9706061,9706061,,2,3,5,2,3,5,0,0.000001,0,10937,6,0.000029,4,0.470588,0.614583,5208.982312,0.15,0.000551
9304078,9304078,,2,0,2,2,0,2,0,0,0,13589,6,0.000013,0,0,0,0,0,0.000445
9711052,9711052,,10,9,19,10,9,19,0.000187,0.002417,0,6849,26,0.000024,15,0.170384,0.197799,120423.84678,0.125731,0.002384
4100,4100,,6,20,26,6,20,26,0.000074,0.001606,0,12969,52,0.000014,15,0.175102,0.20103,6331.787197,0.24,0.001606
4102,4102,,23,22,45,23,22,45,0.004852,0.002004,0,13592,1,0.000018,12,0.192965,0.213236,6966.886505,0.202525,0.007235
4104,4104,,12,30,42,12,30,42,0.000772,0.002525,0,13593,30,0.000018,14,0.212143,0.237049,21362.605948,0.0964,0.004267
4105,4105,,1,6,7,1,6,7,0.000228,0.010874,0,13594,1,0.000011,17,0.171445,0.192697,3598.318437,0.214286,0.000511
4106,4106,,49,19,68,49,19,68,0.001724,0.002116,0,12235,3,0.00004,12,0.211081,0.234357,247500.90974,0.140255,0.021788
4107,4107,,4,10,14,4,10,14,0.000215,0.000734,0,13595,1,0.000013,13,0.185107,0.205389,749.94406,0.247253,0.000923
4108,4108,,2,5,7,2,5,7,0.000005,0.000038,0,13597,23,0.000012,13,0.161773,0.184978,514.558689,0.071429,0.000464
9804192,9804192,,15,2,17,15,2,17,0.000006,0.000018,0,13596,23,0.000051,13,0.153333,0.169453,20958.92936,0.139706,0.003676
9709189,9709189,,2,6,8,2,6,8,0,0.000004,0,7224,23,0.000061,19,0.093638,0.104376,25255.888385,0.053571,0.000487
4110,4110,,0,1,1,0,1,1,0,0,0,13598,26,0.00001,3,0.40625,0.448718,0,0,0
9508150,9508150,,3,3,6,3,3,6,0.000101,0.000761,0,5244,2,0.000012,6,0.281453,0.315438,11044.981737,0.1,0.000818
4112,4112,,15,11,26,15,11,26,0.00074,0.000926,0,12881,3,0.000018,13,0.181739,0.199336,167.457191,0.333846,0.007944
4113,4113,,5,12,17,5,12,17,0.00098,0.00484,0,13599,2,0.000012,12,0.215977,0.239943,626.498732,0.268382,0.001629
4114,4114,,26,36,62,26,36,62,0.000746,0.003054,0,12131,25,0.00003,17,0.195267,0.218404,29223.465783,0.104178,0.007161
4115,4115,,29,32,61,29,32,61,0.001975,0.001477,0,12178,30,0.000025,14,0.19945,0.22114,21126.885411,0.18306,0.010372
4116,4116,,2,5,7,2,5,7,0,0.000002,0,13601,22,0.000012,6,0.330435,0.417105,89.374366,0.285714,0.000507
9806127,9806127,,10,8,18,10,8,18,0.000005,0.000004,0,13600,22,0.00004,5,0.428571,0.562963,2497.062549,0.104575,0.002427
9605121,9605121,,10,8,18,10,8,18,0.000002,0.000014,0,4355,22,0.000033,4,0.527778,0.662281,26058.632588,0.114379,0.002566
9408085,9408085,,2,1,3,2,1,3,0,0.000001,0,10104,22,0.000029,1,1,1,134.132542,0,0.000541
4117,4117,,6,14,20,6,14,20,0.000672,0.019472,0,12411,25,0.000013,12,0.220763,0.25152,11386.835572,0.210526,0.001983
4118,4118,,0,11,11,0,11,11,0,0.000018,0,13605,23,0.00001,15,0.149887,0.164986,0,0.3,0
9603029,9603029,,12,0,12,12,0,12,0.000081,0,0,7117,23,0.000044,0,0,0,0,0.257576,0.00389
9611142,9611142,,11,1,12,11,1,12,0.00004,0.000158,0,10082,20,0.000053,10,0.175521,0.20851,3581.538237,0.068182,0.00255
9803133,9803133,,24,3,27,24,3,27,0.00009,0.000009,0,9191,23,0.000047,14,0.148776,0.170616,11094.869756,0.189459,0.006855
9810167,9810167,,17,6,23,17,6,23,0.000047,0.000069,0,13572,23,0.000032,13,0.164953,0.189094,6825.553847,0.243083,0.004787
9904045,9904045,,18,17,35,18,17,35,0.000047,0.001063,0,13573,23,0.000031,16,0.148388,0.17997,21029.425302,0.169748,0.004978
9911242,9911242,,9,27,36,9,27,36,0.000019,0.001602,0,13604,23,0.000021,14,0.172844,0.193916,122909.17681,0.118254,0.002521
9309150,9309150,,11,0,11,11,0,11,0.000025,0,0,7136,23,0.000075,0,0,0,0,0.3,0.002958
9405145,9405145,,7,1,8,7,1,8,0.000023,0,0,7137,23,0.000035,1,1,1,0,0.5,0.001986
9502083,9502083,,8,2,10,8,2,10,0.000035,0.000001,0,7138,23,0.000031,1,1,1,5,0.388889,0.002307
9511033,9511033,,4,2,6,4,2,6,0.000031,0.000001,0,7139,23,0.000018,2,0.75,0.833333,10.969298,0.2,0.001186
9502100,9502100,,11,8,19,11,8,19,0.000001,0.000003,0,4760,23,0.000048,3,0.615385,0.729167,58654.841872,0.111111,0.003055
9803063,9803063,,16,2,18,16,2,18,0.000561,0.000009,0,7141,23,0.000033,14,0.147733,0.167554,178116.796076,0.251634,0.004804
9504001,9504001,,5,10,15,5,10,15,0.000021,0.000042,0,11537,22,0.000016,4,0.471429,0.588384,2496.32282,0.166667,0.001228
9907063,9907063,,4,8,12,4,8,12,0.000032,0.000013,0,13603,23,0.000012,14,0.161899,0.178181,3395.89343,0.143939,0.00106
4120,4120,,1,22,23,1,22,23,0.000001,0.000757,0,13606,13,0.000011,16,0.148652,0.173769,4509.809754,0.272727,0.000219
9311113,9311113,,8,0,8,8,0,8,0.000001,0,0,2218,23,0.000079,0,0,0,0,0.071429,0.001992
4121,4121,,3,16,19,3,16,19,0,0.000007,0,13607,6,0.000012,13,0.139684,0.158425,499.759831,0.365497,0.000711
4122,4122,,2,10,12,2,10,12,0.000127,0.000318,0,13608,52,0.00001,18,0.147946,0.16643,414.157188,0.242424,0.000473
4123,4123,,4,25,29,4,25,29,0.000926,0.01914,0,13609,1,0.000012,12,0.225041,0.256504,9918.536243,0.213054,0.001875
9604121,9604121,,4,2,6,4,2,6,0.000056,0.000046,0,11680,9,0.000018,6,0.317073,0.36,78.276843,0.166667,0.001039
4127,4127,,2,6,8,2,6,8,0.000011,0.002058,0,13610,30,0.000014,14,0.174563,0.18945,6340.784653,0.107143,0.000486
4128,4128,,2,5,7,2,5,7,0.000008,0.000009,0,13612,23,0.000013,15,0.138441,0.146041,180.493849,0.214286,0.000445
9307089,9307089,,2,1,3,2,1,3,0,0.000001,0,13611,23,0.000014,1,1,1,0,0.5,0.000458
102171,102171,,1,5,6,1,5,6,0.000008,0.000001,0,13613,23,0.000011,15,0.138061,0.144819,1.75,0.266667,0.000219
4129,4129,,0,6,6,0,6,6,0,0.015057,0,13617,1,0.00001,14,0.176718,0.198123,0,0.3,0
9810066,9810066,,2,5,7,2,5,7,0.000353,0.016568,0,13615,1,0.000014,13,0.187679,0.209732,5092.954509,0.380952,0.000495
9909141,9909141,,8,8,16,8,8,16,0.001078,0.015012,0,13616,1,0.000023,14,0.176755,0.19839,11036.313259,0.175,0.002138
9411204,9411204,,5,4,9,5,4,9,0.000237,0.000027,0,6851,26,0.000018,6,0.226244,0.300333,969.302687,0.277778,0.001365
9902145,9902145,,4,4,8,4,4,8,0.000245,0.014999,0,13614,1,0.00002,15,0.17689,0.199363,1977.742909,0.214286,0.000953
4130,4130,,4,14,18,4,14,18,0.000037,0.000487,0,13623,2,0.000013,12,0.194753,0.21422,5399.745455,0.189542,0.000969
9509033,9509033,,4,2,6,4,2,6,0.000097,0.000073,0,3517,2,0.000013,1,1,1,12280.056122,0.033333,0.001036
9910171,9910171,,14,5,19,14,5,19,0.000185,0.000439,0,10751,2,0.000024,15,0.167558,0.189195,4220.839209,0.195906,0.003398
9911174,9911174,,7,18,25,7,18,25,0.000043,0.002708,0,13622,2,0.000027,11,0.228378,0.259181,56564.04096,0.053333,0.001617
5099,5099,,4,11,15,4,11,15,0.000034,0.00051,0,13624,2,0.000013,13,0.172842,0.190265,300.202743,0.261905,0.000955
6242,6242,,6,19,25,6,19,25,0.000083,0.001012,0,13626,2,0.000014,12,0.214154,0.24148,9037.203754,0.183333,0.001348
6090,6090,,8,17,25,8,17,25,0.000344,0.002935,0,13625,2,0.000016,12,0.219449,0.244524,16382.830928,0.12,0.002108
9305111,9305111,,7,0,7,7,0,7,0.000247,0,0,3516,0,0.000024,0,0,0,0,0.071429,0.001608
9303063,9303063,,2,1,3,2,1,3,0.000021,0.000094,0,4561,2,0.000014,1,1,1,0,0.333333,0.000592
9802175,9802175,,8,5,13,8,5,13,0.000275,0.001589,0,7236,2,0.000021,17,0.169295,0.197752,3094.871985,0.179487,0.002622
9511136,9511136,,2,1,3,2,1,3,0.000032,0.000001,0,13621,2,0.000013,1,1,1,11.274039,0.166667,0.000485
9901133,9901133,,2,1,3,2,1,3,0.000032,0,0,13620,23,0.000016,1,1,1,2355,0,0.000485
9904175,9904175,,6,12,18,6,12,18,0.00028,0.001051,0,13618,2,0.000015,15,0.168011,0.195306,7998.561669,0.104575,0.001416
4131,4131,,10,18,28,10,18,28,0.000525,0.017158,0,12853,3,0.000015,13,0.197595,0.221735,15065.115696,0.115079,0.003693
9904048,9904048,,3,1,4,3,1,4,0.000202,0,0,12852,20,0.000018,1,1,1,3640.278988,0.083333,0.000761
9603047,9603047,,4,0,4,4,0,4,0.000021,0,0,12473,20,0.000035,0,0,0,0,0.083333,0.001021
9312184,9312184,,1,12,13,1,12,13,0.000004,0.000315,0,1119,13,0.000013,5,0.351779,0.436891,28319.491275,0.160256,0.000311
4135,4135,,3,8,11,3,8,11,0,0.000007,0,13627,23,0.000013,17,0.140462,0.156669,26658.723108,0.209091,0.000751
9710125,9710125,,8,6,14,8,6,14,0.000223,0.000521,0,7450,4,0.00002,12,0.163122,0.181694,1235.268589,0.208791,0.002415
9809007,9809007,,3,16,19,3,16,19,0.000112,0.004874,0,9483,0,0.000012,13,0.204315,0.236337,8638.184178,0.178363,0.000939
4137,4137,,2,9,11,2,9,11,0,0.000002,0,13628,23,0.000012,19,0.137528,0.152787,18884.369351,0.127273,0.000491
9205111,9205111,,6,0,6,6,0,6,0.000003,0,0,2588,23,0.000021,0,0,0,0,0.166667,0.001402
9305038,9305038,,7,3,10,7,3,10,0.000002,0.000047,0,2589,23,0.000023,2,0.8,0.875,13197.722322,0.122222,0.001667
4138,4138,,1,3,4,1,3,4,0.000001,0.000009,0,13629,23,0.00001,11,0.192941,0.244144,0,0.416667,0.000232
4139,4139,,2,2,4,2,2,4,0.000002,0.000001,0,13634,26,0.000011,17,0.123237,0.132182,18.153846,0,0.000438
9903017,9903017,,7,5,12,7,5,12,0.000029,0,0,13633,26,0.000036,5,0.393939,0.491667,152.504289,0.068182,0.001586
9501107,9501107,,6,1,7,6,1,7,0,0,0,13630,26,0.000028,1,1,1,0,0.357143,0.001441
9707137,9707137,,2,1,3,2,1,3,0,0,0,13632,26,0.000024,2,0.666667,0.75,0,0.333333,0.000524
9806163,9806163,,6,8,14,6,8,14,0,0.000003,0,13631,26,0.000027,4,0.536585,0.647727,3111.389,0.104396,0.001414
4140,4140,,1,5,6,1,5,6,0,0,0,13636,26,0.000011,5,0.390625,0.491333,467.39465,0.233333,0.000272
9903018,9903018,,4,4,8,4,4,8,0,0,0,13635,26,0.000015,5,0.380952,0.470139,49,0.25,0.000897
9711022,9711022,,2,0,2,2,0,2,0.000035,0,0,11069,26,0.000014,0,0,0,0,0,0.000518
4141,4141,,43,19,62,43,19,62,0.003245,0.005134,0,12214,52,0.000039,16,0.223944,0.251181,187743.298125,0.085669,0.013965
4142,4142,,18,15,33,18,15,33,0.002351,0.017386,0,12420,1,0.000019,16,0.211185,0.237302,3722.772867,0.157197,0.005191
5163,5163,,15,14,29,15,14,29,0.001974,0.010621,0,13637,1,0.000016,16,0.230481,0.263378,23257.104118,0.184729,0.004156
4143,4143,,1,10,11,1,10,11,0,0.00001,0,13649,22,0.000011,13,0.145847,0.157371,7386.539237,0.036364,0.000219
9602080,9602080,,5,3,8,5,3,8,0.000001,0,0,13648,23,0.00004,2,0.8,0.875,32,0.053571,0.001128
9603054,9603054,,3,1,4,3,1,4,0,0,0,13646,28,0.000034,1,1,1,3,0.083333,0.00073
9708045,9708045,,2,4,6,2,4,6,0,0.000002,0,13644,22,0.000011,8,0.237374,0.328774,42.101149,0.233333,0.000445
9812069,9812069,,5,3,8,5,3,8,0,0.001027,0,13642,30,0.000017,6,0.267894,0.306489,673.924352,0,0.001122
9903127,9903127,,3,0,3,3,0,3,0,0,0,13639,22,0.000016,0,0,0,0,0.166667,0.000671
9905110,9905110,,1,3,4,1,3,4,0,0.000003,0,13640,22,0.000011,7,0.273438,0.345034,23,0.083333,0.000226
9906172,9906172,,1,1,2,1,1,2,0,0,0,13638,6,0.000011,6,0.283784,0.331746,0,0.5,0.000226
9504024,9504024,,5,0,5,5,0,5,0,0,0,6797,23,0.000039,0,0,0,0,0.15,0.001176
9512197,9512197,,1,1,2,1,1,2,0,0,0,13647,23,0.000022,2,0.666667,0.75,0,0.5,0.000252
9512168,9512168,,4,0,4,4,0,4,0,0,0,13645,28,0.000058,0,0,0,0,0.166667,0.000943
9707109,9707109,,5,6,11,5,6,11,0.000034,0.000003,0,13643,22,0.000016,7,0.291139,0.408023,181.907346,0.254545,0.001155
9505095,9505095,,13,1,14,13,1,14,0.000027,0.000001,0,4849,23,0.00005,2,0.666667,0.75,73.273869,0.087912,0.003208
9509157,9509157,,1,0,1,1,0,1,0.000012,0,0,13641,30,0.000015,0,0,0,0,0,0.000252
9503224,9503224,,5,0,5,5,0,5,0,0,0,9142,23,0.000025,0,0,0,0,0.1,0.001157
4144,4144,,3,8,11,3,8,11,0.000082,0.00138,0,13650,25,0.000013,17,0.190214,0.210229,971.590245,0.209091,0.001081
4145,4145,,7,19,26,7,19,26,0.000013,0.000796,0,13660,23,0.000015,13,0.19201,0.210769,39453.024359,0.153846,0.001673
9604181,9604181,,12,8,20,12,8,20,0.0001,0.000127,0,4844,23,0.000027,9,0.22234,0.265822,34192.25648,0.057895,0.003011
9808104,9808104,,2,4,6,2,4,6,0.000009,0.000176,0,13659,2,0.000012,14,0.159523,0.17683,4075.197448,0.166667,0.000499
9904183,9904183,,9,14,23,9,14,23,0.000073,0.000014,0,13658,23,0.000016,10,0.210106,0.249076,1877.042588,0.057312,0.002072
9202045,9202045,,7,0,7,7,0,7,0.000007,0,0,4847,23,0.000021,0,0,0,0,0.047619,0.001629
9304067,9304067,,14,3,17,14,3,17,0.000027,0.000001,0,1654,23,0.000058,1,1,1,15377.074388,0.066176,0.003513
9311076,9311076,,4,1,5,4,1,5,0.000002,0,0,4843,23,0.000017,1,1,1,77.998409,0.05,0.001
9502032,9502032,,11,4,15,11,4,15,0.000169,0.000001,0,4841,23,0.000036,2,0.833333,0.9,2328.556362,0.07619,0.002742
9511168,9511168,,12,3,15,12,3,15,0.000104,0.000003,0,4842,23,0.000038,7,0.209106,0.247523,2485.379666,0.080952,0.002973
9509173,9509173,,12,15,27,12,15,27,0.00002,0.000026,0,4762,23,0.00003,7,0.276031,0.334791,67539.074211,0.109687,0.003214
9511081,9511081,,4,10,14,4,10,14,0.000033,0.000056,0,7803,23,0.000016,7,0.262372,0.314413,46809.6117,0.104396,0.001012
9701080,9701080,,26,8,34,26,8,34,0.000021,0.000003,0,13657,23,0.000048,9,0.191489,0.230437,7365.272201,0.089127,0.006353
9703226,9703226,,10,1,11,10,1,11,0.000178,0.000002,0,9454,26,0.000035,3,0.444444,0.541667,5438.950057,0.090909,0.002408
9706018,9706018,,12,6,18,12,6,18,0.000015,0.000003,0,13655,23,0.000025,10,0.154492,0.207906,6202.973778,0.130719,0.002916
9712099,9712099,,6,4,10,6,4,10,0.000002,0.000008,0,13651,23,0.000021,7,0.333333,0.373402,2389.751478,0.055556,0.001447
4146,4146,,0,14,14,0,14,14,0,0.016191,0,13665,1,0.00001,12,0.201415,0.223698,0,0.263736,0
9612201,9612201,,3,15,18,3,15,18,0.000428,0.000073,0,13664,9,0.000012,11,0.164179,0.191164,7142.021994,0.04902,0.000666
9312002,9312002,,14,4,18,14,4,18,0.000209,0.000034,0,2279,9,0.000032,2,0.833333,0.9,685.49297,0.147059,0.003426
9408076,9408076,,11,5,16,11,5,16,0.000197,0.000014,0,4225,52,0.000025,5,0.35,0.47381,6388.327456,0.191667,0.002686
9501058,9501058,,11,14,25,11,14,25,0.000645,0.000068,0,4247,17,0.000019,4,0.365979,0.476526,23771.111275,0.145,0.002851
9503052,9503052,,1,2,3,1,2,3,0.000001,0.000002,0,13663,17,0.000011,2,0.75,0.833333,18.213837,0,0.000239
9503116,9503116,,4,8,12,4,8,12,0.000005,0.000089,0,13661,5,0.000014,7,0.228995,0.284275,299.469401,0.083333,0.00091
9605097,9605097,,7,1,8,7,1,8,0.000052,0,0,7030,9,0.000017,9,0.198259,0.225509,12757.144149,0.107143,0.001658
9608020,9608020,,2,6,8,2,6,8,0.000007,0.000202,0,13662,9,0.000011,10,0.181041,0.202088,1563.475971,0.160714,0.000472
9310015,9310015,,8,0,8,8,0,8,0.000052,0,0,5427,30,0.000045,0,0,0,0,0.071429,0.002076
9404112,9404112,,5,0,5,5,0,5,0.000033,0,0,5402,15,0.000033,0,0,0,0,0.1,0.001241
9401075,9401075,,11,2,13,11,2,13,0.00046,0.000052,0,3284,3,0.000037,2,0.75,0.833333,1452.310819,0.147436,0.002795
9603168,9603168,,6,3,9,6,3,9,0.000485,0.000209,0,6836,30,0.00002,13,0.167609,0.196065,501.179655,0.25,0.001819
9607015,9607015,,8,7,15,8,7,15,0.000138,0.000026,0,6377,5,0.000019,11,0.1775,0.20122,47667.173193,0.147619,0.00209
9712146,9712146,,1,12,13,1,12,13,0.000037,0.002942,0,6844,2,0.000012,15,0.188041,0.217264,15139.111855,0.166667,0.000507
4148,4148,,31,42,73,31,42,73,0.005746,0.024725,0,12272,1,0.000026,12,0.21709,0.248,41695.86189,0.148212,0.010278
9912005,9912005,,4,1,5,4,1,5,0.000027,0,0,12771,0,0.000015,19,0.094228,0.103112,3043.267003,0.05,0.000933
9411111,9411111,,1,1,2,1,1,2,0,0,0,7477,0,0.000108,1,1,1,0,0.5,0.000298
9509127,9509127,,2,8,10,2,8,10,0.000014,0.000114,0,4540,0,0.000014,6,0.292058,0.32461,79.850751,0.222222,0.000578
9303175,9303175,,6,7,13,6,7,13,0.000172,0.000085,0,2298,13,0.000022,3,0.631579,0.763889,928.43995,0.064103,0.002167
9711071,9711071,,2,4,6,2,4,6,0,0.000003,0,12770,23,0.000024,18,0.103945,0.116759,1715.202372,0.133333,0.000478
4150,4150,,0,4,4,0,4,4,0,0.000144,0,13666,1,0.00001,13,0.175288,0.191119,0,0.5,0
4151,4151,,14,15,29,14,15,29,0.002414,0.018667,0,12441,1,0.000016,16,0.230021,0.262684,24854.118825,0.157635,0.004578
4152,4152,,2,17,19,2,17,19,0,0.000141,0,13677,15,0.000042,16,0.191423,0.213712,38244,0.026316,0.000465
9801199,9801199,,2,6,8,2,6,8,0.000002,0.000005,0,13676,15,0.000014,15,0.182302,0.203848,858.913506,0.267857,0.000458
9803229,9803229,,3,10,13,3,10,13,0.000026,0.002201,0,13673,15,0.000013,15,0.185767,0.212864,2448.845731,0.115385,0.000724
9903245,9903245,,4,5,9,4,5,9,0.000004,0.000173,0,13671,15,0.000024,12,0.17276,0.197177,8557.332163,0.138889,0.001059
9906176,9906176,,4,22,26,4,22,26,0.000091,0.007214,0,9357,15,0.000014,14,0.204038,0.232662,24714.999283,0.050769,0.001044
9509031,9509031,,1,0,1,1,0,1,0.000007,0,0,6991,15,0.000014,0,0,0,0,0,0.000315
9510133,9510133,,8,3,11,8,3,11,0.000134,0.000014,0,6190,15,0.000027,2,0.666667,0.75,5447.699871,0.218182,0.002055
9707054,9707054,,2,0,2,2,0,2,0.00014,0,0,5307,2,0.000013,0,0,0,0,0.5,0.00058
9605103,9605103,,6,1,7,6,1,7,0,0.000002,0,6173,15,0.000038,2,0.571429,0.625,816.137862,0.333333,0.001415
9610055,9610055,,5,3,8,5,3,8,0,0.000002,0,6174,15,0.00003,9,0.225123,0.263297,25807.152895,0.25,0.001162
9707082,9707082,,5,2,7,5,2,7,0.000043,0,0,6175,15,0.000019,10,0.184006,0.204258,42324.397678,0.309524,0.001164
9708010,9708010,,2,4,6,2,4,6,0,0.000001,0,13675,15,0.000013,10,0.184415,0.20642,8,0.333333,0.000458
9212103,9212103,,9,1,10,9,1,10,0.000066,0.000002,0,2895,15,0.000037,1,1,1,593.60786,0.088889,0.002411
9308102,9308102,,5,2,7,5,2,7,0.000059,0.000012,0,2880,15,0.000015,1,1,1,4325.940767,0.02381,0.001257
9508129,9508129,,10,2,12,10,2,12,0.00017,0.000012,0,2897,30,0.00002,1,1,1,3173.135156,0.136364,0.002899
9512013,9512013,,10,1,11,10,1,11,0.000112,0,0,6973,15,0.000033,1,1,1,335.644507,0.127273,0.002634
9607187,9607187,,11,17,28,11,17,28,0.000199,0.00479,0,2817,13,0.000022,10,0.224813,0.263933,271315.579106,0.056878,0.003028
9801117,9801117,,1,2,3,1,2,3,0.00001,0.000006,0,6970,28,0.000011,16,0.145309,0.161725,30976.634386,0.166667,0.000279
9407088,9407088,,1,0,1,1,0,1,0.000026,0,0,13672,15,0.000011,0,0,0,0,0,0.00024
9408088,9408088,,4,1,5,4,1,5,0.000026,0.000005,0,6188,15,0.00003,2,0.571429,0.625,5.416667,0.25,0.001002
9610019,9610019,,8,16,24,8,16,24,0.000057,0.00003,0,13670,22,0.000021,12,0.207262,0.243183,24788.984215,0.077899,0.00199
9810105,9810105,,9,11,20,9,11,20,0.000028,0.000009,0,13669,22,0.000022,11,0.177068,0.19841,13406.279547,0.078947,0.002396
9207048,9207048,,6,0,6,6,0,6,0.000269,0,0,532,15,0.000018,0,0,0,0,0.166667,0.001485
9304075,9304075,,3,3,6,3,3,6,0.00019,0,0,9356,9,0.000015,2,0.8,0.875,7137.702695,0.133333,0.000713
9812242,9812242,,4,3,7,4,3,7,0.000268,0.000064,0,9352,15,0.000012,14,0.166132,0.180217,970.358899,0.190476,0.000999
4154,4154,,4,11,15,4,11,15,0.000007,0.000196,0,13679,22,0.000012,12,0.201976,0.233462,8014.485971,0.209524,0.000976
9312081,9312081,,4,2,6,4,2,6,0.000007,0,0,13678,22,0.000013,1,1,1,309.612318,0.2,0.000964
9603139,9603139,,6,2,8,6,2,8,0.000052,0,0,10002,22,0.000015,1,1,1,341.192982,0.178571,0.001554
9302076,9302076,,24,0,24,24,0,24,0.000003,0,0,3801,15,0.000227,0,0,0,0,0.043478,0.00609
4157,4157,,2,15,17,2,15,17,0.000008,0.002886,0,13692,23,0.000011,13,0.192555,0.211709,18360.376348,0.102941,0.000452
9403188,9403188,,25,2,27,25,2,27,0.000049,0.000001,0,6232,23,0.000058,1,1,1,27.77196,0.118234,0.006316
9408038,9408038,,16,1,17,16,1,17,0.000061,0,0,13656,23,0.000036,1,1,1,102.78444,0.113971,0.004038
9807180,9807180,,5,10,15,5,10,15,0.000067,0.000275,0,13691,23,0.000015,11,0.19601,0.219957,11857.112843,0.090476,0.001136
9906019,9906019,,6,11,17,6,11,17,0.000043,0.000006,0,13690,23,0.000014,10,0.173136,0.218193,607.828365,0.154412,0.001401
9908112,9908112,,10,5,15,10,5,15,0.000043,0.000002,0,13687,23,0.000022,11,0.159636,0.196867,695.245251,0.190476,0.002333
9310043,9310043,,29,0,29,29,0,29,0.000025,0,0,4751,23,0.00024,0,0,0,0,0.091133,0.008116
9403069,9403069,,29,1,30,29,1,30,0.000027,0,0,6229,23,0.000111,1,1,1,9.478571,0.095402,0.007776
9310044,9310044,,33,0,33,33,0,33,0.00004,0,0,4750,23,0.000133,0,0,0,0,0.065341,0.008733
9511212,9511212,,13,7,20,13,7,20,0.000011,0.000006,0,8378,23,0.000035,8,0.197561,0.256026,2749.629386,0.113158,0.003517
9512110,9512110,,2,12,14,2,12,14,0,0.000005,0,13689,23,0.000017,3,0.761905,0.864583,176.337395,0.098901,0.000492
9702002,9702002,,15,14,29,15,14,29,0.000011,0.000007,0,8386,23,0.000029,9,0.178926,0.258397,73221.482642,0.091133,0.003522
9702134,9702134,,20,10,30,20,10,30,0.000032,0.000005,0,13683,23,0.000036,10,0.178867,0.223604,2271.7502,0.125287,0.00479
9711092,9711092,,10,11,21,10,11,21,0.000009,0.000004,0,13684,23,0.000025,10,0.171129,0.219199,910.845851,0.164286,0.002438
9811066,9811066,,11,6,17,11,6,17,0.00002,0.000002,0,13686,23,0.000025,11,0.159692,0.199217,445.665106,0.176471,0.002624
4158,4158,,33,12,45,33,12,45,0.00002,0.000021,0,13693,23,0.000044,15,0.15033,0.165448,36478.944894,0.160606,0.008466
4159,4159,,3,28,31,3,28,31,0.000163,0.006533,0,13694,30,0.000011,14,0.211354,0.235994,2963.872798,0.184946,0.000798
4161,4161,,2,1,3,2,1,3,0.000001,0,0,13696,22,0.000012,15,0.151581,0.163518,114.388106,0.333333,0.000445
9901163,9901163,,4,5,9,4,5,9,0.000015,0.005707,0,13695,22,0.000023,14,0.178626,0.199359,14727.488511,0.125,0.000936
4162,4162,,1,9,10,1,9,10,0,0.000005,0,13697,22,0.000013,4,0.472973,0.571429,29.166667,0.155556,0.000219
9706198,9706198,,4,7,11,4,7,11,0.000019,0.000005,0,9428,22,0.00002,4,0.471429,0.55303,2481.507002,0.2,0.000926
9204056,9204056,,14,0,14,14,0,14,0.000046,0,0,1772,22,0.0001,0,0,0,0,0.027473,0.003764
9312161,9312161,,17,2,19,17,2,19,0.000002,0,0,2653,22,0.00007,2,0.75,0.833333,13671.808425,0.108187,0.004363
9304103,9304103,,6,0,6,6,0,6,0,0,0,2647,22,0.000206,0,0,0,0,0.133333,0.001558
9307178,9307178,,18,1,19,18,1,19,0.000001,0,0,2651,22,0.000149,1,1,1,13547.47963,0.108187,0.004787
9403134,9403134,,1,1,2,1,1,2,0,0,0,2646,15,0.000014,1,1,1,2605.151655,0,0.000318
9406039,9406039,,3,0,3,3,0,3,0,0,0,3117,5,0.000035,0,0,0,0,0,0.000728
4163,4163,,2,16,18,2,16,18,0.000005,0.000197,0,13704,23,0.000011,18,0.135369,0.153986,5.483766,0.238562,0.000451
9810078,9810078,,11,8,19,11,8,19,0.000011,0.000002,0,13700,23,0.000023,17,0.139331,0.153302,2871.802632,0.233918,0.002637
9903206,9903206,,7,6,13,7,6,13,0.00001,0.000001,0,13702,23,0.000016,17,0.139342,0.152723,1413.608919,0.352564,0.001673
9905190,9905190,,7,5,12,7,5,12,0.000036,0,0,13698,23,0.000017,17,0.144469,0.158933,24683.886949,0.181818,0.001667
9910060,9910060,,7,6,13,7,6,13,0.00001,0.000001,0,13699,23,0.000016,18,0.126302,0.136213,2319.937229,0.25641,0.001613
9911214,9911214,,4,19,23,4,19,23,0.000007,0.000202,0,13703,23,0.000014,17,0.15238,0.174213,12590.030714,0.203557,0.000929
9508038,9508038,,1,1,2,1,1,2,0,0,0,9145,23,0.000014,1,1,1,5457.695238,0,0.00031
9901140,9901140,,3,5,8,3,5,8,0.000005,0.000001,0,13701,23,0.000013,18,0.12238,0.13203,0.290909,0.446429,0.000718
4167,4167,,1,12,13,1,12,13,0.000001,0.001716,0,13705,10,0.000011,13,0.182476,0.200322,5990.361674,0.153846,0.000219
4168,4168,,0,11,11,0,11,11,0,0.000006,0,13708,22,0.00001,11,0.166205,0.215603,0,0.154545,0
9306006,9306006,,12,3,15,12,3,15,0.000063,0,0,8556,22,0.000048,1,1,1,8930.839882,0.142857,0.00295
9308009,9308009,,5,0,5,5,0,5,0,0,0,2643,22,0.000065,0,0,0,0,0.05,0.001138
9611224,9611224,,3,10,13,3,10,13,0,0.000003,0,10388,22,0.000015,3,0.581395,0.68,21329.940555,0.044872,0.000731
9908181,9908181,,2,15,17,2,15,17,0,0.000013,0,13707,22,0.000014,10,0.190892,0.242631,777.233333,0.091912,0.000438
9210131,9210131,,5,0,5,5,0,5,0,0,0,8555,22,0.000038,0,0,0,0,0.25,0.001268
9303080,9303080,,10,0,10,10,0,10,0.000001,0,0,2652,22,0.000066,0,0,0,0,0.111111,0.002466
9303117,9303117,,8,1,9,8,1,9,0,0,0,5578,22,0.000107,1,1,1,93.554106,0.138889,0.002114
9409133,9409133,,7,2,9,7,2,9,0,0,0,10387,26,0.000024,1,1,1,511.477733,0.069444,0.001581
9412218,9412218,,5,4,9,5,4,9,0.000002,0.000002,0,8391,26,0.000019,2,0.75,0.833333,1862.531002,0.055556,0.001157
9507077,9507077,,10,1,11,10,1,11,0.000012,0,0,5579,22,0.00003,2,0.666667,0.75,5.333333,0.172727,0.002414
9511207,9511207,,19,5,24,19,5,24,0.000026,0.000001,0,5582,22,0.000041,2,0.777778,0.857143,9249.05037,0.168478,0.004538
9601046,9601046,,8,1,9,8,1,9,0,0,0,10385,23,0.000033,1,1,1,4087.5,0.097222,0.00186
9702100,9702100,,2,1,3,2,1,3,0.000119,0.000003,0,13706,28,0.000011,1,1,1,178.619129,0,0.000465
4169,4169,,0,2,2,0,2,2,0,0.000001,0,13709,23,0.00001,2,0.75,0.833333,0,0,0
9401001,9401001,,7,0,7,7,0,7,0.000012,0,0,13619,23,0.000044,0,0,0,0,0.214286,0.001777
4170,4170,,4,11,15,4,11,15,0.000092,0.000077,0,13711,0,0.000012,14,0.173218,0.192054,1349.863808,0.17619,0.00095
9910147,9910147,,4,13,17,4,13,17,0.000008,0.000151,0,13710,0,0.000015,14,0.182863,0.208452,25616.181122,0.198529,0.00107
9610089,9610089,,4,18,22,4,18,22,0.000073,0.000169,0,4939,0,0.000015,11,0.208275,0.242587,1161.810618,0.192641,0.001187
4171,4171,,26,1,27,26,1,27,0.000661,0.000038,0,13712,2,0.000049,15,0.143504,0.153912,0,0.235043,0.007003
4172,4172,,2,13,15,2,13,15,0.000038,0.000494,0,13715,3,0.000011,12,0.196969,0.2195,7002.575586,0.047619,0.000505
9304096,9304096,,4,3,7,4,3,7,0.000039,0.00004,0,1706,13,0.000012,3,0.538462,0.666667,152.76922,0.071429,0.001077
9702019,9702019,,5,8,13,5,8,13,0.00035,0.000013,0,7032,9,0.000012,10,0.17776,0.226785,32542.551178,0.057692,0.001319
9706069,9706069,,1,7,8,1,7,8,0.000006,0.001288,0,13714,52,0.000011,12,0.2101,0.240913,3317.12589,0.089286,0.000233
9203012,9203012,,12,0,12,12,0,12,0.000075,0,0,141,9,0.000094,0,0,0,0,0.083333,0.003713
9206077,9206077,,14,0,14,14,0,14,0.000846,0,0,75,9,0.000106,0,0,0,0,0.131868,0.004876
9209013,9209013,,7,0,7,7,0,7,0.000058,0,0,427,9,0.000031,0,0,0,0,0.190476,0.002287
9503229,9503229,,8,30,38,8,30,38,0.000054,0.000075,0,3770,22,0.000026,6,0.393382,0.542212,133887.379808,0.062589,0.002188
9602172,9602172,,6,52,58,6,52,58,0.000414,0.008648,0,2010,13,0.000018,10,0.249783,0.3069,221521.779066,0.08288,0.002664
9602177,9602177,,6,6,12,6,6,12,0.000022,0.000011,0,7029,6,0.00003,8,0.24608,0.302299,4550.268651,0.136364,0.001402
9609079,9609079,,4,22,26,4,22,26,0.00017,0.00055,0,10906,52,0.000017,11,0.211097,0.246545,18265.988878,0.047692,0.000923
9609221,9609221,,1,2,3,1,2,3,0.000015,0.000002,0,13713,52,0.000011,12,0.174524,0.192902,16.756005,0.166667,0.000226
4173,4173,,0,6,6,0,6,6,0,0,0,13719,21,0.00001,11,0.136243,0.155729,0,0.366667,0
9710209,9710209,,3,6,9,3,6,9,0,0.000001,0,13717,21,0.000017,10,0.15626,0.176674,1037.885256,0.236111,0.00067
9911053,9911053,,2,3,5,2,3,5,0,0,0,13718,21,0.000013,11,0.135477,0.149352,32.635256,0.25,0.000438
9406057,9406057,,3,0,3,3,0,3,0,0,0,7122,21,0.00003,0,0,0,0,0.166667,0.000765
9504116,9504116,,3,2,5,3,2,5,0,0,0,7121,21,0.000027,2,0.75,0.833333,0.5,0.25,0.000731
9612175,9612175,,3,2,5,3,2,5,0,0,0,13716,21,0.000023,2,0.75,0.833333,3.25,0.2,0.000677
4174,4174,,1,1,2,1,1,2,0,0,0,13720,23,0.000011,18,0.103224,0.113665,6,0,0.000226
4175,4175,,1,1,2,1,1,2,0,0,0,13721,22,0.000012,4,0.387097,0.4375,0,0.5,0.000219
9409068,9409068,,13,4,17,13,4,17,0.000035,0.000006,0,9513,22,0.000051,3,0.578947,0.666667,17824.041587,0.055147,0.003243
9209077,9209077,,2,0,2,2,0,2,0,0,0,9512,22,0.000028,0,0,0,0,0,0.00057
9307099,9307099,,10,0,10,10,0,10,0.000001,0,0,9511,22,0.000065,0,0,0,0,0.044444,0.002372
9310125,9310125,,4,3,7,4,3,7,0,0.000011,0,9510,22,0.000074,2,0.8,0.875,127.839422,0.142857,0.001111
4176,4176,,1,3,4,1,3,4,0,0,0,13723,26,0.000013,8,0.204924,0.228492,208.477279,0.083333,0.000219
9603204,9603204,,3,6,9,3,6,9,0,0.000001,0,11407,23,0.000019,8,0.25887,0.292948,2693.863785,0.194444,0.000678
9609206,9609206,,2,4,6,2,4,6,0,0,0,13722,26,0.000017,8,0.214555,0.244869,327.265237,0.066667,0.000445
9505016,9505016,,5,5,10,5,5,10,0,0.000006,0,8969,23,0.00003,7,0.332731,0.374961,8227.007746,0.144444,0.001196
9511221,9511221,,5,6,11,5,6,11,0,0.000001,0,8970,23,0.000026,8,0.258021,0.292974,2166.578729,0.245455,0.00117
9512112,9512112,,6,9,15,6,9,15,0,0.000001,0,8971,23,0.000049,8,0.259705,0.301773,19970.181369,0.147619,0.001429
4177,4177,,4,5,9,4,5,9,0.000013,0.000535,0,13725,1,0.000017,14,0.153158,0.167505,1757.569821,0.180556,0.00089
9903257,9903257,,4,7,11,4,7,11,0.000024,0.000801,0,13724,1,0.000019,14,0.17023,0.190971,13238.447879,0.136364,0.000922
9602033,9602033,,4,5,9,4,5,9,0.000031,0.000578,0,11263,41,0.000018,5,0.324042,0.369892,2487.723574,0.138889,0.000964
9712161,9712161,,6,8,14,6,8,14,0.000062,0.000354,0,6490,2,0.000018,16,0.161599,0.184513,29858.84606,0.159341,0.001477
4178,4178,,7,8,15,7,8,15,0.000463,0.000174,0,13726,25,0.000013,12,0.185941,0.204549,2166.763018,0.147619,0.00171
9901111,9901111,,7,6,13,7,6,13,0.000219,0.000288,0,8727,25,0.000019,13,0.178892,0.19801,11584.067514,0.147436,0.002133
9910071,9910071,,14,11,25,14,11,25,0.000209,0.000483,0,12339,25,0.000029,13,0.188831,0.211876,29701.050706,0.126667,0.003632
9708067,9708067,,6,2,8,6,2,8,0.000028,0.000035,0,6008,25,0.000032,16,0.155609,0.168363,1770.939448,0.321429,0.00178
9808090,9808090,,7,1,8,7,1,8,0.000338,0.000002,0,8726,25,0.00002,13,0.174888,0.190632,1914.343569,0.071429,0.00166
4179,4179,,5,13,18,5,13,18,0.000511,0.017575,0,13727,1,0.000012,11,0.227162,0.257338,6265.187957,0.20915,0.00133
4180,4180,,2,8,10,2,8,10,0.000003,0.000109,0,13729,13,0.000012,15,0.145957,0.172204,5502.89997,0.133333,0.000438
9403101,9403101,,2,0,2,2,0,2,0.000003,0,0,13728,13,0.000012,0,0,0,0,0.5,0.000451
4181,4181,,4,13,17,4,13,17,0.000014,0.000029,0,13730,6,0.000012,13,0.151168,0.201809,27276.608001,0.150735,0.001028
4182,4182,,2,9,11,2,9,11,0.000014,0.000175,0,13732,2,0.000011,15,0.154413,0.177294,21050.170341,0.163636,0.000465
9904152,9904152,,5,6,11,5,6,11,0.00001,0.000002,0,13731,2,0.000014,14,0.16103,0.18042,567.463394,0.272727,0.001122
4183,4183,,31,65,96,31,65,96,0.001272,0.00546,0,12202,30,0.000039,13,0.21749,0.24471,275882.677391,0.138158,0.013948
4184,4184,,4,8,12,4,8,12,0,0.000019,0,13733,23,0.000014,14,0.149086,0.172404,17.966136,0.318182,0.000953
4185,4185,,5,19,24,5,19,24,0.001096,0.019732,0,13734,1,0.000012,11,0.226694,0.257026,1530.668839,0.21558,0.001145
4186,4186,,8,36,44,8,36,44,0.000895,0.018355,0,13739,4,0.000015,15,0.203767,0.23483,30389.16298,0.113108,0.002041
9903189,9903189,,2,1,3,2,1,3,0.000216,0,0,13738,26,0.000044,2,0.666667,0.75,4731.648947,0,0.000566
9912006,9912006,,2,1,3,2,1,3,0.000219,0.000001,0,13735,4,0.000013,2,0.666667,0.75,73.245459,0.166667,0.000508
9812203,9812203,,4,1,5,4,1,5,0.000001,0,0,13737,26,0.000053,1,1,1,2582,0,0.000945
9512064,9512064,,5,1,6,5,1,6,0.000066,0,0,3070,22,0.000038,1,1,1,6181.709068,0.133333,0.001667
4187,4187,,12,69,81,12,69,81,0.002213,0.032708,0,13016,1,0.000016,11,0.247609,0.282573,144008.1762,0.097531,0.005816
9907142,9907142,,6,34,40,6,34,40,0.001673,0.024794,0,13014,1,0.000012,11,0.235408,0.269891,20921.449432,0.125641,0.001826
9801162,9801162,,1,13,14,1,13,14,0.000238,0.002959,0,5873,2,0.000011,14,0.193249,0.222321,649.610453,0.10989,0.000449
9907016,9907016,,1,3,4,1,3,4,0.000291,0.003643,0,13013,2,0.00001,11,0.181868,0.202538,1.709146,0.166667,0.000265
4188,4188,,16,36,52,16,36,52,0.000729,0.002996,0,12365,25,0.000017,16,0.206902,0.23316,30130.95463,0.149698,0.004103
9912162,9912162,,13,17,30,13,17,30,0.000725,0.000403,0,12363,25,0.000018,12,0.182859,0.203234,11119.67026,0.191954,0.003315
9710109,9710109,,2,2,4,2,2,4,0.000004,0,0,9430,22,0.000016,5,0.333333,0.379524,14177.366006,0.083333,0.000627
4189,4189,,3,6,9,3,6,9,0.000032,0.000153,0,13740,9,0.000011,17,0.167673,0.189596,16.446154,0.375,0.000873
4190,4190,,3,1,4,3,1,4,0,0,0,13742,23,0.000016,2,0.666667,0.75,16.293478,0.333333,0.000691
9912253,9912253,,3,1,4,3,1,4,0,0.000001,0,13741,23,0.000029,1,1,1,17.586957,0.25,0.000691
4191,4191,,3,5,8,3,5,8,0.000008,0.000175,0,13743,2,0.000012,14,0.160333,0.17881,50.385834,0.267857,0.00067
4192,4192,,2,1,3,2,1,3,0.000018,0,0,13745,30,0.000013,1,1,1,6,0.166667,0.000465
9906140,9906140,,1,0,1,1,0,1,0,0,0,13744,30,0.000022,0,0,0,0,0,0.000232
4194,4194,,13,12,25,13,12,25,0.001638,0.002758,0,12393,2,0.000015,14,0.176225,0.198401,6300.618331,0.255,0.003805
9912103,9912103,,7,8,15,7,8,15,0.000907,0.000735,0,12392,2,0.000013,14,0.178408,0.199977,1191.059581,0.32381,0.002219
4195,4195,,22,22,44,22,22,44,0.001531,0.006197,0,12796,2,0.00004,12,0.204355,0.229298,55293.887385,0.077696,0.005787
9609069,9609069,,8,2,10,8,2,10,0.00016,0.000003,0,3113,20,0.000024,3,0.529412,0.592593,42859.077911,0.188889,0.002808
4196,4196,,22,16,38,22,16,38,0.000749,0.002084,0,11650,4,0.00003,11,0.22803,0.258969,88181.496225,0.193457,0.008921
9412210,9412210,,7,0,7,7,0,7,0.000096,0,0,10860,52,0.000038,0,0,0,0,0.214286,0.001864
9208042,9208042,,6,0,6,6,0,6,0.000005,0,0,694,4,0.000019,0,0,0,0,0.166667,0.00154
4197,4197,,0,1,1,0,1,1,0,0,0,13748,22,0.00001,6,0.279661,0.313131,0,0,0
9811157,9811157,,8,2,10,8,2,10,0.000001,0,0,13747,22,0.000035,5,0.376471,0.430729,125.908171,0.133333,0.001901
9809036,9809036,,7,8,15,7,8,15,0.000001,0.000003,0,13746,22,0.000032,2,0.785714,0.863636,313.08858,0.133333,0.001696
4198,4198,,5,89,94,5,89,94,0.000358,0.033224,0,13749,3,0.000012,12,0.255111,0.294761,50268.195278,0.07138,0.001481
9712092,9712092,,2,2,4,2,2,4,0.000478,0.000193,0,5058,0,0.00001,12,0.175652,0.195606,937.45622,0.166667,0.000593
9509006,9509006,,1,2,3,1,2,3,0.000072,0.000011,0,2147,0,0.000013,3,0.48,0.541667,5176.47493,0.166667,0.000753
9703008,9703008,,6,20,26,6,20,26,0.000232,0.005148,0,4671,2,0.000017,12,0.213662,0.248889,49783.339145,0.081538,0.001572
4199,4199,,7,16,23,7,16,23,0.001341,0.00219,0,13750,13,0.000012,18,0.184797,0.217316,3359.527885,0.195652,0.001788
4200,4200,,0,3,3,0,3,3,0,0.000001,0,13751,23,0.00001,10,0.165593,0.184619,0,0.333333,0
9309045,9309045,,14,0,14,14,0,14,0.00004,0,0,1754,26,0.000416,0,0,0,0,0.137363,0.004226
9710157,9710157,,1,0,1,1,0,1,0,0,0,8124,23,0.000017,0,0,0,0,0,0.000269
4201,4201,,3,17,20,3,17,20,0.000438,0.012288,0,12482,1,0.000013,14,0.198021,0.223464,1291.607796,0.252632,0.001448
4202,4202,,0,1,1,0,1,1,0,0.000001,0,13752,2,0.00001,13,0.166335,0.17866,0,0,0
4203,4203,,3,6,9,3,6,9,0,0.000011,0,13753,23,0.000017,8,0.173791,0.203687,479.850128,0.055556,0.000664
9303150,9303150,,11,1,12,11,1,12,0.000008,0,0,4398,22,0.000037,1,1,1,5167.735283,0.151515,0.002679
4204,4204,,1,25,26,1,25,26,0.000347,0.019938,0,13754,1,0.00001,11,0.230281,0.262282,33.718697,0.163077,0.000219
4205,4205,,2,4,6,2,4,6,0,0,0,13755,26,0.000014,11,0.139857,0.15539,330,0.266667,0.000438
9703139,9703139,,9,5,14,9,5,14,0,0.000002,0,10830,26,0.000042,3,0.625,0.733333,243.935592,0.159341,0.002092
9203029,9203029,,7,0,7,7,0,7,0,0,0,4742,22,0.000047,0,0,0,0,0.119048,0.001622
9306008,9306008,,12,0,12,12,0,12,0,0,0,5895,26,0.000085,0,0,0,0,0.143939,0.002917
9510037,9510037,,10,1,11,10,1,11,0.000002,0,0,10829,26,0.000034,1,1,1,2.333333,0.163636,0.002318
9510157,9510157,,23,8,31,23,8,31,0.000211,0.000015,0,7373,26,0.000094,9,0.18963,0.215507,27702.465276,0.095699,0.005652
5002,5002,,5,5,10,5,5,10,0.000092,0.000345,0,13756,1,0.000014,14,0.165706,0.18713,1504.518225,0.166667,0.001533
5003,5003,,12,26,38,12,26,38,0.002116,0.011261,0,12385,1,0.000018,11,0.230455,0.263279,48277.083391,0.100996,0.003553
9804074,9804074,,4,15,19,4,15,19,0.000552,0.008235,0,7994,4,0.000012,12,0.19823,0.225304,11113.348004,0.152047,0.001079
9910013,9910013,,13,27,40,13,27,40,0.001626,0.018161,0,12384,1,0.000017,11,0.228974,0.260798,57944.759722,0.075641,0.003935
9511014,9511014,,8,7,15,8,7,15,0.000274,0.002422,0,5022,4,0.000018,7,0.252392,0.299966,409.597831,0.304762,0.00197
9701012,9701012,,11,12,23,11,12,23,0.000336,0.002797,0,5024,4,0.000019,10,0.186813,0.239411,32096.122888,0.213439,0.002621
9210019,9210019,,1,1,2,1,1,2,0.000213,0,0,12383,22,0.00001,1,1,1,289.208657,0,0.000318
9304020,9304020,,5,0,5,5,0,5,0.000215,0,0,1052,9,0.00002,0,0,0,0,0.2,0.00142
9808094,9808094,,1,11,12,1,11,12,0.000213,0.006049,0,12382,9,0.00001,14,0.190716,0.216085,7426.122444,0.075758,0.000318
9909097,9909097,,1,2,3,1,2,3,0.000213,0.000537,0,12380,1,0.00001,13,0.168188,0.183574,0,0.5,0.000318
5004,5004,,3,10,13,3,10,13,0,0.001584,0,13758,23,0.000014,11,0.195646,0.22116,12686.970795,0.057692,0.00071
9902048,9902048,,1,6,7,1,6,7,0.000019,0.000012,0,13757,23,0.000011,9,0.200643,0.230279,301.518431,0.071429,0.000239
9308127,9308127,,5,2,7,5,2,7,0.000027,0.000001,0,8539,23,0.00003,1,1,1,1725.895261,0.02381,0.00116
9411088,9411088,,1,0,1,1,0,1,0.000001,0,0,5141,23,0.000027,0,0,0,0,0,0.000351
9406092,9406092,,4,0,4,4,0,4,0.000018,0,0,974,23,0.000019,0,0,0,0,0.083333,0.001062
9410134,9410134,,10,0,10,10,0,10,0.000081,0,0,4832,23,0.000034,0,0,0,0,0.133333,0.002569
9606120,9606120,,5,5,10,5,5,10,0.000002,0.000004,0,4840,23,0.000019,6,0.261773,0.303792,11272.783876,0.111111,0.001153
9407150,9407150,,2,0,2,2,0,2,0,0,0,7246,22,0.000015,0,0,0,0,0,0.000539
9609240,9609240,,1,6,7,1,6,7,0,0.000004,0,12518,23,0.000012,3,0.5,0.595238,4251.368232,0.095238,0.00028
9705028,9705028,,8,8,16,8,8,16,0.000003,0.000067,0,9637,26,0.000047,8,0.203013,0.231348,16082.778993,0.079167,0.001917
5005,5005,,24,14,38,24,14,38,0.000813,0.003114,0,13068,30,0.000037,13,0.192411,0.211024,10741.30902,0.135846,0.009152
5006,5006,,118,25,143,118,25,143,0.006186,0.003057,0,12218,3,0.00012,15,0.208179,0.232408,219493.265008,0.081798,0.056809
5007,5007,,9,47,56,9,47,56,0.001478,0.021563,0,13017,30,0.000013,12,0.222624,0.24998,14242.959881,0.161039,0.003185
5008,5008,,4,20,24,4,20,24,0.000416,0.003566,0,13759,0,0.000011,16,0.178775,0.216932,1307.049854,0.179348,0.000967
9703180,9703180,,17,42,59,17,42,59,0.000985,0.004777,0,4020,4,0.000015,14,0.196517,0.240588,13188.847252,0.24547,0.004984
9708073,9708073,,4,24,28,4,24,28,0.000196,0.003317,0,5958,4,0.000011,13,0.187982,0.218951,139.894827,0.357143,0.001025
5009,5009,,3,6,9,3,6,9,0.000001,0.000145,0,13760,15,0.000015,13,0.1705,0.186428,6527.863868,0.194444,0.000705
9204039,9204039,,4,0,4,4,0,4,0.000001,0,0,2249,15,0.000086,0,0,0,0,0,0.001141
5010,5010,,6,11,17,6,11,17,0.000035,0.000382,0,13765,2,0.000014,13,0.187917,0.215695,11738.867075,0.169118,0.001374
9701157,9701157,,5,3,8,5,3,8,0.000023,0.00007,0,3412,2,0.000019,8,0.229412,0.256463,2375.270573,0.232143,0.001536
9809136,9809136,,7,8,15,7,8,15,0.000026,0.000192,0,13764,2,0.000016,14,0.162157,0.181938,4860.638614,0.157143,0.00164
9404095,9404095,,1,2,3,1,2,3,0.000084,0.000041,0,1855,2,0.000012,2,0.666667,0.75,752.785198,0.166667,0.000482
9702024,9702024,,2,15,17,2,15,17,0.000013,0.000727,0,3410,2,0.000015,11,0.19731,0.224092,15232.990757,0.106618,0.000799
9501081,9501081,,6,0,6,6,0,6,0.000046,0,0,1107,2,0.00004,0,0,0,0,0.033333,0.001803
9806033,9806033,,1,12,13,1,12,13,0.000002,0.000318,0,13763,2,0.000012,14,0.163754,0.186297,2175.816001,0.192308,0.000266
5011,5011,,2,6,8,2,6,8,0.000001,0.000001,0,13766,23,0.000011,19,0.133137,0.145698,9.641148,0.107143,0.000445
9409046,9409046,,3,8,11,3,8,11,0,0.000007,0,12526,23,0.000014,2,0.681818,0.766667,1110.281685,0.172727,0.000724
9503192,9503192,,3,8,11,3,8,11,0,0.000002,0,12523,23,0.000013,3,0.733333,0.848485,35.842299,0.072727,0.000717
9203014,9203014,,4,0,4,4,0,4,0.000387,0,0,12524,23,0.000013,0,0,0,0,0.083333,0.000924
5015,5015,,98,13,111,98,13,111,0.005567,0.002881,0,12160,30,0.000114,15,0.195701,0.217106,66938.725607,0.056757,0.038596
5129,5129,,156,22,178,156,22,178,0.007159,0.003894,0,12207,30,0.000143,12,0.199073,0.219748,138331.058395,0.055672,0.051781
5040,5040,,155,15,170,155,15,170,0.012403,0.003602,0,12205,30,0.000117,15,0.201291,0.223435,114686.369762,0.052698,0.05836
5046,5046,,43,5,48,43,5,48,0.00351,0.001845,0,12204,30,0.000047,16,0.182294,0.199818,7307.098817,0.116578,0.017331
5048,5048,,159,16,175,159,16,175,0.01289,0.002288,0,12203,30,0.000116,12,0.207329,0.228955,311439.269434,0.049885,0.060334
5073,5073,,62,22,84,62,22,84,0.004462,0.01891,0,12206,30,0.000057,13,0.2005,0.223524,39119.73373,0.117613,0.024188
5017,5017,,6,6,12,6,6,12,0.000035,0.001022,0,13771,25,0.000018,12,0.189361,0.206171,25848.960303,0.272727,0.001394
9902069,9902069,,7,1,8,7,1,8,0.000047,0,0,13770,25,0.000021,2,0.666667,0.75,2708,0.285714,0.001653
9912229,9912229,,11,5,16,11,5,16,0.000102,0.000084,0,13767,25,0.00003,13,0.146339,0.165038,2118.448638,0.116667,0.002571
9810061,9810061,,1,1,2,1,1,2,0,0,0,13769,25,0.000029,1,1,1,1355,0,0.000266
5018,5018,,2,5,7,2,5,7,0,0,0,13772,23,0.000013,16,0.118896,0.132071,271.44878,0.428571,0.000465
5019,5019,,0,6,6,0,6,6,0,0.000002,0,13778,26,0.00001,6,0.333333,0.476,0,0.166667,0
9710042,9710042,,5,2,7,5,2,7,0.000002,0,0,13776,26,0.000021,5,0.354167,0.435294,14.75,0.190476,0.001122
9903147,9903147,,2,1,3,2,1,3,0,0.000002,0,13773,26,0.000015,2,0.666667,0.75,2,0.333333,0.000445
9903200,9903200,,1,3,4,1,3,4,0,0,0,13777,26,0.000011,5,0.362069,0.451587,7,0.25,0.000219
9701029,9701029,,5,4,9,5,4,9,0.000002,0.000002,0,13775,26,0.000028,4,0.464286,0.589744,64.833333,0.111111,0.001174
9707112,9707112,,5,1,6,5,1,6,0.000002,0,0,13774,26,0.000027,3,0.454545,0.533333,10,0.266667,0.001168
5020,5020,,0,10,10,0,10,10,0,0.018468,0,13779,1,0.00001,11,0.225067,0.255215,0,0.277778,0
5021,5021,,17,39,56,17,39,56,0.001608,0.013361,0,12211,30,0.000019,15,0.236758,0.271705,64731.544334,0.098701,0.005502
5023,5023,,0,3,3,0,3,3,0,0.000008,0,13780,23,0.00001,10,0.192953,0.21484,0,0.333333,0
5024,5024,,0,4,4,0,4,4,0,0,0,13781,26,0.00001,16,0.114317,0.123158,0,0.333333,0
5026,5026,,42,33,75,42,33,75,0.002956,0.005907,0,12252,30,0.000034,14,0.213492,0.240434,172334.920672,0.108649,0.013633
9912065,9912065,,7,10,17,7,10,17,0.000809,0.00197,0,12242,30,0.000013,13,0.198412,0.219645,8639.754496,0.191176,0.002138
5123,5123,,26,15,41,26,15,41,0.001705,0.004229,0,12253,30,0.000025,15,0.196708,0.219274,20022.549072,0.141463,0.007841
9912274,9912274,,19,22,41,19,22,41,0.000837,0.004721,0,12241,3,0.000023,13,0.196578,0.216188,12654.981524,0.113415,0.007198
5027,5027,,6,13,19,6,13,19,0,0.000056,0,13784,6,0.000022,13,0.171401,0.187119,74756.870813,0.090643,0.001429
9909019,9909019,,5,3,8,5,3,8,0.000001,0.000017,0,13783,6,0.000019,7,0.252381,0.310669,217.998122,0.196429,0.00119
9911016,9911016,,5,29,34,5,29,34,0.000587,0.017866,0,13782,41,0.000014,12,0.202049,0.227127,81616.068574,0.195187,0.001607
9405090,9405090,,4,2,6,4,2,6,0.000302,0.000011,0,12299,13,0.000013,1,1,1,97.62254,0.166667,0.000918
9602057,9602057,,6,11,17,6,11,17,0.000239,0.000771,0,2011,13,0.000018,11,0.199532,0.23513,9469.019303,0.176471,0.002274
9201044,9201044,,8,0,8,8,0,8,0.000087,0,0,491,0,0.000119,0,0,0,0,0.125,0.00214
9207002,9207002,,7,1,8,7,1,8,0.000088,0.000001,0,492,0,0.000038,1,1,1,0.5,0.160714,0.001826
9712022,9712022,,3,26,29,3,26,29,0.000108,0.003007,0,7661,0,0.000013,14,0.193063,0.226929,2581.459499,0.215517,0.001257
5029,5029,,55,72,127,55,72,127,0.004585,0.017119,0,12291,3,0.000034,12,0.222484,0.257125,271216.668174,0.074428,0.018782
9609232,9609232,,2,0,2,2,0,2,0.0001,0,0,3584,2,0.000037,0,0,0,0,0.5,0.001032
5030,5030,,0,15,15,0,15,15,0,0.000376,0,13789,23,0.00001,14,0.176989,0.203622,0,0.042857,0
9506199,9506199,,5,3,8,5,3,8,0.000137,0.000013,0,3626,52,0.000016,6,0.260593,0.295935,21582.036076,0.125,0.001352
9606178,9606178,,4,0,4,4,0,4,0.000012,0,0,13785,23,0.000018,0,0,0,0,0.25,0.000936
9611232,9611232,,1,4,5,1,4,5,0.000004,0.000591,0,13788,23,0.00001,9,0.208955,0.246251,50.103461,0.05,0.000219
9804070,9804070,,7,5,12,7,5,12,0.000015,0.000002,0,13786,23,0.00002,2,0.777778,0.857143,51.122222,0.090909,0.0016
9206082,9206082,,4,1,5,4,1,5,0.000031,0.000003,0,366,26,0.000034,1,1,1,0.25,0.3,0.001569
9408122,9408122,,5,0,5,5,0,5,0.000008,0,0,13787,23,0.00004,0,0,0,0,0.2,0.001135
9607044,9607044,,5,4,9,5,4,9,0.000003,0.000005,0,6026,23,0.000025,13,0.155254,0.175136,4.721605,0.402778,0.001338
9611015,9611015,,2,10,12,2,10,12,0,0.000135,0,6030,23,0.000018,13,0.163143,0.190253,617.229478,0.212121,0.000571
5031,5031,,179,35,214,179,35,214,0.009317,0.012072,0,12237,3,0.000164,15,0.208192,0.234951,356089.410177,0.065443,0.081386
5033,5033,,1,4,5,1,4,5,0.000085,0.000999,0,13790,25,0.00001,18,0.180566,0.199006,69.978491,0.15,0.000226
5034,5034,,0,10,10,0,10,10,0,0.000942,0,13793,0,0.00001,14,0.190457,0.216527,0,0.2,0
9904134,9904134,,7,5,12,7,5,12,0.000185,0.000079,0,13791,0,0.00002,13,0.179555,0.199808,7269.387754,0.121212,0.001595
9907148,9907148,,1,11,12,1,11,12,0.000011,0.001035,0,13792,0,0.000011,14,0.19435,0.221211,186.50727,0.219697,0.000219
5035,5035,,1,15,16,1,15,16,0.000002,0.001066,0,13794,0,0.000012,12,0.205704,0.230865,18009.168722,0.075,0.000266
9312045,9312045,,12,7,19,12,7,19,0.000041,0.000012,0,1445,9,0.000029,2,0.705882,0.791667,42982.309216,0.081871,0.003259
9411155,9411155,,1,0,1,1,0,1,0.000034,0,0,8172,2,0.000011,0,0,0,0,0,0.000256
9609031,9609031,,8,6,14,8,6,14,0.000035,0.000014,0,8171,6,0.00003,13,0.167373,0.196992,29918.936634,0.087912,0.001868
5036,5036,,94,32,126,94,32,126,0.003785,0.002724,0,12854,3,0.000081,12,0.204564,0.227827,50738.490814,0.137016,0.046672
5037,5037,,4,5,9,4,5,9,0.000098,0.00001,0,13796,6,0.000012,12,0.17306,0.199655,132.152372,0.291667,0.000909
9512105,9512105,,16,18,34,16,18,34,0.000251,0.001523,0,6910,6,0.000037,12,0.194126,0.237304,42062.735396,0.080214,0.003926
9909118,9909118,,6,10,16,6,10,16,0.000098,0.002748,0,13795,6,0.000015,12,0.175706,0.208604,299.882157,0.220833,0.001394
9211088,9211088,,8,2,10,8,2,10,0.00005,0.000004,0,1456,6,0.000035,1,1,1,3300.052862,0.044444,0.002086
9504131,9504131,,2,1,3,2,1,3,0.000019,0.000001,0,6906,6,0.000013,3,0.428571,0.5,14.889445,0.333333,0.000602
9505047,9505047,,8,14,22,8,14,22,0.000088,0.000059,0,6909,6,0.000027,8,0.270197,0.324901,26071.932645,0.064935,0.001959
9210037,9210037,,18,0,18,18,0,18,0.000007,0,0,1265,9,0.000051,0,0,0,0,0.101307,0.004713
9502063,9502063,,1,1,2,1,1,2,0,0,0,6916,6,0.000012,1,1,1,9144,0,0.000323
9503211,9503211,,7,10,17,7,10,17,0.000007,0.000001,0,6913,9,0.000018,3,0.609756,0.693333,5931.117479,0.121324,0.001772
9503217,9503217,,7,8,15,7,8,15,0.000006,0.000002,0,1493,9,0.00002,5,0.343373,0.401754,159995.785059,0.133333,0.001866
9509096,9509096,,7,10,17,7,10,17,0.000032,0.000001,0,6914,9,0.000017,5,0.383838,0.468202,18194.767373,0.132353,0.001712
5038,5038,,0,1,1,0,1,1,0,0,0,13798,5,0.00001,1,1,1,0,0,0
9911168,9911168,,4,0,4,4,0,4,0,0,0,13797,5,0.000039,0,0,0,0,0,0.000877
5039,5039,,3,2,5,3,2,5,0,0,0,13799,6,0.00002,1,1,1,35.277778,0.25,0.000737
9202001,9202001,,8,0,8,8,0,8,0.000004,0,0,12947,6,0.000034,0,0,0,0,0.107143,0.001914
5041,5041,,11,3,14,11,3,14,0.000232,0.000035,0,13800,15,0.000025,13,0.147481,0.162234,1330.742638,0.164835,0.002668
5042,5042,,1,3,4,1,3,4,0,0.00002,0,13801,22,0.00001,2,0.588235,0.65,3.366667,0.333333,0.000232
5043,5043,,0,2,2,0,2,2,0,0.000014,0,13802,13,0.00001,12,0.147911,0.156747,0,0,0
9807094,9807094,,4,1,5,4,1,5,0.000276,0.000024,0,9644,13,0.000017,11,0.173422,0.186919,1634.02365,0.05,0.001058
5044,5044,,4,18,22,4,18,22,0.000007,0.000249,0,13803,0,0.000012,15,0.163974,0.189245,10851.454081,0.25974,0.000936
9706108,9706108,,18,6,24,18,6,24,0.00014,0.000155,0,5950,0,0.000033,10,0.196735,0.219428,10767.299743,0.275362,0.004779
9706169,9706169,,14,5,19,14,5,19,0.000135,0.000142,0,5951,0,0.000026,11,0.181154,0.200709,48.211541,0.388889,0.003762
9706216,9706216,,15,9,24,15,9,24,0.000111,0.000147,0,5952,0,0.000028,11,0.184663,0.207165,15150.392851,0.25,0.004043
9709088,9709088,,12,6,18,12,6,18,0.000187,0.000137,0,5953,0,0.00002,11,0.180084,0.199982,10778.24377,0.369281,0.003175
5086,5086,,5,12,17,5,12,17,0.000025,0.000057,0,13804,0,0.000012,16,0.151451,0.180344,2143.63525,0.194853,0.001155
9512165,9512165,,7,8,15,7,8,15,0.000037,0.00279,0,3587,0,0.000032,10,0.200359,0.23677,525.756536,0.214286,0.001958
9607216,9607216,,4,11,15,4,11,15,0.000004,0.002465,0,3588,0,0.000023,11,0.206004,0.242509,2671.366011,0.161905,0.00111
9709129,9709129,,4,40,44,4,40,44,0.000185,0.00337,0,5954,0,0.000013,11,0.223211,0.266031,20517.988965,0.158034,0.001102
5045,5045,,10,15,25,10,15,25,0.000576,0.000316,0,13805,25,0.000019,16,0.177535,0.197937,18957.624017,0.24,0.002343
5047,5047,,15,38,53,15,38,53,0.001294,0.013506,0,12212,2,0.000019,16,0.233529,0.267863,76088.99056,0.122279,0.004859
5049,5049,,31,63,94,31,63,94,0.002425,0.020702,0,11674,52,0.000022,11,0.233967,0.269327,306985.958795,0.071952,0.009246
9801140,9801140,,3,8,11,3,8,11,0.000532,0.00168,0,6059,0,0.000011,11,0.213333,0.246661,32.096325,0.309091,0.001029
9803228,9803228,,7,22,29,7,22,29,0.00075,0.006663,0,8574,0,0.000014,12,0.210004,0.247481,3174.640407,0.205665,0.001898
9812049,9812049,,8,52,60,8,52,60,0.001024,0.021089,0,8576,0,0.000012,12,0.22182,0.262951,131299.793542,0.085028,0.002616
9610001,9610001,,4,6,10,4,6,10,0.000192,0.000167,0,2488,0,0.000014,11,0.217655,0.248487,14268.046097,0.077778,0.001175
9609094,9609094,,4,47,51,4,47,51,0.000231,0.013996,0,4565,13,0.000013,10,0.239048,0.289219,2623.773131,0.119608,0.001063
9809202,9809202,,1,8,9,1,8,9,0.000248,0.002669,0,8575,0,0.00001,12,0.201653,0.236786,1.743411,0.361111,0.000283
9811032,9811032,,1,20,21,1,20,21,0.000248,0.001844,0,8573,13,0.00001,12,0.209868,0.247807,7831.266321,0.17619,0.000283
5050,5050,,0,1,1,0,1,1,0,0,0,13806,26,0.00001,1,1,1,0,0,0
5051,5051,,1,11,12,1,11,12,0.000214,0.006157,0,13807,1,0.00001,15,0.175846,0.201322,1261.167508,0.227273,0.000353
5052,5052,,19,47,66,19,47,66,0.001589,0.003862,0,12920,52,0.000018,14,0.22266,0.256523,88048.924166,0.070396,0.005778
9210063,9210063,,2,0,2,2,0,2,0.000045,0,0,12919,52,0.000012,0,0,0,0,0,0.000604
9605232,9605232,,15,18,33,15,18,33,0.001086,0.003046,0,3673,4,0.000019,9,0.202932,0.252759,122.113537,0.284091,0.005388
5053,5053,,8,31,39,8,31,39,0.00059,0.016259,0,13812,4,0.000016,13,0.201138,0.228399,106311.053047,0.091768,0.002071
9409093,9409093,,11,6,17,11,6,17,0.00042,0.000014,0,4820,4,0.000022,5,0.303922,0.367563,25448.255768,0.121324,0.003181
9409190,9409190,,5,6,11,5,6,11,0.000193,0.000033,0,4821,4,0.000019,5,0.309598,0.369333,15951.14228,0.136364,0.001287
9501013,9501013,,2,0,2,2,0,2,0.000222,0,0,13811,4,0.000011,0,0,0,0,0.5,0.000517
9707029,9707029,,4,2,6,4,2,6,0.000191,0,0,13810,22,0.000017,1,1,1,6530.5,0.166667,0.000933
9711006,9711006,,5,25,30,5,25,30,0.000503,0.002286,0,7149,2,0.000012,13,0.201415,0.236292,64625.716865,0.075862,0.001251
9309026,9309026,,4,4,8,4,4,8,0.000005,0.000023,0,436,4,0.000039,1,1,1,25259.262284,0.017857,0.001257
9307048,9307048,,15,0,15,15,0,15,0.000001,0,0,1471,6,0.000089,0,0,0,0,0.02381,0.003791
9209074,9209074,,8,0,8,8,0,8,0.000142,0,0,712,4,0.000018,0,0,0,0,0.160714,0.002335
9301059,9301059,,13,1,14,13,1,14,0.000036,0.000001,0,2623,22,0.000044,1,1,1,278.129498,0.076923,0.003374
9303129,9303129,,3,3,6,3,3,6,0.000213,0.000024,0,5974,4,0.000012,1,1,1,44.154784,0.2,0.000885
9703079,9703079,,4,0,4,4,0,4,0,0,0,13809,22,0.000034,0,0,0,0,0.25,0.000916
9703080,9703080,,4,0,4,4,0,4,0,0,0,13808,22,0.000024,0,0,0,0,0.25,0.000903
9702018,9702018,,9,18,27,9,18,27,0.000775,0.004662,0,5741,13,0.000017,12,0.217066,0.252328,14546.078886,0.149573,0.002328
9703141,9703141,,5,7,12,5,7,12,0.0003,0.003451,0,7147,2,0.000014,12,0.198882,0.226681,1608.268616,0.083333,0.001298
9712140,9712140,,1,8,9,1,8,9,0,0,0,9032,22,0.000011,8,0.188414,0.225562,238.819585,0.402778,0.000235
9601161,9601161,,4,8,12,4,8,12,0.00026,0.000054,0,4823,4,0.000014,6,0.280591,0.348747,19452.338022,0.068182,0.001091
5054,5054,,9,44,53,9,44,53,0.002047,0.024514,0,12296,1,0.000013,12,0.219669,0.247095,112763.95289,0.099782,0.002504
5055,5055,,3,17,20,3,17,20,0.000009,0.009376,0,13814,26,0.000011,12,0.201601,0.225475,1874.503132,0.189474,0.000729
9904027,9904027,,4,15,19,4,15,19,0.00021,0.008061,0,13813,26,0.000012,13,0.184626,0.209506,1220.813384,0.21345,0.000957
9402052,9402052,,18,4,22,18,4,22,0.00001,0.000007,0,3004,17,0.000038,3,0.5,0.611111,3442.999595,0.088745,0.0047
9408129,9408129,,2,10,12,2,10,12,0.000001,0.000018,0,4240,17,0.000014,2,0.8125,0.884615,14607.750566,0.060606,0.000725
5056,5056,,1,10,11,1,10,11,0.000029,0.000143,0,12405,4,0.00001,17,0.158023,0.176939,20241.998255,0.290909,0.000374
9911126,9911126,,2,5,7,2,5,7,0.000002,0.000019,0,12404,22,0.000012,15,0.147003,0.160542,10061.959794,0.214286,0.000467
9805116,9805116,,9,7,16,9,7,16,0.000001,0.000011,0,12403,22,0.000028,7,0.233945,0.342017,373.606813,0.254167,0.002133
5059,5059,,17,19,36,17,19,36,0.000767,0.002589,0,12897,30,0.000027,13,0.192963,0.213451,26427.596639,0.096825,0.005746
5060,5060,,1,2,3,1,2,3,0,0.000001,0,13816,26,0.000014,1,1,1,1,0.166667,0.000219
3279,3279,,1,0,1,1,0,1,0,0,0,13815,26,0.000016,0,0,0,0,0,0.000226
5061,5061,,85,16,101,85,16,101,0.008343,0.000771,0,13817,41,0.000072,14,0.169221,0.191649,14827.919818,0.066931,0.032707
9709142,9709142,,2,0,2,2,0,2,0.000013,0,0,11063,41,0.000017,0,0,0,0,0,0.001334
9205058,9205058,,18,0,18,18,0,18,0.000553,0,0,227,41,0.000116,0,0,0,0,0.133987,0.00708
9210160,9210160,,5,0,5,5,0,5,0.00004,0,0,223,13,0.000021,0,0,0,0,0.15,0.001875
9309042,9309042,,6,7,13,6,7,13,0.000072,0.000055,0,270,13,0.000024,4,0.55,0.757576,759.811112,0.179487,0.002573
9311048,9311048,,2,5,7,2,5,7,0.000031,0.000013,0,269,13,0.000012,3,0.576923,0.655556,16259.253636,0.119048,0.000927
9311122,9311122,,4,5,9,4,5,9,0.0002,0.000102,0,219,13,0.00002,4,0.5,0.652778,199.715742,0.097222,0.001699
9303054,9303054,,1,2,3,1,2,3,0.00003,0.000011,0,1086,13,0.000012,2,0.75,0.833333,0,0.333333,0.000689
9406079,9406079,,8,2,10,8,2,10,0.000303,0.000055,0,346,13,0.000035,3,0.392857,0.424242,253.941111,0.133333,0.002943
9503027,9503027,,6,41,47,6,41,47,0.000948,0.001145,0,1077,13,0.000015,6,0.340394,0.408941,247970.508237,0.048566,0.00203
8235,8235,,4,2,6,4,2,6,0.000299,0.000011,0,13818,0,0.000014,3,0.5,0.574074,202.614495,0.2,0.001114
5063,5063,,3,11,14,3,11,14,0.000011,0.000026,0,13825,5,0.000011,11,0.22383,0.286309,1311.430846,0.263736,0.000714
9309094,9309094,,9,2,11,9,2,11,0.000011,0.000001,0,13824,5,0.000016,1,1,1,11.064262,0.136364,0.002032
9311047,9311047,,10,2,12,10,2,12,0.000056,0,0,6217,5,0.000017,1,1,1,288.20415,0.098485,0.002302
9810095,9810095,,6,10,16,6,10,16,0.000014,0.000023,0,13821,5,0.000013,11,0.215548,0.275275,489.889325,0.283333,0.001433
9912098,9912098,,6,21,27,6,21,27,0.000414,0.000059,0,13823,5,0.000013,11,0.242991,0.331856,5095.917201,0.146724,0.001516
9509168,9509168,,3,1,4,3,1,4,0.000164,0.000006,0,12268,5,0.000014,1,1,1,0,0.5,0.001073
9610052,9610052,,1,3,4,1,3,4,0,0.000008,0,12267,5,0.000012,6,0.3,0.376852,408.933922,0.083333,0.000291
9511217,9511217,,8,8,16,8,8,16,0.000009,0.000032,0,13820,5,0.000017,6,0.330049,0.414677,1839.199484,0.179167,0.001958
9609077,9609077,,4,7,11,4,7,11,0.000008,0.000009,0,13822,5,0.000012,7,0.274131,0.355433,647.318902,0.290909,0.000946
5064,5064,,4,10,14,4,10,14,0,0.000006,0,13826,23,0.000013,19,0.13361,0.147442,1697.919406,0.175824,0.000929
9602122,9602122,,6,1,7,6,1,7,0.000237,0.000002,0,9201,8,0.000023,2,0.666667,0.75,117.627778,0.02381,0.001369
9809060,9809060,,4,0,4,4,0,4,0.000097,0,0,9200,8,0.000021,0,0,0,0,0,0.000911
5065,5065,,16,35,51,16,35,51,0.00179,0.022046,0,13827,1,0.000017,11,0.230124,0.262936,70776.194351,0.159608,0.004935
9812195,9812195,,3,31,34,3,31,34,0.000215,0.002991,0,12282,0,0.000011,16,0.177831,0.212834,2667.846347,0.184492,0.001351
9512034,9512034,,3,11,14,3,11,14,0.000052,0.000413,0,2446,0,0.000013,10,0.206111,0.240751,448.382298,0.186813,0.001109
9405120,9405120,,3,4,7,3,4,7,0.000014,0.000483,0,4402,0,0.000023,5,0.319885,0.376727,144.465745,0.119048,0.00074
5070,5070,,0,2,2,0,2,2,0,0,0,13829,9,0.00001,13,0.125402,0.137538,0,0,0
9902133,9902133,,1,1,2,1,1,2,0,0,0,13828,9,0.000014,4,0.458333,0.507576,11,0,0.000219
5071,5071,,2,6,8,2,6,8,0.000012,0.000074,0,13831,2,0.000012,12,0.187757,0.215333,3622.874441,0.053571,0.000465
9502056,9502056,,1,0,1,1,0,1,0.000001,0,0,13830,2,0.000012,0,0,0,0,0,0.000232
9311008,9311008,,8,1,9,8,1,9,0.000045,0,0,3350,2,0.000047,1,1,1,7073.852659,0.083333,0.002161
5072,5072,,16,35,51,16,35,51,0.002444,0.010883,0,12961,1,0.000017,13,0.20767,0.237082,74750.912213,0.097255,0.004883
5074,5074,,0,6,6,0,6,6,0,0.000209,0,13832,2,0.00001,15,0.156777,0.173379,0,0.3,0
5075,5075,,4,12,16,4,12,16,0.000007,0.000095,0,13835,26,0.000012,16,0.147792,0.164263,1396.510715,0.295833,0.00095
9805155,9805155,,5,14,19,5,14,19,0.000006,0.000097,0,13834,26,0.000013,11,0.166532,0.191911,819.378009,0.248538,0.00115
9809084,9809084,,2,13,15,2,13,15,0.000076,0.000096,0,13833,26,0.000011,11,0.163506,0.205919,333.290931,0.171429,0.000485
5076,5076,,15,35,50,15,35,50,0.000652,0.004448,0,13837,4,0.000016,18,0.159317,0.182905,63599.708559,0.160408,0.004274
9801027,9801027,,5,11,16,5,11,16,0.000298,0.00276,0,8001,4,0.000012,11,0.178721,0.200459,403.480827,0.266667,0.001363
9911097,9911097,,4,21,25,4,21,25,0.000094,0.002285,0,13836,23,0.000014,17,0.175618,0.196468,79990.520721,0.076667,0.001014
5078,5078,,3,8,11,3,8,11,0.00004,0.000002,0,13840,28,0.000014,11,0.17604,0.207039,350.875909,0.118182,0.000664
9603057,9603057,,3,4,7,3,4,7,0,0.000053,0,13839,28,0.000032,8,0.255484,0.296368,1338.099856,0.071429,0.000697
9604111,9604111,,5,2,7,5,2,7,0,0,0,13838,28,0.000033,2,0.75,0.833333,27,0,0.001115
9311019,9311019,,4,0,4,4,0,4,0.000001,0,0,10263,28,0.000043,0,0,0,0,0,0.000949
9609197,9609197,,2,4,6,2,4,6,0,0.000003,0,10041,28,0.000016,4,0.348485,0.449275,993.222708,0.2,0.000567
5079,5079,,0,3,3,0,3,3,0,0,0,13843,26,0.00001,11,0.157191,0.171217,0,0,0
9907221,9907221,,1,2,3,1,2,3,0,0.000003,0,13842,26,0.000013,13,0.124438,0.132726,248.015719,0,0.000219
9801045,9801045,,1,0,1,1,0,1,0,0,0,13841,26,0.000016,0,0,0,0,0,0.000226
5080,5080,,7,10,17,7,10,17,0.000246,0.001272,0,12936,3,0.000015,13,0.19241,0.209628,1980.511847,0.198529,0.002437
9912254,9912254,,18,21,39,18,21,39,0.000792,0.004129,0,12240,30,0.000022,13,0.199389,0.219585,8260.86886,0.136977,0.005853
5081,5081,,2,20,22,2,20,22,0.000552,0.018557,0,12397,1,0.00001,11,0.228487,0.259424,15428.776781,0.190476,0.000541
9906102,9906102,,6,23,29,6,23,29,0.00095,0.012949,0,10597,1,0.000014,11,0.229735,0.262124,31145.787157,0.146552,0.001462
9906105,9906105,,4,18,22,4,18,22,0.000689,0.017921,0,10598,1,0.000012,11,0.229095,0.260605,16634.636816,0.248918,0.000967
9202065,9202065,,12,0,12,12,0,12,0.000037,0,0,397,5,0.000042,0,0,0,0,0.060606,0.003305
9905099,9905099,,4,19,23,4,19,23,0.000566,0.008089,0,10595,1,0.000012,14,0.191896,0.220518,817.181158,0.100791,0.00104
5082,5082,,1,6,7,1,6,7,0,0,0,13855,23,0.000011,16,0.133915,0.142683,1338.964411,0.142857,0.000219
9709024,9709024,,5,1,6,5,1,6,0,0,0,13846,23,0.000068,1,1,1,4.633333,0.233333,0.001289
9709144,9709144,,8,1,9,8,1,9,0.000002,0,0,13851,23,0.000038,2,0.666667,0.75,24.25,0.152778,0.001872
9712108,9712108,,4,0,4,4,0,4,0,0,0,13850,23,0.000021,0,0,0,0,0,0.000936
9807158,9807158,,13,4,17,13,4,17,0,0,0,13849,23,0.000058,2,0.833333,0.9,349.533333,0.0625,0.003033
9903076,9903076,,2,2,4,2,2,4,0,0.000152,0,13854,23,0.000012,15,0.154413,0.167068,32698.765175,0.166667,0.000458
9905022,9905022,,5,3,8,5,3,8,0,0,0,13853,23,0.000019,3,0.5625,0.648148,5.561905,0.25,0.001129
9707187,9707187,,2,0,2,2,0,2,0,0,0,13845,23,0.000084,0,0,0,0,0.5,0.00056
9602168,9602168,,2,1,3,2,1,3,0,0,0,13848,23,0.000027,1,1,1,81,0,0.000525
9712104,9712104,,2,0,2,2,0,2,0,0,0,13844,23,0.000026,0,0,0,0,0.5,0.000538
9904004,9904004,,5,4,9,5,4,9,0,0,0,13852,23,0.000029,3,0.615385,0.729167,97.995238,0.152778,0.001155
5083,5083,,8,13,21,8,13,21,0.000013,0.000011,0,13856,20,0.000015,13,0.164635,0.178424,23430.994479,0.159524,0.001846
9912020,9912020,,8,4,12,8,4,12,0,0,0,12081,23,0.000026,1,1,1,3412.873524,0.265152,0.00195
9909123,9909123,,5,3,8,5,3,8,0,0,0,12080,23,0.000024,1,1,1,16.47004,0.392857,0.001245
5085,5085,,19,13,32,19,13,32,0.001088,0.000726,0,12877,3,0.000027,16,0.18731,0.204435,1013.253094,0.3125,0.012259
5087,5087,,36,44,80,36,44,80,0.004295,0.025407,0,12396,52,0.000028,16,0.233548,0.265761,131904.856589,0.075475,0.011571
5088,5088,,8,23,31,8,23,31,0.000722,0.003092,0,13857,4,0.000017,12,0.189855,0.214135,6937.011229,0.155914,0.002097
9209066,9209066,,5,0,5,5,0,5,0.000286,0,0,4720,23,0.000043,0,0,0,0,0.1,0.001675
9306065,9306065,,4,2,6,4,2,6,0.000001,0.000001,0,4719,23,0.00004,1,1,1,12083.116442,0.066667,0.001218
9703171,9703171,,1,18,19,1,18,19,0.000047,0.002739,0,4900,4,0.00001,13,0.173903,0.201497,308.743002,0.295322,0.000291
5089,5089,,6,11,17,6,11,17,0.000389,0.010139,0,13860,26,0.00002,15,0.167519,0.187901,27891.123622,0.143382,0.001567
9208041,9208041,,19,0,19,19,0,19,0.000519,0,0,1523,26,0.000069,0,0,0,0,0.128655,0.004526
9209094,9209094,,13,0,13,13,0,13,0.00019,0,0,1528,26,0.000036,0,0,0,0,0.134615,0.003124
9301001,9301001,,19,0,19,19,0,19,0.000533,0,0,1527,26,0.000044,0,0,0,0,0.105263,0.004458
9308094,9308094,,11,0,11,11,0,11,0.000317,0,0,1525,26,0.000027,0,0,0,0,0.172727,0.002634
9401045,9401045,,12,1,13,12,1,13,0.000319,0.000006,0,1524,26,0.00003,1,1,1,0.5,0.179487,0.002858
9409030,9409030,,11,6,17,11,6,17,0.000317,0.000022,0,1529,26,0.000026,1,1,1,2347.46466,0.231618,0.002586
9706173,9706173,,3,5,8,3,5,8,0.000187,0.000022,0,13859,26,0.000013,2,0.777778,0.857143,0,0.357143,0.000726
9907031,9907031,,1,7,8,1,7,8,0.000119,0.000026,0,13858,26,0.000011,7,0.232419,0.265999,1942.815939,0.285714,0.000261
9304088,9304088,,9,0,9,9,0,9,0.000017,0,0,1526,26,0.000046,0,0,0,0,0.069444,0.002112
9503213,9503213,,2,14,16,2,14,16,0.000001,0.001226,0,3605,26,0.000013,6,0.299003,0.353827,39066.797185,0.079167,0.000466
5090,5090,,42,20,62,42,20,62,0.002712,0.003439,0,12419,3,0.000034,13,0.194095,0.218376,39291.329219,0.07377,0.012764
5091,5091,,22,13,35,22,13,35,0.002437,0.002254,0,11647,3,0.000025,14,0.189848,0.213106,31596.46137,0.104202,0.008368
5092,5092,,1,2,3,1,2,3,0.00001,0.000016,0,13861,5,0.000011,3,0.47619,0.516667,0,0.5,0.000279
5093,5093,,1,31,32,1,31,32,0.000073,0.002457,0,13862,0,0.00001,15,0.176777,0.206899,44.252771,0.221774,0.000226
9503094,9503094,,8,3,11,8,3,11,0.000373,0.000018,0,1678,13,0.000022,5,0.353293,0.394633,296.869376,0.145455,0.002634
9706165,9706165,,5,13,18,5,13,18,0.000317,0.006331,0,6888,13,0.000014,12,0.198299,0.227611,2203.503241,0.27451,0.001403
5094,5094,,8,9,17,8,9,17,0.000801,0.01562,0,13863,1,0.000017,16,0.195821,0.218467,20889.803804,0.165441,0.001995
5095,5095,,2,29,31,2,29,31,0.000037,0.004774,0,13865,30,0.000013,13,0.202124,0.22503,2376.042998,0.131183,0.000471
9706090,9706090,,11,7,18,11,7,18,0.000481,0.001655,0,6720,2,0.00002,14,0.187638,0.217418,9954.263212,0.091503,0.002582
9708076,9708076,,7,5,12,7,5,12,0.000509,0.003911,0,6696,2,0.000013,12,0.191285,0.220022,20100.49561,0.174242,0.001726
9909051,9909051,,6,16,22,6,16,22,0.00022,0.007003,0,13864,2,0.000014,14,0.189308,0.217761,1468.019226,0.106061,0.001374
9310024,9310024,,7,2,9,7,2,9,0.000106,0.000003,0,2862,2,0.000019,1,1,1,1256.070304,0.055556,0.001802
9701010,9701010,,9,18,27,9,18,27,0.000153,0.006848,0,4839,4,0.000034,12,0.222871,0.266108,55560.543243,0.089744,0.002276
5096,5096,,1,11,12,1,11,12,0.000032,0.000007,0,13869,22,0.00001,15,0.120228,0.134061,2211.209961,0.174242,0.000359
9212129,9212129,,2,0,2,2,0,2,0.000012,0,0,13867,22,0.000012,0,0,0,0,0.5,0.000467
9303082,9303082,,6,1,7,6,1,7,0.000016,0,0,2625,5,0.000035,1,1,1,687.850705,0.214286,0.001518
9901061,9901061,,2,4,6,2,4,6,0.000012,0.000003,0,13866,22,0.000012,3,0.615385,0.729167,6.808601,0.4,0.000467
9907119,9907119,,3,14,17,3,14,17,0.000016,0.001037,0,13868,22,0.000014,15,0.120754,0.137173,5629.620954,0.143382,0.000756
5097,5097,,1,4,5,1,4,5,0.000001,0.000004,0,13874,52,0.00001,16,0.15033,0.164436,0,0.45,0.000226
9706180,9706180,,6,3,9,6,3,9,0.000189,0.000002,0,13871,52,0.000022,5,0.276471,0.340426,38.666667,0.194444,0.001361
9901116,9901116,,3,17,20,3,17,20,0.000001,0.01575,0,13872,52,0.000019,15,0.176725,0.200591,15501.740134,0.089474,0.000684
9902109,9902109,,2,2,4,2,2,4,0.000001,0.000002,0,13873,52,0.000013,16,0.150233,0.163964,0,0.5,0.000451
9211082,9211082,,17,3,20,17,3,20,0.000271,0.00003,0,423,5,0.000032,1,1,1,54.451169,0.089474,0.004373
9401100,9401100,,3,3,6,3,3,6,0.000002,0.000006,0,11289,52,0.000025,2,0.8,0.875,160.423115,0.1,0.000737
9311173,9311173,,3,1,4,3,1,4,0.000002,0.000046,0,13870,52,0.000018,2,0.666667,0.75,8,0.166667,0.000703
9302032,9302032,,4,1,5,4,1,5,0.000188,0,0,957,5,0.000014,1,1,1,15540,0.05,0.000953
5098,5098,,3,30,33,3,30,33,0.000295,0.020023,0,13875,1,0.000011,16,0.230976,0.266086,26429.19815,0.09375,0.000779
5100,5100,,1,8,9,1,8,9,0,0,0,13876,6,0.000011,19,0.129728,0.157993,1375.583707,0.305556,0.000246
9712121,9712121,,6,10,16,6,10,16,0,0.000002,0,10929,6,0.000017,9,0.217812,0.282079,1824.341438,0.154167,0.001395
9506078,9506078,,1,1,2,1,1,2,0,0,0,7827,6,0.000012,1,1,1,6.090487,0,0.000276
9506108,9506108,,5,4,9,5,4,9,0,0.000002,0,7807,6,0.000016,5,0.330357,0.397297,412.897256,0.194444,0.001294
9506107,9506107,,2,2,4,2,2,4,0,0.000001,0,10928,6,0.000012,3,0.571429,0.708333,26.25,0.166667,0.000491
9405200,9405200,,2,7,9,2,7,9,0,0.000007,0,10932,6,0.000015,4,0.471698,0.583333,249.274768,0.041667,0.000466
9406180,9406180,,10,6,16,10,6,16,0,0,0,5890,6,0.000032,4,0.4,0.503205,5496.316751,0.0875,0.00259
9506167,9506167,,6,4,10,6,4,10,0,0,0,10930,6,0.00002,5,0.368421,0.459524,94.245204,0.188889,0.001411
9707074,9707074,,4,6,10,4,6,10,0,0,0,10931,6,0.000013,7,0.248288,0.297044,128.940918,0.144444,0.000926
5101,5101,,18,10,28,18,10,28,0.000506,0.001179,0,12943,30,0.000022,13,0.191867,0.210101,5088.65919,0.149471,0.004997
5102,5102,,0,8,8,0,8,8,0,0.000025,0,13877,0,0.00001,15,0.161283,0.177164,0,0.482143,0
5103,5103,,3,6,9,3,6,9,0.000148,0.000379,0,13878,3,0.000011,12,0.191189,0.209098,3768.248525,0.222222,0.001064
5105,5105,,1,28,29,1,28,29,0.000061,0.007211,0,13879,3,0.00001,12,0.243012,0.276669,6258.373476,0.121921,0.000308
5106,5106,,5,15,20,5,15,20,0.00054,0.01397,0,13880,1,0.000015,11,0.228853,0.258391,16178.776867,0.152632,0.001456
9801008,9801008,,3,19,22,3,19,22,0.000571,0.000256,0,6276,0,0.000014,13,0.172749,0.200046,75150.881041,0.242424,0.001085
9504111,9504111,,7,2,9,7,2,9,0.000178,0,0,7928,6,0.000031,3,0.571429,0.708333,3831.841546,0.055556,0.001999
9704201,9704201,,3,5,8,3,5,8,0.00021,0.001035,0,6572,13,0.000013,12,0.192547,0.217203,4837.039916,0.160714,0.000807
9807104,9807104,,1,17,18,1,17,18,0.000184,0.007215,0,8372,13,0.000011,13,0.170832,0.197439,1111.807313,0.287582,0.000336
5107,5107,,1,6,7,1,6,7,0.000002,0.000066,0,13882,20,0.00001,15,0.157503,0.171213,961.833435,0.261905,0.000279
9911111,9911111,,1,12,13,1,12,13,0.000001,0.000464,0,13881,20,0.000011,15,0.167631,0.185203,2196.212481,0.089744,0.000227
9506062,9506062,,5,1,6,5,1,6,0.000006,0.000001,0,8691,20,0.000022,1,1,1,209.524425,0.166667,0.001192
9705015,9705015,,6,1,7,6,1,7,0.00012,0.000003,0,5987,4,0.00002,18,0.125325,0.141445,2765.083162,0.071429,0.001504
9804025,9804025,,6,8,14,6,8,14,0.000184,0.000006,0,8681,6,0.000016,13,0.140359,0.155293,12046.66931,0.153846,0.001531
9304095,9304095,,2,0,2,2,0,2,0.000048,0,0,6004,20,0.000011,0,0,0,0,0,0.00055
5108,5108,,6,9,15,6,9,15,0.000395,0.003038,0,13883,8,0.000016,12,0.195207,0.216508,4261.723108,0.114286,0.001765
9704072,9704072,,8,3,11,8,3,11,0.00071,0,0,4992,13,0.000022,1,1,1,34002,0.1,0.003935
9507009,9507009,,7,17,24,7,17,24,0.000076,0.001667,0,4603,5,0.00002,10,0.222877,0.269854,8045.756094,0.101449,0.002036
5109,5109,,4,1,5,4,1,5,0.000127,0.000013,0,13884,4,0.000013,2,0.6,0.666667,3.64329,0.25,0.001069
5110,5110,,4,6,10,4,6,10,0.000136,0.010592,0,13885,1,0.000017,11,0.195649,0.214943,8204.621951,0.222222,0.000936
5111,5111,,5,52,57,5,52,57,0.000255,0.006095,0,13886,2,0.000012,12,0.226202,0.257351,12488.057234,0.084273,0.001225
9806115,9806115,,7,25,32,7,25,32,0.00094,0.009033,0,7963,2,0.000012,14,0.190654,0.221982,2444.391197,0.215726,0.00178
9812119,9812119,,6,10,16,6,10,16,0.000768,0.00587,0,12387,2,0.000011,16,0.16919,0.196667,47.5358,0.266667,0.001462
9407169,9407169,,11,3,14,11,3,14,0.000652,0.000381,0,998,26,0.000036,3,0.52381,0.560606,1858.176248,0.131868,0.003144
9203022,9203022,,3,0,3,3,0,3,0.000448,0,0,7964,9,0.000017,0,0,0,0,0,0.00076
9205056,9205056,,8,0,8,8,0,8,0.000449,0,0,1207,9,0.00008,0,0,0,0,0,0.001947
9206060,9206060,,9,1,10,9,1,10,0.000459,0.000005,0,1495,9,0.00004,1,1,1,2224.093255,0,0.002137
5112,5112,,3,3,6,3,3,6,0.000011,0,0,13892,5,0.000013,15,0.146628,0.157387,155.15958,0.233333,0.000711
9908027,9908027,,4,4,8,4,4,8,0.000004,0.000001,0,13891,22,0.000018,3,0.529412,0.666667,66.355942,0.125,0.000937
9911128,9911128,,5,8,13,5,8,13,0.000002,0.000031,0,13890,5,0.000018,14,0.171006,0.187713,20584.045825,0.083333,0.001163
9912263,9912263,,9,6,15,9,6,15,0.000003,0.00007,0,13888,22,0.000023,6,0.277143,0.342612,303.533038,0.228571,0.002098
9902207,9902207,,4,2,6,4,2,6,0.000002,0.000011,0,13889,5,0.000015,6,0.276042,0.331761,46.223846,0.266667,0.000956
9409088,9409088,,11,2,13,11,2,13,0.000039,0,0,7851,22,0.000038,1,1,1,345.421511,0.115385,0.002848
9507076,9507076,,18,1,19,18,1,19,0.000026,0,0,5580,22,0.000046,2,0.666667,0.75,6601.555609,0.178363,0.004454
9510060,9510060,,18,1,19,18,1,19,0.000026,0,0,5577,22,0.000046,1,1,1,1631.463577,0.175439,0.004454
9706021,9706021,,13,7,20,13,7,20,0.00007,0.000479,0,13887,22,0.000027,5,0.275618,0.344231,771.765045,0.192105,0.003074
5113,5113,,3,19,22,3,19,22,0.00023,0.00532,0,13893,30,0.000011,13,0.204766,0.233135,5704.169544,0.168831,0.000883
9911200,9911200,,6,65,71,6,65,71,0.000223,0.023386,0,13002,13,0.000012,14,0.18441,0.22464,14881.498981,0.055332,0.001397
9507063,9507063,,5,23,28,5,23,28,0.000478,0.005887,0,5346,13,0.000013,8,0.250242,0.316494,23613.876019,0.089947,0.001249
9904110,9904110,,6,13,19,6,13,19,0.001119,0.002093,0,13001,8,0.000013,13,0.187874,0.211246,7027.67598,0.210526,0.001717
5114,5114,,10,37,47,10,37,47,0.000821,0.003451,0,12917,3,0.000013,16,0.202938,0.227882,11140.419206,0.229417,0.003366
5115,5115,,10,16,26,10,16,26,0.000483,0.002456,0,13894,1,0.000025,13,0.195733,0.216561,73613.577896,0.12,0.002813
5116,5116,,4,7,11,4,7,11,0.000216,0.001341,0,12306,25,0.000012,17,0.187749,0.207342,636.046432,0.236364,0.0013
5117,5117,,2,18,20,2,18,20,0.000061,0.01065,0,13895,0,0.000012,13,0.197677,0.222564,1818.930533,0.123684,0.000445
5119,5119,,9,8,17,9,8,17,0.00047,0.001058,0,13896,4,0.000017,13,0.179732,0.197225,8971.51868,0.231618,0.002228
5120,5120,,9,22,31,9,22,31,0.000847,0.000605,0,13905,0,0.000014,16,0.192067,0.222476,40199.99553,0.1,0.002684
9412152,9412152,,3,5,8,3,5,8,0.000009,0.000013,0,13903,28,0.000013,7,0.225088,0.256188,1683.734759,0.125,0.000748
9606108,9606108,,1,8,9,1,8,9,0.000007,0.0001,0,13904,28,0.00001,9,0.206871,0.239106,2510.296006,0.111111,0.000287
9610102,9610102,,12,5,17,12,5,17,0.000049,0.00017,0,5838,28,0.000024,10,0.197109,0.220944,9857.970839,0.095588,0.003097
9809056,9809056,,3,9,12,3,9,12,0.000041,0.000407,0,13902,28,0.000012,13,0.188342,0.215781,3691.104701,0.090909,0.000752
9912181,9912181,,5,56,61,5,56,61,0.000113,0.005568,0,13900,0,0.000012,12,0.220942,0.259464,24642.59298,0.152186,0.00157
9210163,9210163,,15,0,15,15,0,15,0.000032,0,0,1088,28,0.000074,0,0,0,0,0.052381,0.003707
9307096,9307096,,3,6,9,3,6,9,0,0.000021,0,1094,28,0.000023,1,1,1,17624.213546,0.152778,0.000762
9312198,9312198,,3,8,11,3,8,11,0,0.000016,0,1097,28,0.000023,2,0.9,0.944444,35757.004094,0.145455,0.000804
9505068,9505068,,4,4,8,4,4,8,0.000005,0.00005,0,2288,28,0.000036,5,0.282895,0.355426,50034.625828,0.214286,0.001021
9708139,9708139,,5,10,15,5,10,15,0.000041,0.000159,0,6534,5,0.000014,18,0.150198,0.189907,461.549219,0.261905,0.001492
9711151,9711151,,11,2,13,11,2,13,0.000101,0.00001,0,13901,2,0.000022,8,0.163763,0.208536,266.788872,0.128205,0.002723
9703182,9703182,,2,48,50,2,48,50,0.000118,0.010135,0,13899,0,0.00001,12,0.228252,0.27281,3928.863426,0.159184,0.000477
9908067,9908067,,1,10,11,1,10,11,0.000065,0.002423,0,13898,0,0.00001,15,0.174271,0.200966,0,0.254545,0.000258
9912025,9912025,,2,18,20,2,18,20,0.000171,0.00096,0,13897,0,0.00001,13,0.191557,0.22167,216.972593,0.213158,0.00049
9603134,9603134,,6,19,25,6,19,25,0.000265,0.00339,0,3944,4,0.000013,12,0.183282,0.224631,25967.066327,0.171667,0.001804
9606146,9606146,,4,23,27,4,23,27,0.000243,0.009426,0,3483,0,0.000014,10,0.232781,0.273658,8172.794369,0.149573,0.001665
9511028,9511028,,3,6,9,3,6,9,0,0.000014,0,4279,22,0.000024,5,0.328467,0.406296,46569.997461,0.125,0.00084
9605171,9605171,,1,3,4,1,3,4,0,0.000014,0,10294,22,0.000013,7,0.254902,0.293758,1120.121305,0,0.000247
5124,5124,,2,23,25,2,23,25,0.000131,0.00205,0,13906,0,0.000011,14,0.182404,0.208546,1820.733711,0.22,0.000452
5125,5125,,14,15,29,14,15,29,0.000009,0.000027,0,13907,23,0.000027,15,0.150425,0.166066,18486.243109,0.21798,0.003737
5126,5126,,13,8,21,13,8,21,0.00019,0.001114,0,13908,2,0.000019,13,0.204963,0.225613,27522.140935,0.214286,0.003603
5128,5128,,0,16,16,0,16,16,0,0.000088,0,13916,4,0.00001,15,0.165481,0.203714,0,0.0625,0
9212070,9212070,,27,2,29,27,2,29,0.000017,0.000001,0,1268,9,0.000059,1,1,1,5228.019238,0.089901,0.007003
9309012,9309012,,9,6,15,9,6,15,0.000006,0.000009,0,6388,4,0.000021,2,0.75,0.833333,3190.477939,0.119048,0.002137
9407091,9407091,,4,12,16,4,12,16,0.000067,0.000158,0,13915,4,0.000012,5,0.346253,0.415796,651.695076,0.079167,0.000925
9410214,9410214,,4,3,7,4,3,7,0.000004,0.000001,0,13385,4,0.000013,3,0.5,0.6,1.75,0.285714,0.000942
9601139,9601139,,7,10,17,7,10,17,0.000057,0.00005,0,6389,4,0.000021,8,0.253464,0.302354,5300.824046,0.069853,0.001588
9602007,9602007,,2,8,10,2,8,10,0.000001,0.000028,0,13913,4,0.000011,5,0.332168,0.411228,10.116667,0.077778,0.000438
9605140,9605140,,8,30,38,8,30,38,0.000135,0.000121,0,13387,4,0.000015,7,0.30014,0.409557,1533.873748,0.054765,0.001786
9605175,9605175,,1,1,2,1,1,2,0.000001,0.000006,0,13912,4,0.00001,2,0.666667,0.75,0.25,0,0.000219
9609214,9609214,,4,3,7,4,3,7,0.000026,0.000019,0,13911,4,0.00002,14,0.17574,0.203434,3856.874815,0.142857,0.000891
9706182,9706182,,3,2,5,3,2,5,0.000344,0.000026,0,13910,4,0.000011,1,1,1,9.066667,0.05,0.000677
9204019,9204019,,33,0,33,33,0,33,0.000011,0,0,832,9,0.000244,0,0,0,0,0.088068,0.009065
9208071,9208071,,7,0,7,7,0,7,0.000002,0,0,4255,4,0.000025,0,0,0,0,0.095238,0.001721
9209022,9209022,,19,2,21,19,2,21,0.000084,0.000004,0,1206,17,0.00008,1,1,1,34.762323,0.104762,0.004869
9212106,9212106,,6,0,6,6,0,6,0.00008,0,0,13914,4,0.00002,0,0,0,0,0.133333,0.001999
9311070,9311070,,11,4,15,11,4,15,0.000009,0.000001,0,1446,9,0.000028,2,0.833333,0.9,3073.308017,0.12381,0.002806
9402081,9402081,,10,0,10,10,0,10,0.000268,0,0,6016,4,0.000019,0,0,0,0,0.111111,0.002493
9208045,9208045,,12,0,12,12,0,12,0.000032,0,0,713,4,0.000027,0,0,0,0,0.136364,0.002966
9306037,9306037,,9,9,18,9,9,18,0.000032,0.000007,0,718,4,0.000019,2,0.714286,0.8,23348.85156,0.19281,0.002282
9506030,9506030,,6,1,7,6,1,7,0.000001,0.000025,0,6387,4,0.000027,5,0.287554,0.334328,328.936773,0.119048,0.001407
9310193,9310193,,3,2,5,3,2,5,0.000002,0.000068,0,3011,4,0.000013,4,0.31405,0.368421,11090.682768,0.1,0.000796
9405158,9405158,,3,1,4,3,1,4,0.000002,0.000003,0,13386,4,0.000017,1,1,1,3,0.166667,0.000736
9206095,9206095,,12,0,12,12,0,12,0.000032,0,0,717,4,0.000031,0,0,0,0,0.090909,0.002888
9208020,9208020,,7,2,9,7,2,9,0.000003,0.000001,0,715,4,0.000018,1,1,1,731.179775,0.097222,0.001744
9306043,9306043,,11,6,17,11,6,17,0.000033,0.000013,0,711,4,0.000019,2,0.65,0.730769,1954.783174,0.147059,0.00271
9312145,9312145,,5,10,15,5,10,15,0.000031,0.000008,0,719,4,0.000014,3,0.534884,0.666667,11317.142635,0.219048,0.001276
9501037,9501037,,6,15,21,6,15,21,0.000033,0.000007,0,4257,4,0.000014,3,0.6,0.707071,27637.227512,0.140476,0.001436
9402111,9402111,,3,0,3,3,0,3,0.000001,0,0,4825,4,0.000016,0,0,0,0,0,0.000754
9505005,9505005,,7,3,10,7,3,10,0.000052,0.000006,0,4057,4,0.000027,3,0.468085,0.522727,3957.990667,0.088889,0.001669
9312015,9312015,,3,0,3,3,0,3,0.000006,0,0,13909,9,0.000016,0,0,0,0,0.166667,0.00071
5130,5130,,1,26,27,1,26,27,0,0.002775,0,13928,6,0.00001,13,0.181077,0.215303,413.38326,0.058405,0.000219
9610059,9610059,,6,12,18,6,12,18,0.000035,0.000047,0,3935,26,0.000018,13,0.154875,0.17904,95115.904713,0.114379,0.001472
9705243,9705243,,3,5,8,3,5,8,0.000034,0.000012,0,8028,26,0.000012,14,0.145168,0.166599,17623.061923,0.25,0.000697
9905026,9905026,,4,9,13,4,9,13,0.000098,0.00001,0,13927,6,0.000012,11,0.196944,0.223098,2183.300086,0.083333,0.000909
9407128,9407128,,18,7,25,18,7,25,0.000016,0.000218,0,3926,26,0.000085,6,0.26626,0.327099,4505.206878,0.068333,0.004403
9507114,9507114,,9,6,15,9,6,15,0.000015,0.000009,0,3929,26,0.00003,7,0.250485,0.29498,9381.136837,0.147619,0.002233
9511191,9511191,,3,11,14,3,11,14,0.000012,0.000042,0,5085,26,0.000017,8,0.247904,0.289383,2675.799375,0.120879,0.000775
9503235,9503235,,7,3,10,7,3,10,0.000001,0.000002,0,3928,26,0.000023,7,0.247573,0.285051,519.418215,0.344444,0.001725
9608122,9608122,,4,5,9,4,5,9,0.000001,0.000002,0,3932,26,0.000014,7,0.250482,0.292711,5390.307477,0.347222,0.000965
9608155,9608155,,2,4,6,2,4,6,0.000001,0.000001,0,3930,26,0.000012,8,0.224242,0.260622,526.961729,0.166667,0.000479
9704192,9704192,,3,15,18,3,15,18,0.000002,0.000098,0,8026,26,0.000013,13,0.165192,0.192958,3124.066811,0.075163,0.000684
9607088,9607088,,1,5,6,1,5,6,0,0.000002,0,13926,23,0.000011,11,0.158895,0.192025,65.510997,0.266667,0.000246
9610067,9610067,,4,5,9,4,5,9,0.000001,0.00001,0,13922,23,0.000031,7,0.333333,0.375185,3008.115598,0.055556,0.00097
9711186,9711186,,1,3,4,1,3,4,0,0.000003,0,13920,23,0.000011,2,0.615385,0.6875,48,0.25,0.000246
9810120,9810120,,1,2,3,1,2,3,0,0,0,13919,23,0.000011,1,1,1,6,0.166667,0.000246
9811001,9811001,,1,2,3,1,2,3,0,0,0,13918,23,0.000011,1,1,1,6,0.166667,0.000246
5131,5131,,0,1,1,0,1,1,0,0,0,13929,23,0.00001,3,0.444444,0.541667,0,0,0
5132,5132,,1,8,9,1,8,9,0.000001,0.000179,0,13930,15,0.000013,18,0.184422,0.205237,30335.434311,0.041667,0.000273
5133,5133,,0,24,24,0,24,24,0,0.000042,0,13931,5,0.00001,17,0.135813,0.171484,0,0.070652,0
9609194,9609194,,8,6,14,8,6,14,0.000034,0.000001,0,9270,5,0.000024,10,0.155569,0.19427,22167.904449,0.087912,0.001953
9306154,9306154,,13,1,14,13,1,14,0.000006,0,0,1666,5,0.000084,1,1,1,85.866495,0.082418,0.003468
9310128,9310128,,8,0,8,8,0,8,0,0,0,1661,5,0.000086,0,0,0,0,0.053571,0.002193
9412088,9412088,,2,0,2,2,0,2,0,0,0,5620,5,0.000032,0,0,0,0,0.5,0.000468
9209038,9209038,,3,0,3,3,0,3,0,0,0,9269,5,0.000027,0,0,0,0,0.166667,0.000734
9406047,9406047,,9,0,9,9,0,9,0.000004,0,0,1914,5,0.000073,0,0,0,0,0.194444,0.002291
9612116,9612116,,6,8,14,6,8,14,0.000019,0.000017,0,9268,5,0.000021,8,0.239421,0.291373,14124.601973,0.082418,0.001579
9702148,9702148,,2,0,2,2,0,2,0,0,0,9267,5,0.000014,0,0,0,0,0.5,0.000508
9710130,9710130,,2,1,3,2,1,3,0,0,0,9266,5,0.000014,1,1,1,0,0.5,0.000508
5134,5134,,3,7,10,3,7,10,0.000199,0.010541,0,13945,1,0.000014,12,0.191343,0.210636,3259.071501,0.211111,0.000684
9912008,9912008,,1,6,7,1,6,7,0.000124,0.000022,0,13944,6,0.000012,15,0.154468,0.169914,656.192941,0.071429,0.000239
9703129,9703129,,8,3,11,8,3,11,0.000517,0.000002,0,13935,1,0.000025,2,0.615385,0.6875,2113.402778,0.081818,0.001957
9901031,9901031,,10,4,14,10,4,14,0.000796,0.000011,0,13937,1,0.000021,18,0.127462,0.141043,30327.674527,0.054945,0.00228
9908021,9908021,,2,14,16,2,14,16,0.000134,0.011408,0,13943,6,0.000013,14,0.179225,0.202651,27827.099293,0.091667,0.000486
5135,5135,,18,28,46,18,28,46,0.003197,0.017491,0,13946,1,0.000017,14,0.203721,0.228734,5635.098152,0.201449,0.005281
5136,5136,,23,11,34,23,11,34,0.001502,0.015343,0,13948,1,0.00005,12,0.204537,0.225148,89762.533582,0.086453,0.006292
9810231,9810231,,9,1,10,9,1,10,0.001102,0.000004,0,13947,1,0.000019,1,1,1,540.962415,0.177778,0.00272
5138,5138,,9,12,21,9,12,21,0.000706,0.002246,0,13949,30,0.000014,13,0.199161,0.219823,2098.636107,0.207143,0.00239
5140,5140,,0,5,5,0,5,5,0,0,0,13954,26,0.00001,3,0.642857,0.759259,0,0.05,0
9504153,9504153,,9,0,9,9,0,9,0,0,0,10993,26,0.000042,0,0,0,0,0.055556,0.002127
9504154,9504154,,13,0,13,13,0,13,0.000001,0,0,10992,26,0.000069,0,0,0,0,0.064103,0.003069
9811111,9811111,,7,1,8,7,1,8,0,0,0,13952,26,0.000031,1,1,1,3.5,0.160714,0.001573
9902013,9902013,,4,2,6,4,2,6,0,0,0,13953,26,0.000017,2,0.6,0.666667,9,0.2,0.00089
9407137,9407137,,6,0,6,6,0,6,0,0,0,13950,26,0.000055,0,0,0,0,0.133333,0.001374
9812167,9812167,,1,4,5,1,4,5,0,0.000001,0,13951,26,0.000017,1,1,1,8.5,0.1,0.000245
5141,5141,,0,1,1,0,1,1,0,0.000004,0,13955,9,0.00001,5,0.331081,0.368707,0,0,0
9207066,9207066,,7,0,7,7,0,7,0,0,0,185,26,0.000091,0,0,0,0,0.166667,0.001829
9305088,9305088,,3,0,3,3,0,3,0.000001,0,0,5380,15,0.000027,0,0,0,0,0,0.000847
9306033,9306033,,18,10,28,18,10,28,0.000006,0.000025,0,1056,9,0.000047,3,0.605263,0.702899,68193.790045,0.119048,0.004872
9403157,9403157,,2,5,7,2,5,7,0.000001,0.000002,0,5378,9,0.000014,2,0.777778,0.857143,15517.910822,0.095238,0.000628
5142,5142,,6,8,14,6,8,14,0.000198,0.001256,0,13957,30,0.000013,13,0.192813,0.210127,7047.746034,0.28022,0.001423
9911179,9911179,,3,2,5,3,2,5,0.000046,0.000001,0,13956,5,0.000012,14,0.152823,0.165104,6069.840823,0.1,0.000719
5143,5143,,9,8,17,9,8,17,0.000571,0.015292,0,13958,1,0.000024,12,0.198719,0.220247,1811.907206,0.261029,0.00235
5144,5144,,1,13,14,1,13,14,0,0.000079,0,13962,9,0.000011,17,0.146281,0.160383,114.931408,0.082418,0.000227
9407010,9407010,,2,0,2,2,0,2,0.000187,0,0,13961,9,0.000011,0,0,0,0,0,0.000452
9609153,9609153,,3,4,7,3,4,7,0.000004,0.000004,0,5982,4,0.000013,4,0.428571,0.538889,1362.88501,0.119048,0.000684
9810018,9810018,,3,0,3,3,0,3,0.000002,0,0,13960,9,0.000014,0,0,0,0,0.166667,0.000672
9811239,9811239,,2,2,4,2,2,4,0.000001,0.000003,0,13959,9,0.000012,6,0.262156,0.290591,32.666667,0.083333,0.000452
9502138,9502138,,4,2,6,4,2,6,0,0.000003,0,2319,52,0.000021,1,1,1,747.746354,0.333333,0.000923
9507085,9507085,,3,7,10,3,7,10,0,0.000004,0,2323,52,0.000018,1,1,1,40824.59229,0.133333,0.000685
9410091,9410091,,7,0,7,7,0,7,0.000002,0,0,1864,4,0.000035,0,0,0,0,0.214286,0.002171
5145,5145,,28,58,86,28,58,86,0.002851,0.024051,0,12395,2,0.00002,12,0.236326,0.268414,99692.834056,0.094118,0.00792
9812120,9812120,,3,8,11,3,8,11,0.000371,0.002808,0,12391,2,0.000011,13,0.187765,0.209347,231.001491,0.354545,0.000969
9907099,9907099,,4,29,33,4,29,33,0.000934,0.006595,0,12389,2,0.000012,13,0.187452,0.216056,23491.551819,0.100379,0.001528
9909227,9909227,,2,71,73,2,71,73,0.000901,0.020589,0,12388,2,0.00001,14,0.206788,0.248926,8811.150004,0.118531,0.001089
9801014,9801014,,9,9,18,9,9,18,0.000138,0.000142,0,7736,10,0.00002,12,0.187761,0.209723,7982.320911,0.120915,0.002143
5146,5146,,1,16,17,1,16,17,0.000054,0.009142,0,13963,13,0.00001,12,0.225611,0.256859,1740.944304,0.165441,0.000219
5147,5147,,19,37,56,19,37,56,0.000746,0.003652,0,13964,30,0.000022,13,0.200815,0.224249,9053.718703,0.141234,0.00517
9308091,9308091,,4,0,4,4,0,4,0.000071,0,0,4248,30,0.000013,0,0,0,0,0.083333,0.001119
5148,5148,,13,16,29,13,16,29,0.001008,0.001247,0,13965,52,0.000018,17,0.20954,0.234815,22256.326727,0.171182,0.004252
5149,5149,,0,2,2,0,2,2,0,0,0,13968,17,0.00001,3,0.571429,0.708333,0,0,0
9608160,9608160,,6,1,7,6,1,7,0.000001,0,0,13967,23,0.000027,2,0.666667,0.75,43.166667,0.095238,0.001455
9902084,9902084,,5,0,5,5,0,5,0,0,0,13966,17,0.000036,0,0,0,0,0,0.00119
5150,5150,,3,1,4,3,1,4,0,0,0,13970,23,0.000026,1,1,1,2,0.333333,0.000684
9911025,9911025,,2,0,2,2,0,2,0,0,0,13969,23,0.000037,0,0,0,0,0.5,0.000465
5151,5151,,25,47,72,25,47,72,0.004241,0.02215,0,13972,1,0.000021,15,0.22754,0.263317,33225.547253,0.126174,0.007425
9806100,9806100,,6,0,6,6,0,6,0.001119,0,0,13971,1,0.000014,0,0,0,0,0.066667,0.001699
5152,5152,,14,25,39,14,25,39,0.001075,0.012657,0,13974,1,0.000029,12,0.207123,0.232193,32912.191164,0.203104,0.004185
9905130,9905130,,4,35,39,4,35,39,0.000982,0.020367,0,13973,1,0.000014,16,0.200591,0.226748,5706.315372,0.27193,0.001293
6070,6070,,10,16,26,10,16,26,0.001271,0.000562,0,13976,1,0.000014,12,0.197562,0.218648,3852.917579,0.178462,0.002871
5183,5183,,53,28,81,53,28,81,0.005054,0.002373,0,13975,1,0.000041,12,0.198799,0.223228,123886.139024,0.091667,0.0171
9608018,9608018,,12,8,20,12,8,20,0.000124,0.000044,0,7495,9,0.000026,8,0.210558,0.240579,1417.153958,0.144737,0.003168
5153,5153,,7,43,50,7,43,50,0.000403,0.00331,0,12916,3,0.000012,12,0.210413,0.237194,4680.97634,0.19551,0.001909
5154,5154,,8,4,12,8,4,12,0,0,0,12082,23,0.000023,2,0.833333,0.9,1683.151139,0.325758,0.001884
105042,105042,,5,8,13,5,8,13,0.000023,0.000002,0,13982,23,0.000014,17,0.118749,0.126256,13878.969038,0.224359,0.001223
7179,7179,,4,4,8,4,4,8,0.000092,0,0,12083,23,0.000015,2,0.75,0.833333,18931.359902,0.232143,0.001251
9075,9075,,2,12,14,2,12,14,0,0,0,13981,23,0.000013,16,0.134494,0.144546,20401.786279,0.082418,0.000473
9911211,9911211,,7,5,12,7,5,12,0,0,0,13979,23,0.000017,4,0.414286,0.497126,612.713591,0.136364,0.001601
5155,5155,,1,2,3,1,2,3,0,0.000001,0,13983,15,0.000012,13,0.162564,0.173015,1081.850598,0.333333,0.000232
5156,5156,,6,7,13,6,7,13,0.000411,0.002666,0,12868,30,0.000015,17,0.174308,0.19111,1695.740438,0.205128,0.001824
5157,5157,,7,7,14,7,7,14,0.000266,0.000512,0,13985,30,0.000014,14,0.176316,0.191451,3042.345161,0.302198,0.001951
9804119,9804119,,4,9,13,4,9,13,0.00002,0.000382,0,13984,1,0.000018,12,0.157249,0.179412,4207.468417,0.083333,0.000974
9403077,9403077,,6,2,8,6,2,8,0.00001,0.000006,0,3647,5,0.000021,2,0.666667,0.75,165.081918,0.142857,0.001462
9604154,9604154,,2,7,9,2,7,9,0.000004,0.001039,0,9779,5,0.000017,6,0.28972,0.344301,3013.36301,0.013889,0.000474
5158,5158,,8,14,22,8,14,22,0.000033,0.000011,0,13989,6,0.000016,14,0.151686,0.165318,5103.847316,0.101732,0.001859
9806090,9806090,,9,3,12,9,3,12,0.000002,0.000002,0,13986,6,0.000017,7,0.251534,0.280952,93.406351,0.242424,0.002138
9810046,9810046,,5,11,16,5,11,16,0.000002,0.000007,0,13988,6,0.000014,13,0.176069,0.193819,28849.892089,0.1125,0.001195
9403070,9403070,,12,3,15,12,3,15,0.000173,0.000006,0,4494,4,0.000027,2,0.8,0.875,922.386096,0.080952,0.003016
9412064,9412064,,8,7,15,8,7,15,0.000002,0.000029,0,4352,22,0.000038,2,0.818182,0.888889,22317.230106,0.133333,0.002085
9210077,9210077,,4,0,4,4,0,4,0,0,0,7930,6,0.000028,0,0,0,0,0.083333,0.000983
9411138,9411138,,2,3,5,2,3,5,0.000006,0.000007,0,7931,6,0.000016,3,0.555556,0.633333,8850.045145,0.2,0.000543
9301066,9301066,,2,0,2,2,0,2,0,0,0,13987,9,0.000014,0,0,0,0,0,0.000479
5159,5159,,24,30,54,24,30,54,0.001203,0.003734,0,13990,30,0.000023,17,0.210279,0.235976,50468.114221,0.106219,0.006761
5160,5160,,3,26,29,3,26,29,0.000093,0.003554,0,13991,4,0.000011,17,0.206993,0.235995,21621.779694,0.105911,0.000818
9604003,9604003,,10,5,15,10,5,15,0.000292,0.000042,0,5326,13,0.000018,15,0.17036,0.215858,17254.34152,0.033333,0.002525
9803065,9803065,,9,18,27,9,18,27,0.000197,0.00133,0,13064,4,0.000015,12,0.192732,0.221682,5311.759926,0.121083,0.002161
9803148,9803148,,2,12,14,2,12,14,0.000085,0.001173,0,13065,4,0.000011,13,0.182675,0.206176,3660.108074,0.296703,0.000655
9508124,9508124,,8,8,16,8,8,16,0.000367,0.002597,0,1257,4,0.000016,6,0.270833,0.318889,173.897006,0.141667,0.002305
5161,5161,,3,11,14,3,11,14,0.000024,0.000031,0,13993,6,0.000012,11,0.18705,0.231705,218.281937,0.230769,0.00069
9906010,9906010,,14,6,20,14,6,20,0.000059,0.000029,0,13992,6,0.000023,10,0.208625,0.252553,2829.262604,0.147368,0.003293
9403159,9403159,,1,2,3,1,2,3,0,0.000002,0,10655,6,0.000013,1,1,1,0,0.5,0.000295
5162,5162,,12,40,52,12,40,52,0.000522,0.006464,0,12135,25,0.000022,11,0.219006,0.247628,74863.641673,0.099925,0.004796
9306057,9306057,,6,0,6,6,0,6,0.00027,0,0,579,25,0.000017,0,0,0,0,0.1,0.001597
9411131,9411131,,1,11,12,1,11,12,0.000076,0.000474,0,12133,0,0.00001,3,0.568627,0.666667,1500.337595,0.045455,0.000327
9303158,9303158,,6,1,7,6,1,7,0.000068,0,0,782,0,0.000018,1,1,1,15583.019963,0.047619,0.001656
6102,6102,,13,11,24,13,11,24,0.001813,0.008201,0,13994,1,0.000015,16,0.213325,0.238868,20237.239077,0.230072,0.00361
5164,5164,,1,18,19,1,18,19,0.000074,0.002239,0,13996,0,0.00001,13,0.194399,0.216686,2345.291236,0.175439,0.000431
9905059,9905059,,1,12,13,1,12,13,0.000026,0.000683,0,13995,0,0.00001,13,0.188799,0.211519,323.851222,0.269231,0.000229
9807018,9807018,,1,0,1,1,0,1,0.000026,0,0,10589,2,0.000011,0,0,0,0,0,0.000275
9707045,9707045,,1,0,1,1,0,1,0.000004,0,0,6489,2,0.000012,0,0,0,0,0,0.00026
9712106,9712106,,3,2,5,3,2,5,0.000013,0.000042,0,6488,2,0.000014,12,0.173357,0.191072,9436,0.3,0.000705
5166,5166,,6,23,29,6,23,29,0.000465,0.003179,0,13997,52,0.000013,11,0.203601,0.228648,4869.215596,0.21798,0.001957
5167,5167,,5,32,37,5,32,37,0.000185,0.002489,0,12139,25,0.000014,11,0.201086,0.222395,28903.038226,0.159159,0.00154
5168,5168,,7,14,21,7,14,21,0.001041,0.00806,0,13998,1,0.000017,11,0.225849,0.256399,22052.127998,0.161905,0.001919
9607002,9607002,,2,4,6,2,4,6,0.000046,0.000208,0,5384,4,0.000013,11,0.157519,0.186944,32.327631,0.266667,0.000504
5169,5169,,2,39,41,2,39,41,0.000689,0.013691,0,13999,1,0.00001,12,0.20515,0.234703,1918.364554,0.146341,0.000694
9208025,9208025,,1,3,4,1,3,4,0.000006,0.000027,0,262,13,0.000035,1,1,1,17.793309,0.333333,0.000712
9205078,9205078,,5,2,7,5,2,7,0.000023,0.000001,0,59,13,0.000027,2,0.75,0.833333,9.758032,0.285714,0.001691
9304098,9304098,,3,0,3,3,0,3,0.000021,0,0,502,41,0.000015,0,0,0,0,0.333333,0.001088
9405118,9405118,,6,0,6,6,0,6,0.000225,0,0,856,3,0.00002,0,0,0,0,0.233333,0.002865
5170,5170,,8,18,26,8,18,26,0.000024,0.00002,0,14002,6,0.000016,14,0.149609,0.163734,50679.659983,0.147692,0.001992
9509056,9509056,,11,3,14,11,3,14,0.000014,0.000005,0,11468,6,0.000019,7,0.249201,0.306777,214.738308,0.203297,0.002694
9806184,9806184,,2,18,20,2,18,20,0,0.000004,0,14001,6,0.000011,13,0.161552,0.211129,20066.328355,0.15,0.000493
9810032,9810032,,3,0,3,3,0,3,0,0,0,14000,6,0.000014,0,0,0,0,0.333333,0.000753
9301056,9301056,,4,0,4,4,0,4,0,0,0,12191,6,0.000024,0,0,0,0,0,0.000913
9302089,9302089,,2,1,3,2,1,3,0,0.000006,0,12190,6,0.000014,1,1,1,1.333333,0,0.000474
9304112,9304112,,5,2,7,5,2,7,0,0.000001,0,1189,6,0.000024,1,1,1,15881.201843,0.071429,0.001268
5171,5171,,0,1,1,0,1,1,0,0,5,14004,19,0.00001,1,1,1,0,0,0
9612006,9612006,,2,0,2,2,0,2,0,0,5,14003,19,0.000028,0,0,0,0,0,0.000438
5172,5172,,6,14,20,6,14,20,0.00037,0.011145,0,12410,1,0.000015,13,0.193248,0.216652,2937.950222,0.257895,0.002319
5173,5173,,12,4,16,12,4,16,0.00224,0.001962,0,14005,1,0.000022,16,0.157887,0.176549,447.637037,0.1125,0.002898
5174,5174,,11,23,34,11,23,34,0.00071,0.004645,0,13060,30,0.000015,14,0.201952,0.224298,22407.996936,0.173797,0.00336
5175,5175,,2,7,9,2,7,9,0.000001,0.000002,0,14006,20,0.000012,3,0.552632,0.642857,89.206765,0.236111,0.000465
9404024,9404024,,3,1,4,3,1,4,0,0,0,4755,23,0.000022,1,1,1,544.368715,0.083333,0.000839
9605206,9605206,,8,1,9,8,1,9,0.000001,0,0,7060,20,0.00006,1,1,1,7147,0.111111,0.001875
9707008,9707008,,7,4,11,7,4,11,0.000002,0.000002,0,7062,20,0.00003,2,0.666667,0.75,21261.256924,0.2,0.001662
9306067,9306067,,15,0,15,15,0,15,0.000005,0,0,3978,22,0.000204,0,0,0,0,0.157143,0.003826
9410123,9410123,,5,0,5,5,0,5,0.000061,0,0,4828,4,0.000104,0,0,0,0,0.1,0.001396
9502075,9502075,,5,0,5,5,0,5,0,0,0,4783,20,0.000127,0,0,0,0,0,0.001377
9604038,9604038,,2,0,2,2,0,2,0,0,0,7059,20,0.000066,0,0,0,0,0.5,0.000492
9504038,9504038,,1,1,2,1,1,2,0,0.000001,0,7061,20,0.000017,1,1,1,175.523045,0,0.000266
5176,5176,,0,32,32,0,32,32,0,0.008339,0,14007,2,0.00001,13,0.224862,0.25269,0,0.075605,0
9403125,9403125,,2,0,2,2,0,2,0.000001,0,0,1936,5,0.000016,0,0,0,0,0,0.000478
9801118,9801118,,7,20,27,7,20,27,0.000417,0.006296,0,7333,2,0.000015,15,0.182697,0.218812,8144.925777,0.235043,0.001818
5178,5178,,3,31,34,3,31,34,0.000092,0.004924,0,14008,30,0.000013,14,0.206804,0.230203,7681.416713,0.12656,0.000833
5179,5179,,14,18,32,14,18,32,0.001535,0.012446,0,14012,1,0.000016,13,0.193044,0.218239,2953.780576,0.202621,0.003522
9912024,9912024,,6,9,15,6,9,15,0.000527,0.000055,0,14011,5,0.000014,14,0.155106,0.182209,868.018093,0.152381,0.001717
9301020,9301020,,4,2,6,4,2,6,0.000003,0.000021,0,1988,5,0.000022,1,1,1,8.741703,0.2,0.001126
9501038,9501038,,3,17,20,3,17,20,0.000004,0.000047,0,1273,4,0.000019,5,0.351974,0.446417,7367.636028,0.115789,0.000918
9607062,9607062,,27,8,35,27,8,35,0.000275,0.000019,0,8204,5,0.000051,7,0.237659,0.267824,5453.397089,0.092437,0.006777
9702139,9702139,,3,2,5,3,2,5,0.000013,0.000011,0,8320,5,0.000014,6,0.284211,0.325617,2176.026916,0.1,0.000755
9705145,9705145,,8,7,15,8,7,15,0.000009,0.000048,0,8210,5,0.000021,7,0.255448,0.287964,1305.199636,0.214286,0.002059
9709055,9709055,,6,10,16,6,10,16,0.000033,0.00075,0,8318,5,0.000017,11,0.207876,0.241459,26785.836523,0.133333,0.001525
9801155,9801155,,4,13,17,4,13,17,0.000009,0.000532,0,8319,5,0.000015,12,0.184771,0.2192,4169.568619,0.191176,0.00105
9802013,9802013,,4,7,11,4,7,11,0.000009,0.00005,0,8314,5,0.000015,12,0.161964,0.188607,3159.928493,0.181818,0.00105
9310047,9310047,,6,2,8,6,2,8,0.000014,0.000007,0,5538,5,0.000026,2,0.666667,0.75,35.78495,0.125,0.001475
9808135,9808135,,3,7,10,3,7,10,0.000158,0.000027,0,14010,5,0.000013,13,0.176073,0.2036,1262.956589,0.244444,0.000818
9808136,9808136,,3,8,11,3,8,11,0.000158,0.00002,0,14009,5,0.000013,13,0.176247,0.204247,1322.112656,0.190909,0.000818
5180,5180,,3,21,24,3,21,24,0.000312,0.003998,0,14013,4,0.000011,11,0.232847,0.265152,2343.149737,0.112319,0.000684
5181,5181,,3,8,11,3,8,11,0,0.000027,0,14014,6,0.000018,12,0.170098,0.21119,998.535152,0.063636,0.000723
9505086,9505086,,4,6,10,4,6,10,0,0.000005,0,9291,6,0.00004,7,0.257042,0.342172,6924.318189,0.077778,0.000999
5182,5182,,40,39,79,40,39,79,0.007357,0.014966,0,12960,1,0.000027,11,0.208247,0.233645,33793.409906,0.150925,0.012593
5184,5184,,0,10,10,0,10,10,0,0.002553,0,14015,0,0.00001,12,0.192921,0.218388,0,0.133333,0
5186,5186,,8,28,36,8,28,36,0.000428,0.001539,0,14017,4,0.000013,18,0.187734,0.212546,33979.362056,0.161905,0.002194
9908120,9908120,,9,21,30,9,21,30,0.000304,0.002678,0,14016,4,0.000015,12,0.202052,0.229346,7825.741459,0.103448,0.002808
9408079,9408079,,8,4,12,8,4,12,0.000002,0.000005,0,4142,22,0.000047,1,1,1,1407.499431,0.234848,0.002187
9801026,9801026,,3,5,8,3,5,8,0.000051,0.000003,0,8536,23,0.000012,12,0.147161,0.162892,37910.528892,0.053571,0.000829
5187,5187,,8,12,20,8,12,20,0.000275,0.000372,0,14018,52,0.000017,13,0.176183,0.193248,19259.780779,0.215789,0.001933
9802022,9802022,,2,5,7,2,5,7,0.000007,0.000043,0,8957,52,0.000014,15,0.175737,0.199028,5201.041165,0.166667,0.000584
9606025,9606025,,7,11,18,7,11,18,0.000015,0.000047,0,2924,52,0.000022,6,0.300668,0.349506,34040.028408,0.104575,0.001789
5188,5188,,0,1,1,0,1,1,0,0,0,14019,4,0.00001,21,0.100329,0.116441,0,0,0
9406002,9406002,,8,3,11,8,3,11,0.000054,0.000002,0,1665,5,0.00002,3,0.545455,0.694444,90.158208,0.263636,0.002352
9206036,9206036,,6,0,6,6,0,6,0.000123,0,0,1639,5,0.000048,0,0,0,0,0.133333,0.001622
5190,5190,,2,2,4,2,2,4,0.000078,0.000022,0,14023,4,0.00001,16,0.142794,0.158898,17.391011,0.25,0.000458
9911023,9911023,,12,11,23,12,11,23,0.000379,0.000012,0,14022,4,0.000023,15,0.151648,0.169088,8846.817179,0.086957,0.005168
9609210,9609210,,3,11,14,3,11,14,0.000067,0.004353,0,14020,2,0.000014,10,0.210526,0.256863,1475.602975,0.131868,0.000783
9610199,9610199,,2,8,10,2,8,10,0.000027,0.003357,0,14021,2,0.000013,10,0.197669,0.23304,376.377085,0.211111,0.00055
5191,5191,,3,4,7,3,4,7,0.00006,0,0,14053,30,0.000012,14,0.170373,0.197275,958.368499,0.02381,0.000711
9605080,9605080,,7,12,19,7,12,19,0.000003,0.000108,0,4850,23,0.000025,10,0.210789,0.247581,89406.308743,0.05848,0.001741
9611068,9611068,,6,14,20,6,14,20,0,0.000001,0,14052,21,0.000019,7,0.244592,0.331584,4208.782928,0.171053,0.001349
9709020,9709020,,1,4,5,1,4,5,0,0.000002,0,14025,23,0.000013,2,0.75,0.833333,52.380952,0,0.000239
9808174,9808174,,3,1,4,3,1,4,0,0,0,14024,21,0.000015,13,0.1586,0.176575,2398.741702,0,0.000678
9308003,9308003,,3,1,4,3,1,4,0,0,0,14038,21,0.000015,1,1,1,0,0.333333,0.00078
9312062,9312062,,18,0,18,18,0,18,0.000038,0,0,3942,21,0.000144,0,0,0,0,0.183007,0.0047
9407067,9407067,,14,1,15,14,1,15,0.000042,0,0,3943,21,0.000049,1,1,1,11809.599623,0.180952,0.003486
9408077,9408077,,19,6,25,19,6,25,0,0.000173,0,14034,21,0.000057,3,0.5,0.595238,1521.469643,0.123333,0.004744
9408146,9408146,,14,1,15,14,1,15,0,0,0,14030,21,0.00005,1,1,1,13.418117,0.228571,0.003596
9408176,9408176,,14,2,16,14,2,16,0,0,0,14035,21,0.000036,4,0.353846,0.413043,0.5,0.229167,0.003525
9409134,9409134,,22,1,23,22,1,23,0,0,0,14029,21,0.000065,2,0.666667,0.75,333,0.132411,0.005469
9410174,9410174,,12,10,22,12,10,22,0,0.000001,0,14039,21,0.000035,4,0.424658,0.564516,217.67619,0.168831,0.00299
9504157,9504157,,12,7,19,12,7,19,0,0,0,14050,21,0.00003,4,0.410256,0.515625,250.203571,0.152047,0.002788
9504158,9504158,,17,12,29,17,12,29,0,0.000003,0,14048,21,0.000045,6,0.281184,0.356767,3483.097938,0.116995,0.004029
9504159,9504159,,11,9,20,11,9,20,0,0,0,14041,21,0.00003,4,0.423077,0.545455,238.63587,0.152632,0.002636
9510237,9510237,,4,3,7,4,3,7,0,0,0,14043,21,0.000015,5,0.315789,0.3875,331.402381,0.095238,0.000956
9604148,9604148,,4,17,21,4,17,21,0,0.000001,0,14051,21,0.000015,7,0.246206,0.344129,1006.273231,0.178571,0.000935
5192,5192,,5,52,57,5,52,57,0.001145,0.022825,0,14055,1,0.000015,13,0.230404,0.270218,35650.690281,0.14599,0.001438
9907015,9907015,,1,21,22,1,21,22,0.000268,0.020221,0,14054,1,0.00001,11,0.228335,0.259309,404.513492,0.235931,0.000256
5194,5194,,15,17,32,15,17,32,0.000406,0.000328,0,14057,30,0.000019,13,0.195596,0.21703,18628.92919,0.101815,0.004179
9902015,9902015,,2,0,2,2,0,2,0.000037,0,0,14056,30,0.000012,0,0,0,0,0,0.000548
9211126,9211126,,4,1,5,4,1,5,0.000029,0.000004,0,2479,4,0.000037,1,1,1,1788.195136,0.05,0.001184
5195,5195,,1,2,3,1,2,3,0,0,0,14064,23,0.000013,14,0.142,0.152833,0,0.5,0.000219
9708104,9708104,,10,0,10,10,0,10,0.000029,0,0,14059,23,0.000042,0,0,0,0,0.144444,0.002277
9904055,9904055,,3,4,7,3,4,7,0,0.000001,0,14063,23,0.00002,13,0.165457,0.183107,8808.622675,0.214286,0.000664
9801004,9801004,,2,3,5,2,3,5,0.000024,0.000013,0,14061,23,0.000016,18,0.127366,0.14627,357.508917,0.15,0.000478
9807037,9807037,,3,14,17,3,14,17,0.000002,0.002006,0,14062,23,0.000019,12,0.197581,0.229248,17717.945894,0.080882,0.00069
5196,5196,,0,6,6,0,6,6,0,0.008453,0,14065,2,0.00001,14,0.179541,0.200259,0,0.233333,0
5197,5197,,3,15,18,3,15,18,0.000754,0.01688,0,14066,1,0.000011,13,0.206401,0.229497,21.184149,0.284314,0.000839
5198,5198,,1,16,17,1,16,17,0.00003,0.002259,0,14067,0,0.00001,13,0.188503,0.212199,6378.173741,0.169118,0.000235
5201,5201,,2,9,11,2,9,11,0,0.000004,0,14077,5,0.000011,15,0.135669,0.148871,4701.472999,0.345455,0.000458
9804071,9804071,,8,3,11,8,3,11,0.000002,0.000001,0,14070,5,0.000019,12,0.14196,0.153558,61.811722,0.4,0.001967
9804072,9804072,,6,5,11,6,5,11,0.000001,0.000001,0,14069,5,0.000017,13,0.124665,0.134362,324.668189,0.290909,0.001495
9805184,9805184,,8,9,17,8,9,17,0.000002,0.000003,0,14072,5,0.000018,12,0.14242,0.157121,1868.573734,0.235294,0.00186
9906229,9906229,,4,13,17,4,13,17,0.00002,0.000042,0,14076,5,0.000014,14,0.155313,0.173522,26973.439906,0.091912,0.000964
9410027,9410027,,4,0,4,4,0,4,0.00004,0,0,2713,26,0.000018,0,0,0,0,0,0.000991
9602134,9602134,,2,7,9,2,7,9,0.000004,0.000006,0,2711,30,0.00002,3,0.714286,0.833333,22159.40152,0.208333,0.000591
9606183,9606183,,3,1,4,3,1,4,0,0,0,2688,23,0.000017,1,1,1,11154.193445,0.083333,0.000757
9501093,9501093,,7,2,9,7,2,9,0.000001,0,0,9283,5,0.000033,2,0.583333,0.642857,2764.297484,0.097222,0.001788
9508055,9508055,,7,0,7,7,0,7,0.000001,0,0,9281,5,0.000027,0,0,0,0,0.214286,0.001766
9602046,9602046,,1,3,4,1,3,4,0,0.000001,0,14071,5,0.000012,3,0.45,0.574074,7.996652,0.166667,0.000272
9503056,9503056,,2,0,2,2,0,2,0.000001,0,0,14073,5,0.000012,0,0,0,0,0.5,0.000533
9707257,9707257,,9,9,18,9,9,18,0.000109,0.000041,0,14075,5,0.000016,12,0.152637,0.174566,3246.292253,0.065359,0.002112
9804118,9804118,,10,10,20,10,10,20,0.000005,0.000024,0,14074,5,0.000018,12,0.142609,0.158529,5676.141072,0.157895,0.002373
9812137,9812137,,1,7,8,1,7,8,0,0.000003,0,14068,23,0.000011,13,0.149845,0.163046,317.588434,0.267857,0.000246
5202,5202,,5,12,17,5,12,17,0.000067,0.001162,0,14078,3,0.000013,12,0.189134,0.207143,1270.199915,0.227941,0.001299
5203,5203,,0,7,7,0,7,7,0,0.000004,0,14079,23,0.00001,15,0.125397,0.146988,0,0.333333,0
9504132,9504132,,5,3,8,5,3,8,0,0.000003,0,8385,23,0.000019,1,1,1,7909.335387,0.303571,0.001298
9510136,9510136,,6,6,12,6,6,12,0.000019,0.000003,0,13652,23,0.000017,4,0.588235,0.758333,2900.720306,0.181818,0.001389
5205,5205,,5,18,23,5,18,23,0.000333,0.004416,0,14080,30,0.000012,13,0.198512,0.221371,789.102247,0.195652,0.001876
5207,5207,,0,3,3,0,3,3,0,0.000002,0,14082,20,0.00001,3,0.555556,0.633333,0,0.333333,0
9910166,9910166,,2,7,9,2,7,9,0,0.000006,0,14081,20,0.000014,2,0.888889,0.9375,9.416667,0.138889,0.000438
5208,5208,,92,32,124,92,32,124,0.004049,0.002356,0,12896,30,0.000062,12,0.200511,0.222289,69223.39104,0.102675,0.03104
5209,5209,,49,9,58,49,9,58,0.001582,0.000074,0,14084,8,0.000088,12,0.186835,0.203302,55213.585272,0.103448,0.014092
9410082,9410082,,3,2,5,3,2,5,0.000134,0.000009,0,8336,0,0.000026,2,0.75,0.833333,2680.419414,0,0.00128
9510159,9510159,,3,3,6,3,3,6,0.000019,0.000058,0,14083,5,0.000025,9,0.228836,0.270766,749.167027,0.133333,0.001304
9507094,9507094,,6,13,19,6,13,19,0.000622,0.001298,0,1813,5,0.000025,8,0.276973,0.354734,8303.22291,0.122807,0.002037
5210,5210,,19,33,52,19,33,52,0.000298,0.004127,0,13035,30,0.000038,13,0.215837,0.240136,153466.266168,0.080694,0.005536
9207084,9207084,,30,1,31,30,1,31,0.000102,0,0,3085,15,0.000113,1,1,1,2636.921075,0.03871,0.007288
9312179,9312179,,11,8,19,11,8,19,0.000077,0.000007,0,5458,15,0.000024,1,1,1,10375.281773,0.096491,0.002725
9402033,9402033,,12,3,15,12,3,15,0.000097,0.000007,0,3087,15,0.000023,2,0.8,0.875,5982.890958,0.1,0.002939
9208037,9208037,,8,1,9,8,1,9,0.000001,0,0,5457,15,0.000038,1,1,1,6.333333,0.055556,0.001862
9210150,9210150,,20,2,22,20,2,22,0.000014,0.000005,0,5433,15,0.000072,1,1,1,387.485665,0.051948,0.004709
9304161,9304161,,5,2,7,5,2,7,0.000001,0.000001,0,3794,15,0.000025,1,1,1,452.094421,0.166667,0.001275
5211,5211,,3,26,29,3,26,29,0.000444,0.004472,0,14089,3,0.000015,14,0.191679,0.217356,14711.174918,0.126847,0.002653
9909182,9909182,,1,9,10,1,9,10,0.000053,0.003106,0,14088,0,0.00001,11,0.217335,0.245152,740.276805,0.188889,0.000265
9910100,9910100,,1,9,10,1,9,10,0.000053,0.000897,0,14087,0,0.00001,13,0.191223,0.213619,2598.647928,0.111111,0.000265
9912029,9912029,,1,11,12,1,11,12,0.000053,0.001527,0,14085,3,0.00001,13,0.195689,0.218391,1246.660381,0.265152,0.000265
9906059,9906059,,1,5,6,1,5,6,0.000011,0.000634,0,14086,0,0.000011,15,0.186318,0.206635,243.870636,0.2,0.000226
9205096,9205096,,3,0,3,3,0,3,0.000003,0,0,12761,0,0.000046,0,0,0,0,0,0.000755
5213,5213,,4,25,29,4,25,29,0.000351,0.023198,0,14090,1,0.000012,16,0.224702,0.257123,6652.451589,0.269704,0.001098
5214,5214,,3,5,8,3,5,8,0.000064,0.000005,0,14092,30,0.000013,7,0.226542,0.267019,130.052165,0.160714,0.00069
9905065,9905065,,4,1,5,4,1,5,0.000064,0,0,14091,30,0.000015,2,0.666667,0.75,11,0.35,0.000929
9410057,9410057,,6,1,7,6,1,7,0.000001,0,0,7229,22,0.000032,1,1,1,1923.527512,0.166667,0.001444
9706206,9706206,,2,3,5,2,3,5,0,0.000013,0,7234,22,0.000022,2,0.714286,0.8,1258.826378,0.15,0.000465
5215,5215,,2,7,9,2,7,9,0.000003,0.000637,0,14094,2,0.000016,14,0.16822,0.190125,3722.132486,0.097222,0.000438
9903158,9903158,,5,7,12,5,7,12,0.000019,0.001299,0,14093,2,0.000016,15,0.179578,0.207866,6836.456703,0.151515,0.001209
5218,5218,,2,2,4,2,2,4,0,0.000001,0,14096,6,0.00002,4,0.461538,0.597222,7,0.083333,0.000438
9906120,9906120,,2,2,4,2,2,4,0,0,0,14095,6,0.000021,3,0.571429,0.708333,8,0.25,0.000451
9401086,9401086,,11,1,12,11,1,12,0.000001,0.000004,0,10935,26,0.000039,2,0.666667,0.75,147.568582,0.045455,0.00251
5219,5219,,4,19,23,4,19,23,0.000248,0.003743,0,14097,1,0.000012,12,0.224884,0.256489,3767.407761,0.162055,0.001035
5220,5220,,5,31,36,5,31,36,0.000832,0.010747,0,14098,1,0.000012,13,0.222373,0.256028,6385.57661,0.12381,0.001284
9512041,9512041,,11,0,11,11,0,11,0.000282,0,0,2163,2,0.000027,0,0,0,0,0.081818,0.002936
9605134,9605134,,4,5,9,4,5,9,0.000296,0.001093,0,2165,0,0.000014,9,0.188818,0.226475,443.745157,0.263889,0.001232
9605143,9605143,,2,4,6,2,4,6,0.000246,0.000044,0,4028,0,0.00001,10,0.15957,0.184764,16.347931,0.3,0.000555
9609073,9609073,,5,5,10,5,5,10,0.000252,0.000247,0,4027,2,0.000014,13,0.169087,0.196465,57.34848,0.333333,0.001263
5221,5221,,6,14,20,6,14,20,0.000049,0.001315,0,14099,4,0.000018,14,0.170956,0.191382,17460.713015,0.084211,0.001368
9811041,9811041,,5,7,12,5,7,12,0.000019,0.000051,0,10365,4,0.000016,15,0.14819,0.163547,107.347589,0.280303,0.001195
9811112,9811112,,4,12,16,4,12,16,0.000017,0.000178,0,10366,4,0.000014,13,0.180913,0.199024,19445.606188,0.195833,0.000949
9405129,9405129,,6,0,6,6,0,6,0.000005,0,0,3639,4,0.000041,0,0,0,0,0.1,0.001545
9807172,9807172,,3,3,6,3,3,6,0.000004,0.000024,0,10364,4,0.000014,15,0.144018,0.156622,0.5,0.433333,0.000745
5222,5222,,27,8,35,27,8,35,0.000836,0.002119,0,13053,30,0.000035,13,0.194622,0.212968,7483.329816,0.145378,0.007938
5223,5223,,14,19,33,14,19,33,0.002875,0.01845,0,14100,1,0.000018,15,0.191743,0.216615,7693.423238,0.206439,0.005244
5224,5224,,12,6,18,12,6,18,0.002839,0.011173,0,14101,1,0.00002,12,0.196587,0.216272,9665.298093,0.267974,0.004387
9308116,9308116,,20,0,20,20,0,20,0.000206,0,0,6062,26,0.000117,0,0,0,0,0.126316,0.005016
9409152,9409152,,9,1,10,9,1,10,0.000203,0.000002,0,6063,26,0.000045,1,1,1,188.78769,0.233333,0.002348
9508148,9508148,,15,3,18,15,3,18,0.000251,0.000007,0,6065,26,0.000051,1,1,1,7914.297316,0.166667,0.003659
9510188,9510188,,8,2,10,8,2,10,0.000249,0.000005,0,6066,26,0.000029,2,0.666667,0.75,1452.334915,0.233333,0.00201
9702072,9702072,,8,8,16,8,8,16,0.000194,0.000015,0,7580,26,0.000028,10,0.188515,0.21359,118902.998611,0.133333,0.002
9710074,9710074,,5,1,6,5,1,6,0.000137,0,0,9639,26,0.000018,9,0.169001,0.183428,5497.630686,0.233333,0.001259
9801163,9801163,,3,2,5,3,2,5,0.000137,0.000002,0,9640,26,0.000012,9,0.169249,0.184865,5446.491489,0.35,0.000793
9801172,9801172,,4,1,5,4,1,5,0.000139,0,0,9638,26,0.000012,9,0.169001,0.183428,5446.491489,0.25,0.001019
9807163,9807163,,5,11,16,5,11,16,0.000193,0.004777,0,7594,26,0.000015,15,0.173087,0.194032,326748.725772,0.141667,0.00125
5225,5225,,18,17,35,18,17,35,0.000653,0.000076,0,14102,0,0.000048,15,0.161618,0.183518,31765.172642,0.07479,0.00468
9312077,9312077,,4,5,9,4,5,9,0.00007,0.000096,0,4934,0,0.000012,1,1,1,112.374637,0.097222,0.001025
9611061,9611061,,1,18,19,1,18,19,0.000002,0.000655,0,4935,0,0.000011,15,0.190901,0.237851,567.284184,0.125731,0.000334
9065,9065,,2,5,7,2,5,7,0.00004,0.001484,0,14103,25,0.000012,12,0.191035,0.208365,215.053658,0.238095,0.000438
5227,5227,,1,4,5,1,4,5,0.000081,0.000484,0,14105,9,0.00001,12,0.207124,0.234817,467.99394,0.2,0.000226
9210105,9210105,,7,13,20,7,13,20,0.000145,0.00003,0,4678,9,0.000031,1,1,1,43124.466122,0.044737,0.001647
9412095,9412095,,7,2,9,7,2,9,0.000156,0.000023,0,14104,9,0.000023,2,0.538462,0.571429,27.013498,0.180556,0.001587
9201034,9201034,,4,0,4,4,0,4,0.000002,0,0,4677,9,0.000018,0,0,0,0,0.166667,0.000978
9201065,9201065,,1,0,1,1,0,1,0,0,0,4676,9,0.000012,0,0,0,0,0,0.000266
9201066,9201066,,1,0,1,1,0,1,0,0,0,4675,9,0.000012,0,0,0,0,0,0.000266
9204052,9204052,,11,1,12,11,1,12,0.000021,0,0,478,5,0.000031,1,1,1,359.368215,0.075758,0.002924
9205020,9205020,,3,1,4,3,1,4,0.000001,0,0,4674,9,0.000016,1,1,1,2,0.083333,0.000704
9205101,9205101,,2,0,2,2,0,2,0.000001,0,0,4673,9,0.000014,0,0,0,0,0,0.000507
9206111,9206111,,4,0,4,4,0,4,0.000002,0,0,2546,3,0.000025,0,0,0,0,0.083333,0.001085
9602059,9602059,,4,9,13,4,9,13,0.001019,0.000715,0,3274,13,0.000012,9,0.213555,0.259723,13453.243968,0.230769,0.001178
5228,5228,,0,4,4,0,4,4,0,0.001825,0,14107,9,0.00001,10,0.178537,0.203969,0,0.166667,0
9505107,9505107,,5,6,11,5,6,11,0.00015,0.000027,0,14106,9,0.000018,2,0.625,0.7,45.399349,0.127273,0.001109
5229,5229,,6,8,14,6,8,14,0.000002,0.000005,0,14109,17,0.000013,13,0.146949,0.178374,31.886641,0.274725,0.001395
9912146,9912146,,8,23,31,8,23,31,0.000002,0.000009,0,14108,17,0.000016,12,0.169822,0.21426,1191.150519,0.251613,0.00188
9804049,9804049,,7,1,8,7,1,8,0.000001,0,0,10469,17,0.000014,6,0.238994,0.271491,0,0.303571,0.001772
5231,5231,,1,2,3,1,2,3,0.000005,0.000002,0,14110,28,0.00001,11,0.168354,0.198651,0,0.5,0.0003
5232,5232,,0,5,5,0,5,5,0,0.000014,0,14112,15,0.00001,14,0.140987,0.156799,0,0.25,0
9601105,9601105,,5,5,10,5,5,10,0.000003,0.000004,0,14111,15,0.000019,2,0.692308,0.777778,40.570033,0.233333,0.001144
5233,5233,,2,7,9,2,7,9,0,0.000026,0,14114,15,0.000014,14,0.141158,0.15814,402.705311,0.111111,0.000505
9511122,9511122,,4,0,4,4,0,4,0.000003,0,0,14113,15,0.000017,0,0,0,0,0,0.000925
5234,5234,,1,7,8,1,7,8,0,0.000035,0,14115,15,0.000013,14,0.153189,0.167753,798.226841,0.089286,0.000279
5235,5235,,2,9,11,2,9,11,0,0.00018,0,14116,15,0.000012,11,0.209199,0.23789,15744.541879,0.1,0.000451
9605128,9605128,,4,5,9,4,5,9,0.000009,0.000002,0,4802,15,0.000015,3,0.545455,0.666667,18876.39065,0.041667,0.00093
5237,5237,,2,5,7,2,5,7,0,0.000003,0,14117,15,0.000014,3,0.52381,0.666667,79.156228,0.142857,0.000505
9305173,9305173,,1,0,1,1,0,1,0,0,0,4801,15,0.000012,0,0,0,0,0,0.000246
5236,5236,,4,17,21,4,17,21,0.000025,0.000235,0,14118,0,0.000016,12,0.202041,0.22859,3380.807279,0.161905,0.000917
5238,5238,,0,4,4,0,4,4,0,0.000013,0,14119,23,0.00001,14,0.168877,0.184136,0,0.083333,0
9209106,9209106,,17,0,17,17,0,17,0.000004,0,0,1154,23,0.000132,0,0,0,0,0.073529,0.00427
5240,5240,,0,1,1,0,1,1,0,0,0,14121,28,0.00001,1,1,1,0,0,0
9902091,9902091,,4,0,4,4,0,4,0,0,0,14120,28,0.000031,0,0,0,0,0.166667,0.000909
5241,5241,,7,11,18,7,11,18,0.000413,0.007262,0,12950,2,0.000015,12,0.200948,0.222752,5052.636332,0.212418,0.001688
5242,5242,,23,35,58,23,35,58,0.001881,0.009854,0,12914,3,0.000023,14,0.234328,0.269198,137279.376895,0.100726,0.007119
9905146,9905146,,12,22,34,12,22,34,0.001088,0.006723,0,12903,13,0.000018,14,0.216529,0.249667,18672.833822,0.082888,0.003767
9148,9148,,195,18,213,195,18,213,0.007875,0.001128,0,12926,3,0.000131,16,0.193162,0.216647,194109.380858,0.070268,0.076373
8231,8231,,70,11,81,70,11,81,0.003079,0.000481,0,12924,3,0.000065,14,0.185712,0.201912,53644.798903,0.116512,0.034614
9103,9103,,174,16,190,174,16,190,0.007576,0.001328,0,12925,3,0.000114,15,0.181752,0.200337,71137.068292,0.074965,0.069604
9303067,9303067,,51,1,52,51,1,52,0.001873,0.000076,0,797,3,0.000059,1,1,1,0.111111,0.122549,0.023765
9311177,9311177,,92,1,93,92,1,93,0.004051,0.000003,0,1938,3,0.000078,5,0.349727,0.389583,6862.699864,0.091047,0.040283
5243,5243,,0,5,5,0,5,5,0,0.000002,0,14124,4,0.00001,15,0.158587,0.181627,0,0.05,0
9701120,9701120,,7,29,36,7,29,36,0.000028,0.003417,0,14123,4,0.000029,11,0.203526,0.242318,8526.458603,0.093651,0.001574
9905208,9905208,,4,5,9,4,5,9,0.000067,0.002345,0,14122,4,0.000017,14,0.165146,0.188098,11758.265974,0.097222,0.001264
9503234,9503234,,4,0,4,4,0,4,0.000153,0,0,3417,4,0.000014,0,0,0,0,0.333333,0.001105
9505135,9505135,,10,11,21,10,11,21,0.000542,0.003068,0,812,4,0.000025,8,0.2446,0.294926,40494.593888,0.166667,0.003812
9611012,9611012,,2,17,19,2,17,19,0.0001,0.002814,0,3940,4,0.000012,10,0.210096,0.237866,10264.971739,0.157895,0.000668
5244,5244,,21,13,34,21,13,34,0.00204,0.003001,0,14125,52,0.000022,17,0.206015,0.232029,11259.140395,0.150624,0.006146
5246,5246,,14,30,44,14,30,44,0.00266,0.018813,0,11609,13,0.000019,12,0.211582,0.242747,12315.713305,0.140063,0.005883
9312030,9312030,,2,2,4,2,2,4,0.00007,0.000009,0,3362,5,0.000012,1,1,1,1133.656984,0,0.000633
5247,5247,,101,42,143,101,42,143,0.004007,0.008504,0,11646,52,0.000061,12,0.209563,0.240178,177532.121361,0.060721,0.034505
9304130,9304130,,3,0,3,3,0,3,0.000332,0,0,4290,52,0.000014,0,0,0,0,0.166667,0.000813
9607223,9607223,,3,23,26,3,23,26,0.000145,0.0047,0,3480,4,0.000012,9,0.243233,0.281607,38884.00052,0.196923,0.001099
5249,5249,,2,1,3,2,1,3,0.00003,0,0,12449,22,0.000014,9,0.177528,0.2174,7962.104437,0.166667,0.000624
5250,5250,,4,28,32,4,28,32,0.00108,0.009268,0,14126,1,0.000011,14,0.204235,0.22847,4187.207953,0.177419,0.001001
9707052,9707052,,1,1,2,1,1,2,0.000286,0,0,9622,26,0.00001,2,0.571429,0.625,13633.280174,0,0.000333
9807038,9807038,,3,9,12,3,9,12,0.000293,0.000019,0,9619,5,0.000011,14,0.173749,0.196042,39916.906231,0.090909,0.000842
9902190,9902190,,4,19,23,4,19,23,0.001075,0.019598,0,9613,1,0.000011,15,0.195391,0.22601,22101.195128,0.187747,0.001253
9903138,9903138,,2,10,12,2,10,12,0.000223,0,0,9652,22,0.000012,6,0.409639,0.559314,50007.088994,0.083333,0.000589
5251,5251,,18,14,32,18,14,32,0.00087,0.001574,0,14128,0,0.00002,13,0.190722,0.212744,45943.606682,0.141129,0.006315
9912144,9912144,,20,14,34,20,14,34,0.000875,0.004128,0,14127,0,0.000022,12,0.212825,0.245734,16096.129025,0.149733,0.006098
5252,5252,,0,2,2,0,2,2,0,0.000018,0,14129,23,0.00001,14,0.157448,0.170354,0,0,0
5253,5253,,16,15,31,16,15,31,0.000334,0.003303,0,12941,30,0.000024,15,0.190595,0.210212,5953.313704,0.121505,0.005061
5254,5254,,5,5,10,5,5,10,0,0,0,14130,6,0.00002,14,0.15365,0.183024,2375.415458,0.144444,0.001155
5255,5255,,6,2,8,6,2,8,0.000002,0,0,14131,23,0.000019,13,0.14481,0.157276,15896.583937,0.071429,0.001517
9311158,9311158,,4,0,4,4,0,4,0.000001,0,0,10706,23,0.000046,0,0,0,0,0.083333,0.001044
5256,5256,,1,33,34,1,33,34,0.000241,0.020659,0,14132,1,0.00001,11,0.232246,0.264639,8161.732218,0.145276,0.000274
5257,5257,,5,10,15,5,10,15,0,0.000003,0,14133,5,0.000018,11,0.140491,0.18129,542.671123,0.138095,0.001168
5258,5258,,2,14,16,2,14,16,0,0.000006,0,14134,22,0.000014,7,0.247899,0.331127,222.643027,0.104167,0.000445
5259,5259,,18,13,31,18,13,31,0.00038,0.00003,0,14138,4,0.00002,8,0.252727,0.314264,9395.61657,0.109677,0.005062
9401163,9401163,,7,0,7,7,0,7,0.000009,0,0,14137,17,0.000016,0,0,0,0,0.357143,0.001819
9711091,9711091,,5,4,9,5,4,9,0.000044,0.000032,0,14136,4,0.000014,2,0.833333,0.9,310.3226,0.069444,0.001565
9909147,9909147,,14,7,21,14,7,21,0.000152,0.000045,0,14135,4,0.000021,5,0.310145,0.375857,1084.111139,0.166667,0.004443
9301070,9301070,,10,0,10,10,0,10,0.000013,0,0,926,4,0.000051,0,0,0,0,0.266667,0.003237
9302027,9302027,,13,2,15,13,2,15,0.00001,0.000021,0,925,9,0.00004,1,1,1,204.96793,0.12381,0.003518
9401135,9401135,,7,3,10,7,3,10,0.000003,0.000019,0,951,4,0.000026,4,0.307018,0.371429,14230.134736,0.111111,0.002066
9209041,9209041,,30,1,31,30,1,31,0.000013,0,0,833,9,0.000065,1,1,1,3220.074092,0.094624,0.007919
9311089,9311089,,4,7,11,4,7,11,0.000002,0.000009,0,1270,4,0.000017,2,0.818182,0.888889,1864.240835,0.1,0.001128
9404011,9404011,,8,12,20,8,12,20,0.000003,0.00004,0,1271,4,0.000026,5,0.348837,0.451667,36802.289192,0.065789,0.002036
9307115,9307115,,5,5,10,5,5,10,0.000023,0.00004,0,1173,4,0.000061,3,0.7,0.833333,16743.32314,0.1,0.002955
9209006,9209006,,18,2,20,18,2,20,0.000002,0.000004,0,1285,9,0.000048,1,1,1,2243.970232,0.089474,0.004805
9305005,9305005,,28,1,29,28,1,29,0.000003,0,0,1267,9,0.000092,1,1,1,525.200786,0.093596,0.007637
9312209,9312209,,9,4,13,9,4,13,0.000136,0.000003,0,1264,4,0.000062,2,0.7,0.785714,13302.454729,0.076923,0.002619
9410048,9410048,,4,0,4,4,0,4,0.000001,0,0,1307,30,0.00002,0,0,0,0,0.083333,0.000997
9303152,9303152,,6,0,6,6,0,6,0.000017,0,0,1261,4,0.000033,0,0,0,0,0.133333,0.001584
9410063,9410063,,4,4,8,4,4,8,0.000042,0.000009,0,4211,4,0.000018,7,0.223881,0.299683,25834.101109,0.089286,0.001051
5260,5260,,0,2,2,0,2,2,0,0.000031,0,14140,30,0.00001,1,1,1,0,0,0
9802087,9802087,,1,0,1,1,0,1,0,0,0,14139,30,0.000014,0,0,0,0,0,0.000219
5261,5261,,3,6,9,3,6,9,0.000011,0.000308,0,14141,1,0.000013,14,0.156598,0.173398,171.689321,0.319444,0.000684
5262,5262,,1,20,21,1,20,21,0.000028,0.00159,0,14149,4,0.000011,12,0.201258,0.224635,1704.7299,0.17381,0.00024
9709203,9709203,,1,7,8,1,7,8,0.000019,0.000186,0,14148,4,0.00001,7,0.248336,0.279267,328,0.25,0.000226
9801066,9801066,,15,18,33,15,18,33,0.001155,0.002779,0,12831,4,0.000019,15,0.171477,0.208372,5998.681629,0.166667,0.003698
9812055,9812055,,7,27,34,7,27,34,0.000729,0.002827,0,12834,4,0.000013,14,0.194481,0.222116,2900.03789,0.188057,0.00168
9907123,9907123,,9,85,94,9,85,94,0.000731,0.022811,0,14146,4,0.000015,11,0.248572,0.29156,196128.382985,0.07218,0.002393
9512021,9512021,,4,5,9,4,5,9,0.000359,0.002266,0,5140,4,0.000013,6,0.29646,0.338209,0,0.361111,0.001132
9702054,9702054,,10,12,22,10,12,22,0.000814,0.002085,0,5139,4,0.000015,14,0.157635,0.181576,13928.328009,0.316017,0.00278
9603160,9603160,,1,2,3,1,2,3,0.000002,0.000065,0,14147,4,0.000011,7,0.216346,0.245256,0.333333,0.166667,0.000226
9711132,9711132,,10,22,32,10,22,32,0.000944,0.002623,0,9090,4,0.000014,14,0.182547,0.21812,22414.952889,0.234879,0.002591
9806015,9806015,,5,28,33,5,28,33,0.000562,0.003196,0,12833,4,0.000011,14,0.199406,0.230482,15341.334207,0.197917,0.001298
9806032,9806032,,8,35,43,8,35,43,0.000817,0.003217,0,12832,4,0.000013,14,0.207383,0.24353,8542.160593,0.194906,0.00196
9503020,9503020,,5,21,26,5,21,26,0.000496,0.000315,0,2520,26,0.000012,5,0.402597,0.510932,21662.609844,0.206154,0.001254
9901161,9901161,,2,41,43,2,41,43,0.00046,0.018351,0,14144,4,0.000011,14,0.202967,0.239858,659.712623,0.16722,0.00055
9903172,9903172,,7,25,32,7,25,32,0.000387,0.01632,0,14145,4,0.000015,14,0.203032,0.236814,7478.58151,0.146169,0.001698
9907053,9907053,,5,12,17,5,12,17,0.000457,0.001249,0,14143,10,0.000013,14,0.184441,0.211721,6623.972554,0.183824,0.001285
5263,5263,,1,7,8,1,7,8,0,0,0,14151,21,0.000012,18,0.138248,0.157822,9445.761927,0.089286,0.00024
9504134,9504134,,9,1,10,9,1,10,0,0,0,14042,21,0.000027,1,1,1,143,0.088889,0.002125
9609142,9609142,,6,6,12,6,6,12,0,0,0,14150,21,0.000019,7,0.226601,0.279538,1850.358134,0.189394,0.001322
9312089,9312089,,1,0,1,1,0,1,0.000002,0,0,14033,21,0.000018,0,0,0,0,0,0.00035
9312090,9312090,,1,0,1,1,0,1,0.000002,0,0,14032,21,0.000018,0,0,0,0,0,0.00035
9401043,9401043,,3,0,3,3,0,3,0.000002,0,0,14031,21,0.000023,0,0,0,0,0.333333,0.000871
9307118,9307118,,13,0,13,13,0,13,0,0,0,14027,21,0.000133,0,0,0,0,0.185897,0.003396
9312091,9312091,,9,0,9,9,0,9,0,0,0,14040,21,0.000029,0,0,0,0,0.25,0.002326
9506083,9506083,,14,7,21,14,7,21,0,0,0,14049,21,0.000035,7,0.225539,0.281197,202.514466,0.152381,0.003207
5264,5264,,0,1,1,0,1,1,0,0,0,14152,5,0.00001,16,0.137227,0.154134,0,0,0
9407019,9407019,,3,0,3,3,0,3,0.000068,0,0,9728,5,0.000031,0,0,0,0,0.166667,0.000769
9601090,9601090,,1,2,3,1,2,3,0,0,0,9738,23,0.000012,6,0.244898,0.276984,5027.05222,0,0.000294
9607197,9607197,,1,3,4,1,3,4,0,0,0,9736,5,0.000012,4,0.376623,0.439655,0,0.416667,0.000294
9612155,9612155,,1,8,9,1,8,9,0,0.000001,0,9734,5,0.000012,10,0.15659,0.200492,4611.682633,0.138889,0.000294
9703005,9703005,,4,1,5,4,1,5,0.000001,0,0,9732,5,0.000016,1,1,1,22.333333,0.25,0.000971
5265,5265,,17,14,31,17,14,31,0.00028,0.002363,0,14153,2,0.000023,14,0.20449,0.227015,30499.402594,0.131183,0.004721
5266,5266,,7,6,13,7,6,13,0.000781,0.000532,0,14154,8,0.000015,14,0.169485,0.186512,1403.099286,0.217949,0.002583
5267,5267,,1,3,4,1,3,4,0.000001,0.005724,0,14155,1,0.000014,13,0.174427,0.19067,4601.403607,0.083333,0.0003
5268,5268,,11,19,30,11,19,30,0.000519,0.003262,0,14156,2,0.000017,14,0.209517,0.234184,8041.686788,0.111494,0.002954
5269,5269,,6,5,11,6,5,11,0.000005,0.000015,0,14163,5,0.000016,7,0.225309,0.272097,282.915873,0.227273,0.001509
9905201,9905201,,1,3,4,1,3,4,0,0,0,14162,26,0.000013,1,1,1,127.911111,0,0.000261
9910165,9910165,,4,9,13,4,9,13,0.000002,0.000025,0,14160,5,0.000016,7,0.222749,0.279382,159.161111,0.179487,0.000985
9402078,9402078,,3,0,3,3,0,3,0.000001,0,0,7264,26,0.000044,0,0,0,0,0,0.000754
9408010,9408010,,2,0,2,2,0,2,0,0,0,11772,26,0.00004,0,0,0,0,0,0.000505
9610109,9610109,,2,0,2,2,0,2,0,0,0,14161,26,0.000018,0,0,0,0,0,0.000445
9610009,9610009,,5,1,6,5,1,6,0.000015,0.000001,0,14159,26,0.000016,1,1,1,6.411111,0.333333,0.001156
9812075,9812075,,2,0,2,2,0,2,0,0,0,14158,5,0.000016,0,0,0,0,0,0.000466
9907199,9907199,,1,1,2,1,1,2,0,0,0,14157,5,0.000011,2,0.6,0.666667,0,0.5,0.000247
5270,5270,,27,5,32,27,5,32,0.000907,0.001095,0,14164,13,0.000032,13,0.183042,0.201113,28764.116591,0.077621,0.006775
5271,5271,,0,26,26,0,26,26,0,0.004982,0,14165,0,0.00001,16,0.174799,0.205003,0,0.153846,0
5272,5272,,51,33,84,51,33,84,0.001962,0.002786,0,12898,30,0.00004,13,0.198533,0.221601,48365.838346,0.128084,0.018044
9805085,9805085,,4,5,9,4,5,9,0.00006,0.000082,0,12888,30,0.000016,11,0.174637,0.18974,145.147914,0.125,0.001444
5273,5273,,12,13,25,12,13,25,0.000223,0.001941,0,14166,30,0.000023,16,0.200731,0.221952,16240.579326,0.101667,0.002944
9303115,9303115,,2,0,2,2,0,2,0.000047,0,0,10557,15,0.000011,0,0,0,0,0,0.00049
9312075,9312075,,5,11,16,5,11,16,0.000053,0.000024,0,5464,15,0.000025,4,0.353982,0.495833,8026.088436,0.041667,0.001181
9406042,9406042,,1,0,1,1,0,1,0.000032,0,0,10555,15,0.000011,0,0,0,0,0,0.000243
9406172,9406172,,1,1,2,1,1,2,0.000032,0,0,10554,15,0.000011,1,1,1,557.248561,0,0.000243
9411039,9411039,,2,12,14,2,12,14,0.000032,0.000006,0,10553,15,0.000013,2,0.772727,0.852941,34493.131096,0.093407,0.000463
9412153,9412153,,2,4,6,2,4,6,0.000052,0.000003,0,5436,15,0.000011,3,0.583333,0.738095,24171.246288,0.066667,0.00049
9508047,9508047,,4,8,12,4,8,12,0.000044,0.000009,0,10548,15,0.000017,5,0.301205,0.42,19016.846722,0.075758,0.000954
5275,5275,,7,38,45,7,38,45,0.000357,0.00293,0,14167,4,0.000012,13,0.189731,0.215558,9954.693053,0.135354,0.001755
9708006,9708006,,3,5,8,3,5,8,0.000009,0.000017,0,10729,4,0.000013,13,0.153117,0.173306,397.823928,0.107143,0.000701
5277,5277,,10,16,26,10,16,26,0.00001,0.000079,0,14169,4,0.000018,13,0.174071,0.197375,11313.796706,0.164615,0.002344
9403136,9403136,,1,0,1,1,0,1,0.000001,0,0,14168,4,0.000011,0,0,0,0,0,0.000286
9809152,9809152,,3,5,8,3,5,8,0.000002,0.000003,0,11030,22,0.000024,10,0.179207,0.216255,5409.536981,0.25,0.000754
9501044,9501044,,2,0,2,2,0,2,0.000003,0,0,11026,22,0.000013,0,0,0,0,0.5,0.000555
9606092,9606092,,7,3,10,7,3,10,0.000003,0.000016,0,11025,22,0.000024,3,0.5,0.590909,63.373236,0.177778,0.001745
9803169,9803169,,1,3,4,1,3,4,0,0.000011,0,11029,22,0.000014,10,0.17797,0.210328,36.973846,0.25,0.00024
9501023,9501023,,1,2,3,1,2,3,0.000001,0.000004,0,11035,22,0.000011,5,0.317073,0.417949,4981.646627,0,0.000314
9807102,9807102,,2,2,4,2,2,4,0.000001,0,0,11033,23,0.000012,12,0.157387,0.181337,11646.281336,0.166667,0.00054
5278,5278,,1,10,11,1,10,11,0.000001,0.000068,0,14170,4,0.000011,13,0.17158,0.193117,37.866667,0.245455,0.000233
9306155,9306155,,6,0,6,6,0,6,0,0,0,2795,4,0.000043,0,0,0,0,0.166667,0.001604
5279,5279,,3,14,17,3,14,17,0.000003,0.000039,0,14172,22,0.000012,18,0.124614,0.13566,1193.516131,0.264706,0.000792
9909185,9909185,,2,2,4,2,2,4,0.000001,0.000004,0,14171,22,0.000012,10,0.142031,0.162831,107.746032,0.083333,0.000466
5280,5280,,7,29,36,7,29,36,0.000812,0.017875,0,14173,1,0.000012,13,0.212812,0.240508,143158.565135,0.126984,0.001897
5281,5281,,1,8,9,1,8,9,0.000019,0.001532,0,14175,25,0.000011,12,0.192268,0.20992,2,0.263889,0.000226
9408057,9408057,,1,0,1,1,0,1,0.000018,0,0,14174,25,0.000011,0,0,0,0,0,0.000226
5282,5282,,5,11,16,5,11,16,0.000077,0.00039,0,14176,26,0.000013,12,0.201414,0.224289,11479.906064,0.204167,0.001174
9404058,9404058,,8,6,14,8,6,14,0.000086,0.000071,0,5404,26,0.000021,5,0.28,0.37381,4617.105751,0.153846,0.002056
9510104,9510104,,8,8,16,8,8,16,0.00006,0.000069,0,6260,26,0.000029,6,0.268551,0.372807,2763.919209,0.1875,0.00216
5283,5283,,10,18,28,10,18,28,0.000295,0.003263,0,14177,30,0.000016,15,0.202425,0.225544,5316.371147,0.125661,0.002429
5284,5284,,0,3,3,0,3,3,0,0,0,14180,22,0.00001,6,0.276596,0.370513,0,0.166667,0
9501103,9501103,,3,0,3,3,0,3,0,0,0,14178,22,0.000027,0,0,0,0,0.166667,0.000664
9705081,9705081,,1,1,2,1,1,2,0,0,0,14179,22,0.000013,1,1,1,0,0.5,0.000219
5285,5285,,1,5,6,1,5,6,0,0.000992,0,14181,28,0.000013,12,0.193101,0.212441,8172.452831,0,0.000219
5286,5286,,2,4,6,2,4,6,0.000012,0.000006,0,14186,22,0.000011,12,0.185627,0.201218,142.307857,0.233333,0.000485
9202052,9202052,,6,0,6,6,0,6,0.000012,0,0,1653,22,0.000065,0,0,0,0,0.066667,0.001445
9905136,9905136,,4,6,10,4,6,10,0.000024,0.001033,0,14183,22,0.000015,6,0.282983,0.335473,259.119907,0.133333,0.000957
9906174,9906174,,3,8,11,3,8,11,0.000012,0.00103,0,14185,22,0.000014,6,0.285714,0.344333,377.295205,0.127273,0.000718
9205116,9205116,,10,0,10,10,0,10,0.000026,0,0,1652,23,0.000064,0,0,0,0,0.066667,0.002484
9511195,9511195,,6,12,18,6,12,18,0.000098,0.000002,0,9980,22,0.000019,2,0.8,0.875,16330.141964,0.120915,0.001648
9704081,9704081,,2,0,2,2,0,2,0.000024,0,0,14182,22,0.000014,0,0,0,0,0.5,0.000486
9806070,9806070,,1,0,1,1,0,1,0.000012,0,0,14184,22,0.000011,0,0,0,0,0,0.000239
5287,5287,,3,6,9,3,6,9,0,0,0,14187,22,0.000012,9,0.165632,0.199912,0,0.375,0.00069
5288,5288,,1,5,6,1,5,6,0.000228,0.007739,0,14188,1,0.00001,11,0.225538,0.254536,177.804333,0.266667,0.000226
6001,6001,,4,1,5,4,1,5,0.000299,0.000785,0,12930,30,0.000012,13,0.183897,0.198875,37.471725,0.1,0.001107
6003,6003,,28,3,31,28,3,31,0.000661,0.00007,0,14189,2,0.000053,15,0.144171,0.15576,8617.63875,0.208602,0.007511
6004,6004,,3,10,13,3,10,13,0.000008,0.000176,0,14192,4,0.000013,13,0.181136,0.2074,180.287502,0.230769,0.000677
9909196,9909196,,5,35,40,5,35,40,0.000452,0.002568,0,14191,4,0.000012,13,0.186219,0.217737,20088.589751,0.167949,0.001442
9405018,9405018,,2,5,7,2,5,7,0.00003,0.000001,0,9785,6,0.000012,2,0.857143,0.916667,8439.330809,0.071429,0.000482
9807183,9807183,,9,28,37,9,28,37,0.000819,0.003962,0,10889,4,0.000012,17,0.190264,0.230163,2335.124028,0.177928,0.002262
9809180,9809180,,4,14,18,4,14,18,0.000171,0.002023,0,10900,4,0.000011,15,0.169074,0.194725,19.177858,0.297386,0.000966
9812085,9812085,,4,24,28,4,24,28,0.00019,0.002902,0,10899,4,0.000011,13,0.184707,0.216715,10.706085,0.316138,0.000949
9906207,9906207,,3,52,55,3,52,55,0.0002,0.003964,0,14190,4,0.00001,15,0.183618,0.217174,304.04002,0.200673,0.000745
6005,6005,,9,6,15,9,6,15,0.000241,0.000796,0,14196,30,0.000021,14,0.182579,0.200486,10758.384236,0.17619,0.002255
9512007,9512007,,5,0,5,5,0,5,0.00001,0,0,6976,30,0.000041,0,0,0,0,0.15,0.001278
9601024,9601024,,2,1,3,2,1,3,0.00001,0,0,14195,30,0.000014,1,1,1,5,0.166667,0.000514
9608009,9608009,,1,2,3,1,2,3,0.000009,0,0,14194,30,0.000013,1,1,1,2540,0.166667,0.000281
9508035,9508035,,1,0,1,1,0,1,0,0,0,14193,30,0.000016,0,0,0,0,0,0.000227
9405073,9405073,,1,3,4,1,3,4,0.000001,0.000014,0,6974,15,0.000011,1,1,1,1245.916189,0,0.000305
9409135,9409135,,3,0,3,3,0,3,0.000023,0,0,6972,15,0.000045,0,0,0,0,0.166667,0.000855
9410047,9410047,,4,1,5,4,1,5,0.000045,0,0,2901,15,0.000032,3,0.5,0.566667,2985.757216,0,0.00117
9612170,9612170,,3,7,10,3,7,10,0.000011,0.000194,0,4687,28,0.000014,10,0.200068,0.227225,4694.47765,0.122222,0.000881
6006,6006,,2,28,30,2,28,30,0.000093,0.004027,0,14198,30,0.000011,13,0.213138,0.238275,10672.245434,0.082759,0.000669
9304003,9304003,,4,0,4,4,0,4,0.000098,0,0,5415,15,0.000015,0,0,0,0,0.083333,0.000934
9509098,9509098,,6,2,8,6,2,8,0.00027,0.000015,0,6439,30,0.000013,8,0.239316,0.27804,557.722286,0.160714,0.001629
9511106,9511106,,13,0,13,13,0,13,0.000098,0,0,14197,15,0.000061,0,0,0,0,0.166667,0.003104
9310083,9310083,,3,0,3,3,0,3,0.000054,0,0,556,30,0.000037,0,0,0,0,0,0.00072
9312101,9312101,,4,0,4,4,0,4,0.000001,0,0,554,4,0.000038,0,0,0,0,0.083333,0.001024
9312133,9312133,,11,0,11,11,0,11,0.000001,0,0,1874,22,0.000052,0,0,0,0,0.027273,0.002533
9702068,9702068,,5,9,14,5,9,14,0.000194,0.001055,0,6438,26,0.000014,12,0.171612,0.196238,10076.82005,0.17033,0.001161
9503041,9503041,,12,6,18,12,6,18,0.000345,0.00006,0,5116,26,0.000028,7,0.263333,0.32711,32773.354891,0.228758,0.003688
6008,6008,,22,24,46,22,24,46,0.001817,0.021516,0,12400,4,0.000025,16,0.226681,0.259867,25471.98806,0.118357,0.007758
6009,6009,,10,34,44,10,34,44,0.001453,0.019125,0,14199,1,0.000015,16,0.216517,0.248083,39928.978442,0.088266,0.002817
9704154,9704154,,4,5,9,4,5,9,0.0003,0.000714,0,5752,0,0.000014,8,0.241179,0.26905,15189.248889,0.125,0.001396
6010,6010,,6,16,22,6,16,22,0.00025,0.001173,0,14200,4,0.000013,15,0.167596,0.191655,8308.125054,0.11039,0.002596
6011,6011,,10,31,41,10,31,41,0.000673,0.003278,0,14201,4,0.000019,11,0.233297,0.267434,35224.879709,0.09939,0.003365
9710073,9710073,,5,14,19,5,14,19,0.000534,0.003058,0,12963,4,0.000012,16,0.15554,0.188595,2011.624529,0.239766,0.001528
6013,6013,,25,21,46,25,21,46,0.00206,0.009934,0,12208,30,0.000024,13,0.193948,0.215763,2457.622427,0.18599,0.008979
6014,6014,,14,21,35,14,21,35,0.001057,0.004761,0,13010,30,0.000016,13,0.21056,0.236391,112300.349405,0.173109,0.004318
6015,6015,,1,11,12,1,11,12,0.000054,0.000314,0,14202,13,0.00001,12,0.191438,0.210331,23.586616,0.219697,0.000219
6016,6016,,0,16,16,0,16,16,0,0.000026,0,14203,20,0.00001,14,0.15718,0.172424,0,0.295833,0
6017,6017,,2,14,16,2,14,16,0.000029,0.000274,0,14207,2,0.000012,13,0.180377,0.197686,3796.861262,0.254167,0.000648
9905108,9905108,,5,9,14,5,9,14,0.000231,0.000276,0,14206,2,0.000014,15,0.149736,0.174381,2717.671722,0.192308,0.001212
9911166,9911166,,6,6,12,6,6,12,0.00024,0.000176,0,14204,2,0.000014,15,0.147581,0.169734,291.267876,0.19697,0.001479
9801016,9801016,,1,6,7,1,6,7,0.000003,0.001189,0,14205,2,0.000011,11,0.176055,0.197952,9.13726,0.285714,0.000253
6018,6018,,15,13,28,15,13,28,0.000925,0.001465,0,14208,30,0.000022,12,0.206638,0.226341,8028.957416,0.153439,0.004645
6058,6058,,4,24,28,4,24,28,0.000138,0.010256,0,14209,30,0.000012,15,0.199257,0.223858,2499.39645,0.177249,0.001481
6019,6019,,2,31,33,2,31,33,0.000363,0.008749,0,12152,30,0.000011,12,0.21426,0.239197,970.187289,0.168561,0.000936
6020,6020,,1,10,11,1,10,11,0.000007,0.002886,0,14210,13,0.000011,11,0.226167,0.256018,2822.960371,0.136364,0.000219
6021,6021,,0,1,1,0,1,1,0,0,0,14211,26,0.00001,2,0.666667,0.75,0,0,0
9306131,9306131,,8,0,8,8,0,8,0.000002,0,0,8011,26,0.000096,0,0,0,0,0.160714,0.001983
6022,6022,,4,18,22,4,18,22,0.000188,0.014603,0,14212,1,0.000011,11,0.231909,0.262105,13006.407493,0.166667,0.001124
9808172,9808172,,6,48,54,6,48,54,0.000914,0.021733,0,9612,9,0.000014,13,0.212952,0.248652,58429.398811,0.087002,0.001722
9710080,9710080,,3,1,4,3,1,4,0.000255,0,0,9611,23,0.000017,4,0.344828,0.4,6177.992141,0.083333,0.00073
9908138,9908138,,3,0,3,3,0,3,0.000104,0,0,9696,22,0.000012,0,0,0,0,0,0.000753
6023,6023,,47,30,77,47,30,77,0.004541,0.011187,0,12213,30,0.000037,13,0.213564,0.241014,119056.735664,0.150547,0.016756
6024,6024,,2,40,42,2,40,42,0.000109,0.016318,0,14213,2,0.000011,14,0.210006,0.24027,5541.80732,0.134146,0.000546
6025,6025,,7,2,9,7,2,9,0.000041,0.000001,0,14225,10,0.000021,15,0.132523,0.140587,0,0.430556,0.00177
9911139,9911139,,13,6,19,13,6,19,0.000057,0.000001,0,14223,10,0.000044,14,0.152485,0.164732,16043.469986,0.204678,0.003305
9911225,9911225,,11,6,17,11,6,17,0.000057,0.000035,0,14224,10,0.000037,14,0.15272,0.165351,10973.837986,0.238971,0.00279
9706219,9706219,,7,0,7,7,0,7,0.000003,0,0,14219,10,0.000037,0,0,0,0,0.404762,0.001867
9805038,9805038,,8,6,14,8,6,14,0.000028,0.000171,0,14220,10,0.000029,14,0.174805,0.193198,14713.625309,0.175824,0.002089
9808147,9808147,,7,1,8,7,1,8,0.000008,0,0,14215,10,0.000061,1,1,1,1326,0.178571,0.001729
9903006,9903006,,3,1,4,3,1,4,0,0,0,14216,10,0.000029,2,0.666667,0.75,0,0.416667,0.000782
9903174,9903174,,3,8,11,3,8,11,0.000027,0.000007,0,14222,10,0.000024,13,0.176835,0.195439,27854.812402,0.136364,0.000879
9910075,9910075,,4,2,6,4,2,6,0.000007,0,0,14217,10,0.000022,2,0.75,0.833333,1.416667,0.3,0.001
6026,6026,,6,9,15,6,9,15,0.000034,0.000228,0,14226,25,0.000017,13,0.179371,0.196751,12751.54043,0.152381,0.001566
6027,6027,,8,3,11,8,3,11,0.000038,0.000001,0,14227,10,0.00002,15,0.132527,0.140678,235.028654,0.2,0.001893
6028,6028,,22,44,66,22,44,66,0.000529,0.002464,0,12406,4,0.000028,12,0.213024,0.239248,319891.018391,0.071096,0.005737
9801078,9801078,,2,16,18,2,16,18,0.000012,0.000889,0,7978,25,0.000013,13,0.189441,0.215947,2883.063807,0.186275,0.000692
6031,6031,,1,2,3,1,2,3,0,0.000001,0,14228,23,0.000014,3,0.571429,0.708333,0,0.5,0.000226
6032,6032,,0,8,8,0,8,8,0,0.002058,0,14230,0,0.00001,15,0.178941,0.208433,0,0.178571,0
9801176,9801176,,3,7,10,3,7,10,0.000098,0.000165,0,14229,0,0.000012,15,0.175009,0.198213,55.796198,0.322222,0.000658
6033,6033,,21,50,71,21,50,71,0.002483,0.003828,0,12901,0,0.000017,13,0.211753,0.241993,18687.907481,0.141046,0.008108
6034,6034,,10,4,14,10,4,14,0.000222,0.000075,0,14231,13,0.000023,15,0.16969,0.193433,860.057816,0.17033,0.00278
9709227,9709227,,8,7,15,8,7,15,0.000356,0.0035,0,6461,13,0.000022,12,0.206457,0.235265,22031.148371,0.157143,0.002156
6035,6035,,15,23,38,15,23,38,0.000402,0.002144,0,14232,5,0.000022,14,0.179756,0.205225,37692.283993,0.083215,0.003609
9401081,9401081,,7,4,11,7,4,11,0.000257,0.000159,0,3736,5,0.000018,4,0.454545,0.519444,3049.565678,0.109091,0.001974
9412131,9412131,,6,32,38,6,32,38,0.000567,0.00162,0,1964,5,0.000014,8,0.327913,0.500315,6713.690181,0.068279,0.002278
9704168,9704168,,10,12,22,10,12,22,0.000253,0.000052,0,8209,5,0.000022,7,0.261049,0.300497,36660.778813,0.090909,0.002703
9205114,9205114,,5,0,5,5,0,5,0.000011,0,0,428,5,0.000019,0,0,0,0,0.05,0.001301
9301058,9301058,,3,7,10,3,7,10,0.00001,0.000026,0,417,5,0.000012,2,0.561404,0.609375,13.147222,0.277778,0.00081
9301082,9301082,,2,1,3,2,1,3,0.000007,0.000001,0,416,5,0.000015,1,1,1,986.572897,0.166667,0.000772
9302096,9302096,,12,1,13,12,1,13,0.000051,0.00007,0,388,5,0.000033,1,1,1,102.18379,0.070513,0.003315
9302101,9302101,,1,6,7,1,6,7,0.000003,0.000032,0,414,5,0.00001,1,1,1,810.299723,0.119048,0.000316
9302127,9302127,,4,0,4,4,0,4,0.000013,0,0,413,5,0.000015,0,0,0,0,0.083333,0.001
9303011,9303011,,2,4,6,2,4,6,0.000006,0.000015,0,411,5,0.000011,1,1,1,14.034387,0.233333,0.000578
9304163,9304163,,2,2,4,2,2,4,0.000005,0.000012,0,400,5,0.000011,1,1,1,0.333333,0.333333,0.000566
9407015,9407015,,3,9,12,3,9,12,0.000005,0.000063,0,2608,5,0.000016,4,0.417266,0.49569,270.721366,0.174242,0.000841
9604064,9604064,,1,12,13,1,12,13,0.000001,0.00014,0,6514,5,0.000011,8,0.285392,0.331009,21202.699023,0.179487,0.000276
9606097,9606097,,6,13,19,6,13,19,0.000118,0.00012,0,6519,5,0.000015,6,0.32619,0.38455,3590.323304,0.157895,0.001511
9307033,9307033,,4,1,5,4,1,5,0.000003,0.000002,0,8205,5,0.000016,2,0.511628,0.522727,39.613175,0.2,0.000983
9411105,9411105,,2,7,9,2,7,9,0.000001,0.000007,0,8208,5,0.000013,4,0.422222,0.502193,15903.229276,0.097222,0.000526
6036,6036,,12,4,16,12,4,16,0.000118,0,0,14234,23,0.000044,15,0.140516,0.153934,2128.621897,0.0875,0.002823
9909006,9909006,,9,4,13,9,4,13,0.000003,0.000006,0,14233,23,0.00005,14,0.161261,0.180332,35534.058403,0.121795,0.002179
6037,6037,,6,26,32,6,26,32,0.00119,0.020219,0,14236,1,0.000013,13,0.220905,0.253994,6634.850626,0.188508,0.001613
9811126,9811126,,8,9,17,8,9,17,0.001357,0.016719,0,14235,1,0.000013,12,0.188303,0.213557,416.475839,0.205882,0.002011
8211,8211,,5,38,43,5,38,43,0.000611,0.020553,0,14238,1,0.000011,13,0.223876,0.257156,4467.337765,0.151163,0.00121
8028,8028,,16,12,28,16,12,28,0.001631,0.00814,0,14237,1,0.000016,14,0.213335,0.24632,9884.610895,0.199735,0.004487
6038,6038,,1,7,8,1,7,8,0,0.000003,0,14239,10,0.000011,15,0.143325,0.155884,0,0.321429,0.000246
9710024,9710024,,9,9,18,9,9,18,0.000129,0.000985,0,6360,4,0.000022,13,0.169229,0.190964,3581.813665,0.20915,0.002481
9802178,9802178,,2,11,13,2,11,13,0.000002,0.000718,0,14218,4,0.000017,13,0.196099,0.222748,9768.360223,0.134615,0.000517
6039,6039,,2,6,8,2,6,8,0.000001,0.000105,0,14245,22,0.000012,14,0.162554,0.179742,10255.084737,0.017857,0.000479
9312001,9312001,,21,3,24,21,3,24,0.000116,0.000012,0,2660,22,0.000036,2,0.666667,0.75,1292.937676,0.052536,0.005245
9411054,9411054,,12,1,13,12,1,13,0.00004,0.000001,0,3767,22,0.000033,3,0.390244,0.427083,853.717691,0.070513,0.003461
9902028,9902028,,4,15,19,4,15,19,0.000005,0.000005,0,14244,22,0.000014,4,0.538462,0.644841,1288.825587,0.055556,0.000943
9306076,9306076,,1,3,4,1,3,4,0,0,0,14243,22,0.000011,1,1,1,123.2,0,0.000246
9506015,9506015,,4,5,9,4,5,9,0,0.000003,0,14240,22,0.000024,4,0.472222,0.583333,80.657618,0.166667,0.00093
9512076,9512076,,1,1,2,1,1,2,0,0,0,14241,22,0.000011,5,0.333333,0.386111,0,0.5,0.000246
6040,6040,,0,4,4,0,4,4,0,0.000001,0,14247,5,0.00001,17,0.122173,0.135688,0,0.333333,0
9907212,9907212,,2,1,3,2,1,3,0,0,0,14246,5,0.000014,17,0.122031,0.134296,0,0.333333,0.000438
6041,6041,,1,38,39,1,38,39,0.000215,0.023781,0,14248,1,0.00001,16,0.230692,0.264974,2212.106407,0.157895,0.000219
6060,6060,,29,19,48,29,19,48,0.005178,0.0173,0,11607,13,0.000027,11,0.208143,0.234556,12807.287022,0.139184,0.012258
9803042,9803042,,1,9,10,1,9,10,0.00028,0.002472,0,11605,4,0.000012,13,0.178997,0.205775,14723.90212,0.144444,0.001543
9905155,9905155,,6,50,56,6,50,56,0.001438,0.014896,0,11604,13,0.000015,11,0.234727,0.271924,23706.039625,0.091234,0.003125
9906203,9906203,,8,16,24,8,16,24,0.001648,0.001984,0,11603,13,0.000015,14,0.204242,0.233166,21114.715875,0.23913,0.003623
9310197,9310197,,10,3,13,10,3,13,0.000385,0.000006,0,542,13,0.000029,2,0.636364,0.714286,19442.678501,0.102564,0.002495
9311181,9311181,,22,3,25,22,3,25,0.000214,0.000014,0,2281,9,0.000063,1,1,1,7959.365698,0.106667,0.005673
9405016,9405016,,6,11,17,6,11,17,0.000206,0.000118,0,549,13,0.00002,4,0.383051,0.45059,21750.631081,0.084559,0.001445
9411190,9411190,,5,6,11,5,6,11,0.000204,0.000167,0,7908,13,0.000019,7,0.277635,0.316325,9054.266932,0.118182,0.001152
9412051,9412051,,1,5,6,1,5,6,0.000196,0.00007,0,7906,9,0.00001,6,0.241379,0.316931,66.101552,0.233333,0.000249
9502094,9502094,,8,6,14,8,6,14,0.000214,0.000038,0,2286,9,0.000024,4,0.357798,0.442308,47716.237534,0.21978,0.00188
6042,6042,,1,3,4,1,3,4,0,0.000003,0,14250,30,0.000019,16,0.159601,0.173847,5508,0.083333,0.000219
9906122,9906122,,1,15,16,1,15,16,0,0.001157,0,14249,30,0.000015,15,0.189712,0.215037,10988,0.179167,0.000226
6043,6043,,6,33,39,6,33,39,0.001719,0.022098,0,12326,1,0.000012,16,0.21169,0.238825,5421.745151,0.148448,0.00214
6045,6045,,0,1,1,0,1,1,0,0,0,14252,6,0.00001,1,1,1,0,0,0
6029,6029,,2,0,2,2,0,2,0,0,0,14251,6,0.00002,0,0,0,0,0,0.000438
6046,6046,,16,15,31,16,15,31,0.000694,0.001934,0,14253,25,0.000019,18,0.185094,0.204246,1417.858824,0.125806,0.003964
6048,6048,,19,37,56,19,37,56,0.004483,0.024514,0,12409,1,0.000017,12,0.221527,0.251872,14768.498162,0.194156,0.006571
6049,6049,,6,23,29,6,23,29,0.00052,0.001955,0,14254,0,0.000013,14,0.19792,0.221714,3147.865761,0.264778,0.003226
9711039,9711039,,5,18,23,5,18,23,0.000928,0.005983,0,5055,0,0.000013,11,0.197672,0.22645,11193.722419,0.197628,0.002319
9505080,9505080,,16,0,16,16,0,16,0.000106,0,0,1715,0,0.000065,0,0,0,0,0.233333,0.004765
6050,6050,,3,8,11,3,8,11,0.000195,0.002862,0,14255,4,0.000012,14,0.175333,0.200111,72.175947,0.127273,0.000734
6051,6051,,10,12,22,10,12,22,0.000057,0.001879,0,14256,23,0.000034,14,0.156852,0.188994,8343.007995,0.19697,0.002516
9601028,9601028,,9,0,9,9,0,9,0.000023,0,0,6741,23,0.000045,0,0,0,0,0.097222,0.002193
6052,6052,,5,30,35,5,30,35,0.000121,0.004932,0,12880,3,0.000013,12,0.205494,0.229955,13439.815678,0.178151,0.002408
9909091,9909091,,4,13,17,4,13,17,0.000222,0.003654,0,12879,13,0.000012,13,0.174689,0.197,12570.197999,0.172794,0.001034
6054,6054,,3,24,27,3,24,27,0.0002,0.000501,0,14258,0,0.000011,13,0.19085,0.213612,1771.021324,0.202279,0.000862
9907124,9907124,,5,2,7,5,2,7,0.000338,0.000064,0,14257,0,0.000015,13,0.157738,0.16994,699.88536,0.095238,0.001239
6179,6179,,8,16,24,8,16,24,0.000146,0.006815,0,14259,0,0.000023,12,0.203614,0.228762,35258.636884,0.065217,0.002213
6056,6056,,9,26,35,9,26,35,0.000516,0.003214,0,14260,30,0.000013,14,0.209748,0.233839,8191.637691,0.202521,0.002882
6057,6057,,11,4,15,11,4,15,0.000057,0.000003,0,14263,23,0.000042,15,0.141178,0.166416,7545.647912,0.161905,0.002576
9907190,9907190,,6,5,11,6,5,11,0.000002,0.000008,0,14262,28,0.000026,10,0.192499,0.228085,2253.522406,0.118182,0.00146
9812124,9812124,,2,0,2,2,0,2,0,0,0,14261,28,0.000016,0,0,0,0,0.5,0.000486
6062,6062,,105,25,130,105,25,130,0.008205,0.00374,0,12254,30,0.000101,14,0.203348,0.225309,297689.84632,0.066667,0.035061
6112,6112,,57,31,88,57,31,88,0.004309,0.011628,0,13006,30,0.00004,14,0.202137,0.226785,43682.994188,0.117424,0.020499
6225,6225,,18,19,37,18,19,37,0.001465,0.00231,0,13009,30,0.000018,14,0.195351,0.216348,918.482314,0.250751,0.006142
6193,6193,,25,21,46,25,21,46,0.002174,0.004762,0,13008,30,0.000022,14,0.199355,0.222915,8284.669121,0.169082,0.008385
6202,6202,,35,23,58,35,23,58,0.002689,0.01091,0,13007,30,0.000026,14,0.205424,0.229721,10615.564078,0.150635,0.011319
6063,6063,,1,16,17,1,16,17,0.000015,0.0025,0,14266,13,0.000011,15,0.172269,0.205981,442.701904,0.139706,0.000219
9910122,9910122,,3,6,9,3,6,9,0.000324,0.00056,0,14265,13,0.000012,14,0.160956,0.184561,8014.394311,0.291667,0.000964
9512107,9512107,,7,3,10,7,3,10,0.000203,0.000068,0,3260,26,0.000023,4,0.375,0.434028,1136.307544,0.233333,0.001897
9607183,9607183,,1,0,1,1,0,1,0.000015,0,0,3258,26,0.000013,0,0,0,0,0,0.000285
9606039,9606039,,2,16,18,2,16,18,0.000065,0.007888,0,6437,26,0.000012,11,0.205552,0.245302,1995.08336,0.111111,0.000472
9710035,9710035,,1,18,19,1,18,19,0.000007,0.003556,0,14264,13,0.000012,13,0.178883,0.209563,2377.654135,0.108187,0.000243
9508053,9508053,,6,12,18,6,12,18,0.000115,0.001126,0,3049,4,0.000016,10,0.178779,0.229279,17591.64849,0.101307,0.001474
6065,6065,,0,9,9,0,9,9,0,0.00002,0,14271,28,0.00001,18,0.141651,0.157652,0,0.194444,0
9507163,9507163,,4,6,10,4,6,10,0.000003,0.000019,0,14268,28,0.000015,2,0.6875,0.772727,10.083333,0.3,0.000903
9612074,9612074,,3,7,10,3,7,10,0.000001,0.000178,0,14269,28,0.000014,11,0.167779,0.183645,2286.879056,0.266667,0.000664
9811103,9811103,,1,6,7,1,6,7,0,0.000019,0,14270,28,0.000011,12,0.143802,0.154309,0.25,0.404762,0.000219
9903126,9903126,,2,0,2,2,0,2,0,0,0,14267,28,0.000012,0,0,0,0,0,0.000438
9506004,9506004,,23,0,23,23,0,23,0.000015,0,0,1836,22,0.000137,0,0,0,0,0.12253,0.005715
9601009,9601009,,6,7,13,6,7,13,0.000006,0,0,7247,22,0.000023,6,0.358025,0.495977,12093.090171,0.115385,0.001429
9703185,9703185,,1,2,3,1,2,3,0.000006,0,0,7244,22,0.000012,3,0.5,0.566667,980.738189,0,0.000246
6067,6067,,10,15,25,10,15,25,0.000178,0.002016,0,14272,2,0.000019,15,0.200013,0.223114,3917.203354,0.161667,0.002898
9206069,9206069,,3,0,3,3,0,3,0.000007,0,0,942,5,0.000016,0,0,0,0,0.166667,0.000757
9306063,9306063,,4,4,8,4,4,8,0.000003,0.000019,0,936,5,0.000021,3,0.378378,0.440476,299.694165,0.035714,0.001017
9306141,9306141,,5,5,10,5,5,10,0.000009,0.000009,0,935,5,0.000016,3,0.386667,0.45977,108.55642,0.088889,0.001296
9307185,9307185,,6,4,10,6,4,10,0.000049,0.000011,0,934,5,0.000014,3,0.378378,0.440476,94.081965,0.122222,0.001478
9502165,9502165,,4,0,4,4,0,4,0.00007,0,0,4230,9,0.000023,0,0,0,0,0.25,0.001266
9306137,9306137,,3,0,3,3,0,3,0.000002,0,0,6327,9,0.000015,0,0,0,0,0.166667,0.000826
9306139,9306139,,3,0,3,3,0,3,0.000016,0,0,6326,9,0.000014,0,0,0,0,0.5,0.000902
9310004,9310004,,14,0,14,14,0,14,0.000107,0,0,6325,9,0.000037,0,0,0,0,0.175824,0.003862
6071,6071,,101,20,121,101,20,121,0.005175,0.002815,0,12851,3,0.000092,15,0.197582,0.218776,39666.096154,0.093595,0.047255
6073,6073,,6,17,23,6,17,23,0.000328,0.003983,0,13033,30,0.000012,16,0.1936,0.214982,7656.114519,0.217391,0.001847
9812230,9812230,,4,30,34,4,30,34,0.000334,0.010284,0,13024,2,0.000011,15,0.205436,0.241466,3870.239452,0.186275,0.000999
9907117,9907117,,3,35,38,3,35,38,0.000228,0.009061,0,13026,2,0.000011,12,0.217156,0.249169,6716.400559,0.133001,0.000759
9911251,9911251,,4,26,30,4,26,30,0.000218,0.00829,0,13027,30,0.000012,13,0.202878,0.225318,10971.053776,0.211494,0.001391
9705111,9705111,,6,13,19,6,13,19,0.000646,0.007691,0,5508,2,0.000012,12,0.195041,0.225283,485.993757,0.233918,0.001585
9807239,9807239,,5,32,37,5,32,37,0.000414,0.00954,0,13023,2,0.000012,11,0.222606,0.255556,3988.374832,0.167417,0.0012
9412026,9412026,,1,3,4,1,3,4,0.000106,0.000008,0,13025,13,0.00001,5,0.257937,0.301538,573.04046,0,0.00024
6074,6074,,0,2,2,0,2,2,0,0.000021,0,14273,22,0.00001,6,0.249097,0.30314,0,0,0
6075,6075,,1,2,3,1,2,3,0,0,0,14275,28,0.000016,1,1,1,0,0.333333,0.000239
9901025,9901025,,4,0,4,4,0,4,0,0,0,14274,28,0.000032,0,0,0,0,0.166667,0.000909
9901035,9901035,,7,0,7,7,0,7,0.000022,0,0,10144,28,0.000046,0,0,0,0,0.095238,0.00158
6076,6076,,2,5,7,2,5,7,0.000646,0.000188,0,12418,0,0.000011,14,0.1781,0.198075,0,0.452381,0.001026
6077,6077,,7,7,14,7,7,14,0.000182,0.000141,0,14276,25,0.000013,14,0.172459,0.190191,3828.767457,0.131868,0.001635
6078,6078,,2,9,11,2,9,11,0,0.00003,0,14285,26,0.000016,15,0.154858,0.171397,7630.392302,0.163636,0.000438
9706077,9706077,,3,9,12,3,9,12,0.000001,0.000014,0,14281,26,0.000014,9,0.200505,0.23885,778.364817,0.189394,0.000697
9811182,9811182,,4,10,14,4,10,14,0.000032,0.000013,0,14284,26,0.000014,10,0.18083,0.21539,6025.972354,0.071429,0.000923
9907071,9907071,,4,9,13,4,9,13,0.000027,0.00002,0,14282,26,0.000016,18,0.11659,0.133514,7840.667233,0.160256,0.000955
9505126,9505126,,3,1,4,3,1,4,0.000001,0,0,4437,26,0.000017,2,0.666667,0.75,761.453261,0.083333,0.000812
9509136,9509136,,10,9,19,10,9,19,0.000001,0.0001,0,7310,26,0.000033,8,0.225108,0.260086,13752.048622,0.067251,0.002536
9603177,9603177,,6,7,13,6,7,13,0.00004,0.000002,0,7938,26,0.000019,9,0.188586,0.217637,11064.164293,0.102564,0.001485
9207082,9207082,,5,0,5,5,0,5,0.000003,0,0,7309,26,0.000031,0,0,0,0,0.05,0.001198
9501050,9501050,,5,3,8,5,3,8,0.000136,0.000025,0,1782,26,0.000018,5,0.277174,0.34281,22785.855427,0.107143,0.001178
9509143,9509143,,8,14,22,8,14,22,0.000183,0.000083,0,11084,26,0.000018,8,0.232885,0.278534,5917.078868,0.123377,0.001866
9604032,9604032,,3,11,14,3,11,14,0.000001,0.000029,0,14280,26,0.000013,6,0.261649,0.389041,182.207901,0.06044,0.000678
9703107,9703107,,6,6,12,6,6,12,0.000019,0.000019,0,14279,26,0.000021,9,0.192231,0.223229,1144.498525,0.136364,0.001375
9601094,9601094,,5,4,9,5,4,9,0.000001,0.000013,0,7792,26,0.000023,7,0.22561,0.305309,4322.428555,0.097222,0.001207
9810029,9810029,,2,4,6,2,4,6,0,0.000011,0,14283,26,0.000013,9,0.195931,0.221848,1227.652819,0.166667,0.000472
9805088,9805088,,2,4,6,2,4,6,0,0.000011,0,14277,26,0.000016,17,0.123362,0.133227,7740.096887,0.066667,0.000465
6079,6079,,8,7,15,8,7,15,0.000069,0.00007,0,14286,15,0.000024,19,0.157217,0.170579,24168.112288,0.128571,0.001894
6080,6080,,1,3,4,1,3,4,0,0.000001,0,14287,23,0.000014,3,0.625,0.766667,1.5,0.333333,0.000219
6081,6081,,0,8,8,0,8,8,0,0.000004,0,14288,6,0.00001,14,0.12617,0.143815,0,0.089286,0
9401118,9401118,,4,3,7,4,3,7,0,0.000001,0,1187,6,0.000023,1,1,1,3494.307639,0.238095,0.001046
9302088,9302088,,4,1,5,4,1,5,0.000075,0,0,2349,6,0.000019,1,1,1,699.589087,0,0.000959
9312008,9312008,,6,0,6,6,0,6,0,0,0,2348,6,0.00003,0,0,0,0,0.1,0.00143
9406116,9406116,,3,1,4,3,1,4,0,0,0,2474,6,0.000018,2,0.666667,0.75,163.617032,0.166667,0.000725
9506067,9506067,,2,5,7,2,5,7,0,0.000003,0,13281,6,0.000011,7,0.246006,0.32415,39.419212,0.333333,0.000485
9708145,9708145,,2,5,7,2,5,7,0,0.000003,0,13278,6,0.000012,4,0.41791,0.505952,1.516831,0.309524,0.000511
9709078,9709078,,10,4,14,10,4,14,0.000004,0.000004,0,13280,6,0.000018,7,0.232759,0.292122,333.980416,0.17033,0.002466
6084,6084,,1,8,9,1,8,9,0.000007,0.000557,0,14290,1,0.000011,14,0.170215,0.188539,0,0.263889,0.000226
9810176,9810176,,8,5,13,8,5,13,0.000022,0.000064,0,14289,22,0.000021,12,0.172059,0.19174,5291.447031,0.057692,0.00184
6086,6086,,3,18,21,3,18,21,0.000124,0.00356,0,14291,4,0.000011,18,0.154921,0.173869,431.534983,0.335714,0.000716
6087,6087,,7,15,22,7,15,22,0.000184,0.003328,0,12942,30,0.000016,15,0.192242,0.212371,1088.200792,0.218615,0.002234
6088,6088,,2,36,38,2,36,38,0.000108,0.003177,0,14292,0,0.00001,13,0.210074,0.243601,701.003462,0.118065,0.000452
6089,6089,,3,2,5,3,2,5,0,0,0,14294,20,0.000021,2,0.75,0.833333,25.5,0.1,0.000677
9908003,9908003,,2,0,2,2,0,2,0,0,0,14293,20,0.000023,0,0,0,0,0.5,0.000465
9709138,9709138,,9,32,41,9,32,41,0.001014,0.008257,0,5366,4,0.000015,12,0.217352,0.251354,81995.00392,0.094512,0.002971
9811036,9811036,,3,25,28,3,25,28,0.000551,0.006618,0,8118,4,0.00001,12,0.210244,0.244132,16026.118855,0.174603,0.000775
6092,6092,,0,3,3,0,3,3,0,0,0,14296,22,0.00001,3,0.625,0.766667,0,0.333333,0
9610219,9610219,,1,1,2,1,1,2,0,0,0,14295,22,0.000013,3,0.5,0.583333,0,0.5,0.000219
9510085,9510085,,2,2,4,2,2,4,0,0,0,10397,22,0.000036,1,1,1,1314,0.333333,0.000471
6094,6094,,10,9,19,10,9,19,0.000016,0.000146,0,12973,52,0.000021,13,0.171919,0.188736,8736.747128,0.125731,0.002637
9510095,9510095,,6,10,16,6,10,16,0,0.000003,0,7812,6,0.00002,6,0.332226,0.4185,9200.540444,0.104167,0.001441
6095,6095,,1,6,7,1,6,7,0.000003,0.000248,0,14297,0,0.000011,14,0.179246,0.200107,0,0.47619,0.000219
6096,6096,,2,7,9,2,7,9,0.000074,0.002684,0,14300,30,0.000015,14,0.176247,0.191735,2772.031463,0.166667,0.000805
9407093,9407093,,2,0,2,2,0,2,0.000045,0,0,14298,30,0.000017,0,0,0,0,0.5,0.00048
9912265,9912265,,3,4,7,3,4,7,0.000097,0.001108,0,14299,30,0.000022,13,0.189423,0.206124,11579.583378,0.119048,0.00095
10187,10187,,16,10,26,16,10,26,0.000225,0.00006,0,14309,30,0.000018,14,0.180849,0.195345,13197.923997,0.133846,0.004319
6216,6216,,22,12,34,22,12,34,0.000339,0.000112,0,14308,30,0.000025,15,0.14694,0.168329,1534.269408,0.191622,0.005626
7030,7030,,22,10,32,22,10,32,0.00043,0.000093,0,14307,30,0.000023,15,0.146083,0.166124,1913.771193,0.204637,0.005995
8010,8010,,15,5,20,15,5,20,0.00025,0.000797,0,14306,30,0.000027,13,0.185285,0.200905,6172.968745,0.084211,0.003695
10165,10165,,14,23,37,14,23,37,0.000642,0.005584,0,14305,2,0.000017,13,0.217961,0.24338,26173.742455,0.12012,0.003902
9911087,9911087,,26,11,37,26,11,37,0.000414,0.000107,0,14301,30,0.00003,15,0.146903,0.168083,2271.45347,0.187688,0.007119
6097,6097,,1,3,4,1,3,4,0,0.000003,0,14311,23,0.000013,16,0.120139,0.131979,5655,0.083333,0.000219
9708030,9708030,,19,1,20,19,1,20,0.00019,0.000056,0,14310,23,0.000078,2,0.6,0.666667,29.5,0.184211,0.004737
9802084,9802084,,2,8,10,2,8,10,0.000001,0.000029,0,11419,23,0.000016,7,0.225657,0.280088,3049.807322,0.177778,0.000539
9707245,9707245,,8,14,22,8,14,22,0.000019,0.00008,0,12679,23,0.000018,14,0.151502,0.172317,4083.039639,0.134199,0.002045
9710144,9710144,,7,7,14,7,7,14,0.000022,0.000075,0,12680,23,0.000018,14,0.151475,0.170692,4767.721708,0.21978,0.001678
9804042,9804042,,2,9,11,2,9,11,0.000014,0.000083,0,12681,23,0.000011,15,0.132201,0.147215,454.752695,0.290909,0.000528
6098,6098,,9,14,23,9,14,23,0.001375,0.000755,0,14312,1,0.000014,12,0.193785,0.213988,1584.641215,0.179842,0.003217
6099,6099,,4,5,9,4,5,9,0.000001,0.000001,0,14313,20,0.000012,8,0.221244,0.261032,104.934882,0.166667,0.000943
6100,6100,,24,40,64,24,40,64,0.001227,0.004077,0,12966,52,0.000018,11,0.217241,0.24681,40607.126131,0.11756,0.007209
9902119,9902119,,1,23,24,1,23,24,0.000027,0.001818,0,9387,4,0.00001,12,0.205958,0.240142,13781.952619,0.190217,0.000298
6101,6101,,1,18,19,1,18,19,0.000016,0.000976,0,14319,0,0.000011,14,0.178189,0.20174,5696.609527,0.111111,0.000295
9909198,9909198,,3,17,20,3,17,20,0.000043,0.001368,0,14318,0,0.000011,13,0.165316,0.188739,3643.66671,0.134211,0.000672
9305064,9305064,,4,1,5,4,1,5,0.000055,0.000041,0,517,13,0.000042,2,0.571429,0.625,143.839327,0.05,0.001252
9503113,9503113,,5,3,8,5,3,8,0.000376,0.000011,0,14317,0,0.000012,5,0.304878,0.379333,1286.428618,0.035714,0.00141
9808142,9808142,,2,3,5,2,3,5,0.000018,0.000033,0,14315,0,0.000011,13,0.163925,0.179911,1123.218583,0.15,0.000465
6103,6103,,15,57,72,15,57,72,0.003667,0.022955,0,14320,1,0.000013,13,0.206797,0.236653,25422.705918,0.155712,0.004646
6105,6105,,1,4,5,1,4,5,0,0.000024,0,14323,8,0.000013,14,0.1587,0.171288,2,0.15,0.000219
9303010,9303010,,2,0,2,2,0,2,0,0,0,14321,8,0.000024,0,0,0,0,0.5,0.000451
9409087,9409087,,1,1,2,1,1,2,0,0,0,14322,8,0.000013,1,1,1,0,0.5,0.000226
6106,6106,,7,13,20,7,13,20,0.000032,0.000038,0,14326,22,0.000018,14,0.177637,0.193268,36674.653074,0.121053,0.001712
9612037,9612037,,2,0,2,2,0,2,0.000001,0,0,14325,22,0.000012,0,0,0,0,0.5,0.000512
9612038,9612038,,1,0,1,1,0,1,0,0,0,14324,22,0.000011,0,0,0,0,0,0.000267
6107,6107,,15,14,29,15,14,29,0.001974,0.017351,0,14327,1,0.000019,17,0.221882,0.254346,34528.725931,0.12931,0.004068
6108,6108,,5,18,23,5,18,23,0.000124,0.003058,0,14328,3,0.000013,15,0.202913,0.226187,86615.014524,0.094862,0.001313
9509147,9509147,,4,1,5,4,1,5,0.000014,0.000001,0,4425,0,0.000032,3,0.454545,0.533333,105.060686,0.3,0.001029
9905001,9905001,,3,10,13,3,10,13,0.000014,0.000006,0,9072,22,0.000014,15,0.121869,0.13952,2978.079659,0.205128,0.000682
9912063,9912063,,2,14,16,2,14,16,0.000267,0.000554,0,12318,5,0.000011,14,0.155581,0.17338,40422.604437,0.083333,0.000449
9406188,9406188,,4,0,4,4,0,4,0,0,0,6861,22,0.00002,0,0,0,0,0.5,0.000985
9603062,9603062,,10,3,13,10,3,13,0.000209,0,0,4641,22,0.000043,1,1,1,27610.391248,0.217949,0.002737
9603159,9603159,,10,3,13,10,3,13,0.000005,0.000003,0,6859,22,0.000035,2,0.8,0.875,73.979978,0.24359,0.002409
9606174,9606174,,9,7,16,9,7,16,0.000006,0.000003,0,6862,22,0.000032,1,1,1,22490.589755,0.179167,0.002169
9702171,9702171,,4,5,9,4,5,9,0,0.000004,0,8420,22,0.00002,2,0.666667,0.75,1937.772219,0.319444,0.000984
9708138,9708138,,8,4,12,8,4,12,0.000078,0.000005,0,8421,22,0.000024,14,0.138086,0.158131,13009.351899,0.151515,0.001937
9805090,9805090,,5,7,12,5,7,12,0.000067,0.000003,0,8423,22,0.000018,15,0.121763,0.138081,21489.92289,0.242424,0.001158
9608124,9608124,,8,1,9,8,1,9,0.000261,0.000588,0,12308,5,0.000038,6,0.27907,0.307639,2035.167452,0.111111,0.001853
9707181,9707181,,5,3,8,5,3,8,0.00063,0.000494,0,8216,5,0.000014,3,0.470588,0.604167,1280.576348,0.089286,0.001246
9805009,9805009,,8,5,13,8,5,13,0.000011,0.000006,0,12311,9,0.000021,7,0.227984,0.258706,14162.399083,0.160256,0.001875
9807042,9807042,,2,7,9,2,7,9,0.000007,0.000652,0,12316,5,0.000015,13,0.173706,0.192084,13140.039335,0.069444,0.000464
9911012,9911012,,2,1,3,2,1,3,0.00026,0.000003,0,12315,5,0.000011,7,0.218971,0.234003,0,0.5,0.000451
9911013,9911013,,2,8,10,2,8,10,0.000007,0.000107,0,12314,5,0.000013,19,0.145386,0.168629,10317.496831,0.044444,0.000458
6111,6111,,1,25,26,1,25,26,0,0.000009,0,14329,17,0.00001,12,0.152697,0.198136,1549.15982,0.355385,0.000234
6113,6113,,8,26,34,8,26,34,0.000571,0.0035,0,14331,4,0.000012,14,0.198929,0.228819,1290.424566,0.27451,0.002189
9901120,9901120,,7,42,49,7,42,49,0.000481,0.003862,0,10890,4,0.000012,14,0.200824,0.23467,2182.961617,0.201956,0.002135
9911115,9911115,,14,41,55,14,41,55,0.001259,0.004438,0,14330,4,0.000014,14,0.202713,0.235894,19767.674577,0.225589,0.004215
11227,11227,,2,22,24,2,22,24,0.000433,0.002703,0,14335,4,0.00001,20,0.173792,0.210479,38381.893093,0.28442,0.000933
10061,10061,,2,29,31,2,29,31,0.00008,0.003568,0,14334,4,0.00001,19,0.179201,0.214469,6097.560337,0.267742,0.000465
9806144,9806144,,16,59,75,16,59,75,0.001226,0.007895,0,10884,4,0.000015,12,0.211437,0.250449,14949.127481,0.198739,0.004447
9901124,9901124,,14,13,27,14,13,27,0.001227,0.00289,0,10885,4,0.000013,13,0.182062,0.208406,498.347042,0.337607,0.004017
9904078,9904078,,14,58,72,14,58,72,0.001161,0.007876,0,10886,4,0.000014,12,0.211781,0.25087,9857.47338,0.21518,0.003754
6114,6114,,20,20,40,20,20,40,0.000491,0.003065,0,13031,30,0.000029,13,0.190879,0.211596,107260.428657,0.170513,0.006593
6116,6116,,1,7,8,1,7,8,0,0.000022,0,14337,26,0.000011,20,0.153996,0.169204,343.114212,0.089286,0.000219
9811241,9811241,,5,0,5,5,0,5,0,0,0,14336,26,0.000028,0,0,0,0,0.15,0.001141
6117,6117,,23,20,43,23,20,43,0.002342,0.001579,0,14338,52,0.00002,17,0.20748,0.233022,12899.056973,0.112957,0.006381
6118,6118,,1,6,7,1,6,7,0,0.000004,0,14339,22,0.000011,14,0.126662,0.133825,5522.55875,0.166667,0.000226
9407130,9407130,,8,3,11,8,3,11,0.000001,0.000009,0,4281,22,0.000033,1,1,1,4537.156007,0.245455,0.002047
9304022,9304022,,2,0,2,2,0,2,0,0,0,4154,22,0.000053,0,0,0,0,0.5,0.00056
6119,6119,,38,16,54,38,16,54,0.00197,0.002477,0,12899,30,0.000041,15,0.195535,0.216328,42695.778264,0.118798,0.015354
9905054,9905054,,8,4,12,8,4,12,0.000318,0.000176,0,12887,9,0.000027,13,0.171485,0.188185,20125.670442,0.037879,0.002413
9307065,9307065,,1,6,7,1,6,7,0,0.00001,0,3017,17,0.000013,1,1,1,18373.387528,0.071429,0.000283
9504013,9504013,,8,3,11,8,3,11,0.000005,0.000062,0,2995,26,0.000024,7,0.255507,0.295854,6630.202539,0.218182,0.001973
6120,6120,,13,21,34,13,21,34,0.000525,0.00242,0,14341,30,0.000017,15,0.197343,0.220479,31727.817258,0.127451,0.003621
9904150,9904150,,3,38,41,3,38,41,0.000099,0.015395,0,14340,2,0.000011,13,0.202291,0.237722,10430.546897,0.073171,0.000759
9209011,9209011,,9,4,13,9,4,13,0.000203,0.000024,0,962,9,0.000023,1,1,1,626.696684,0.108974,0.002336
9404010,9404010,,5,5,10,5,5,10,0.000008,0.000082,0,333,9,0.00009,1,1,1,8160.00858,0.155556,0.001414
6121,6121,,7,18,25,7,18,25,0,0.000007,0,14342,5,0.000017,16,0.124649,0.141613,15267.136569,0.168333,0.001627
9173,9173,,6,13,19,6,13,19,0.000015,0.000005,0,14343,5,0.000024,15,0.137423,0.148649,66770.711005,0.154971,0.001442
10140,10140,,0,1,1,0,1,1,0,0,0,14344,5,0.00001,16,0.120837,0.127808,0,0,0
12241,12241,,1,7,8,1,7,8,0,0.000001,0,14346,5,0.000011,16,0.116097,0.1273,2.176838,0.232143,0.000219
10214,10214,,8,7,15,8,7,15,0.000015,0,0,14345,5,0.00002,15,0.118478,0.128962,24139.152442,0.128571,0.001873
101062,101062,,3,3,6,3,3,6,0,0,0,14347,5,0.000013,16,0.106076,0.113748,1.5,0.266667,0.000677
6122,6122,,5,32,37,5,32,37,0.00042,0.005871,0,14348,3,0.000012,13,0.215866,0.242874,5169.654689,0.123123,0.001478
6123,6123,,2,5,7,2,5,7,0,0.000003,0,14349,28,0.000014,12,0.148574,0.173904,1887.974281,0.142857,0.000485
6124,6124,,0,1,1,0,1,1,0,0.000001,0,14354,23,0.00001,15,0.14824,0.15778,0,0,0
9902154,9902154,,2,9,11,2,9,11,0.000068,0.00007,0,14353,23,0.00002,14,0.174011,0.190404,6295.314537,0.090909,0.000438
9309049,9309049,,2,2,4,2,2,4,0.000001,0.000003,0,14351,23,0.000014,1,1,1,5.733333,0.166667,0.000464
9804186,9804186,,2,6,8,2,6,8,0.000068,0.000005,0,14352,23,0.000013,14,0.164572,0.191203,1100.178137,0.125,0.000451
6126,6126,,0,4,4,0,4,4,0,0.000626,0,14355,1,0.00001,12,0.173943,0.191534,0,0.166667,0
6128,6128,,0,1,1,0,1,1,0,0,0,14356,22,0.00001,3,0.461538,0.527778,0,0,0
9310096,9310096,,7,0,7,7,0,7,0.000001,0,0,4378,22,0.00007,0,0,0,0,0.071429,0.001802
6131,6131,,0,4,4,0,4,4,0,0.000023,0,14357,23,0.00001,12,0.167138,0.183123,0,0,0
6132,6132,,16,8,24,16,8,24,0.002626,0.005021,0,14358,1,0.000023,11,0.22946,0.257472,61926.037811,0.061594,0.004761
6134,6134,,4,15,19,4,15,19,0.000094,0.007631,0,14359,25,0.000011,17,0.199807,0.222685,1508.137095,0.157895,0.000995
6135,6135,,2,3,5,2,3,5,0.000017,0.000711,0,14360,1,0.000013,15,0.163315,0.178962,4171.880712,0.1,0.000453
6136,6136,,0,4,4,0,4,4,0,0.000201,0,14361,2,0.00001,15,0.156447,0.174637,0,0.416667,0
6137,6137,,15,28,43,15,28,43,0.000857,0.005075,0,14363,41,0.00002,11,0.201088,0.225772,18469.536807,0.119601,0.003774
9910146,9910146,,6,38,44,6,38,44,0.001013,0.024045,0,14362,8,0.000015,11,0.233926,0.266444,60610.249943,0.115222,0.002292
9903192,9903192,,5,2,7,5,2,7,0.000005,0.000024,0,9378,15,0.000019,14,0.140859,0.155141,359.279746,0.166667,0.001197
6138,6138,,1,3,4,1,3,4,0,0,0,14364,5,0.00001,11,0.140505,0.173345,0,0.333333,0.000232
9503181,9503181,,8,2,10,8,2,10,0.000008,0,0,10617,17,0.000031,1,1,1,75.651153,0.155556,0.00188
6140,6140,,4,38,42,4,38,42,0.000971,0.02501,0,14373,1,0.000011,16,0.229461,0.264289,12276.322823,0.181185,0.001011
9912133,9912133,,9,82,91,9,82,91,0.001171,0.0089,0,14372,4,0.000013,13,0.209958,0.251047,41651.65662,0.155922,0.002472
9712011,9712011,,9,29,38,9,29,38,0.000672,0.006031,0,9554,4,0.000012,15,0.202897,0.238766,1923.61133,0.208393,0.002537
9910015,9910015,,4,18,22,4,18,22,0.000349,0.003768,0,14368,4,0.000011,17,0.169675,0.201147,8138.457624,0.201299,0.001057
9911022,9911022,,4,106,110,4,106,110,0.000502,0.00962,0,14371,4,0.000011,13,0.215763,0.260221,31711.415002,0.149458,0.001195
9912011,9912011,,3,21,24,3,21,24,0.000221,0.001718,0,14365,4,0.00001,12,0.188482,0.213805,32.718056,0.300725,0.000742
6141,6141,,3,54,57,3,54,57,0.000151,0.004793,0,14374,4,0.000011,14,0.195118,0.229327,609.844128,0.192982,0.000677
9908143,9908143,,5,10,15,5,10,15,0.000593,0.002345,0,14369,4,0.000011,13,0.189302,0.2169,149.738929,0.22381,0.001393
9507111,9507111,,4,1,5,4,1,5,0.000066,0,0,3071,22,0.000027,1,1,1,6146.001922,0.2,0.001434
9511101,9511101,,10,6,16,10,6,16,0.000119,0.000003,0,3109,20,0.000039,1,1,1,38838.717861,0.133333,0.003448
9609175,9609175,,3,6,9,3,6,9,0.000115,0.000171,0,3473,26,0.000012,3,0.692308,0.814815,30282.33053,0.083333,0.001471
9601170,9601170,,3,10,13,3,10,13,0.000123,0.000007,0,4009,6,0.000013,16,0.156427,0.181792,111909.843362,0.076923,0.001074
9802004,9802004,,4,50,54,4,50,54,0.000152,0.005472,0,9553,4,0.000011,12,0.205073,0.240836,2640.589454,0.237596,0.001027
9710068,9710068,,7,24,31,7,24,31,0.000392,0.003348,0,5972,4,0.000011,13,0.188049,0.219187,707.289681,0.345161,0.00189
9903182,9903182,,1,62,63,1,62,63,0.000068,0.004292,0,10908,4,0.00001,15,0.178184,0.212529,36994.910253,0.18894,0.000263
9806234,9806234,,5,6,11,5,6,11,0.000384,0.001644,0,14366,4,0.000012,14,0.165793,0.188975,22.805417,0.272727,0.001226
9806246,9806246,,4,15,19,4,15,19,0.000554,0.002188,0,14367,4,0.000011,13,0.178038,0.205459,398.970959,0.195906,0.000985
9712025,9712025,,10,32,42,10,32,42,0.000565,0.003263,0,5967,4,0.000012,13,0.182818,0.217952,13776.282552,0.181185,0.002883
9905126,9905126,,5,25,30,5,25,30,0.000318,0.002292,0,14370,4,0.000011,14,0.181804,0.211615,3537.535095,0.167816,0.001522
6143,6143,,1,3,4,1,3,4,0,0.00001,0,14375,23,0.000011,18,0.137419,0.157534,0,0.416667,0.000219
6144,6144,,11,7,18,11,7,18,0.000185,0.000095,0,14377,1,0.000035,13,0.172943,0.185141,24238.863863,0.120915,0.003114
3011,3011,,9,0,9,9,0,9,0.000017,0,0,14376,1,0.000042,0,0,0,0,0.138889,0.002396
9210114,9210114,,2,0,2,2,0,2,0.000001,0,0,626,0,0.000063,0,0,0,0,0,0.00066
6145,6145,,36,11,47,36,11,47,0.001871,0.000374,0,14378,52,0.000029,17,0.196219,0.215878,7839.348997,0.159574,0.010063
6147,6147,,7,2,9,7,2,9,0.000001,0.000002,0,14379,23,0.000025,18,0.109935,0.12668,3080.820093,0.152778,0.001619
6148,6148,,5,5,10,5,5,10,0.000035,0.000018,0,14384,23,0.000019,13,0.152556,0.167011,423.958937,0.244444,0.001263
9909037,9909037,,8,5,13,8,5,13,0.000001,0.00002,0,14383,23,0.000032,13,0.166056,0.180524,38570.915972,0.153846,0.001955
9901096,9901096,,5,10,15,5,10,15,0.000001,0.000005,0,14382,23,0.000024,14,0.134673,0.149476,11078.392789,0.171429,0.001177
6149,6149,,1,6,7,1,6,7,0.000003,0.000248,0,14385,0,0.000011,14,0.179246,0.200107,0,0.47619,0.000219
6150,6150,,1,4,5,1,4,5,0,0,0,14387,21,0.000014,13,0.125199,0.145224,850,0.05,0.000219
9601111,9601111,,6,3,9,6,3,9,0.000001,0.000007,0,8460,6,0.000022,3,0.5625,0.648148,31,0.263889,0.001381
9809025,9809025,,1,4,5,1,4,5,0,0.000001,0,14386,26,0.000013,12,0.139631,0.15999,1674,0.2,0.000226
9407160,9407160,,3,1,4,3,1,4,0.000004,0.000001,0,7130,21,0.00002,1,1,1,7969.818548,0.083333,0.000737
9412174,9412174,,3,5,8,3,5,8,0.000001,0.000001,0,7128,21,0.000017,2,0.857143,0.916667,247.581416,0.178571,0.000705
9502145,9502145,,7,0,7,7,0,7,0.000001,0,0,8280,6,0.000036,0,0,0,0,0.333333,0.001675
9511118,9511118,,6,2,8,6,2,8,0.000057,0.000006,0,8281,6,0.000023,3,0.533333,0.604167,1417.010036,0.267857,0.001459
6151,6151,,13,15,28,13,15,28,0.000455,0.000298,0,12974,52,0.000021,13,0.183365,0.20633,27149.620174,0.082011,0.003437
9610058,9610058,,5,1,6,5,1,6,0.000035,0.000005,0,9927,52,0.000017,4,0.375,0.416667,84.293556,0.2,0.001323
9707034,9707034,,2,7,9,2,7,9,0.000005,0.000033,0,12972,52,0.000012,6,0.361257,0.428019,4572.891568,0.138889,0.000551
9611200,9611200,,2,0,2,2,0,2,0.000001,0,0,12971,52,0.000012,0,0,0,0,0.5,0.000473
6152,6152,,1,8,9,1,8,9,0.000001,0.000047,0,14388,23,0.00001,16,0.16377,0.188189,1704.32482,0.277778,0.000219
9807064,9807064,,17,9,26,17,9,26,0.000703,0.00034,0,12844,3,0.000024,14,0.187892,0.211342,63059.217842,0.116923,0.007185
6153,6153,,4,3,7,4,3,7,0,0,0,14389,20,0.000017,4,0.4,0.541667,0,0.452381,0.000903
9907044,9907044,,7,0,7,7,0,7,0,0,0,11305,20,0.000041,0,0,0,0,0.452381,0.001675
9907168,9907168,,7,2,9,7,2,9,0,0,0,11306,20,0.000031,1,1,1,3,0.305556,0.001628
6154,6154,,5,4,9,5,4,9,0.000026,0,0,14395,22,0.000018,7,0.215097,0.237016,2611.500329,0.111111,0.00125
9701007,9701007,,1,3,4,1,3,4,0,0.000002,0,14394,23,0.000014,8,0.25079,0.279277,1491.494279,0.083333,0.000254
9805095,9805095,,4,2,6,4,2,6,0,0,0,14392,22,0.000036,1,1,1,250.65,0.233333,0.000992
9912169,9912169,,9,2,11,9,2,11,0.000001,0,0,14393,22,0.000042,2,0.75,0.833333,195.683333,0.154545,0.002187
9702023,9702023,,4,0,4,4,0,4,0,0,0,14391,22,0.000056,0,0,0,0,0.333333,0.000972
9707154,9707154,,1,0,1,1,0,1,0,0,0,14390,22,0.000026,0,0,0,0,0,0.000247
6155,6155,,0,1,1,0,1,1,0,0,4,14396,16,0.00001,2,0.571429,0.625,0,0,0
6156,6156,,6,14,20,6,14,20,0.000323,0.000022,0,14398,6,0.000018,17,0.153596,0.166457,25614.663864,0.065789,0.001778
9308125,9308125,,9,0,9,9,0,9,0.000007,0,0,7847,22,0.000073,0,0,0,0,0.208333,0.002264
9509026,9509026,,10,6,16,10,6,16,0.000005,0.00011,0,13237,22,0.000021,4,0.352941,0.432099,870.977606,0.116667,0.002389
9701039,9701039,,1,0,1,1,0,1,0,0,0,14397,6,0.000011,0,0,0,0,0,0.000264
9408041,9408041,,6,1,7,6,1,7,0,0.000002,0,2473,6,0.000033,2,0.666667,0.75,216.839788,0.071429,0.001494
9212076,9212076,,2,3,5,2,3,5,0.000001,0.000004,0,2481,4,0.000021,1,1,1,13138.824308,0.1,0.000572
9406183,9406183,,3,5,8,3,5,8,0,0.000001,0,2476,6,0.00003,2,0.857143,0.916667,26807.543252,0.017857,0.000784
9403013,9403013,,6,1,7,6,1,7,0.000006,0,0,7848,22,0.000034,1,1,1,0,0.333333,0.001499
6157,6157,,2,1,3,2,1,3,0,0,0,14399,23,0.000014,2,0.666667,0.75,0,0.5,0.000451
6158,6158,,9,12,21,9,12,21,0.000503,0.002045,0,12375,25,0.000015,18,0.187229,0.207918,5797.411306,0.178571,0.002752
6159,6159,,0,7,7,0,7,7,0,0.000498,0,14400,0,0.00001,13,0.19102,0.2127,0,0.190476,0
6160,6160,,25,35,60,25,35,60,0.000925,0.004436,0,13067,30,0.000031,13,0.205877,0.230079,89242.763698,0.126836,0.008146
6161,6161,,1,6,7,1,6,7,0,0.000005,0,14401,23,0.000012,12,0.176278,0.19558,2565.545722,0.119048,0.000259
6162,6162,,2,6,8,2,6,8,0.000011,0.000004,0,14409,22,0.000012,12,0.185616,0.20131,3984.592825,0.196429,0.000445
9509135,9509135,,6,7,13,6,7,13,0.000002,0.000003,0,11538,22,0.000018,5,0.395349,0.501961,493.49528,0.166667,0.001388
9604031,9604031,,12,1,13,12,1,13,0.000006,0,0,7566,22,0.000038,2,0.666667,0.75,34.28837,0.134615,0.002843
9612063,9612063,,9,6,15,9,6,15,0.000036,0.000001,0,14403,22,0.000021,9,0.194805,0.227643,2503.401934,0.138095,0.002099
9707150,9707150,,5,11,16,5,11,16,0.000036,0.000001,0,14407,22,0.000015,10,0.171203,0.211701,565.442845,0.154167,0.001169
9906197,9906197,,5,14,19,5,14,19,0.00006,0.002591,0,14408,1,0.000014,11,0.227103,0.256682,43385.591438,0.125731,0.001188
9402129,9402129,,7,3,10,7,3,10,0.000001,0,0,3745,22,0.000024,2,0.636364,0.714286,449.699167,0.166667,0.001702
9404146,9404146,,3,4,7,3,4,7,0.000001,0.000003,0,11536,22,0.000015,4,0.481481,0.596154,3.666667,0.380952,0.000738
9510141,9510141,,17,4,21,17,4,21,0.000009,0.000001,0,4377,22,0.000044,2,0.75,0.833333,729.891042,0.092857,0.004049
9603101,9603101,,6,12,18,6,12,18,0.000045,0.000245,0,4387,22,0.000018,8,0.233056,0.279519,31446.495273,0.075163,0.001468
9603128,9603128,,4,8,12,4,8,12,0.000006,0.000001,0,4389,22,0.000015,9,0.192661,0.226693,63561.753912,0.166667,0.000984
9506099,9506099,,11,2,13,11,2,13,0.000007,0,0,4382,22,0.000035,1,1,1,5230.329572,0.147436,0.002606
9507015,9507015,,17,3,20,17,3,20,0.000005,0,0,4380,22,0.000049,1,1,1,7423.243652,0.097368,0.003989
9603122,9603122,,2,5,7,2,5,7,0,0.000001,0,12433,22,0.000012,7,0.301887,0.424256,3.5,0.357143,0.000478
9703193,9703193,,3,7,10,3,7,10,0,0.000001,0,14406,22,0.000014,10,0.165041,0.193636,99.833333,0.177778,0.000697
9711187,9711187,,1,0,1,1,0,1,0.00003,0,0,14402,1,0.000011,0,0,0,0,0,0.000253
9802024,9802024,,3,1,4,3,1,4,0.000031,0,0,7567,26,0.000013,3,0.5,0.611111,5.457576,0.25,0.000737
6163,6163,,3,17,20,3,17,20,0.000015,0.000015,0,14412,28,0.000013,12,0.188738,0.206358,5150.526908,0.076316,0.000671
9204075,9204075,,3,0,3,3,0,3,0,0,0,4738,23,0.000113,0,0,0,0,0,0.000782
9802101,9802101,,6,5,11,6,5,11,0.000001,0.000003,0,10057,28,0.000015,4,0.52,0.647436,135.628332,0.218182,0.0014
9812041,9812041,,1,15,16,1,15,16,0,0.000017,0,14411,28,0.000011,11,0.158809,0.202722,187.226433,0.133333,0.000239
9407188,9407188,,2,1,3,2,1,3,0,0,0,3615,28,0.000021,1,1,1,0,0.333333,0.000597
9408148,9408148,,3,1,4,3,1,4,0,0,0,3614,28,0.000029,1,1,1,0,0.333333,0.000873
9411201,9411201,,13,3,16,13,3,16,0.000001,0.000001,0,4753,23,0.000043,2,0.714286,0.8,346.523283,0.175,0.003204
9502070,9502070,,13,7,20,13,7,20,0.000001,0,0,4759,23,0.000041,2,0.684211,0.769231,35614.7594,0.136842,0.003129
9611198,9611198,,5,3,8,5,3,8,0,0,0,9140,23,0.000019,3,0.482759,0.559524,2.174242,0.321429,0.001143
9701100,9701100,,3,8,11,3,8,11,0,0.000001,0,14410,28,0.000013,4,0.469388,0.601449,46.083333,0.3,0.000664
9708027,9708027,,2,2,4,2,2,4,0,0.000158,0,10084,20,0.000014,10,0.175798,0.210023,1004.328334,0.166667,0.000465
6165,6165,,4,17,21,4,17,21,0.001143,0.013935,0,14413,1,0.000011,12,0.223619,0.254033,7522.532791,0.242857,0.001468
6166,6166,,1,11,12,1,11,12,0.000064,0.00002,0,14415,15,0.00001,15,0.156437,0.176787,70.709637,0.075758,0.000226
9312170,9312170,,6,5,11,6,5,11,0.000002,0.000008,0,5443,15,0.000023,1,1,1,684.541197,0.163636,0.001491
9409058,9409058,,4,3,7,4,3,7,0.000001,0.000005,0,14414,15,0.000015,2,0.666667,0.75,4.25119,0.238095,0.000916
9208008,9208008,,10,0,10,10,0,10,0.000002,0,0,4655,15,0.000048,0,0,0,0,0.011111,0.002308
9212065,9212065,,9,0,9,9,0,9,0.000022,0,0,6184,15,0.00012,0,0,0,0,0.125,0.002437
9310173,9310173,,5,0,5,5,0,5,0.000015,0,0,3090,15,0.000083,0,0,0,0,0.1,0.001538
6167,6167,,1,11,12,1,11,12,0.000001,0.000039,0,14416,15,0.000011,15,0.15631,0.176993,125.858365,0.075758,0.000226
6168,6168,,18,15,33,18,15,33,0.002245,0.017952,0,12985,52,0.000018,16,0.216192,0.24203,11349.689246,0.149621,0.004963
6169,6169,,3,8,11,3,8,11,0.000075,0.00198,0,14419,30,0.000015,13,0.192873,0.210478,1444.379786,0.136364,0.000671
9904001,9904001,,4,3,7,4,3,7,0.000105,0.000774,0,14418,30,0.000016,16,0.163278,0.1817,408.329946,0.142857,0.000909
9511039,9511039,,4,3,7,4,3,7,0,0.000008,0,9158,9,0.000045,2,0.666667,0.75,329.390854,0.190476,0.000998
9703067,9703067,,2,1,3,2,1,3,0.000051,0.00013,0,14417,0,0.000016,12,0.194594,0.214394,798.751965,0.166667,0.000471
6170,6170,,2,8,10,2,8,10,0,0.000008,0,14420,20,0.000011,13,0.164537,0.177851,2816.132305,0.288889,0.000465
6172,6172,,2,21,23,2,21,23,0.00007,0.002647,0,14421,0,0.000011,13,0.189687,0.214381,145.949809,0.243083,0.000478
6173,6173,,0,11,11,0,11,11,0,0.00006,0,14422,23,0.00001,15,0.165375,0.187882,0,0.027273,0
9409081,9409081,,1,10,11,1,10,11,0,0.000008,0,12525,23,0.00001,2,0.75,0.833333,1095.115018,0.181818,0.000266
9511056,9511056,,2,12,14,2,12,14,0.000008,0.000275,0,3283,13,0.000013,9,0.220271,0.269378,2518.293181,0.153846,0.000569
9610220,9610220,,2,18,20,2,18,20,0.000001,0.000021,0,12522,23,0.000011,11,0.18947,0.222775,874.273909,0.144737,0.000491
9611113,9611113,,1,2,3,1,2,3,0,0.000003,0,12521,23,0.00001,7,0.233607,0.257828,67.025984,0.166667,0.000266
6175,6175,,0,11,11,0,11,11,0,0.000001,0,14425,23,0.00001,4,0.47541,0.614943,0,0.254545,0
9608178,9608178,,1,1,2,1,1,2,0,0,0,14424,23,0.000011,1,1,1,1,0,0.000219
9912282,9912282,,1,3,4,1,3,4,0,0.00002,0,14423,23,0.000011,3,0.517241,0.577778,15,0,0.000219
6176,6176,,10,50,60,10,50,60,0.001606,0.015799,0,14426,1,0.000013,12,0.234753,0.2711,26624.261498,0.091525,0.002832
6177,6177,,1,2,3,1,2,3,0,0.000002,0,14427,23,0.000011,14,0.163008,0.173644,8327.836893,0,0.000219
6178,6178,,1,2,3,1,2,3,0,0.000001,0,14432,4,0.000013,14,0.140424,0.154196,1437.076858,0.166667,0.000226
9803159,9803159,,1,2,3,1,2,3,0,0,0,14431,4,0.000016,13,0.161308,0.181462,4129.18104,0.166667,0.000226
9904102,9904102,,7,6,13,7,6,13,0.000087,0.000011,0,14429,4,0.000021,12,0.182578,0.212183,3190.040079,0.115385,0.001608
9712171,9712171,,2,28,30,2,28,30,0.000001,0.002285,0,14430,4,0.000018,12,0.190219,0.225992,7379.26941,0.082759,0.000465
9703069,9703069,,2,3,5,2,3,5,0.000009,0.000064,0,14428,4,0.000015,12,0.176685,0.202517,88.350586,0.1,0.000485
6180,6180,,3,10,13,3,10,13,0.000001,0.000014,0,14435,20,0.000014,18,0.121466,0.138844,177.320868,0.282051,0.000677
9912262,9912262,,5,10,15,5,10,15,0.000013,0.000008,0,14434,20,0.000015,17,0.134598,0.151173,5284.112924,0.266667,0.001135
9905142,9905142,,1,20,21,1,20,21,0,0.000899,0,14433,20,0.000011,16,0.153958,0.176492,9080.196886,0.166667,0.000252
6181,6181,,12,14,26,12,14,26,0.000645,0.000189,0,12970,52,0.000023,15,0.170961,0.189438,43660.143639,0.090769,0.003316
9803057,9803057,,1,9,10,1,9,10,0.000002,0.000001,0,12968,52,0.000011,8,0.27027,0.349069,14078.089576,0.1,0.000306
9308145,9308145,,4,0,4,4,0,4,0,0,0,1378,52,0.000207,0,0,0,0,0.083333,0.001051
9407079,9407079,,7,0,7,7,0,7,0,0,0,2051,52,0.000037,0,0,0,0,0.119048,0.00165
9512100,9512100,,4,0,4,4,0,4,0,0,0,6333,52,0.000031,0,0,0,0,0.333333,0.000974
9705019,9705019,,2,4,6,2,4,6,0,0.000002,0,9045,52,0.000022,4,0.411765,0.5,6340.658291,0.133333,0.000487
6182,6182,,0,4,4,0,4,4,0,0.000018,0,14436,23,0.00001,14,0.146536,0.158772,0,0.5,0
6183,6183,,2,11,13,2,11,13,0.000001,0.000025,0,14437,20,0.000011,12,0.191785,0.21001,12316.726613,0.217949,0.000458
6184,6184,,1,3,4,1,3,4,0.000055,0.00114,0,14438,25,0.00001,12,0.187061,0.202548,0,0.333333,0.000232
6185,6185,,1,18,19,1,18,19,0.000024,0.015247,0,14441,2,0.00001,13,0.196626,0.221892,164.405796,0.175439,0.000219
9907048,9907048,,2,3,5,2,3,5,0.000179,0.000004,0,14440,26,0.000015,14,0.161458,0.176336,53204.432697,0.05,0.000485
9905084,9905084,,6,1,7,6,1,7,0,0.000002,0,14439,26,0.000028,17,0.14389,0.157587,17714.019831,0.02381,0.001361
6186,6186,,4,17,21,4,17,21,0.000025,0.000753,0,14442,13,0.000012,15,0.160238,0.188055,2476.530449,0.240476,0.000923
9601087,9601087,,2,1,3,2,1,3,0.000015,0.000026,0,3280,13,0.000011,7,0.232656,0.259554,68.873474,0.166667,0.000663
9601158,9601158,,2,17,19,2,17,19,0.000056,0.000362,0,3279,13,0.000011,9,0.227471,0.284145,77.131367,0.195906,0.000558
6188,6188,,0,6,6,0,6,6,0,0.000285,0,14443,4,0.00001,16,0.168478,0.189246,0,0.3,0
6189,6189,,18,39,57,18,39,57,0.000788,0.004425,0,12967,52,0.000016,13,0.213003,0.24198,99886.380063,0.12312,0.005782
9503214,9503214,,3,0,3,3,0,3,0.000052,0,0,10208,23,0.000016,0,0,0,0,0.166667,0.000846
6190,6190,,4,44,48,4,44,48,0.000888,0.020152,0,14444,13,0.000011,15,0.221629,0.255222,9554.304984,0.184397,0.001298
9201063,9201063,,3,0,3,3,0,3,0.000275,0,0,12357,25,0.000016,0,0,0,0,0,0.00079
6236,6236,,63,29,92,63,29,92,0.003612,0.00488,0,13038,30,0.000049,14,0.211685,0.237181,92512.868762,0.085882,0.018564
6209,6209,,31,57,88,31,57,88,0.001266,0.005722,0,13011,30,0.000038,13,0.212559,0.238003,86852.896772,0.138192,0.010606
6194,6194,,0,33,33,0,33,33,0,0.002545,0,14445,0,0.00001,17,0.200033,0.230232,0,0.067235,0
9404044,9404044,,1,0,1,1,0,1,0,0,0,14316,0,0.000014,0,0,0,0,0,0.000256
9506168,9506168,,1,5,6,1,5,6,0.00007,0.000353,0,4199,0,0.00001,8,0.230275,0.259255,95.989522,0.166667,0.000428
9512060,9512060,,4,26,30,4,26,30,0.000297,0.006397,0,1544,0,0.000012,13,0.22022,0.271906,262.354912,0.245977,0.001202
6196,6196,,15,24,39,15,24,39,0.002714,0.021874,0,12386,1,0.000016,11,0.231176,0.26372,30454.495903,0.169366,0.004696
6197,6197,,0,9,9,0,9,9,0,0.000004,0,14446,6,0.00001,13,0.14211,0.161087,0,0.166667,0
6198,6198,,2,22,24,2,22,24,0.000063,0.002502,0,14450,4,0.000011,16,0.180415,0.212314,2452.804398,0.13587,0.000445
9803151,9803151,,1,3,4,1,3,4,0.000029,0.000002,0,14449,23,0.00001,7,0.228448,0.291375,75.101323,0.25,0.000232
9905069,9905069,,6,5,11,6,5,11,0.00014,0.001953,0,14447,4,0.000015,12,0.175831,0.198535,322.975479,0.281818,0.001382
9905194,9905194,,4,6,10,4,6,10,0.000107,0.001896,0,14448,4,0.000012,12,0.176011,0.199556,85.484162,0.333333,0.000897
6199,6199,,5,11,16,5,11,16,0.000391,0.000055,0,14451,22,0.000012,15,0.150898,0.164719,2282.344693,0.145833,0.001208
6200,6200,,2,1,3,2,1,3,0.000083,0.00003,0,14452,52,0.000011,12,0.179406,0.193836,191.840181,0,0.000507
6201,6201,,4,29,33,4,29,33,0.000031,0.004088,0,14453,0,0.000013,14,0.204287,0.229778,13960.88099,0.194129,0.000956
9504054,9504054,,1,7,8,1,7,8,0.000105,0.000026,0,1530,26,0.000015,1,1,1,66467.437175,0.125,0.000781
6205,6205,,0,1,1,0,1,1,0,0,0,14459,23,0.00001,11,0.135088,0.149226,0,0,0
9901007,9901007,,1,3,4,1,3,4,0,0,0,14458,23,0.000019,10,0.15568,0.178185,307,0.166667,0.000219
9409085,9409085,,11,0,11,11,0,11,0,0,0,10939,23,0.000082,0,0,0,0,0.227273,0.00261
9706159,9706159,,7,5,12,7,5,12,0,0.000002,0,14457,23,0.000041,5,0.433333,0.605128,197.416667,0.121212,0.001587
6206,6206,,0,2,2,0,2,2,0,0.000016,0,14460,2,0.00001,15,0.154497,0.170603,0,0,0
6207,6207,,8,1,9,8,1,9,0.000175,0.000001,0,13042,30,0.000018,1,1,1,3466.882545,0.194444,0.002535
9707088,9707088,,3,0,3,3,0,3,0.000055,0,0,13041,30,0.000027,0,0,0,0,0.5,0.001021
6208,6208,,4,8,12,4,8,12,0,0.000283,0,14462,4,0.000022,16,0.154536,0.178269,5910.236638,0.045455,0.000896
9906227,9906227,,2,6,8,2,6,8,0.000005,0.00011,0,14461,2,0.000013,15,0.172628,0.194624,8506.552847,0.267857,0.000484
9507064,9507064,,5,16,21,5,16,21,0.0002,0.003507,0,2461,4,0.000017,9,0.219485,0.265019,538.050066,0.195238,0.001438
6210,6210,,21,28,49,21,28,49,0.000678,0.001059,0,14463,30,0.000022,13,0.199937,0.220082,83840.55805,0.164541,0.007025
6211,6211,,13,7,20,13,7,20,0.000659,0.001045,0,14464,8,0.00002,12,0.19092,0.208207,13855.423482,0.107895,0.003289
6214,6214,,2,3,5,2,3,5,0,0,0,14470,8,0.000014,8,0.183616,0.227711,2,0.3,0.000451
9505169,9505169,,6,0,6,6,0,6,0,0,0,14467,8,0.000099,0,0,0,0,0.1,0.00142
9610028,9610028,,10,1,11,10,1,11,0,0,0,14468,8,0.000059,1,1,1,6,0.1,0.002264
9911233,9911233,,4,3,7,4,3,7,0,0,0,14469,8,0.00002,7,0.219178,0.263244,112.467787,0.238095,0.000903
9610145,9610145,,6,0,6,6,0,6,0,0,0,14466,8,0.00003,0,0,0,0,0.166667,0.001374
9807165,9807165,,2,1,3,2,1,3,0,0.000001,0,14465,8,0.000018,6,0.264317,0.296111,264.224619,0.166667,0.000478
6217,6217,,3,7,10,3,7,10,0.000006,0.000244,0,14471,5,0.000014,12,0.192962,0.212157,9641.47487,0.2,0.000677
9411128,9411128,,12,3,15,12,3,15,0.000226,0.000135,0,1405,5,0.000035,4,0.369231,0.427083,294.906697,0.157143,0.003231
9504064,9504064,,7,16,23,7,16,23,0.000071,0.000208,0,4594,5,0.000021,7,0.301238,0.365112,14000.397721,0.136364,0.001896
9505121,9505121,,1,9,10,1,9,10,0.000036,0.000211,0,8160,5,0.00001,7,0.26539,0.315562,6.854295,0.366667,0.000323
9610011,9610011,,3,22,25,3,22,25,0.000039,0.000207,0,8158,5,0.000012,12,0.16754,0.198129,339.631235,0.216667,0.000782
9610180,9610180,,5,9,14,5,9,14,0.000042,0.000065,0,6376,5,0.000014,11,0.17778,0.203354,317.74204,0.241758,0.001256
9703125,9703125,,1,12,13,1,12,13,0.000036,0.000168,0,8159,5,0.00001,12,0.170416,0.198295,28.072104,0.314103,0.000323
9706065,9706065,,2,13,15,2,13,15,0.000061,0.000209,0,8157,5,0.000011,11,0.18825,0.216991,406.949405,0.161905,0.000556
9709213,9709213,,7,15,22,7,15,22,0.000255,0.000065,0,8156,5,0.000019,13,0.15159,0.177271,810.175621,0.15368,0.001739
6218,6218,,0,21,21,0,21,21,0,0.000058,0,14472,23,0.00001,14,0.167613,0.187144,0,0.133333,0
6219,6219,,49,37,86,49,37,86,0.002262,0.006738,0,12866,30,0.000066,12,0.224716,0.251112,216451.176544,0.078249,0.018902
6220,6220,,1,3,4,1,3,4,0,0,0,14474,5,0.00001,14,0.131099,0.143309,522.973818,0,0.000226
9803036,9803036,,3,8,11,3,8,11,0,0.000012,0,14473,5,0.000015,13,0.150148,0.167996,2547.645497,0.2,0.000664
9606132,9606132,,2,9,11,2,9,11,0,0.000004,0,9239,5,0.000024,3,0.508475,0.605556,687.006337,0.163636,0.000472
6221,6221,,1,1,2,1,1,2,0,0,0,14475,23,0.00001,5,0.28169,0.31125,29.685247,0,0.000226
6222,6222,,7,28,35,7,28,35,0.000651,0.002977,0,14476,13,0.000019,13,0.201821,0.229397,74662.572167,0.055462,0.001892
9203061,9203061,,15,0,15,15,0,15,0.000204,0,0,3772,9,0.000027,0,0,0,0,0.095238,0.003965
9507171,9507171,,3,6,9,3,6,9,0.000015,0.000087,0,10447,13,0.000012,8,0.231224,0.265765,25134.212582,0.208333,0.000726
9601129,9601129,,2,2,4,2,2,4,0.000003,0.000038,0,10443,9,0.000011,2,0.666667,0.75,117.96307,0.083333,0.000477
9902072,9902072,,3,25,28,3,25,28,0.000078,0.005261,0,10137,13,0.000011,14,0.181427,0.221642,147.593914,0.230159,0.000707
9902107,9902107,,2,20,22,2,20,22,0.000052,0.00218,0,10138,13,0.000011,14,0.180432,0.21764,46.463675,0.255411,0.000474
9903064,9903064,,1,20,21,1,20,21,0.000027,0.002123,0,10139,13,0.00001,14,0.178295,0.214511,2.695283,0.245238,0.000248
6223,6223,,10,10,20,10,10,20,0.000571,0.002822,0,12929,3,0.000015,14,0.179394,0.200226,981.056677,0.228947,0.003646
6224,6224,,51,21,72,51,21,72,0.002011,0.002198,0,12976,52,0.00003,13,0.194875,0.219681,9624.577276,0.134194,0.014954
6227,6227,,4,9,13,4,9,13,0,0.000004,0,14477,23,0.000014,11,0.159047,0.200557,416.082022,0.205128,0.000956
9509139,9509139,,11,2,13,11,2,13,0.000021,0.000001,0,13685,23,0.000025,1,1,1,13.5,0.147436,0.002645
9243,9243,,6,11,17,6,11,17,0,0.000016,0,14478,23,0.000018,15,0.161257,0.178623,28033.468588,0.132353,0.001367
9705157,9705157,,8,9,17,8,9,17,0.000021,0.000003,0,13681,23,0.000019,10,0.165107,0.204807,360.156844,0.191176,0.001907
9504151,9504151,,8,6,14,8,6,14,0.000201,0.000002,0,6233,23,0.000031,1,1,1,42769.247415,0.159341,0.002071
9507100,9507100,,8,4,12,8,4,12,0,0.000002,0,8381,23,0.000026,2,0.833333,0.9,30.194403,0.227273,0.002105
9408075,9408075,,13,1,14,13,1,14,0.000006,0,0,13654,23,0.000041,2,0.571429,0.625,252.217037,0.098901,0.003438
9701102,9701102,,7,11,18,7,11,18,0.000009,0.000005,0,13653,23,0.000022,9,0.17577,0.243662,5544.1481,0.117647,0.001732
9803258,9803258,,9,11,20,9,11,20,0.000021,0.000003,0,13682,23,0.000022,10,0.166025,0.210073,722.331016,0.176316,0.00214
6228,6228,,5,29,34,5,29,34,0.000231,0.02409,0,14479,2,0.000011,16,0.194478,0.23396,2095.457636,0.118538,0.001163
9210054,9210054,,1,0,1,1,0,1,0.000064,0,0,4932,2,0.00001,0,0,0,0,0,0.000332
6229,6229,,4,4,8,4,4,8,0,0,0,14482,23,0.000014,14,0.135403,0.146494,432.977783,0.285714,0.00093
9506211,9506211,,7,0,7,7,0,7,0,0,0,6739,23,0.000063,0,0,0,0,0.309524,0.002022
9605163,9605163,,6,2,8,6,2,8,0,0,0,6742,23,0.000045,7,0.20442,0.258816,7093.447827,0.232143,0.001784
9912195,9912195,,5,14,19,5,14,19,0,0.000008,0,14481,23,0.000017,13,0.154417,0.170481,14177.836235,0.219298,0.001189
9603102,9603102,,2,3,5,2,3,5,0,0.000001,0,6740,23,0.000059,6,0.243056,0.302381,39.696141,0.25,0.000846
9905187,9905187,,3,13,16,3,13,16,0,0.000009,0,14480,23,0.000013,13,0.154269,0.169838,248.089799,0.308333,0.000725
6230,6230,,4,7,11,4,7,11,0,0.000001,0,14483,23,0.000014,16,0.118386,0.130613,2155.522307,0.209091,0.000923
6231,6231,,6,16,22,6,16,22,0.000711,0.009467,0,14484,2,0.000014,13,0.188915,0.212335,12929.39101,0.136364,0.001453
6233,6233,,5,2,7,5,2,7,0,0,0,14485,6,0.000021,9,0.214145,0.242499,1226.707473,0.119048,0.001135
9503165,9503165,,1,8,9,1,8,9,0,0.00001,0,10653,9,0.000011,5,0.372197,0.434137,1709.573943,0.180556,0.000254
9508020,9508020,,6,9,15,6,9,15,0.000003,0.000012,0,3169,9,0.000017,6,0.335366,0.408485,29618.380887,0.090476,0.001553
6234,6234,,9,15,24,9,15,24,0.00088,0.002325,0,14486,2,0.000014,13,0.181457,0.199525,18141.00673,0.251812,0.002651
6235,6235,,23,11,34,23,11,34,0.000976,0.00147,0,13043,30,0.00003,14,0.1923,0.210121,23125.136962,0.145276,0.008338
9158,9158,,8,13,21,8,13,21,0.000172,0.001307,0,14492,30,0.000015,14,0.19435,0.214067,8160.385849,0.166667,0.001986
7192,7192,,3,6,9,3,6,9,0.000071,0.000025,0,14491,30,0.000012,15,0.164346,0.17591,2742.199982,0.180556,0.001014
9908151,9908151,,6,7,13,6,7,13,0.000016,0.000042,0,14489,23,0.000024,13,0.158719,0.182463,12267.803787,0.032051,0.001417
6237,6237,,2,5,7,2,5,7,0,0.000018,0,14493,8,0.000014,13,0.161575,0.174851,12526.032213,0.166667,0.000438
6238,6238,,1,13,14,1,13,14,0,0.000012,0,14494,22,0.000011,13,0.147721,0.160798,6125.216759,0.214286,0.000226
9609002,9609002,,5,4,9,5,4,9,0,0.000001,0,10001,22,0.000019,4,0.474576,0.532738,389.624409,0.291667,0.00123
6239,6239,,12,24,36,12,24,36,0.002059,0.017491,0,12399,2,0.000015,13,0.223486,0.25011,97839.742889,0.155556,0.004479
9209057,9209057,,3,0,3,3,0,3,0.000004,0,0,1954,22,0.000019,0,0,0,0,0,0.00089
6240,6240,,106,27,133,106,27,133,0.002863,0.002167,0,12855,3,0.000096,16,0.19462,0.217747,27006.972254,0.14542,0.047548
6241,6241,,1,2,3,1,2,3,0.000018,0.000077,0,12991,52,0.000011,15,0.175734,0.195204,855.915356,0.166667,0.000638
6243,6243,,3,3,6,3,3,6,0,0.000007,0,14495,6,0.000024,6,0.288889,0.395513,77.866667,0.166667,0.000677
6244,6244,,0,18,18,0,18,18,0,0.003259,0,14496,4,0.00001,15,0.183649,0.210633,0,0.163399,0
9504005,9504005,,4,3,7,4,3,7,0.000494,0.000402,0,5136,4,0.000014,7,0.232904,0.267781,128.471263,0.404762,0.001
9504146,9504146,,3,4,7,3,4,7,0.000282,0.001919,0,6049,4,0.000011,6,0.27,0.313457,983.99273,0.309524,0.000791
9601027,9601027,,5,6,11,5,6,11,0.000215,0.001115,0,4838,4,0.000015,7,0.252186,0.285333,8850.587123,0.163636,0.001191
9603023,9603023,,4,8,12,4,8,12,0.000509,0.000115,0,11956,4,0.000012,7,0.242996,0.279472,4368.446883,0.219697,0.00091
9603035,9603035,,4,3,7,4,3,7,0.000129,0.001918,0,11954,4,0.000013,6,0.268537,0.308333,35.070407,0.166667,0.00091
6245,6245,,4,7,11,4,7,11,0.000098,0.000069,0,14498,30,0.000015,16,0.146268,0.161446,3179.566115,0.163636,0.001389
9903202,9903202,,1,6,7,1,6,7,0.000001,0.000043,0,14497,30,0.000012,16,0.145416,0.169615,497.478172,0.214286,0.000252
6247,6247,,18,29,47,18,29,47,0.001004,0.002223,0,12975,52,0.000016,14,0.211395,0.239656,61108.466787,0.112858,0.005794
9207109,9207109,,4,2,6,4,2,6,0.000027,0.000021,0,1064,5,0.000013,1,1,1,82.220021,0.1,0.001075
6248,6248,,5,3,8,5,3,8,0,0.000006,0,14499,23,0.000023,14,0.131628,0.142447,9745.923188,0.089286,0.001102
9307186,9307186,,13,1,14,13,1,14,0,0,0,4739,23,0.000109,1,1,1,11862.25,0.159341,0.00339
9404181,9404181,,4,0,4,4,0,4,0,0,0,4737,23,0.00006,0,0,0,0,0.333333,0.001207
9405163,9405163,,2,5,7,2,5,7,0,0.000001,0,4743,22,0.000027,2,0.857143,0.916667,11206.549911,0.047619,0.000583
9406033,9406033,,7,2,9,7,2,9,0.000001,0,0,4740,23,0.000052,2,0.75,0.833333,10,0.180556,0.001922
6249,6249,,4,2,6,4,2,6,0,0.000001,0,14500,26,0.000023,1,1,1,4,0.166667,0.00089
6250,6250,,0,4,4,0,4,4,0,0.000003,0,14501,8,0.00001,14,0.139181,0.147717,0,0.166667,0
7001,7001,,2,35,37,2,35,37,0.000047,0.004687,0,14502,25,0.000011,13,0.211089,0.23744,2482.263784,0.075826,0.000438
9703168,9703168,,4,7,11,4,7,11,0.000109,0.000004,0,12347,41,0.000016,1,1,1,4166.659911,0.154545,0.000994
9811076,9811076,,3,3,6,3,3,6,0.000109,0.000004,0,12348,41,0.000012,2,0.615385,0.6875,1367.663058,0.166667,0.000748
9506021,9506021,,5,2,7,5,2,7,0,0.000001,0,12346,41,0.000035,2,0.666667,0.75,8,0.190476,0.001136
7002,7002,,3,16,19,3,16,19,0.000253,0.001679,0,14504,25,0.000013,17,0.187975,0.207479,6599.933695,0.192982,0.000777
9801094,9801094,,7,3,10,7,3,10,0.000021,0.000005,0,14503,6,0.000022,9,0.206012,0.242043,242.552528,0.266667,0.001655
9403039,9403039,,11,0,11,11,0,11,0.000001,0,0,8221,6,0.000041,0,0,0,0,0.118182,0.002627
9503178,9503178,,3,11,14,3,11,14,0,0.000005,0,8224,6,0.000014,4,0.454545,0.555556,10192.481263,0.087912,0.000766
9604024,9604024,,1,3,4,1,3,4,0,0.000003,0,8222,6,0.000012,4,0.4,0.464286,290.415877,0.166667,0.0003
7006,7006,,0,3,3,0,3,3,0,0.000024,0,14505,8,0.00001,14,0.158709,0.171268,0,0.333333,0
7007,7007,,20,47,67,20,47,67,0.000901,0.019509,0,14506,9,0.000016,13,0.214103,0.244033,38347.700421,0.14066,0.00565
7008,7008,,4,8,12,4,8,12,0.000001,0.000021,0,14507,22,0.000012,2,0.642857,0.722222,40.735714,0.189394,0.000903
7009,7009,,5,24,29,5,24,29,0.000707,0.017829,0,14508,41,0.000011,13,0.198317,0.22502,1606.320242,0.172414,0.001191
7010,7010,,0,3,3,0,3,3,0,0,0,14509,22,0.00001,17,0.126339,0.135658,0,0.5,0
7011,7011,,27,26,53,27,26,53,0.002656,0.0228,0,12417,2,0.000023,12,0.235569,0.268564,76658.214212,0.090348,0.008397
7012,7012,,11,28,39,11,28,39,0.000657,0.003034,0,14510,3,0.000014,16,0.222594,0.250775,35194.164378,0.115385,0.003019
7013,7013,,6,15,21,6,15,21,0.000036,0.000194,0,14511,9,0.000012,13,0.180887,0.202593,1992.301737,0.261905,0.001634
7015,7015,,9,20,29,9,20,29,0.000233,0.00217,0,14512,30,0.000021,16,0.193009,0.21539,27283.539097,0.108374,0.002217
9410072,9410072,,3,0,3,3,0,3,0.000062,0,0,2900,2,0.000016,0,0,0,0,0.166667,0.00083
9604085,9604085,,3,0,3,3,0,3,0.000108,0,0,2754,2,0.000024,0,0,0,0,0,0.001182
7016,7016,,3,4,7,3,4,7,0.000012,0.000009,0,14513,4,0.000015,12,0.171965,0.193515,1395.077195,0.142857,0.000671
7017,7017,,6,14,20,6,14,20,0.000158,0.001095,0,14514,2,0.000014,14,0.193211,0.220278,3035.385829,0.142105,0.0017
7019,7019,,12,28,40,12,28,40,0.000579,0.002939,0,14515,30,0.000021,12,0.210428,0.23575,81070.412199,0.054487,0.003142
9906131,9906131,,4,6,10,4,6,10,0.000292,0.000851,0,14142,10,0.000014,15,0.161293,0.185834,199.371669,0.144444,0.000918
7020,7020,,10,19,29,10,19,29,0.000094,0.000195,0,14519,28,0.000018,15,0.157458,0.184613,13998.35365,0.105911,0.002655
9912016,9912016,,4,15,19,4,15,19,0.000006,0.000183,0,14518,28,0.000014,14,0.157061,0.179115,7395.904958,0.111111,0.00111
9912281,9912281,,6,9,15,6,9,15,0.000066,0.000011,0,14517,28,0.000016,14,0.159342,0.177598,11334.745434,0.147619,0.001779
9508012,9508012,,1,2,3,1,2,3,0,0.000001,0,2893,0,0.000017,2,0.625,0.7,14584.299811,0.166667,0.000326
9608156,9608156,,2,3,5,2,3,5,0.000011,0.000018,0,5755,28,0.000013,13,0.151966,0.164978,9769.17727,0.1,0.000534
9511160,9511160,,1,2,3,1,2,3,0.000062,0.000002,0,2953,0,0.000011,7,0.225806,0.276478,16548.098215,0,0.000457
9605223,9605223,,2,23,25,2,23,25,0.00012,0.003745,0,2951,0,0.000012,9,0.242769,0.285602,5898.53674,0.096667,0.000872
9411101,9411101,,16,2,18,16,2,18,0.000117,0.000005,0,2855,28,0.000047,6,0.318182,0.366931,3695.028664,0.169935,0.004555
9607106,9607106,,2,9,11,2,9,11,0.000007,0.000695,0,6715,28,0.000011,10,0.203612,0.231791,1201.646302,0.209091,0.000493
9204027,9204027,,2,0,2,2,0,2,0.000003,0,0,1801,28,0.000014,0,0,0,0,0,0.000557
9901164,9901164,,8,17,25,8,17,25,0.000054,0.000625,0,8883,28,0.000016,13,0.180457,0.207448,38252.126535,0.113333,0.002089
9808053,9808053,,3,14,17,3,14,17,0.000004,0.000087,0,8884,28,0.000013,16,0.15029,0.174,7956.87528,0.231618,0.000769
9912154,9912154,,4,16,20,4,16,20,0.000047,0.000102,0,14516,28,0.000013,14,0.166653,0.190697,6415.278689,0.197368,0.001051
7021,7021,,1,27,28,1,27,28,0.000069,0.01747,0,14530,1,0.00001,12,0.213523,0.239634,3147.517513,0.164021,0.000361
9910047,9910047,,4,31,35,4,31,35,0.000308,0.00885,0,14529,1,0.000011,12,0.210584,0.238624,25279.165551,0.170588,0.001046
9610029,9610029,,1,11,12,1,11,12,0.000104,0.000069,0,14528,26,0.00001,10,0.219349,0.26932,20251.211811,0.25,0.000247
7022,7022,,12,19,31,12,19,31,0.000718,0.003596,0,14531,30,0.000016,12,0.206384,0.227725,23023.198791,0.180645,0.003193
7023,7023,,8,34,42,8,34,42,0.000618,0.007041,0,12951,30,0.000014,13,0.219812,0.249307,165503.473187,0.090012,0.002941
9412220,9412220,,5,3,8,5,3,8,0.000131,0.000003,0,878,30,0.000024,2,0.714286,0.8,51223.433221,0.089286,0.002215
7024,7024,,96,45,141,96,45,141,0.004667,0.0069,0,14533,0,0.00005,15,0.209932,0.24125,195463.507625,0.096049,0.034915
9908155,9908155,,1,30,31,1,30,31,0.000081,0.003533,0,14532,0,0.000011,12,0.20509,0.232066,1733.892007,0.17957,0.001029
7025,7025,,2,1,3,2,1,3,0.000027,0,0,14534,25,0.000013,5,0.294118,0.376667,4122.707361,0.166667,0.000594
7026,7026,,1,14,15,1,14,15,0.000138,0.006934,0,14535,9,0.00001,15,0.183405,0.206462,88.881164,0.109524,0.000245
7027,7027,,1,4,5,1,4,5,0,0.000225,0,14536,23,0.000011,13,0.177965,0.192716,3627.231476,0.05,0.000219
7028,7028,,2,10,12,2,10,12,0.000056,0.017856,0,14537,8,0.000012,14,0.189166,0.214848,790.741141,0.128788,0.000484
7031,7031,,3,18,21,3,18,21,0.00014,0.007016,0,14538,2,0.000015,16,0.188394,0.228093,7760.136253,0.102381,0.000685
9710079,9710079,,6,5,11,6,5,11,0.000135,0.000102,0,8781,10,0.000016,12,0.178492,0.196808,1405.940823,0.154545,0.001528
9804034,9804034,,6,21,27,6,21,27,0.000599,0.007707,0,6411,2,0.000015,13,0.194612,0.22562,2290.683399,0.232194,0.001789
7032,7032,,4,5,9,4,5,9,0,0.000003,0,14545,22,0.000022,17,0.140588,0.15262,7345.877118,0.138889,0.00089
9504055,9504055,,8,0,8,8,0,8,0,0,0,14539,22,0.000071,0,0,0,0,0.25,0.001886
9507133,9507133,,5,1,6,5,1,6,0,0,0,14540,22,0.000035,1,1,1,0,0.366667,0.001195
9710047,9710047,,5,4,9,5,4,9,0,0,0,14543,22,0.000028,1,1,1,16.333333,0.208333,0.001142
9710186,9710186,,2,4,6,2,4,6,0,0,0,14544,22,0.000016,2,0.833333,0.9,3.833333,0.4,0.000464
9505063,9505063,,2,0,2,2,0,2,0,0,0,14541,22,0.000025,0,0,0,0,0.5,0.000498
9510193,9510193,,4,3,7,4,3,7,0,0,0,14542,22,0.000029,1,1,1,3,0.238095,0.000929
7033,7033,,3,6,9,3,6,9,0.00003,0.000003,0,14550,22,0.000014,5,0.382716,0.482258,12175.091387,0.097222,0.000885
9403092,9403092,,1,2,3,1,2,3,0,0.000009,0,14549,22,0.000012,1,1,1,0.333333,0.166667,0.000242
9404070,9404070,,2,3,5,2,3,5,0,0.000011,0,14547,22,0.000015,2,0.8,0.875,51.425615,0.15,0.000468
9407126,9407126,,2,4,6,2,4,6,0,0.000013,0,14546,22,0.000015,3,0.588235,0.683333,176.630943,0.166667,0.000468
9605160,9605160,,1,4,5,1,4,5,0,0.000003,0,14548,22,0.000012,4,0.436364,0.513889,235.875591,0.15,0.000242
7034,7034,,0,6,6,0,6,6,0,0.000014,0,14551,28,0.00001,6,0.333333,0.452632,0,0.4,0
7035,7035,,22,18,40,22,18,40,0.000867,0.001896,0,14552,2,0.000031,16,0.189075,0.215095,16949.069504,0.112179,0.005842
7036,7036,,29,28,57,29,28,57,0.003731,0.017302,0,14556,41,0.000044,12,0.202601,0.227676,25777.3515,0.143797,0.014962
9602109,9602109,,2,4,6,2,4,6,0.000432,0.000014,0,14555,41,0.000012,8,0.191027,0.213199,2623.254272,0.233333,0.001032
9901095,9901095,,6,27,33,6,27,33,0.001229,0.009357,0,14553,41,0.000013,12,0.19705,0.224179,3126.316633,0.145833,0.002042
9510145,9510145,,2,3,5,2,3,5,0,0.000007,0,14554,5,0.000014,7,0.2307,0.254169,882.208381,0.25,0.000465
9812114,9812114,,2,6,8,2,6,8,0.000317,0.015507,0,8433,41,0.000011,13,0.178601,0.199881,5.208842,0.392857,0.000611
7037,7037,,8,5,13,8,5,13,0.000173,0.000377,0,14557,2,0.000015,15,0.163236,0.184117,516.801885,0.230769,0.001901
7038,7038,,1,3,4,1,3,4,0.000076,0.000042,0,12379,4,0.00001,15,0.132524,0.145113,121.532248,0.25,0.000388
7040,7040,,3,3,6,3,3,6,0.000002,0.000004,0,14558,4,0.000013,1,1,1,134.002501,0.166667,0.000713
7042,7042,,1,7,8,1,7,8,0,0.000003,0,14559,17,0.000012,13,0.145924,0.173072,30.2,0.357143,0.000219
7043,7043,,78,23,101,78,23,101,0.003565,0.005178,0,12872,30,0.000076,13,0.210137,0.233351,105392.876411,0.122178,0.031981
7045,7045,,1,2,3,1,2,3,0,0.000002,0,14560,9,0.000011,10,0.174237,0.205817,0,0.5,0.000219
7046,7046,,20,6,26,20,6,26,0.000291,0.001666,0,14561,30,0.000033,14,0.187131,0.203878,11953.205498,0.126154,0.005425
7047,7047,,3,13,16,3,13,16,0.000002,0.00005,0,14567,30,0.000013,18,0.133372,0.149459,6894.732407,0.175,0.000697
9912217,9912217,,4,6,10,4,6,10,0.000025,0.000047,0,14566,30,0.000014,17,0.134183,0.14849,2670.601836,0.244444,0.000943
9507002,9507002,,6,0,6,6,0,6,0.000022,0,0,13674,30,0.000035,0,0,0,0,0.1,0.001402
9903047,9903047,,2,4,6,2,4,6,0.000001,0.000028,0,14565,26,0.000013,16,0.145748,0.158757,6558.377315,0.2,0.000485
7048,7048,,19,45,64,19,45,64,0.000734,0.017825,0,14568,2,0.00002,17,0.20916,0.238522,63696.677425,0.12004,0.005026
7049,7049,,8,18,26,8,18,26,0.000166,0.000131,0,14569,28,0.000014,14,0.169889,0.194198,9477.628986,0.158462,0.002372
9609220,9609220,,4,4,8,4,4,8,0.000082,0.000058,0,4670,3,0.000019,7,0.267327,0.322046,1227.564442,0.232143,0.00102
9703183,9703183,,3,2,5,3,2,5,0.000025,0.000002,0,5705,3,0.000013,8,0.216359,0.255546,5.655549,0.25,0.000738
9706033,9706033,,2,7,9,2,7,9,0.000029,0.000022,0,5706,3,0.000012,14,0.171197,0.192875,6892.016628,0.083333,0.000771
7050,7050,,18,39,57,18,39,57,0.000675,0.004266,0,13032,30,0.000019,12,0.21198,0.237096,40600.370494,0.161341,0.006293
7051,7051,,9,7,16,9,7,16,0.000694,0.006598,0,14570,2,0.000014,12,0.200319,0.221916,2971.698749,0.216667,0.002406
7052,7052,,20,30,50,20,30,50,0.001652,0.005265,0,13040,30,0.000017,14,0.223697,0.256011,26451.517784,0.164082,0.005992
7053,7053,,19,22,41,19,22,41,0.000952,0.00221,0,12376,25,0.000021,17,0.187633,0.207718,5072.710159,0.157927,0.00527
7054,7054,,4,1,5,4,1,5,0.000011,0,0,14572,22,0.000017,1,1,1,122,0.05,0.00091
9808106,9808106,,1,0,1,1,0,1,0,0,0,14571,22,0.000025,0,0,0,0,0,0.000246
7055,7055,,2,22,24,2,22,24,0.000105,0.008046,0,13045,30,0.000011,13,0.198979,0.22149,685.550831,0.179348,0.00063
7056,7056,,6,32,38,6,32,38,0.000268,0.005306,0,14573,2,0.000017,13,0.208082,0.232881,35411.098475,0.08037,0.001459
9305057,9305057,,3,0,3,3,0,3,0.000123,0,0,2321,52,0.000017,0,0,0,0,0,0.000751
9412036,9412036,,1,1,2,1,1,2,0.000123,0.000002,0,3433,52,0.00001,1,1,1,511.00363,0,0.000286
7058,7058,,4,37,41,4,37,41,0.000809,0.019295,0,14574,1,0.000011,14,0.222117,0.257859,21294.314551,0.143902,0.001021
9306082,9306082,,2,2,4,2,2,4,0.000004,0.000029,0,1015,5,0.00002,1,1,1,48.610963,0.083333,0.000537
7061,7061,,4,40,44,4,40,44,0.000889,0.021975,0,14575,1,0.000011,14,0.225902,0.259533,20276.507606,0.142178,0.001165
7062,7062,,22,22,44,22,22,44,0.005446,0.020915,0,14576,1,0.000017,15,0.218682,0.252687,6386.346645,0.2426,0.006928
7063,7063,,9,19,28,9,19,28,0.000965,0.003028,0,12377,25,0.000014,18,0.186502,0.208641,2407.35114,0.137566,0.002306
7066,7066,,0,12,12,0,12,12,0,0.002951,0,14580,2,0.00001,13,0.182589,0.202748,0,0.151515,0
9809135,9809135,,2,28,30,2,28,30,0.000041,0.001823,0,14579,2,0.000011,15,0.18233,0.213423,666.296285,0.127586,0.000438
9403115,9403115,,1,0,1,1,0,1,0.000021,0,0,14578,2,0.00001,0,0,0,0,0,0.000232
9405047,9405047,,1,3,4,1,3,4,0.000021,0.000059,0,14577,2,0.00001,2,0.714286,0.8,8.083333,0,0.000232
7067,7067,,21,42,63,21,42,63,0.002622,0.006457,0,12401,2,0.000018,12,0.241136,0.274422,141965.348281,0.05658,0.006981
7125,7125,,6,32,38,6,32,38,0.001121,0.008159,0,12407,25,0.000012,12,0.221896,0.248707,125604.280747,0.130156,0.002158
7068,7068,,0,12,12,0,12,12,0,0.000269,0,14582,0,0.00001,15,0.180614,0.20038,0,0.257576,0
9606186,9606186,,1,0,1,1,0,1,0.000003,0,0,14581,0,0.000011,0,0,0,0,0,0.000219
7069,7069,,13,17,30,13,17,30,0.000829,0.000977,0,14583,1,0.000016,15,0.202434,0.228902,17426.265592,0.196552,0.003492
7070,7070,,0,7,7,0,7,7,0,0.004014,0,14584,2,0.00001,12,0.200891,0.231741,0,0.166667,0
7071,7071,,10,20,30,10,20,30,0.000366,0.001564,0,12874,52,0.000014,13,0.186899,0.209141,8043.066605,0.162069,0.003376
7073,7073,,5,24,29,5,24,29,0.000035,0.00039,0,14585,9,0.000012,12,0.214131,0.246731,10053.528425,0.160099,0.001372
7074,7074,,11,3,14,11,3,14,0.000262,0.000791,0,14586,30,0.000019,17,0.177897,0.195682,17939.893398,0.214286,0.002667
7075,7075,,20,45,65,20,45,65,0.000594,0.00308,0,12977,52,0.000018,14,0.214011,0.243096,70502.373736,0.144471,0.006391
7076,7076,,7,15,22,7,15,22,0.000359,0.001063,0,14587,2,0.000014,15,0.172008,0.197802,8284.269029,0.097403,0.001757
9406152,9406152,,6,0,6,6,0,6,0.000009,0,0,5243,2,0.000076,0,0,0,0,0.1,0.00139
7077,7077,,6,13,19,6,13,19,0.000001,0.000008,0,14589,6,0.000015,13,0.156158,0.169676,15829.935328,0.108187,0.001441
9405128,9405128,,2,9,11,2,9,11,0,0.000003,0,14588,6,0.000011,3,0.653846,0.754902,230.239577,0.018182,0.000479
9712033,9712033,,4,14,18,4,14,18,0.000001,0,0,13933,6,0.000015,13,0.151082,0.198216,4746.252296,0.127451,0.000972
9705142,9705142,,3,9,12,3,9,12,0,0,0,13932,6,0.000014,12,0.151146,0.223152,131.390311,0.19697,0.00072
7078,7078,,52,31,83,52,31,83,0.001972,0.004777,0,12873,30,0.000045,13,0.207503,0.231488,59302.110936,0.111666,0.021061
7079,7079,,8,12,20,8,12,20,0.00038,0.016152,0,12356,25,0.000019,11,0.205264,0.22678,22118.964256,0.105263,0.002103
9406003,9406003,,3,0,3,3,0,3,0.00019,0,0,3980,25,0.000017,0,0,0,0,0.166667,0.000742
9707095,9707095,,2,18,20,2,18,20,0.000213,0.002225,0,12354,4,0.000013,12,0.179333,0.205337,5392.425069,0.184211,0.000495
7080,7080,,0,11,11,0,11,11,0,0.000005,0,14590,22,0.00001,5,0.416667,0.5475,0,0.227273,0
7081,7081,,1,4,5,1,4,5,0,0.000011,0,14591,26,0.000012,19,0.104612,0.116178,146.494609,0.15,0.000219
7082,7082,,9,32,41,9,32,41,0.001355,0.006728,0,14592,1,0.000013,12,0.233626,0.266343,16470.520641,0.15061,0.002473
7083,7083,,0,37,37,0,37,37,0,0.004576,0,14593,13,0.00001,11,0.225028,0.253883,0,0.054054,0
9309104,9309104,,4,0,4,4,0,4,0,0,0,4379,22,0.000033,0,0,0,0,0.083333,0.001078
9501041,9501041,,3,0,3,3,0,3,0,0,0,7228,22,0.000024,0,0,0,0,0.166667,0.000718
7086,7086,,9,10,19,9,10,19,0.000855,0.00093,0,14594,1,0.000012,11,0.195149,0.215624,2585.481456,0.064327,0.002509
9305074,9305074,,5,10,15,5,10,15,0.000015,0.000095,0,247,13,0.000019,3,0.764706,0.871795,45.67233,0.17619,0.001599
9310029,9310029,,1,3,4,1,3,4,0.000002,0.000004,0,246,6,0.000012,2,0.8,0.875,30717.653924,0,0.000449
7087,7087,,4,28,32,4,28,32,0.000837,0.003023,0,14595,0,0.000011,11,0.211051,0.23646,366.071164,0.21371,0.001277
7088,7088,,1,11,12,1,11,12,0.000003,0.000025,0,14597,9,0.00001,13,0.188585,0.213375,112.302701,0.219697,0.000258
9709103,9709103,,5,3,8,5,3,8,0.000001,0.000003,0,13542,9,0.00002,9,0.178272,0.201186,1335.801188,0.196429,0.00117
9803182,9803182,,5,8,13,5,8,13,0.000001,0.000043,0,13539,9,0.000016,13,0.189657,0.211479,1117.430453,0.320513,0.001176
9807153,9807153,,8,11,19,8,11,19,0.000001,0.000047,0,13541,9,0.000023,13,0.189859,0.212515,6157.508896,0.21345,0.001872
9906139,9906139,,7,6,13,7,6,13,0.000086,0.000016,0,14596,9,0.000019,8,0.210496,0.239179,3932.169528,0.160256,0.001712
9302060,9302060,,6,0,6,6,0,6,0.000016,0,0,4454,9,0.000018,0,0,0,0,0.133333,0.001674
9205044,9205044,,1,0,1,1,0,1,0,0,0,7530,9,0.000012,0,0,0,0,0,0.000287
9508030,9508030,,5,11,16,5,11,16,0.000001,0.000031,0,6596,9,0.000025,5,0.301266,0.376331,7433.969259,0.095833,0.001304
9606180,9606180,,9,2,11,9,2,11,0.000074,0,0,7529,9,0.000022,6,0.237094,0.274462,1095.879519,0.236364,0.002196
9803114,9803114,,5,7,12,5,7,12,0.000001,0.000043,0,13538,9,0.000017,13,0.189589,0.211134,336.891925,0.363636,0.001222
9301075,9301075,,8,1,9,8,1,9,0.000001,0.000004,0,13540,9,0.000024,1,1,1,1.2,0.347222,0.001905
9301031,9301031,,2,2,4,2,2,4,0.000003,0,0,13545,52,0.000011,2,0.75,0.833333,36,0,0.000491
9301121,9301121,,3,0,3,3,0,3,0.000083,0,0,13543,9,0.000012,0,0,0,0,0.166667,0.000787
7089,7089,,49,19,68,49,19,68,0.00361,0.002022,0,13012,30,0.000031,14,0.203474,0.224813,38244.64913,0.106014,0.015791
7090,7090,,61,56,117,61,56,117,0.003798,0.007211,0,14599,0,0.000034,16,0.21388,0.250793,114043.465727,0.116711,0.023705
9910246,9910246,,5,31,36,5,31,36,0.00108,0.002511,0,14598,0,0.000011,14,0.186425,0.214996,2719.481942,0.220635,0.00197
7091,7091,,0,1,1,0,1,1,0,0,0,14600,25,0.00001,1,1,1,0,0,0
7092,7092,,2,6,8,2,6,8,0,0,0,14601,23,0.000014,2,0.75,0.833333,124.493478,0.178571,0.000459
7094,7094,,1,8,9,1,8,9,0.000014,0.000035,0,14602,5,0.00001,14,0.168735,0.185277,1602.603753,0.083333,0.000232
9402155,9402155,,6,1,7,6,1,7,0.000062,0.000001,0,2006,5,0.000062,1,1,1,1004.744103,0.142857,0.001539
7095,7095,,3,13,16,3,13,16,0.000005,0.000207,0,14603,52,0.000013,15,0.171584,0.193799,2483.325818,0.125,0.00075
9503098,9503098,,3,1,4,3,1,4,0,0.000001,0,7821,6,0.000018,2,0.666667,0.75,65.934372,0.083333,0.000791
7096,7096,,32,13,45,32,13,45,0.002287,0.000776,0,14604,52,0.000022,17,0.201107,0.223015,8597.396594,0.140909,0.009285
7097,7097,,20,38,58,20,38,58,0.001989,0.004695,0,12915,3,0.000018,15,0.219902,0.250811,70727.106429,0.135209,0.006022
7098,7098,,0,9,9,0,9,9,0,0.000007,0,14605,23,0.00001,10,0.183919,0.221609,0,0.291667,0
9210158,9210158,,11,0,11,11,0,11,0.000039,0,0,3121,28,0.000168,0,0,0,0,0.118182,0.002754
7099,7099,,6,16,22,6,16,22,0.000917,0.009575,0,14606,1,0.000014,12,0.210887,0.236846,22893.964936,0.127706,0.001679
7100,7100,,11,25,36,11,25,36,0.000806,0.001998,0,14607,52,0.000015,14,0.211881,0.238406,9536.699077,0.183333,0.003305
7101,7101,,3,2,5,3,2,5,0.000019,0.000041,0,14608,3,0.000013,13,0.172113,0.188903,413.247966,0.1,0.000711
9207005,9207005,,18,0,18,18,0,18,0.000511,0,0,1611,41,0.0003,0,0,0,0,0.084967,0.005137
9609005,9609005,,4,12,16,4,12,16,0.000319,0.005562,0,4632,0,0.000017,10,0.214706,0.246729,17192.702369,0.170833,0.001227
7102,7102,,3,9,12,3,9,12,0.00001,0.00008,0,14610,5,0.000013,15,0.157968,0.171221,2608.514147,0.090909,0.000697
9406176,9406176,,1,3,4,1,3,4,0.000001,0.000035,0,14609,28,0.000011,4,0.322785,0.361111,86.161702,0.083333,0.000239
7103,7103,,0,2,2,0,2,2,0,0.00033,0,14611,9,0.00001,12,0.165484,0.181112,0,0,0
9611033,9611033,,4,8,12,4,8,12,0.000018,0.000003,0,8912,9,0.000018,9,0.207529,0.23443,8340.243442,0.204545,0.00093
9305078,9305078,,7,1,8,7,1,8,0,0,0,3184,9,0.000027,1,1,1,1508.044388,0.125,0.001822
9504084,9504084,,16,8,24,16,8,24,0.000016,0.000001,0,3947,9,0.000037,5,0.32906,0.404329,1763.482592,0.155797,0.004096
9504138,9504138,,14,11,25,14,11,25,0.000016,0.000003,0,3959,9,0.000027,6,0.295635,0.37226,56050.676391,0.15,0.003462
9512220,9512220,,2,2,4,2,2,4,0,0.000004,0,8911,9,0.000014,8,0.233275,0.253086,2768.979461,0.083333,0.000478
9604165,9604165,,12,19,31,12,19,31,0.00003,0.000002,0,3966,9,0.000029,7,0.283051,0.389877,87907.435434,0.101075,0.002831
7104,7104,,8,11,19,8,11,19,0.001435,0.008536,0,14612,1,0.000014,13,0.187728,0.209769,4243.245439,0.157895,0.002433
7105,7105,,6,7,13,6,7,13,0.000142,0.000029,0,14617,28,0.000014,6,0.395349,0.601961,1691.413163,0.435897,0.001489
9810115,9810115,,5,5,10,5,5,10,0.000007,0.000023,0,14616,28,0.000014,5,0.424242,0.585714,2446.029864,0.422222,0.001265
9810119,9810119,,9,4,13,9,4,13,0.000357,0.000023,0,14614,28,0.000018,2,0.833333,0.9,117.233766,0.358974,0.002312
9906156,9906156,,7,3,10,7,3,10,0.000143,0.00001,0,14613,28,0.000016,2,0.636364,0.714286,17.508753,0.4,0.001749
9312147,9312147,,1,1,2,1,1,2,0,0.000008,0,2109,28,0.000041,1,1,1,0,0.5,0.000421
9711088,9711088,,2,5,7,2,5,7,0,0.00002,0,14615,28,0.000015,4,0.521739,0.659722,64.363197,0.238095,0.000473
7106,7106,,22,31,53,22,31,53,0.001868,0.008794,0,13039,30,0.000018,14,0.207448,0.232522,8715.251025,0.198476,0.00722
7107,7107,,18,16,34,18,16,34,0.000589,0.001783,0,12944,30,0.000021,15,0.196465,0.216637,20497.542312,0.141711,0.006328
7108,7108,,2,1,3,2,1,3,0,0.000001,0,14618,23,0.000014,16,0.123776,0.139074,0,0.333333,0.000445
107135,107135,,1,4,5,1,4,5,0,0.000002,0,14620,23,0.000011,16,0.127111,0.145187,635.787475,0.15,0.000232
11196,11196,,6,7,13,6,7,13,0.000076,0.000004,0,14619,23,0.000015,15,0.144133,0.17018,5582.230027,0.179487,0.001394
7110,7110,,1,39,40,1,39,40,0.00003,0.006196,0,14622,0,0.00001,12,0.216468,0.249352,2121.904039,0.154487,0.000219
9912159,9912159,,2,13,15,2,13,15,0.000146,0.003569,0,14621,13,0.00001,14,0.194372,0.222573,547.868483,0.133333,0.000465
9306085,9306085,,4,2,6,4,2,6,0.000022,0.000143,0,352,13,0.00002,1,1,1,3.015152,0.266667,0.0011
9201045,9201045,,1,0,1,1,0,1,0.000017,0,0,368,0,0.000024,0,0,0,0,0,0.000794
9303171,9303171,,2,1,3,2,1,3,0.000071,0.000003,0,363,0,0.000045,1,1,1,4.201125,0.166667,0.001697
9502144,9502144,,7,5,12,7,5,12,0.00029,0.000029,0,1704,0,0.000017,6,0.263265,0.315116,12176.647915,0.083333,0.002113
7111,7111,,0,3,3,0,3,3,0,0,0,14624,20,0.00001,1,1,1,0,0.166667,0
9903236,9903236,,1,0,1,1,0,1,0,0,0,14623,20,0.000013,0,0,0,0,0,0.000219
7112,7112,,0,2,2,0,2,2,0,0.001652,0,14626,23,0.00001,18,0.149073,0.163777,0,0,0
9911125,9911125,,6,14,20,6,14,20,0.00002,0.000127,0,14625,23,0.000023,17,0.172906,0.195146,44134.563573,0.105263,0.00138
9511015,9511015,,9,0,9,9,0,9,0.000017,0,0,4767,23,0.000072,0,0,0,0,0.152778,0.002196
9602157,9602157,,9,2,11,9,2,11,0.000003,0.00186,0,5795,23,0.000033,6,0.263804,0.29832,910.546556,0.1,0.002179
9712248,9712248,,4,3,7,4,3,7,0.000002,0.000003,0,10353,23,0.000026,12,0.122037,0.132044,1089.673468,0.214286,0.001007
9806007,9806007,,5,2,7,5,2,7,0.000003,0,0,10354,23,0.000021,13,0.108929,0.116479,3000.578101,0.333333,0.00131
9901039,9901039,,7,5,12,7,5,12,0.000004,0.000003,0,10355,23,0.000022,12,0.131141,0.152447,9843.951143,0.166667,0.001721
7113,7113,,0,12,12,0,12,12,0,0.000049,0,14627,4,0.00001,14,0.175615,0.190427,0,0.219697,0
9809037,9809037,,4,3,7,4,3,7,0.000002,0.000022,0,10367,4,0.000014,16,0.153875,0.170025,54.321019,0.261905,0.00091
7114,7114,,0,8,8,0,8,8,0,0.002102,0,14628,30,0.00001,13,0.185407,0.201683,0,0.053571,0
9302010,9302010,,5,0,5,5,0,5,0.000026,0,0,5112,26,0.000031,0,0,0,0,0.15,0.001172
9302019,9302019,,3,0,3,3,0,3,0.000026,0,0,5474,15,0.000022,0,0,0,0,0,0.000697
9304110,9304110,,2,0,2,2,0,2,0.000026,0,0,14523,26,0.000012,0,0,0,0,0,0.000465
7115,7115,,2,20,22,2,20,22,0.000153,0.00276,0,14629,0,0.000011,15,0.2056,0.236665,2175.226043,0.201299,0.000451
7116,7116,,7,9,16,7,9,16,0.000134,0.000554,0,14630,6,0.000016,12,0.168436,0.208931,372.776913,0.1625,0.001633
7119,7119,,5,16,21,5,16,21,0.000001,0.000012,0,14631,23,0.000017,19,0.138072,0.153981,5065.581704,0.145238,0.001141
7121,7121,,8,3,11,8,3,11,0.000018,0,0,14633,5,0.000023,18,0.089876,0.097464,1533.253686,0.154545,0.001853
9508077,9508077,,4,0,4,4,0,4,0.000018,0,0,14632,5,0.000019,0,0,0,0,0.416667,0.000951
9608142,9608142,,4,0,4,4,0,4,0,0,0,4517,5,0.000024,0,0,0,0,0.083333,0.000954
7122,7122,,1,20,21,1,20,21,0,0.001134,0,14636,30,0.000011,13,0.192781,0.211338,7988.250858,0.07619,0.000219
9312174,9312174,,2,4,6,2,4,6,0.000013,0.000003,0,14635,22,0.000012,1,1,1,7.25,0,0.000445
9202024,9202024,,1,0,1,1,0,1,0,0,0,14634,22,0.000013,0,0,0,0,0,0.000232
7123,7123,,2,4,6,2,4,6,0,0.000808,0,14648,22,0.000011,15,0.14376,0.159862,39.754688,0.2,0.000445
9905229,9905229,,3,30,33,3,30,33,0.00001,0.000045,0,14647,22,0.000014,14,0.16747,0.194875,9619.18663,0.039773,0.000677
9503236,9503236,,3,2,5,3,2,5,0.000001,0.000001,0,14646,22,0.000016,3,0.409091,0.462963,373.677783,0.05,0.000685
9704128,9704128,,3,5,8,3,5,8,0.000001,0.000174,0,11973,22,0.000016,4,0.438356,0.513021,97.344169,0.232143,0.000684
9707147,9707147,,1,1,2,1,1,2,0.000001,0,0,14645,22,0.00001,1,1,1,4,0,0.000239
9810113,9810113,,9,23,32,9,23,32,0.000001,0.000006,0,14639,6,0.000028,13,0.13168,0.155915,12056.974472,0.139113,0.00209
9811218,9811218,,1,2,3,1,2,3,0.000001,0.000021,0,14644,4,0.00001,14,0.14344,0.160827,868.051191,0.166667,0.000239
9903176,9903176,,5,29,34,5,29,34,0.000001,0.00001,0,14643,6,0.000014,12,0.149351,0.177588,9513.057503,0.118538,0.001135
7124,7124,,19,10,29,19,10,29,0.00075,0.000133,0,14649,25,0.00002,13,0.183311,0.201647,15405.695555,0.139163,0.005048
7126,7126,,8,25,33,8,25,33,0.000281,0.004336,0,12902,3,0.000013,13,0.20258,0.230719,20644.448948,0.100379,0.002372
9309116,9309116,,2,1,3,2,1,3,0.000009,0.000007,0,1939,3,0.000015,1,1,1,0,0.333333,0.000587
7127,7127,,10,14,24,10,14,24,0.000391,0.004306,0,12869,30,0.000027,13,0.197806,0.218545,24543.126141,0.173913,0.002688
7128,7128,,1,5,6,1,5,6,0,0.000006,0,14650,20,0.00001,13,0.163651,0.176255,1.406505,0.3,0.000226
7129,7129,,2,6,8,2,6,8,0.000005,0.000001,0,14651,5,0.000011,4,0.5,0.627451,217.038707,0.196429,0.000451
9304031,9304031,,5,0,5,5,0,5,0.000002,0,0,5628,17,0.000042,0,0,0,0,0.25,0.001289
9405140,9405140,,5,0,5,5,0,5,0.000002,0,0,5627,17,0.000042,0,0,0,0,0.25,0.001289
7130,7130,,3,25,28,3,25,28,0.000283,0.021841,0,14652,3,0.000014,14,0.226985,0.260113,18033.274415,0.113757,0.000697
7131,7131,,25,23,48,25,23,48,0.000764,0.002314,0,13030,30,0.00003,14,0.194811,0.215997,11539.306777,0.164894,0.008647
9907205,9907205,,2,2,4,2,2,4,0.000263,0.000054,0,13029,1,0.000012,14,0.175597,0.192777,1265.466921,0.083333,0.000644
7132,7132,,2,1,3,2,1,3,0,0,6,14654,24,0.000027,1,1,1,2,0.166667,0.000445
9302093,9302093,,2,0,2,2,0,2,0,0,6,14653,24,0.000039,0,0,0,0,0,0.000451
7133,7133,,2,21,23,2,21,23,0.000109,0.003557,0,14655,4,0.00001,14,0.202415,0.235012,835.247976,0.300395,0.000445
7134,7134,,1,8,9,1,8,9,0.000128,0.000949,0,14657,1,0.00001,16,0.185481,0.210687,68.087854,0.083333,0.000226
9911120,9911120,,1,2,3,1,2,3,0.000011,0.00006,0,14656,0,0.000011,12,0.17503,0.190967,91.371718,0.166667,0.000226
7135,7135,,6,4,10,6,4,10,0.000021,0.000002,0,14658,23,0.000023,15,0.132585,0.14443,8561.169184,0.111111,0.001387
7136,7136,,1,4,5,1,4,5,0,0.000006,0,14659,23,0.000013,15,0.154737,0.169745,3138.665461,0.25,0.000219
7137,7137,,8,14,22,8,14,22,0.000463,0.002696,0,12861,30,0.000014,12,0.215861,0.238155,17158.531121,0.147186,0.00225
7138,7138,,8,4,12,8,4,12,0.000039,0.000015,0,14666,8,0.000032,14,0.161984,0.178804,19109.772804,0.128788,0.001952
9603092,9603092,,5,4,9,5,4,9,0.000001,0.000003,0,14665,8,0.000024,2,0.642857,0.722222,4052.962747,0.097222,0.00115
9908031,9908031,,3,3,6,3,3,6,0.000013,0.005697,0,14662,8,0.000019,14,0.182323,0.204114,7478.79513,0.133333,0.000725
9407060,9407060,,6,0,6,6,0,6,0.000014,0,0,6231,23,0.000035,0,0,0,0,0.033333,0.001431
9502044,9502044,,3,0,3,3,0,3,0,0,0,14664,8,0.000018,0,0,0,0,0.333333,0.000691
9503136,9503136,,4,0,4,4,0,4,0,0,0,14663,8,0.000025,0,0,0,0,0.25,0.000929
9804021,9804021,,7,11,18,7,11,18,0.00029,0.004558,0,14661,2,0.000021,14,0.193137,0.222446,7827.235468,0.153595,0.001628
7139,7139,,1,2,3,1,2,3,0,0,0,14667,8,0.000014,1,1,1,1,0.333333,0.000219
7141,7141,,5,23,28,5,23,28,0.000433,0.000942,0,14668,52,0.000011,17,0.205174,0.22999,3352.60811,0.166667,0.001543
7142,7142,,7,13,20,7,13,20,0.00051,0.006613,0,14669,22,0.000014,13,0.195235,0.216845,74027.789113,0.068421,0.001735
7143,7143,,7,9,16,7,9,16,0.000374,0.003434,0,14670,30,0.000012,12,0.210183,0.232197,1173.096552,0.145833,0.001706
7144,7144,,7,1,8,7,1,8,0.000018,0.000001,0,14671,15,0.000022,1,1,1,4.45,0.267857,0.001648
9408025,9408025,,10,0,10,10,0,10,0.000051,0,0,7873,15,0.000053,0,0,0,0,0.044444,0.002415
7145,7145,,10,37,47,10,37,47,0.000425,0.002355,0,14672,52,0.000014,14,0.199087,0.226745,48972.815389,0.138298,0.003131
7146,7146,,94,20,114,94,20,114,0.010414,0.005379,0,14673,8,0.000107,13,0.193382,0.219038,76537.819032,0.066139,0.036811
7147,7147,,33,35,68,33,35,68,0.003393,0.008687,0,13044,30,0.000022,13,0.21189,0.237072,27226.574975,0.158911,0.011241
7148,7148,,3,13,16,3,13,16,0,0.000006,0,14674,23,0.000018,14,0.160752,0.180523,7338.69534,0.0875,0.000711
7149,7149,,0,6,6,0,6,6,0,0.000004,0,14679,20,0.00001,18,0.131211,0.141568,0,0.2,0
9905093,9905093,,1,4,5,1,4,5,0,0.000022,0,14678,26,0.000011,17,0.150702,0.165715,5445,0.05,0.000219
9910002,9910002,,2,3,5,2,3,5,0.000151,0.000004,0,14675,20,0.000012,2,0.8,0.875,2.75,0.2,0.000438
9808102,9808102,,7,9,16,7,9,16,0.000001,0.000006,0,14677,26,0.000022,10,0.165797,0.191646,5089.855278,0.1,0.001654
7150,7150,,4,15,19,4,15,19,0.000001,0.000007,0,14680,22,0.000013,11,0.177871,0.216519,357.225364,0.251462,0.000923
7151,7151,,0,2,2,0,2,2,0,0,0,14682,6,0.00001,13,0.140917,0.154806,0,0,0
9908050,9908050,,6,8,14,6,8,14,0,0.000004,0,14681,6,0.000025,12,0.162659,0.18213,12589.696981,0.120879,0.001375
9209054,9209054,,20,0,20,20,0,20,0.000014,0,0,3079,6,0.00007,0,0,0,0,0.031579,0.004813
9412192,9412192,,4,6,10,4,6,10,0,0.000005,0,7810,6,0.000014,3,0.56,0.678571,44.051526,0.122222,0.00097
9502053,9502053,,6,9,15,6,9,15,0,0.000004,0,7809,6,0.000023,3,0.531915,0.64,420.929992,0.109524,0.001435
9502129,9502129,,5,6,11,5,6,11,0.000004,0.000002,0,7808,6,0.000014,4,0.44,0.556818,630.944421,0.136364,0.00123
9808153,9808153,,4,4,8,4,4,8,0,0.000009,0,10950,6,0.000024,8,0.23507,0.274524,1953.230073,0.125,0.000944
7152,7152,,1,9,10,1,9,10,0,0.000031,0,14683,22,0.000011,16,0.162215,0.178208,10325.444692,0.255556,0.000274
7153,7153,,49,29,78,49,29,78,0.001827,0.001437,0,12878,3,0.000048,14,0.200575,0.221962,25632.323383,0.197469,0.027519
9202062,9202062,,5,0,5,5,0,5,0.000039,0,0,522,3,0.000026,0,0,0,0,0.1,0.002285
9205085,9205085,,14,0,14,14,0,14,0.000116,0,0,475,3,0.000093,0,0,0,0,0.087912,0.00406
7154,7154,,9,17,26,9,17,26,0.001118,0.002658,0,14684,52,0.000014,17,0.213093,0.240331,12557.234429,0.144615,0.002965
7155,7155,,0,18,18,0,18,18,0,0.005099,0,14686,30,0.00001,13,0.198826,0.220863,0,0.173203,0
9808166,9808166,,2,10,12,2,10,12,0.000104,0.002295,0,14685,2,0.000012,14,0.18231,0.208418,366.118994,0.113636,0.000683
7156,7156,,20,7,27,20,7,27,0.000561,0.001184,0,14687,30,0.000031,15,0.18479,0.202457,2450.038026,0.163818,0.006704
7157,7157,,16,25,41,16,25,41,0.001926,0.004191,0,14688,2,0.000016,16,0.219458,0.252398,26786.576378,0.096341,0.004897
7158,7158,,11,70,81,11,70,81,0.000543,0.007233,0,12918,3,0.000014,15,0.220377,0.253131,70051.719506,0.106481,0.003228
9711021,9711021,,3,5,8,3,5,8,0.000185,0.001753,0,5703,2,0.000012,14,0.168347,0.193466,36.196257,0.357143,0.000959
7160,7160,,2,25,27,2,25,27,0.000106,0.001321,0,14689,30,0.000011,13,0.197111,0.217311,2381.859632,0.146724,0.000493
7161,7161,,5,11,16,5,11,16,0.000001,0.000003,0,14690,17,0.000013,12,0.165041,0.200066,499.69813,0.175,0.001169
7162,7162,,0,4,4,0,4,4,0,0,0,14693,22,0.00001,1,1,1,0,0.25,0
9304108,9304108,,3,0,3,3,0,3,0,0,0,14691,22,0.000021,0,0,0,0,0.166667,0.000697
9511013,9511013,,4,3,7,4,3,7,0.000001,0,0,14692,22,0.000019,1,1,1,1190.594712,0.119048,0.000903
7164,7164,,2,4,6,2,4,6,0.000347,0.000013,0,14695,52,0.00001,15,0.132463,0.1453,1108.426754,0.1,0.000666
9412075,9412075,,4,3,7,4,3,7,0.000006,0.000042,0,14694,5,0.000017,2,0.714286,0.8,241.570414,0.166667,0.001035
9303099,9303099,,17,2,19,17,2,19,0.000135,0.000005,0,2629,5,0.00007,1,1,1,13027.441408,0.052632,0.00455
7165,7165,,1,5,6,1,5,6,0,0.000032,0,14696,22,0.000012,15,0.157714,0.172335,5495,0.066667,0.000219
9307109,9307109,,4,1,5,4,1,5,0,0,0,10102,22,0.000027,1,1,1,12.5,0.05,0.00089
7166,7166,,7,19,26,7,19,26,0.000418,0.005229,0,13047,30,0.000019,15,0.199953,0.224454,43432.375517,0.130769,0.002078
7167,7167,,0,2,2,0,2,2,0,0,0,14697,22,0.00001,2,0.666667,0.75,0,0.5,0
7168,7168,,22,26,48,22,26,48,0.001484,0.001717,0,13046,30,0.000018,14,0.206255,0.229552,16396.234914,0.182624,0.00617
7169,7169,,9,21,30,9,21,30,0.00014,0.001768,0,14698,6,0.000018,13,0.189843,0.219935,9274.647338,0.085057,0.002071
7170,7170,,78,262,340,78,262,340,0.011123,0.054702,0,12445,2,0.000046,12,0.265307,0.319296,965866.371288,0.035034,0.023078
9409062,9409062,,7,3,10,7,3,10,0.000076,0.000029,0,1076,13,0.000017,4,0.304636,0.355072,4852.339092,0.144444,0.00182
7171,7171,,5,40,45,5,40,45,0.000345,0.016019,0,14699,2,0.000013,14,0.214838,0.245224,10796.446284,0.119697,0.001476
7172,7172,,4,15,19,4,15,19,0.000222,0.000123,0,14703,5,0.000015,14,0.170223,0.193699,16092.765981,0.187135,0.001086
9905089,9905089,,3,35,38,3,35,38,0.000409,0.001734,0,14702,5,0.000011,13,0.197599,0.232731,22120.558281,0.125178,0.000833
9405072,9405072,,10,24,34,10,24,34,0.000413,0.000118,0,6517,5,0.000023,3,0.692308,0.814815,14002.027167,0.059715,0.002489
9706123,9706123,,2,14,16,2,14,16,0.000006,0.000398,0,9839,1,0.000014,11,0.179216,0.202836,23027.457053,0.15,0.000535
9808109,9808109,,4,6,10,4,6,10,0.000589,0.000081,0,9062,5,0.000012,15,0.15159,0.170888,1313.241051,0.233333,0.001152
9904070,9904070,,12,19,31,12,19,31,0.00093,0.002134,0,14701,5,0.000014,13,0.178651,0.204049,6818.10513,0.158065,0.00322
9905007,9905007,,9,13,22,9,13,22,0.000911,0.002197,0,11615,5,0.000017,13,0.182291,0.206822,10437.017883,0.090909,0.002359
7173,7173,,8,38,46,8,38,46,0.000812,0.006186,0,12984,52,0.000013,12,0.214853,0.245379,16084.998438,0.155556,0.002491
9908129,9908129,,5,31,36,5,31,36,0.000278,0.006102,0,12983,4,0.000012,12,0.214383,0.242483,6776.01352,0.084921,0.001365
7174,7174,,27,18,45,27,18,45,0.001449,0.000372,0,14704,52,0.000021,15,0.169537,0.189193,9741.76775,0.141414,0.007082
7175,7175,,64,19,83,64,19,83,0.00375,0.00337,0,12876,3,0.000053,12,0.201997,0.223711,56062.84687,0.076256,0.024006
7176,7176,,7,5,12,7,5,12,0.000143,0.000273,0,12948,30,0.000016,15,0.17666,0.191787,4616.049796,0.113636,0.002246
9510155,9510155,,3,26,29,3,26,29,0.000004,0.000436,0,4804,26,0.000013,9,0.223684,0.28829,3169.058822,0.140394,0.000738
9608144,9608144,,6,7,13,6,7,13,0.000009,0.000025,0,4803,26,0.000017,10,0.192204,0.23973,30433.964177,0.160256,0.001427
9707080,9707080,,6,10,16,6,10,16,0.000009,0.000205,0,12005,26,0.000016,6,0.304348,0.390278,115.915205,0.183333,0.001415
7181,7181,,19,14,33,19,14,33,0.000518,0.002718,0,14705,30,0.000028,13,0.193479,0.213482,13440.021863,0.14678,0.005106
7182,7182,,1,1,2,1,1,2,0,0.000001,0,14706,28,0.000013,11,0.154525,0.171556,0,0.5,0.000219
7183,7183,,3,19,22,3,19,22,0.000001,0.000013,0,14711,23,0.000015,14,0.150414,0.16827,48191.708613,0.175325,0.000713
9412140,9412140,,10,0,10,10,0,10,0.000025,0,0,10043,23,0.000034,0,0,0,0,0.211111,0.002516
9710022,9710022,,4,1,5,4,1,5,0,0,0,12620,23,0.000014,1,1,1,1570.986146,0.2,0.001025
9807221,9807221,,3,5,8,3,5,8,0,0.000002,0,14710,23,0.000015,13,0.14958,0.162165,4363.14304,0.160714,0.000684
9808027,9808027,,6,9,15,6,9,15,0.000001,0.000007,0,13939,23,0.00002,14,0.130835,0.141284,18996.685307,0.209524,0.001403
9811073,9811073,,2,1,3,2,1,3,0,0,0,14709,23,0.000012,1,1,1,0,0.333333,0.000459
9902002,9902002,,1,17,18,1,17,18,0,0.000019,0,14708,23,0.000011,13,0.165021,0.182504,36321.119089,0.222222,0.000239
9911028,9911028,,5,15,20,5,15,20,0.000001,0.000008,0,14707,23,0.000015,13,0.154579,0.171083,37418.328882,0.305263,0.001196
9612140,9612140,,4,0,4,4,0,4,0,0,0,9150,28,0.000032,0,0,0,0,0.166667,0.000952
9511135,9511135,,2,0,2,2,0,2,0.000001,0,0,9178,22,0.000018,0,0,0,0,0,0.000731
9710088,9710088,,2,5,7,2,5,7,0,0.000039,0,12623,23,0.000012,14,0.145618,0.163362,644.243389,0.142857,0.000526
9411132,9411132,,2,0,2,2,0,2,0.000001,0,0,6541,23,0.000013,0,0,0,0,0,0.000479
9410031,9410031,,3,1,4,3,1,4,0,0,0,9250,23,0.000024,1,1,1,0,0.25,0.000711
9707058,9707058,,2,2,4,2,2,4,0,0,0,9251,23,0.000024,1,1,1,1268.446868,0.083333,0.000479
9406041,9406041,,1,0,1,1,0,1,0.000024,0,0,10044,4,0.000011,0,0,0,0,0,0.000346
9511141,9511141,,3,5,8,3,5,8,0.000032,0.000018,0,2114,28,0.000015,2,0.777778,0.857143,29970.498085,0.125,0.000817
9610241,9610241,,7,12,19,7,12,19,0.000024,0.000005,0,12029,26,0.000021,6,0.306818,0.444444,4350.977942,0.081871,0.001633
7184,7184,,9,26,35,9,26,35,0.000302,0.000602,0,14712,25,0.000014,16,0.194199,0.216216,3549.951731,0.201681,0.002227
7185,7185,,7,4,11,7,4,11,0.000058,0.001103,0,14713,5,0.000016,14,0.186225,0.210951,9557.78922,0.118182,0.001803
7186,7186,,2,10,12,2,10,12,0.000087,0.001395,0,14714,30,0.000012,14,0.194256,0.212736,9563.74538,0.174242,0.000715
7187,7187,,5,8,13,5,8,13,0.00001,0.000007,0,14715,9,0.000014,11,0.152941,0.193366,3753.487689,0.230769,0.001187
7188,7188,,0,10,10,0,10,10,0,0.000023,0,14716,26,0.00001,14,0.16137,0.187233,0,0.188889,0
9212068,9212068,,21,1,22,21,1,22,0.000178,0.000002,0,7372,26,0.000169,1,1,1,278.752098,0.054113,0.004995
9406073,9406073,,4,2,6,4,2,6,0.000177,0.000004,0,9452,26,0.000075,1,1,1,783.381987,0.233333,0.000944
9705087,9705087,,14,18,32,14,18,32,0.000184,0.002313,0,7564,26,0.000025,13,0.191196,0.232239,24414.821683,0.09879,0.003239
9804132,9804132,,17,7,24,17,7,24,0.000183,0.000139,0,7565,26,0.000027,14,0.160819,0.184491,45820.327883,0.115942,0.003825
9607134,9607134,,7,9,16,7,9,16,0.000028,0.000008,0,7562,26,0.000027,10,0.180699,0.209116,17919.51938,0.120833,0.001722
7189,7189,,14,4,18,14,4,18,0.000002,0.000008,0,14717,5,0.000029,14,0.124115,0.148751,100.704185,0.186275,0.003351
7191,7191,,196,46,242,196,46,242,0.030995,0.026862,0,11599,1,0.00012,16,0.216167,0.24655,166445.599455,0.047769,0.068645
9806249,9806249,,8,5,13,8,5,13,0.00035,0.006837,0,10492,8,0.000026,14,0.178889,0.199953,12567.312282,0.128205,0.00204
9912017,9912017,,4,3,7,4,3,7,0.000101,0.000011,0,14490,8,0.000014,14,0.148365,0.161001,82.734198,0.333333,0.00097
9601107,9601107,,1,2,3,1,2,3,0,0.000004,0,10494,8,0.000015,2,0.75,0.833333,2934.993646,0.333333,0.000267
7194,7194,,0,4,4,0,4,4,0,0.000007,0,14719,4,0.00001,11,0.152989,0.177123,0,0.333333,0
9801010,9801010,,2,5,7,2,5,7,0.000001,0.00001,0,14718,4,0.000014,10,0.179077,0.212379,476.366667,0.285714,0.000451
7195,7195,,10,143,153,10,143,153,0.001548,0.03868,0,14724,13,0.000013,16,0.242707,0.292163,133606.337797,0.06566,0.002458
9310006,9310006,,1,2,3,1,2,3,0.000454,0.000001,0,14723,15,0.00001,2,0.75,0.833333,193.333695,0.166667,0.000288
9707108,9707108,,1,9,10,1,9,10,0.000454,0.00002,0,14722,23,0.00001,10,0.210992,0.251242,11536.726133,0.155556,0.000288
9712203,9712203,,2,1,3,2,1,3,0.000455,0.000004,0,14721,26,0.00001,9,0.168378,0.212694,208.300007,0,0.000507
9812026,9812026,,5,10,15,5,10,15,0.000456,0.000143,0,14720,0,0.000017,11,0.181915,0.203856,8199.366813,0.195238,0.001177
9701106,9701106,,7,15,22,7,15,22,0.000265,0.003006,0,4620,13,0.000013,13,0.205026,0.246219,67575.19161,0.12987,0.001937
9512117,9512117,,9,10,19,9,10,19,0.00017,0.000365,0,5343,13,0.000018,9,0.181649,0.20902,7618.914339,0.143275,0.002755
9610163,9610163,,5,10,15,5,10,15,0.000029,0.000142,0,5347,13,0.000014,11,0.186107,0.221488,40619.710161,0.204762,0.001194
9704083,9704083,,12,3,15,12,3,15,0.000185,0.000258,0,5337,13,0.000025,14,0.161935,0.191451,21359.95115,0.247619,0.003007
9505193,9505193,,4,3,7,4,3,7,0.000001,0.000009,0,13819,5,0.000015,3,0.533333,0.645833,53.576617,0.285714,0.000966
7197,7197,,7,19,26,7,19,26,0.000153,0.001485,0,12361,25,0.000015,12,0.20016,0.220868,20398.466254,0.12,0.002049
9903016,9903016,,1,1,2,1,1,2,0.000017,0,0,12353,23,0.000011,1,1,1,2910,0,0.000272
8177,8177,,27,17,44,27,17,44,0.001391,0.002165,0,12788,25,0.000026,15,0.189738,0.211824,27714.506013,0.168076,0.007276
8055,8055,,7,15,22,7,15,22,0.000222,0.002451,0,12362,25,0.000014,15,0.188875,0.211084,9992.165804,0.168831,0.002057
9606121,9606121,,4,0,4,4,0,4,0,0,0,12352,23,0.000027,0,0,0,0,0.25,0.00091
7198,7198,,3,20,23,3,20,23,0.000272,0.007518,0,14726,2,0.000011,13,0.210991,0.236031,734.51368,0.171937,0.000671
9612212,9612212,,6,0,6,6,0,6,0.000089,0,0,9799,20,0.000045,0,0,0,0,0.133333,0.001478
9902149,9902149,,7,35,42,7,35,42,0.000404,0.026188,0,14725,2,0.000013,13,0.200741,0.234303,1586.424676,0.101626,0.001775
7200,7200,,6,16,22,6,16,22,0.00167,0.020144,0,14727,1,0.000011,16,0.213436,0.248268,141.153776,0.404762,0.001582
7202,7202,,3,19,22,3,19,22,0.000573,0.001859,0,14729,1,0.000012,13,0.194846,0.218182,6381.724536,0.199134,0.000844
9806213,9806213,,2,25,27,2,25,27,0.000333,0.019497,0,14728,1,0.00001,12,0.201304,0.232677,608.682756,0.209402,0.00046
7207,7207,,1,10,11,1,10,11,0,0.000044,0,14730,5,0.000011,15,0.153188,0.169438,765.030266,0.109091,0.000234
9505030,9505030,,7,9,16,7,9,16,0.000235,0.000084,0,6538,5,0.000014,4,0.424779,0.505208,14498.884282,0.066667,0.001781
9311079,9311079,,6,4,10,6,4,10,0.000003,0.000032,0,6536,5,0.00003,1,1,1,6803.381756,0.111111,0.001503
7208,7208,,6,12,18,6,12,18,0.000007,0.000069,0,14731,22,0.000015,13,0.180886,0.200629,10293.790512,0.173203,0.001421
9204061,9204061,,7,0,7,7,0,7,0.000006,0,0,1557,5,0.000025,0,0,0,0,0.119048,0.001733
7210,7210,,1,2,3,1,2,3,0.000005,0.000029,0,14732,13,0.00001,14,0.156649,0.173656,5.375525,0,0.000219
7211,7211,,10,45,55,10,45,55,0.001698,0.024358,0,14733,1,0.000016,11,0.216226,0.244926,64590.617858,0.10404,0.003988
7212,7212,,0,21,21,0,21,21,0,0.003028,0,14734,0,0.00001,14,0.199869,0.227995,0,0.17619,0
7213,7213,,17,10,27,17,10,27,0.000403,0.000677,0,14735,0,0.000024,13,0.192906,0.21628,7444.839515,0.126781,0.005539
7214,7214,,3,11,14,3,11,14,0.000003,0.000011,0,14736,6,0.000013,15,0.131751,0.14439,6507.350021,0.164835,0.000739
7215,7215,,29,36,65,29,36,65,0.003101,0.004904,0,13048,30,0.000019,14,0.210271,0.236464,19412.829412,0.144471,0.007518
7216,7216,,1,7,8,1,7,8,0,0.000015,0,14737,5,0.000011,16,0.15484,0.171416,135.173868,0.142857,0.000219
9507079,9507079,,4,0,4,4,0,4,0,0,0,5349,5,0.000043,0,0,0,0,0.333333,0.000958
9509060,9509060,,3,1,4,3,1,4,0,0,0,5350,5,0.000024,1,1,1,106.14533,0.416667,0.000746
9711065,9711065,,1,0,1,1,0,1,0,0,0,11755,23,0.000017,0,0,0,0,0,0.00026
9806027,9806027,,5,4,9,5,4,9,0.000193,0.000011,0,11751,5,0.000028,6,0.25266,0.304561,8350.61617,0.041667,0.00117
9809096,9809096,,1,8,9,1,8,9,0.000183,0.000844,0,11754,41,0.000011,16,0.1539,0.170011,2495.008901,0.125,0.000273
9812045,9812045,,2,6,8,2,6,8,0.000183,0.000002,0,11742,23,0.000011,5,0.344828,0.4325,12979.978965,0.160714,0.000506
9812076,9812076,,1,17,18,1,17,18,0.000183,0.000013,0,11735,28,0.000011,13,0.158116,0.188285,105004.616155,0.117647,0.000273
7217,7217,,30,17,47,30,17,47,0.001305,0.002706,0,12870,30,0.000034,14,0.202864,0.224539,103436.950944,0.151249,0.013808
7219,7219,,1,3,4,1,3,4,0,0.000002,0,14738,9,0.000012,9,0.175439,0.194108,0,0.5,0.000219
7220,7220,,17,10,27,17,10,27,0.000371,0.000027,0,14739,23,0.000029,18,0.138022,0.159579,63933.742442,0.116809,0.004307
7221,7221,,2,3,5,2,3,5,0.000015,0.000251,0,14740,0,0.000024,13,0.188575,0.205743,205.36658,0.2,0.000772
7222,7222,,5,31,36,5,31,36,0.000307,0.020049,0,14741,1,0.000013,13,0.220084,0.254158,51174.627773,0.142857,0.001493
7224,7224,,2,1,3,2,1,3,0,0,0,14742,15,0.000026,17,0.160682,0.173091,4781,0.333333,0.000458
7225,7225,,1,8,9,1,8,9,0.000018,0.000182,0,14744,2,0.00001,13,0.186829,0.20313,582.788046,0.111111,0.000239
9506145,9506145,,2,3,5,2,3,5,0.000002,0.002171,0,14743,4,0.000013,7,0.243781,0.278705,109.251182,0.15,0.000445
7226,7226,,59,19,78,59,19,78,0.002859,0.001533,0,12858,3,0.00006,15,0.199298,0.219762,44889.292283,0.140027,0.027643
7227,7227,,2,4,6,2,4,6,0.000348,0.000054,0,14749,1,0.00001,11,0.189569,0.205881,6059.401766,0.033333,0.000445
9912111,9912111,,4,12,16,4,12,16,0.000003,0.000033,0,14748,6,0.000015,12,0.166551,0.189695,4744.539068,0.066667,0.000929
9907147,9907147,,1,8,9,1,8,9,0,0.000017,0,14747,6,0.000011,12,0.156466,0.186372,1729.505169,0.152778,0.000246
7228,7228,,1,6,7,1,6,7,0.000005,0.000275,0,14750,2,0.00001,13,0.197537,0.215514,470.442678,0.261905,0.000239
7229,7229,,0,2,2,0,2,2,0,0.000001,0,14751,23,0.00001,11,0.151309,0.167539,0,0,0
7230,7230,,4,5,9,4,5,9,0.000009,0.000001,0,14754,23,0.000015,12,0.142677,0.180844,772.740893,0.097222,0.001009
9904084,9904084,,2,4,6,2,4,6,0.000002,0,0,14753,23,0.000013,9,0.178846,0.230797,367.036584,0.1,0.000466
9506166,9506166,,3,2,5,3,2,5,0,0.000003,0,8383,23,0.000015,1,1,1,0,0.35,0.00082
9701050,9701050,,2,2,4,2,2,4,0.000002,0.000001,0,14752,23,0.000014,4,0.463415,0.513158,132.364957,0,0.000465
7231,7231,,18,28,46,18,28,46,0.000274,0.000934,0,14755,2,0.000023,14,0.206169,0.230072,48825.526383,0.107729,0.004426
7234,7234,,14,38,52,14,38,52,0.003939,0.022018,0,14756,1,0.000014,11,0.214474,0.240273,8318.597486,0.165535,0.00466
7235,7235,,19,23,42,19,23,42,0.000632,0.002244,0,12875,3,0.000023,14,0.208597,0.235741,66072.546511,0.178281,0.009494
7236,7236,,8,61,69,8,61,69,0.0007,0.012912,0,13052,30,0.000012,13,0.208249,0.240315,40928.268195,0.079071,0.002694
7237,7237,,3,2,5,3,2,5,0.000512,0.00007,0,14757,8,0.000017,13,0.158259,0.167718,28.299817,0.25,0.001753
7238,7238,,1,2,3,1,2,3,0.000052,0.00007,0,14758,8,0.000012,13,0.158259,0.167718,28.299817,0,0.00055
7240,7240,,2,65,67,2,65,67,0.000261,0.005023,0,14763,4,0.000012,14,0.182945,0.216842,4637.978835,0.085029,0.000451
9606022,9606022,,1,9,10,1,9,10,0.000059,0.000044,0,14762,4,0.00001,7,0.287488,0.336743,372.630607,0.166667,0.000232
9811121,9811121,,5,15,20,5,15,20,0.00015,0.000945,0,8695,1,0.000013,15,0.162272,0.184162,51875.497508,0.155263,0.001176
9902108,9902108,,1,8,9,1,8,9,0.000059,0.001099,0,14760,1,0.00001,13,0.176374,0.194745,4434.731447,0.236111,0.000232
9506172,9506172,,2,4,6,2,4,6,0.000001,0.000019,0,14761,4,0.000013,6,0.275325,0.334119,25.329858,0.2,0.000445
9608050,9608050,,2,2,4,2,2,4,0.000006,0.000017,0,5930,1,0.000021,9,0.191728,0.21531,23850.994885,0.083333,0.0006
9608058,9608058,,1,0,1,1,0,1,0.000003,0,0,5926,1,0.000017,0,0,0,0,0,0.000359
9601138,9601138,,3,0,3,3,0,3,0.000073,0,0,4051,28,0.000018,0,0,0,0,0.166667,0.001079
9307023,9307023,,2,0,2,2,0,2,0.00005,0,0,6003,4,0.000014,0,0,0,0,0,0.00064
9810102,9810102,,2,8,10,2,8,10,0.000222,0.016853,0,8694,1,0.000011,14,0.177842,0.200431,4237.303085,0.222222,0.000738
9811049,9811049,,1,17,18,1,17,18,0.000013,0.009683,0,14759,1,0.000011,12,0.18892,0.21612,1062.468151,0.166667,0.000226
7241,7241,,11,15,26,11,15,26,0.001658,0.003301,0,14764,13,0.000014,11,0.202357,0.227696,6275.848654,0.158462,0.002795
7242,7242,,11,7,18,11,7,18,0.000079,0.000004,0,14765,5,0.000022,18,0.089961,0.09935,23806.410464,0.169935,0.002667
7243,7243,,11,45,56,11,45,56,0.000923,0.001635,0,14767,0,0.000022,14,0.207808,0.236764,57557.224517,0.097403,0.003176
9909122,9909122,,6,23,29,6,23,29,0.000181,0.003063,0,14766,0,0.000012,13,0.199204,0.227102,4466.126326,0.174877,0.001672
7245,7245,,1,1,2,1,1,2,0,0,7,14769,27,0.000014,1,1,1,0,0.5,0.000219
7232,7232,,2,0,2,2,0,2,0,0,7,14768,27,0.000027,0,0,0,0,0.5,0.000445
7246,7246,,1,11,12,1,11,12,0.000054,0.004072,0,12370,25,0.00001,18,0.189352,0.210236,6589.041581,0.212121,0.000297
7247,7247,,19,10,29,19,10,29,0.000635,0.000796,0,12949,30,0.000022,14,0.187523,0.20571,19879.9728,0.155172,0.007651
7248,7248,,1,4,5,1,4,5,0,0,0,14771,6,0.000012,6,0.333333,0.540909,12,0.2,0.000232
9710076,9710076,,6,1,7,6,1,7,0.000001,0,0,14770,6,0.000031,6,0.266667,0.36875,3,0.190476,0.0014
10148,10148,,6,12,18,6,12,18,0.000023,0.000003,0,14774,6,0.00002,14,0.147511,0.158324,8813.5494,0.235294,0.00177
8039,8039,,5,16,21,5,16,21,0.000001,0.000071,0,14773,6,0.000017,13,0.171523,0.186171,56869.281775,0.171429,0.001297
9910215,9910215,,3,11,14,3,11,14,0,0.000003,0,14772,6,0.000016,19,0.131992,0.162609,1597.388728,0.263736,0.000839
7249,7249,,1,1,2,1,1,2,0,0,0,14775,18,0.000014,3,0.428571,0.5,0,0.5,0.000219
7250,7250,,14,36,50,14,36,50,0.002823,0.014136,0,14776,1,0.000016,12,0.233603,0.266301,54302.098874,0.137959,0.004608
7252,7252,,8,11,19,8,11,19,0.000489,0.001539,0,14777,25,0.000015,14,0.195005,0.216456,4313.183877,0.152047,0.001938
7253,7253,,3,39,42,3,39,42,0.000078,0.007211,0,14778,13,0.000011,13,0.212835,0.244499,7038.703786,0.091173,0.000771
7255,7255,,22,20,42,22,20,42,0.00086,0.00297,0,12900,30,0.000028,14,0.196233,0.21615,20212.562512,0.173055,0.010529
8001,8001,,146,16,162,146,16,162,0.021655,0.017596,0,11633,1,0.000096,14,0.207515,0.234076,91898.50775,0.063339,0.054677
8002,8002,,15,31,46,15,31,46,0.000921,0.003909,0,13028,30,0.000015,13,0.204209,0.226805,10299.434642,0.204348,0.005416
8003,8003,,3,4,7,3,4,7,0,0,0,14780,28,0.000026,3,0.583333,0.738095,18,0.119048,0.000658
9608139,9608139,,1,1,2,1,1,2,0,0,0,14779,28,0.000016,2,0.6,0.666667,12,0,0.000239
8004,8004,,0,34,34,0,34,34,0,0.021535,0,14787,5,0.00001,13,0.222248,0.253452,0,0.073084,0
6109,6109,,2,0,2,2,0,2,0.000264,0,0,14786,21,0.000015,0,0,0,0,0,0.000445
9912064,9912064,,1,4,5,1,4,5,0.000253,0.000004,0,14785,5,0.00001,20,0.128524,0.146615,26.499508,0.15,0.000219
9206093,9206093,,4,0,4,4,0,4,0.000007,0,0,258,5,0.000104,0,0,0,0,0,0.001213
9810101,9810101,,1,5,6,1,5,6,0,0,0,14784,9,0.000012,3,0.548387,0.627451,23.666667,0.1,0.000226
8005,8005,,2,7,9,2,7,9,0.000015,0.001818,0,14788,3,0.000011,12,0.199004,0.223928,731.359066,0.208333,0.000451
8006,8006,,0,29,29,0,29,29,0,0.000215,0,14794,41,0.00001,13,0.171265,0.188055,0,0.086207,0
9210116,9210116,,5,0,5,5,0,5,0.000317,0,0,14793,41,0.000013,0,0,0,0,0.1,0.001182
9312115,9312115,,18,0,18,18,0,18,0.000051,0,0,3097,41,0.000047,0,0,0,0,0.081699,0.004408
9412081,9412081,,14,1,15,14,1,15,0.00028,0.000018,0,6122,41,0.00003,2,0.666667,0.75,16.981725,0.1,0.003385
9501102,9501102,,4,4,8,4,4,8,0.000017,0.000003,0,14792,41,0.000012,2,0.75,0.833333,0.866667,0.267857,0.000923
9503060,9503060,,8,3,11,8,3,11,0.000086,0.000003,0,11262,41,0.000029,4,0.375,0.477778,226.714954,0.109091,0.001929
9504050,9504050,,1,3,4,1,3,4,0.000003,0.000003,0,14791,41,0.00001,5,0.288,0.327083,0,0.25,0.000219
9504098,9504098,,1,9,10,1,9,10,0.000003,0.000082,0,14790,41,0.00001,5,0.314961,0.39125,3.136508,0.133333,0.000219
9505029,9505029,,3,4,7,3,4,7,0.000017,0.000002,0,6701,41,0.000013,5,0.375,0.494444,42.87625,0.261905,0.000744
9505158,9505158,,1,5,6,1,5,6,0.000003,0.000004,0,14789,41,0.00001,5,0.300752,0.351667,0,0.266667,0.000219
9511069,9511069,,5,3,8,5,3,8,0.000011,0.000003,0,11261,41,0.00002,5,0.293893,0.3329,272.400991,0.125,0.001136
9512074,9512074,,6,12,18,6,12,18,0.000488,0.000084,0,6702,41,0.000033,5,0.318033,0.400687,27538.994988,0.078431,0.001408
9607056,9607056,,22,5,27,22,5,27,0.002077,0.000012,0,6118,41,0.000028,5,0.29682,0.34623,2619.861619,0.139601,0.006145
9706020,9706020,,6,12,18,6,12,18,0.000025,0.000064,0,6125,41,0.000014,12,0.185059,0.223209,56276.50129,0.140523,0.001424
9209047,9209047,,2,0,2,2,0,2,0,0,0,3101,41,0.000039,0,0,0,0,0,0.000593
9307137,9307137,,6,0,6,6,0,6,0.000023,0,0,3103,41,0.000031,0,0,0,0,0.133333,0.001639
9506214,9506214,,1,6,7,1,6,7,0.000001,0.000003,0,6700,41,0.000012,5,0.286645,0.349621,9008.80336,0.142857,0.000259
9507006,9507006,,15,1,16,15,1,16,0.00026,0.000026,0,5750,41,0.000062,4,0.391304,0.453704,175.945732,0.1875,0.003853
9511103,9511103,,13,4,17,13,4,17,0.000018,0.000026,0,6121,41,0.00003,7,0.224684,0.274715,9815.614052,0.128676,0.003282
9606013,9606013,,13,1,14,13,1,14,0.000449,0.000003,0,6119,41,0.000023,5,0.30303,0.37,1953.534331,0.142857,0.003303
9610243,9610243,,15,11,26,15,11,26,0.000269,0.000044,0,6124,41,0.00003,8,0.234399,0.276608,25961.936421,0.152308,0.003674
8007,8007,,0,2,2,0,2,2,0,0,7,14795,27,0.00001,1,1,1,0,0.5,0
8009,8009,,4,1,5,4,1,5,0.000343,0.000018,0,14796,2,0.000014,13,0.169696,0.182861,218.61326,0.2,0.001038
8011,8011,,3,3,6,3,3,6,0,0,0,14797,6,0.000015,13,0.140271,0.153104,33.720971,0.2,0.000697
9211137,9211137,,4,0,4,4,0,4,0,0,0,1967,6,0.000046,0,0,0,0,0.083333,0.000996
8012,8012,,13,27,40,13,27,40,0.000332,0.00463,0,12260,25,0.00002,14,0.204546,0.230779,44788.892823,0.166026,0.003394
8013,8013,,105,30,135,105,30,135,0.00644,0.006871,0,12871,30,0.000084,14,0.198498,0.221063,77009.44006,0.070481,0.040997
8014,8014,,1,5,6,1,5,6,0.000035,0.002916,0,14798,0,0.000011,14,0.174968,0.19618,0,0.266667,0.000226
8016,8016,,51,16,67,51,16,67,0.00643,0.014194,0,14302,2,0.000032,14,0.207492,0.232056,10579.249418,0.086612,0.01485
8017,8017,,0,4,4,0,4,4,0,0,0,14799,28,0.00001,15,0.138067,0.151367,0,0.25,0
8018,8018,,0,3,3,0,3,3,0,0,0,14801,28,0.00001,15,0.137943,0.150832,0,0.166667,0
9811226,9811226,,2,0,2,2,0,2,0,0,0,14800,28,0.000017,0,0,0,0,0,0.000438
8019,8019,,0,38,38,0,38,38,0,0.023091,0,14802,30,0.00001,13,0.213959,0.240625,0,0.099573,0
8020,8020,,2,16,18,2,16,18,0.000107,0.004367,0,14805,30,0.000011,13,0.197354,0.217698,4822.604668,0.222222,0.000674
9909079,9909079,,6,8,14,6,8,14,0.000301,0.000668,0,14804,2,0.000012,14,0.177931,0.200582,158.894398,0.225275,0.001456
9911146,9911146,,3,17,20,3,17,20,0.000133,0.001696,0,14803,2,0.000011,14,0.189997,0.2181,205.815078,0.294737,0.000687
8022,8022,,5,4,9,5,4,9,0.000018,0.00001,0,14806,23,0.000012,12,0.159155,0.18937,1364.790473,0.236111,0.001223
8023,8023,,20,38,58,20,38,58,0.000939,0.00349,0,12921,3,0.000019,14,0.214635,0.241315,129943.649167,0.11706,0.006756
8024,8024,,0,1,1,0,1,1,0,0,8,14808,29,0.00001,1,1,1,0,0,0
9512067,9512067,,1,0,1,1,0,1,0,0,8,14807,29,0.000019,0,0,0,0,0,0.000219
8025,8025,,2,4,6,2,4,6,0.000181,0.000203,0,14809,13,0.000014,13,0.185578,0.205341,4963.431297,0.2,0.000548
8026,8026,,0,8,8,0,8,8,0,0.00003,0,14810,3,0.00001,11,0.168242,0.182231,0,0.107143,0
9912243,9912243,,15,6,21,15,6,21,0.000315,0.000067,0,12848,3,0.000036,13,0.136755,0.176799,14369.514784,0.080952,0.007682
8027,8027,,19,18,37,19,18,37,0.000637,0.004939,0,14811,30,0.00003,13,0.205326,0.230067,36007.176117,0.099099,0.005536
9303147,9303147,,3,0,3,3,0,3,0.000001,0,0,1993,25,0.00002,0,0,0,0,0,0.000712
8029,8029,,2,22,24,2,22,24,0.000296,0.004999,0,14812,0,0.000011,13,0.220066,0.248396,12059.464656,0.11413,0.000471
8030,8030,,15,43,58,15,43,58,0.001913,0.005592,0,13049,30,0.000017,14,0.206592,0.232722,13004.279429,0.117362,0.004016
8031,8031,,12,28,40,12,28,40,0.000714,0.000935,0,14813,4,0.000018,14,0.171914,0.193929,8023.431711,0.16859,0.003084
8032,8032,,2,1,3,2,1,3,0.000012,0,0,14815,0,0.000015,12,0.149443,0.169084,14.094842,0.166667,0.000438
9612041,9612041,,3,2,5,3,2,5,0,0.000647,0,14814,0,0.000032,11,0.175516,0.209995,2869.094842,0.05,0.00067
8033,8033,,41,38,79,41,38,79,0.001735,0.001995,0,12882,3,0.000038,14,0.201141,0.223981,40495.33314,0.206102,0.023538
8034,8034,,2,5,7,2,5,7,0.000005,0.000022,0,14816,23,0.000011,17,0.14391,0.161439,6739.59938,0.214286,0.000511
8035,8035,,3,5,8,3,5,8,0.000001,0.000376,0,14818,26,0.000016,15,0.15176,0.167637,9560.835534,0.178571,0.000684
9912268,9912268,,5,1,6,5,1,6,0.000006,0,0,14817,26,0.000024,10,0.163168,0.178986,827.409598,0.266667,0.001174
9704206,9704206,,6,8,14,6,8,14,0.000003,0.001041,0,14676,26,0.000039,9,0.194685,0.224839,4826.939002,0.142857,0.001428
8036,8036,,1,8,9,1,8,9,0.000002,0.000005,0,14820,6,0.000011,6,0.281796,0.34882,292.898772,0.111111,0.000252
9502051,9502051,,2,2,4,2,2,4,0,0,0,14819,6,0.000013,2,0.75,0.833333,8.45,0.166667,0.000445
9403149,9403149,,2,0,2,2,0,2,0.000002,0,0,3775,6,0.000018,0,0,0,0,0,0.000631
8037,8037,,0,3,3,0,3,3,0,0,0,14821,23,0.00001,14,0.142028,0.153029,0,0.5,0
8038,8038,,30,21,51,30,21,51,0.001881,0.000606,0,14822,52,0.000025,15,0.198488,0.220914,19988.248338,0.140392,0.008362
9502067,9502067,,2,1,3,2,1,3,0.000001,0,0,10855,26,0.000014,1,1,1,298.684525,0.166667,0.000539
9902094,9902094,,4,9,13,4,9,13,0.000051,0.000004,0,10946,6,0.000014,7,0.293333,0.374711,3383.261237,0.211538,0.000981
8040,8040,,3,2,5,3,2,5,0,0,0,14824,26,0.000014,6,0.301075,0.366667,14.7,0.25,0.00067
9805219,9805219,,6,3,9,6,3,9,0,0,0,14823,26,0.000027,1,1,1,20,0.069444,0.001354
8042,8042,,62,40,102,62,40,102,0.005108,0.008352,0,13018,30,0.000041,14,0.214345,0.240014,73883.042449,0.101242,0.023194
8043,8043,,0,3,3,0,3,3,0,0,0,14826,23,0.00001,13,0.153002,0.164909,0,0,0
9911089,9911089,,8,5,13,8,5,13,0.000012,0.000006,0,14825,23,0.000023,12,0.18036,0.19996,41765.295065,0.102564,0.00187
8044,8044,,14,11,25,14,11,25,0.000058,0.000009,0,14827,6,0.000018,16,0.154266,0.172752,7169.360909,0.158333,0.003325
8045,8045,,5,9,14,5,9,14,0.000142,0.000035,0,14828,28,0.000013,15,0.151929,0.16538,2603.193725,0.39011,0.001235
9511148,9511148,,2,4,6,2,4,6,0.000067,0.000011,0,8424,28,0.000014,3,0.6,0.703704,3732.280907,0.233333,0.000481
8046,8046,,4,23,27,4,23,27,0.000188,0.005638,0,12931,3,0.000013,16,0.212051,0.240169,27732.691694,0.123932,0.001434
8047,8047,,2,10,12,2,10,12,0.000768,0.015887,0,14829,1,0.00001,13,0.183755,0.203878,72.572374,0.272727,0.000796
8048,8048,,4,37,41,4,37,41,0.00075,0.018142,0,14830,1,0.000011,13,0.199236,0.225239,1983.921794,0.193293,0.001101
8049,8049,,3,4,7,3,4,7,0,0.000009,0,14831,23,0.000019,14,0.136078,0.152579,6332.733445,0.166667,0.00067
9605074,9605074,,11,11,22,11,11,22,0.000165,0.00152,0,4835,23,0.000031,5,0.341772,0.40751,45001.616323,0.071429,0.002602
9405046,9405046,,2,0,2,2,0,2,0.000018,0,0,4834,23,0.000013,0,0,0,0,0.5,0.000512
9603013,9603013,,6,6,12,6,6,12,0.000032,0.000013,0,4831,5,0.000016,7,0.223744,0.266845,2949.735374,0.090909,0.001395
8051,8051,,18,10,28,18,10,28,0.001605,0.002351,0,14832,8,0.000019,12,0.196088,0.218187,8444.659174,0.138889,0.004422
8052,8052,,18,10,28,18,10,28,0.000641,0.002588,0,14833,3,0.000026,14,0.199318,0.219355,54771.162522,0.063492,0.005205
9411018,9411018,,6,1,7,6,1,7,0.000122,0,0,3365,8,0.000019,1,1,1,11130.32205,0.047619,0.001574
9310114,9310114,,7,0,7,7,0,7,0.00002,0,0,3364,9,0.000065,0,0,0,0,0.166667,0.001762
8053,8053,,48,26,74,48,26,74,0.001796,0.00222,0,12859,3,0.000039,16,0.197784,0.2198,4302.470025,0.236394,0.024559
8057,8057,,49,31,80,49,31,80,0.001844,0.003127,0,14834,30,0.000047,13,0.203778,0.225664,77869.141703,0.109019,0.015867
8058,8058,,8,21,29,8,21,29,0.001288,0.011566,0,14835,1,0.000013,12,0.194336,0.218934,2479.978335,0.20936,0.001967
8059,8059,,1,3,4,1,3,4,0.000287,0.000094,0,14836,1,0.00001,15,0.141485,0.153046,2.472727,0.25,0.000219
8060,8060,,2,8,10,2,8,10,0.000002,0.001543,0,14837,13,0.000015,15,0.165747,0.186808,2255.997884,0.133333,0.000445
8061,8061,,7,18,25,7,18,25,0.000239,0.000147,0,14838,5,0.000014,15,0.15205,0.173138,17456.494301,0.151667,0.001761
9412211,9412211,,1,1,2,1,1,2,0.000003,0.000123,0,4596,5,0.000011,4,0.349206,0.375,0,0.5,0.000301
9506142,9506142,,2,3,5,2,3,5,0.000003,0.000006,0,4595,5,0.000016,7,0.25974,0.295844,906.310421,0.05,0.00052
8062,8062,,6,31,37,6,31,37,0.000384,0.000541,0,14840,13,0.000012,14,0.18295,0.208093,23808.613616,0.133634,0.001355
9911064,9911064,,2,7,9,2,7,9,0.000014,0.000073,0,14839,13,0.00001,12,0.197639,0.221766,4178.296284,0.305556,0.000491
8063,8063,,6,3,9,6,3,9,0.00026,0.000105,0,14841,1,0.000016,12,0.186058,0.202906,7986.809719,0.083333,0.001417
8064,8064,,17,9,26,17,9,26,0.00083,0.000959,0,12886,3,0.000023,14,0.188576,0.207648,2059.71983,0.235385,0.00772
8065,8065,,8,19,27,8,19,27,0.000965,0.01718,0,14842,1,0.000015,13,0.202305,0.226317,7198.247629,0.19943,0.002037
8066,8066,,1,6,7,1,6,7,0.000013,0.000001,0,14843,6,0.000011,12,0.169773,0.211015,15800.237585,0.095238,0.000306
9509004,9509004,,2,5,7,2,5,7,0,0.000146,0,6772,9,0.000013,6,0.291405,0.336691,32495.114695,0.142857,0.000541
8067,8067,,2,13,15,2,13,15,0.000004,0.000204,0,14844,26,0.000011,11,0.177144,0.221327,13.655844,0.271429,0.000445
8068,8068,,0,39,39,0,39,39,0,0.007706,0,14845,2,0.00001,15,0.209209,0.238063,0,0.094467,0
8069,8069,,0,2,2,0,2,2,0,0,0,14846,20,0.00001,2,0.75,0.833333,0,0.5,0
8070,8070,,4,8,12,4,8,12,0.00002,0.000002,0,14849,23,0.000014,13,0.164038,0.186607,2640.00065,0.242424,0.00091
9701072,9701072,,13,4,17,13,4,17,0.000018,0.000002,0,13680,23,0.000028,3,0.529412,0.666667,298.990344,0.136029,0.003091
9811210,9811210,,2,9,11,2,9,11,0,0.000002,0,14848,23,0.000013,11,0.148974,0.187853,67.990048,0.190909,0.000471
9704207,9704207,,1,0,1,1,0,1,0,0,0,14847,23,0.000011,0,0,0,0,0,0.000233
8071,8071,,16,10,26,16,10,26,0.000005,0.00001,0,14850,6,0.000021,13,0.147955,0.167124,8796.006859,0.176923,0.003879
9812106,9812106,,3,5,8,3,5,8,0,0.000002,0,14746,6,0.000013,12,0.153754,0.179921,7783.795141,0.107143,0.000793
9807041,9807041,,2,17,19,2,17,19,0,0.000073,0,14745,6,0.000013,12,0.167291,0.196344,6660.489984,0.078947,0.000467
8072,8072,,1,4,5,1,4,5,0,0.000003,0,14851,15,0.000012,14,0.15801,0.167513,9942.654555,0.2,0.000226
8073,8073,,11,28,39,11,28,39,0.001241,0.011935,0,13037,30,0.000015,12,0.20856,0.232804,55655.793211,0.153846,0.003286
9205107,9205107,,8,0,8,8,0,8,0.000279,0,0,139,9,0.000029,0,0,0,0,0.125,0.002184
9311148,9311148,,6,5,11,6,5,11,0.000105,0.000038,0,2743,9,0.000017,2,0.857143,0.916667,179.862326,0.2,0.001772
8075,8075,,94,25,119,94,25,119,0.007089,0.013914,0,13019,30,0.000058,14,0.210917,0.234526,109726.925346,0.074989,0.032382
8076,8076,,59,21,80,59,21,80,0.010209,0.020154,0,14864,1,0.000032,12,0.225978,0.254075,296661.601873,0.090348,0.018256
9912271,9912271,,32,102,134,32,102,134,0.002927,0.023955,0,14863,4,0.000024,11,0.227141,0.266863,451976.831436,0.090787,0.00894
9401121,9401121,,5,19,24,5,19,24,0.000365,0.00004,0,1066,9,0.000014,3,0.660377,0.761905,64773.905276,0.030797,0.001441
9411058,9411058,,5,1,6,5,1,6,0.000479,0,0,5720,4,0.000015,2,0.6,0.666667,1009.843471,0.1,0.001429
9809196,9809196,,6,29,35,6,29,35,0.000551,0.003372,0,14332,4,0.000012,13,0.194072,0.228358,1746.574215,0.226891,0.002016
9906033,9906033,,4,31,35,4,31,35,0.000421,0.00249,0,14862,4,0.000013,13,0.196516,0.230934,29097.321757,0.084034,0.00113
9912180,9912180,,9,71,80,9,71,80,0.000732,0.00688,0,14859,4,0.000016,12,0.218543,0.253874,74824.832426,0.169304,0.002504
8077,8077,,1,5,6,1,5,6,0,0.000005,0,14866,26,0.000014,16,0.112951,0.124918,2019,0.1,0.000219
9511226,9511226,,10,5,15,10,5,15,0.000094,0.000003,0,7560,26,0.000056,1,1,1,8613.989888,0.133333,0.002448
9806148,9806148,,5,4,9,5,4,9,0.000001,0.000003,0,14865,26,0.000021,15,0.117441,0.128439,6996.95439,0.125,0.001135
9505188,9505188,,2,3,5,2,3,5,0.000012,0.000003,0,7559,26,0.000024,1,1,1,1.45,0.45,0.000547
9804128,9804128,,3,4,7,3,4,7,0.000012,0.000003,0,8269,26,0.00002,2,0.833333,0.9,27.436287,0.214286,0.000718
9805137,9805137,,6,5,11,6,5,11,0.000001,0.000006,0,13310,26,0.000016,7,0.216981,0.255262,1157.024416,0.154545,0.001389
8078,8078,,2,2,4,2,2,4,0.000006,0.000011,0,14868,28,0.000012,6,0.233945,0.280065,0,0.416667,0.000525
9905027,9905027,,4,3,7,4,3,7,0.000006,0.00003,0,14867,28,0.000018,6,0.236967,0.295667,27.009369,0.190476,0.000978
8080,8080,,2,16,18,2,16,18,0.000483,0.009427,0,14869,1,0.000011,13,0.188574,0.210466,2657.595978,0.245098,0.000649
8081,8081,,52,43,95,52,43,95,0.009551,0.027693,0,14870,1,0.000029,12,0.222751,0.253055,57399.165309,0.101792,0.016025
8082,8082,,9,11,20,9,11,20,0.001609,0.007573,0,14871,1,0.000014,15,0.216269,0.249541,14320.827709,0.194737,0.002729
8083,8083,,12,24,36,12,24,36,0.000311,0.003366,0,14872,30,0.00002,14,0.212236,0.236654,85451.141885,0.119048,0.002938
8084,8084,,16,29,45,16,29,45,0.001513,0.013329,0,14873,1,0.000017,13,0.196879,0.225389,7763.813585,0.147475,0.003865
9507020,9507020,,15,4,19,15,4,19,0.000101,0.000026,0,8194,5,0.000029,5,0.344156,0.403459,489.726422,0.160819,0.003986
8086,8086,,0,30,30,0,30,30,0,0.000133,0,14874,17,0.00001,14,0.180083,0.204429,0,0.170115,0
8088,8088,,22,20,42,22,20,42,0.002606,0.017409,0,14303,2,0.00002,14,0.216619,0.243159,24906.333357,0.160859,0.006437
8089,8089,,15,24,39,15,24,39,0.000521,0.002582,0,14875,30,0.000022,14,0.197552,0.219151,26207.966585,0.103239,0.003677
8090,8090,,44,54,98,44,54,98,0.001897,0.003141,0,13034,30,0.000041,14,0.206897,0.23216,125646.535312,0.126657,0.014698
8091,8091,,17,45,62,17,45,62,0.00177,0.018314,0,12986,1,0.000016,12,0.239568,0.274124,124324.266349,0.131941,0.00566
9002,9002,,28,17,45,28,17,45,0.001271,0.002615,0,12928,3,0.000024,14,0.19374,0.213237,5138.451444,0.138384,0.010285
9030,9030,,50,36,86,50,36,86,0.003095,0.006057,0,12932,3,0.000039,13,0.21775,0.244624,160145.905764,0.095759,0.019355
9706101,9706101,,3,8,11,3,8,11,0.00019,0.000027,0,12839,30,0.000012,11,0.164221,0.181226,13593.954108,0.027273,0.001274
8093,8093,,2,10,12,2,10,12,0,0.000008,0,14878,23,0.000011,18,0.134185,0.149144,1,0.371212,0.000451
9905147,9905147,,16,7,23,16,7,23,0.000003,0.000375,0,14877,23,0.000026,17,0.147974,0.167132,24940.686171,0.152174,0.003938
9911132,9911132,,4,7,11,4,7,11,0,0.000008,0,14876,23,0.000014,15,0.125367,0.137558,9.463492,0.309091,0.000903
8094,8094,,5,8,13,5,8,13,0.000001,0.000037,0,14881,23,0.000017,13,0.163158,0.181363,9849.120199,0.121795,0.001217
9712212,9712212,,1,11,12,1,11,12,0,0.000015,0,14880,23,0.000012,13,0.191586,0.219283,3909.21886,0.083333,0.000253
9712158,9712158,,1,2,3,1,2,3,0,0,0,14879,23,0.000011,3,0.555556,0.666667,131.209974,0.166667,0.000226
8095,8095,,4,2,6,4,2,6,0.000001,0,0,14890,15,0.000016,11,0.158213,0.178501,1372.458272,0.1,0.00089
9808018,9808018,,1,8,9,1,8,9,0,0.001894,0,14889,13,0.000017,11,0.179808,0.221353,1447.425134,0.055556,0.000245
9512212,9512212,,3,2,5,3,2,5,0.000031,0.000009,0,3273,13,0.000016,2,0.75,0.833333,386.75944,0.05,0.000707
9703142,9703142,,1,13,14,1,13,14,0.000022,0.000037,0,14888,26,0.000012,8,0.223201,0.308811,370.243656,0.06044,0.000226
9712173,9712173,,2,4,6,2,4,6,0.00003,0,0,14885,13,0.000014,3,0.636364,0.761905,24,0.066667,0.000452
9805211,9805211,,1,6,7,1,6,7,0.000022,0.000621,0,14886,13,0.000012,11,0.178028,0.225111,473.814704,0.095238,0.000226
8096,8096,,9,23,32,9,23,32,0.000039,0.002209,0,14898,26,0.000023,12,0.186595,0.208021,61943.328543,0.039315,0.002057
9804190,9804190,,3,9,12,3,9,12,0.000026,0.000006,0,14892,26,0.000017,9,0.198039,0.312286,5306.928063,0.05303,0.000772
9903101,9903101,,5,5,10,5,5,10,0.000048,0.000001,0,14895,26,0.000017,9,0.206865,0.261823,13030.883363,0.122222,0.00121
9908173,9908173,,3,4,7,3,4,7,0.000048,0.000008,0,14896,26,0.000013,10,0.189358,0.219182,3707.631306,0.309524,0.000751
9910108,9910108,,2,7,9,2,7,9,0.00004,0.000712,0,14897,26,0.000012,15,0.166119,0.185858,423.713415,0.152778,0.000518
9311126,9311126,,3,0,3,3,0,3,0.000001,0,0,10963,26,0.000022,0,0,0,0,0,0.000699
9511179,9511179,,1,0,1,1,0,1,0,0,0,14891,26,0.000012,0,0,0,0,0,0.00024
9406135,9406135,,2,4,6,2,4,6,0,0,0,14894,6,0.000015,2,0.75,0.833333,1183.753882,0.033333,0.000472
9710039,9710039,,1,6,7,1,6,7,0,0.000008,0,14893,6,0.000013,7,0.249462,0.312705,1363.677933,0.119048,0.000253
8097,8097,,1,4,5,1,4,5,0,0.000022,0,14899,10,0.000012,11,0.204638,0.234052,1075.501771,0.25,0.000219
9407092,9407092,,2,0,2,2,0,2,0,0,0,14214,10,0.000065,0,0,0,0,0,0.000486
8098,8098,,0,4,4,0,4,4,0,0,0,14903,9,0.00001,14,0.120638,0.135902,0,0.166667,0
9911254,9911254,,1,2,3,1,2,3,0,0,0,14902,9,0.000012,13,0.123781,0.133126,729.309524,0.166667,0.000219
9603151,9603151,,3,8,11,3,8,11,0,0.000003,0,9141,23,0.000023,8,0.220657,0.261588,3515.360284,0.181818,0.000704
9911175,9911175,,1,3,4,1,3,4,0,0,0,14901,9,0.000015,12,0.140975,0.154182,1691.309524,0.166667,0.000226
8099,8099,,2,7,9,2,7,9,0,0.000002,0,14908,23,0.000013,14,0.136735,0.151395,647.65092,0.138889,0.000498
9812148,9812148,,6,8,14,6,8,14,0.000001,0.000017,0,14907,23,0.00002,13,0.153937,0.17187,11021.809649,0.038462,0.001374
9401040,9401040,,2,0,2,2,0,2,0,0,0,14905,22,0.000015,0,0,0,0,0.5,0.000492
9503044,9503044,,2,5,7,2,5,7,0,0.000003,0,14906,22,0.000015,4,0.484848,0.604167,327.478848,0.047619,0.000485
8100,8100,,0,16,16,0,16,16,0,0.00225,0,14909,4,0.00001,13,0.195772,0.222406,0,0.2625,0
9907165,9907165,,2,23,25,2,23,25,0.000034,0.002478,0,12836,4,0.000011,13,0.207736,0.240953,23865.536478,0.185,0.000502
9604022,9604022,,2,5,7,2,5,7,0.00003,0.000448,0,12835,4,0.000015,6,0.277008,0.325833,102.667723,0.142857,0.000452
8101,8101,,44,17,61,44,17,61,0.001618,0.001395,0,12860,3,0.000038,16,0.189071,0.209102,1538.81139,0.28306,0.023945
8103,8103,,2,25,27,2,25,27,0.000082,0.003048,0,14910,2,0.000012,13,0.182969,0.205652,2603.051609,0.118234,0.000545
8104,8104,,0,8,8,0,8,8,0,0,0,14919,23,0.00001,14,0.158462,0.193561,0,0.071429,0
9806117,9806117,,9,1,10,9,1,10,0.000002,0,0,14918,23,0.00002,3,0.4375,0.5,16.533333,0.1,0.002064
9906183,9906183,,4,8,12,4,8,12,0.000001,0,0,14916,23,0.000013,13,0.170092,0.213771,524.203728,0.143939,0.000916
9712024,9712024,,4,3,7,4,3,7,0.000001,0.000008,0,14917,23,0.000035,2,0.666667,0.75,16.116667,0.119048,0.000943
9505014,9505014,,5,5,10,5,5,10,0.000001,0.000001,0,4465,23,0.00002,4,0.419355,0.482906,94.640625,0.111111,0.001288
9510030,9510030,,7,10,17,7,10,17,0.000002,0.00001,0,12222,23,0.000019,7,0.268174,0.322117,3330.786883,0.128676,0.001675
9609119,9609119,,5,7,12,5,7,12,0.000001,0.000007,0,14915,23,0.000014,12,0.17641,0.239386,820.495486,0.189394,0.001148
9904106,9904106,,1,1,2,1,1,2,0,0,0,14914,23,0.000011,4,0.416667,0.516667,39,0,0.000246
8105,8105,,6,22,28,6,22,28,0.000323,0.000213,0,14925,1,0.000016,12,0.196743,0.214543,32661.036052,0.055556,0.001574
9609141,9609141,,7,0,7,7,0,7,0.000188,0,0,8866,1,0.000034,0,0,0,0,0.285714,0.001796
9903122,9903122,,4,3,7,4,3,7,0.000241,0.00001,0,14924,1,0.000013,2,0.8,0.875,26.715983,0.309524,0.001062
9911020,9911020,,4,6,10,4,6,10,0.000202,0.000002,0,14923,9,0.000014,14,0.131608,0.141237,12081.590352,0.2,0.000966
9912280,9912280,,5,15,20,5,15,20,0.000339,0.014953,0,14920,1,0.000015,13,0.20131,0.224218,9671.884894,0.105263,0.001519
9504071,9504071,,8,1,9,8,1,9,0,0,0,12309,9,0.000038,3,0.478261,0.515152,0,0.277778,0.001901
9601035,9601035,,8,2,10,8,2,10,0.000001,0,0,12310,9,0.000035,3,0.5,0.555556,48.666667,0.244444,0.0019
9812077,9812077,,4,2,6,4,2,6,0,0,0,14922,9,0.000017,13,0.149032,0.159062,11695.300605,0.166667,0.000923
8106,8106,,5,19,24,5,19,24,0.000097,0.017717,0,14926,13,0.000015,12,0.207276,0.233372,11762.602613,0.130435,0.00131
9806071,9806071,,3,24,27,3,24,27,0.000722,0.00882,0,7399,13,0.000011,13,0.193685,0.225038,50589.154934,0.111111,0.000842
8107,8107,,3,23,26,3,23,26,0.000443,0.013327,0,14927,1,0.000012,12,0.198869,0.220509,3058.746516,0.2,0.001218
8108,8108,,19,14,33,19,14,33,0.000353,0.002593,0,14928,30,0.000023,14,0.195993,0.214809,1353.632058,0.190341,0.005603
8109,8109,,1,6,7,1,6,7,0.000012,0.001792,0,14929,10,0.000011,13,0.184766,0.202501,730.670615,0.214286,0.000219
8110,8110,,3,3,6,3,3,6,0,0.000003,0,14930,23,0.00002,18,0.104423,0.118713,74.5,0.333333,0.000796
8111,8111,,6,8,14,6,8,14,0.000267,0.000233,0,12146,25,0.000018,13,0.182158,0.198956,5955.974816,0.274725,0.001634
8114,8114,,6,2,8,6,2,8,0.000001,0.000003,0,14931,20,0.000016,14,0.127115,0.134113,11120.527002,0.125,0.001453
8118,8118,,16,17,33,16,17,33,0.000829,0.002752,0,14932,30,0.00002,14,0.190755,0.21082,2586.428842,0.190341,0.006487
8119,8119,,14,49,63,14,49,63,0.000775,0.019709,0,14933,30,0.000019,14,0.215194,0.243149,38279.127505,0.150794,0.004146
8120,8120,,5,9,14,5,9,14,0.000149,0.001888,0,14934,30,0.000014,14,0.186337,0.205945,307.569613,0.296703,0.001589
8121,8121,,0,4,4,0,4,4,0,0,0,14936,22,0.00001,16,0.136639,0.146386,0,0.083333,0
9709102,9709102,,1,3,4,1,3,4,0,0,0,14935,22,0.000012,5,0.314607,0.38869,28,0.083333,0.000219
9301078,9301078,,3,0,3,3,0,3,0,0,0,3742,22,0.000083,0,0,0,0,0.166667,0.000795
9307184,9307184,,2,0,2,2,0,2,0,0,0,3748,22,0.000016,0,0,0,0,0.5,0.000458
9511004,9511004,,2,5,7,2,5,7,0,0.000001,0,3749,22,0.000016,4,0.415385,0.506173,45690.701997,0.047619,0.000465
8122,8122,,2,3,5,2,3,5,0.000035,0.000004,0,14937,15,0.000012,20,0.135894,0.144381,5879.222777,0.25,0.000539
8124,8124,,0,8,8,0,8,8,0,0.00004,0,14938,30,0.00001,14,0.190789,0.208488,0,0.071429,0
8125,8125,,27,40,67,27,40,67,0.00125,0.006048,0,12489,2,0.000026,13,0.222986,0.253428,109541.219017,0.082768,0.007895
8126,8126,,16,11,27,16,11,27,0.000437,0.000335,0,14939,30,0.000018,15,0.188519,0.205881,28329.537817,0.128205,0.004549
8127,8127,,20,25,45,20,25,45,0.000931,0.00106,0,12885,3,0.000021,15,0.191072,0.211231,13850.202864,0.270707,0.010511
8129,8129,,5,11,16,5,11,16,0.00002,0.000547,0,14948,13,0.000019,13,0.17615,0.194992,8015.959949,0.170833,0.001109
9704102,9704102,,9,9,18,9,9,18,0.000371,0.000415,0,14940,13,0.000019,10,0.211108,0.245123,536.098579,0.183007,0.002066
9910045,9910045,,3,19,22,3,19,22,0.000069,0.011774,0,14947,1,0.000013,12,0.207047,0.232161,29919.754362,0.183983,0.000703
9510190,9510190,,2,17,19,2,17,19,0.000054,0.004665,0,1675,13,0.000013,10,0.212384,0.261316,299.825097,0.128655,0.000635
9903032,9903032,,2,16,18,2,16,18,0.00014,0.001577,0,14946,13,0.000013,13,0.175653,0.205571,563.459113,0.101307,0.000458
9908198,9908198,,2,19,21,2,19,21,0.000538,0.010824,0,14941,1,0.000011,12,0.20788,0.232418,2776.17617,0.257143,0.000584
8130,8130,,1,65,66,1,65,66,0.000103,0.023067,0,14949,25,0.00001,14,0.222861,0.254862,1040.566311,0.097203,0.000253
8131,8131,,8,3,11,8,3,11,0.000743,0.000056,0,14950,2,0.000016,14,0.17419,0.188086,22115.422527,0.190909,0.001968
8132,8132,,24,25,49,24,25,49,0.000659,0.002647,0,14951,30,0.000031,13,0.200199,0.220197,10091.123646,0.17602,0.007158
8135,8135,,0,5,5,0,5,5,0,0.000002,0,14954,22,0.00001,15,0.122075,0.137678,0,0.15,0
9704124,9704124,,1,1,2,1,1,2,0,0,0,14953,22,0.000012,3,0.5,0.611111,3,0,0.000219
9805037,9805037,,3,3,6,3,3,6,0,0.000003,0,8422,22,0.000016,15,0.121509,0.134963,1.5,0.333333,0.000691
9601031,9601031,,1,1,2,1,1,2,0,0,0,14952,22,0.00002,2,0.666667,0.75,4,0,0.000226
9511198,9511198,,5,8,13,5,8,13,0.000003,0.000974,0,8418,13,0.000034,13,0.158955,0.189626,15122.58362,0.089744,0.001237
8136,8136,,2,5,7,2,5,7,0.000036,0.000245,0,14955,1,0.000011,14,0.174727,0.194639,2878.873994,0.095238,0.000548
9709064,9709064,,12,12,24,12,12,24,0.000515,0.001099,0,6565,5,0.00002,12,0.193633,0.226602,30902.236,0.081522,0.003155
8137,8137,,0,20,20,0,20,20,0,0.000189,0,14956,5,0.00001,15,0.153839,0.175902,0,0.221053,0
9511133,9511133,,3,17,20,3,17,20,0.000006,0.000069,0,6543,5,0.000012,6,0.30617,0.367364,20395.663914,0.078947,0.000794
8138,8138,,2,8,10,2,8,10,0.000006,0.000596,0,14958,1,0.000014,15,0.146685,0.16024,268.103352,0.166667,0.000438
9510181,9510181,,10,3,13,10,3,13,0.000074,0.000469,0,14957,1,0.000026,9,0.170463,0.191581,803.331986,0.217949,0.002324
8139,8139,,4,7,11,4,7,11,0.000001,0.00001,0,14960,23,0.000013,15,0.148096,0.172899,6581.95007,0.054545,0.00089
9907078,9907078,,5,10,15,5,10,15,0.000001,0.000026,0,14959,26,0.000016,15,0.146963,0.174491,3659.400594,0.161905,0.001122
9407042,9407042,,6,6,12,6,6,12,0.000034,0.000065,0,2618,4,0.000018,2,0.714286,0.8,370.496605,0.19697,0.001624
9510187,9510187,,3,15,18,3,15,18,0.000001,0.000046,0,7376,0,0.000013,11,0.219313,0.264718,23466.179479,0.071895,0.000727
8140,8140,,99,16,115,99,16,115,0.013671,0.018333,0,14961,8,0.000074,12,0.202104,0.22493,24671.811219,0.11823,0.034595
8141,8141,,7,44,51,7,44,51,0.001215,0.023623,0,14962,1,0.000012,12,0.230118,0.258274,30185.040369,0.123529,0.001872
8142,8142,,124,48,172,124,48,172,0.008849,0.01999,0,11651,4,0.000098,15,0.225377,0.25563,346429.846537,0.064735,0.053397
8143,8143,,1,18,19,1,18,19,0,0.000002,0,14969,23,0.000011,14,0.144816,0.15628,5914.673559,0.02924,0.000219
9604015,9604015,,6,1,7,6,1,7,0.000001,0,0,7767,23,0.000036,1,1,1,394.843009,0.047619,0.001376
9802180,9802180,,5,0,5,5,0,5,0,0,0,13980,23,0.000014,0,0,0,0,0.05,0.001142
9804109,9804109,,3,1,4,3,1,4,0,0,0,13977,23,0.000014,2,0.666667,0.75,0,0.416667,0.000724
9910027,9910027,,3,5,8,3,5,8,0,0.000001,0,14968,23,0.000013,16,0.104124,0.11061,3316.986789,0.142857,0.000664
9911207,9911207,,3,2,5,3,2,5,0,0,0,14963,23,0.000014,3,0.538462,0.619048,7.028571,0.15,0.000677
9410130,9410130,,2,0,2,2,0,2,0,0,0,10384,23,0.000046,0,0,0,0,0,0.000511
9209028,9209028,,4,0,4,4,0,4,0,0,0,4175,23,0.00007,0,0,0,0,0.083333,0.000954
9602050,9602050,,2,4,6,2,4,6,0,0,0,14967,28,0.000013,1,1,1,17.25,0.133333,0.000458
9703165,9703165,,13,1,14,13,1,14,0.000077,0.000001,0,9614,23,0.000039,2,0.666667,0.75,66.376308,0.093407,0.003022
9809177,9809177,,4,3,7,4,3,7,0,0.000001,0,13941,23,0.000017,15,0.115845,0.123003,15151.405049,0.142857,0.000956
9902083,9902083,,2,5,7,2,5,7,0,0.000001,0,14966,23,0.000014,16,0.104002,0.110082,30.555556,0.119048,0.000458
9906128,9906128,,3,2,5,3,2,5,0.000023,0.000002,0,14964,23,0.000014,2,0.75,0.833333,21.80068,0.25,0.000717
9611211,9611211,,2,5,7,2,5,7,0,0.000002,0,13978,22,0.000014,3,0.6,0.694444,134.654877,0.190476,0.000485
8144,8144,,27,24,51,27,24,51,0.002482,0.004581,0,14970,30,0.000021,13,0.205219,0.227727,7341.08143,0.185098,0.009556
8145,8145,,23,12,35,23,12,35,0.001602,0.000732,0,14971,2,0.000027,14,0.172357,0.191892,28419.70402,0.104202,0.006529
8146,8146,,4,10,14,4,10,14,0.000518,0.003031,0,14973,2,0.000012,13,0.177601,0.194463,48097.479142,0.362637,0.001439
9912085,9912085,,3,14,17,3,14,17,0.000074,0.001196,0,14972,26,0.000015,13,0.189767,0.209119,45321.568355,0.095588,0.000704
8147,8147,,6,9,15,6,9,15,0.000899,0.001259,0,14974,1,0.000013,13,0.179706,0.196065,2036.280542,0.157143,0.001863
8148,8148,,3,3,6,3,3,6,0.000004,0.000004,0,14975,28,0.000015,16,0.147644,0.161421,0,0.366667,0.000698
9510179,9510179,,8,3,11,8,3,11,0.000029,0.001028,0,9829,28,0.000031,6,0.26626,0.305216,464.019013,0.136364,0.001848
9209120,9209120,,13,1,14,13,1,14,0.00003,0.000005,0,3226,28,0.000086,1,1,1,114.593867,0.120879,0.003333
8149,8149,,13,24,37,13,24,37,0.001384,0.005631,0,12981,2,0.000015,12,0.222188,0.248322,19224.41134,0.100601,0.004286
8150,8150,,4,9,13,4,9,13,0.000083,0.002354,0,14976,52,0.000012,16,0.195683,0.219369,3275.45847,0.108974,0.001179
8152,8152,,0,4,4,0,4,4,0,0.000042,0,14977,25,0.00001,14,0.169809,0.190155,0,0,0
8153,8153,,0,2,2,0,2,2,0,0,0,14978,6,0.00001,14,0.116588,0.131094,0,0.5,0
9212094,9212094,,8,0,8,8,0,8,0,0,0,1966,6,0.000096,0,0,0,0,0.178571,0.002603
9808013,9808013,,7,11,18,7,11,18,0,0.000001,0,14637,6,0.000017,10,0.219451,0.271392,2787.667819,0.202614,0.001648
9808171,9808171,,1,4,5,1,4,5,0,0.000002,0,14638,6,0.000011,13,0.129625,0.144976,0,0.25,0.000279
8154,8154,,21,9,30,21,9,30,0.000784,0.000579,0,14979,52,0.000027,15,0.179819,0.201601,4824.124455,0.183908,0.005874
8155,8155,,0,14,14,0,14,14,0,0.009948,0,14980,1,0.00001,12,0.197941,0.220685,0,0.230769,0
8156,8156,,1,10,11,1,10,11,0.000001,0.000003,0,14986,5,0.000012,13,0.152708,0.169763,1072.246841,0.190909,0.000219
9503095,9503095,,12,3,15,12,3,15,0.00002,0.000018,0,2626,5,0.000061,7,0.250277,0.289865,40915.165641,0.161905,0.002933
9704035,9704035,,7,8,15,7,8,15,0.00003,0.000032,0,14982,5,0.000018,8,0.213493,0.25979,68.699145,0.171429,0.001626
9709147,9709147,,5,3,8,5,3,8,0.000016,0.000002,0,14981,5,0.000015,8,0.203345,0.230653,15.174242,0.285714,0.001175
9805187,9805187,,6,8,14,6,8,14,0.00003,0.00003,0,14983,5,0.000017,8,0.214589,0.261321,39.455556,0.21978,0.001368
9901054,9901054,,1,10,11,1,10,11,0,0.000124,0,14985,5,0.000011,12,0.175623,0.195366,3068.509667,0.181818,0.000226
9906092,9906092,,4,9,13,4,9,13,0.000028,0.000032,0,14984,5,0.000013,8,0.21562,0.265542,292.439567,0.224359,0.000909
9209073,9209073,,5,0,5,5,0,5,0.000013,0,0,2627,52,0.000044,0,0,0,0,0.15,0.001278
9706120,9706120,,6,11,17,6,11,17,0.000018,0.000094,0,9285,5,0.000016,11,0.199083,0.224851,29556.879672,0.132353,0.001401
9709119,9709119,,5,14,19,5,14,19,0.000015,0.000192,0,9286,5,0.000019,12,0.186143,0.210452,14362.401486,0.105263,0.001123
8157,8157,,0,15,15,0,15,15,0,0.001141,0,14994,4,0.00001,18,0.144771,0.168081,0,0.238095,0
9705076,9705076,,6,18,24,6,18,24,0.000879,0.003644,0,4495,4,0.000012,13,0.174575,0.202821,1727.063691,0.153986,0.001455
9902150,9902150,,4,25,29,4,25,29,0.000139,0.003374,0,14991,4,0.000011,16,0.175618,0.204788,469.24283,0.248768,0.000903
9902163,9902163,,6,19,25,6,19,25,0.000173,0.00189,0,14988,4,0.000014,14,0.181248,0.213004,2737.779417,0.171667,0.001361
9909193,9909193,,3,29,32,3,29,32,0.000099,0.003385,0,14993,4,0.000011,17,0.161803,0.190371,2951.955351,0.222782,0.000664
9510078,9510078,,3,0,3,3,0,3,0.000171,0,0,4015,4,0.000019,0,0,0,0,0.166667,0.000794
9511006,9511006,,5,3,8,5,3,8,0.000143,0.000011,0,4016,4,0.000022,2,0.666667,0.75,3153.620699,0.142857,0.001339
9812002,9812002,,3,5,8,3,5,8,0.000126,0.000735,0,14990,4,0.000011,13,0.176993,0.20034,0.566667,0.410714,0.00069
9803185,9803185,,4,14,18,4,14,18,0.000079,0.002124,0,14987,4,0.000014,13,0.203927,0.237562,3267.255502,0.199346,0.000936
9808093,9808093,,3,3,6,3,3,6,0.000082,0.00031,0,14992,4,0.000011,15,0.182497,0.203421,860.625339,0.133333,0.00069
9902201,9902201,,3,13,16,3,13,16,0.000126,0.001569,0,14989,4,0.000011,16,0.174789,0.202274,5911.446956,0.2125,0.000684
8159,8159,,0,2,2,0,2,2,0,0.000001,0,14995,23,0.00001,3,0.545455,0.638889,0,0.5,0
8160,8160,,7,11,18,7,11,18,0.001406,0.017964,0,14996,1,0.000014,15,0.212619,0.245121,6355.648486,0.19281,0.003126
8161,8161,,3,3,6,3,3,6,0.000117,0.000142,0,14997,2,0.000012,15,0.145432,0.160907,17.447565,0.3,0.000718
107051,107051,,4,35,39,4,35,39,0.00007,0.00762,0,15016,2,0.000013,14,0.203994,0.232166,33842.407449,0.085695,0.000965
12070,12070,,6,5,11,6,5,11,0.000538,0.001057,0,15015,2,0.000014,14,0.161164,0.176593,1033.839395,0.272727,0.001399
12075,12075,,11,33,44,11,33,44,0.000243,0.007478,0,15001,0,0.000018,17,0.205814,0.23422,40938.095475,0.078224,0.002634
102006,102006,,4,32,36,4,32,36,0.000552,0.007939,0,15014,0,0.000011,11,0.231202,0.263616,15391.592906,0.094444,0.000945
104041,104041,,5,18,23,5,18,23,0.000317,0.001492,0,15010,52,0.000011,14,0.204387,0.228837,22850.362317,0.104743,0.001296
104172,104172,,8,4,12,8,4,12,0.000634,0.000733,0,14999,2,0.000015,15,0.149527,0.17067,250.108841,0.090909,0.001884
9912227,9912227,,6,28,34,6,28,34,0.000805,0.011694,0,14998,2,0.000012,13,0.2084,0.240057,18653.793761,0.121212,0.001732
8162,8162,,5,13,18,5,13,18,0.000421,0.016446,0,15017,0,0.000017,14,0.197848,0.224318,7293.380457,0.173203,0.001151
8165,8165,,15,15,30,15,15,30,0.000422,0.00598,0,15018,9,0.000017,13,0.192653,0.213701,8372.186433,0.285057,0.004273
9137,9137,,16,20,36,16,20,36,0.000417,0.000297,0,15019,9,0.000016,14,0.174318,0.193547,3743.235512,0.286508,0.004272
8166,8166,,1,13,14,1,13,14,0.000013,0.000993,0,15025,13,0.00001,12,0.192236,0.212265,4,0.131868,0.000226
9608028,9608028,,4,12,16,4,12,16,0.000045,0.000679,0,15024,41,0.000013,5,0.395652,0.463736,869.009843,0.125,0.000991
9612199,9612199,,5,3,8,5,3,8,0.000163,0.00003,0,15023,41,0.000014,6,0.253456,0.297879,4017.977026,0.142857,0.001218
9905170,9905170,,4,4,8,4,4,8,0.00026,0.00003,0,15020,13,0.000013,15,0.159942,0.183544,134.350111,0.25,0.00091
9912245,9912245,,3,5,8,3,5,8,0.000039,0.000014,0,15021,13,0.000012,15,0.163076,0.184752,983.284146,0.25,0.000717
9510231,9510231,,6,3,9,6,3,9,0.000028,0.000004,0,15022,41,0.000023,4,0.380952,0.479167,1553.985063,0.097222,0.001502
9605073,9605073,,5,15,20,5,15,20,0.000295,0.008458,0,3141,0,0.000014,9,0.217551,0.25354,932.024331,0.197368,0.0013
9702084,9702084,,1,12,13,1,12,13,0.000051,0.00423,0,8634,13,0.00001,12,0.176471,0.209556,50.675918,0.128205,0.000248
8167,8167,,7,44,51,7,44,51,0.00017,0.001687,0,15026,4,0.000013,11,0.223119,0.25291,52406.392775,0.118039,0.00173
9806118,9806118,,3,2,5,3,2,5,0.00002,0,0,7769,23,0.000021,2,0.75,0.833333,17167.837919,0.05,0.000721
8168,8168,,3,7,10,3,7,10,0.000009,0.000002,0,15029,23,0.000013,12,0.141301,0.174494,283.426553,0.177778,0.000697
9710028,9710028,,3,1,4,3,1,4,0,0.000003,0,15028,23,0.000018,1,1,1,14,0.166667,0.000711
9810191,9810191,,3,1,4,3,1,4,0,0,0,15027,23,0.000018,4,0.361702,0.406863,117,0.083333,0.000684
8169,8169,,0,27,27,0,27,27,0,0.00169,0,15030,4,0.00001,12,0.200528,0.226312,0,0.183761,0
8170,8170,,10,10,20,10,10,20,0.00048,0.000529,0,15031,52,0.000018,14,0.182503,0.20258,8977.243994,0.226316,0.002732
8171,8171,,1,13,14,1,13,14,0,0.000001,0,15033,22,0.000011,14,0.141981,0.156817,1256.021768,0.153846,0.000219
9407161,9407161,,2,5,7,2,5,7,0,0,0,15032,22,0.000015,3,0.7,0.833333,15.833333,0.095238,0.000445
9203048,9203048,,7,0,7,7,0,7,0,0,0,4817,15,0.000056,0,0,0,0,0.071429,0.001648
9311053,9311053,,2,3,5,2,3,5,0,0.000001,0,11736,22,0.000029,2,0.8,0.875,2023.626597,0.15,0.000485
8172,8172,,10,22,32,10,22,32,0.000911,0.001879,0,15034,30,0.000014,14,0.202512,0.226369,8676.642996,0.136089,0.002758
8173,8173,,18,34,52,18,34,52,0.002103,0.003315,0,15035,0,0.000015,11,0.214466,0.24237,11276.041086,0.160256,0.006353
8175,8175,,4,20,24,4,20,24,0.000002,0.001102,0,15038,26,0.000018,9,0.252973,0.310263,1527.017861,0.057971,0.000883
9303178,9303178,,2,0,2,2,0,2,0.000015,0,0,15037,26,0.000012,0,0,0,0,0,0.000484
9802060,9802060,,1,2,3,1,2,3,0.000013,0.000027,0,15036,22,0.000011,7,0.208481,0.279822,21,0.166667,0.000245
9507043,9507043,,7,1,8,7,1,8,0.000001,0,0,3927,26,0.000042,7,0.211538,0.24017,2690.825053,0.178571,0.001726
8176,8176,,1,5,6,1,5,6,0.000093,0.000046,0,15039,26,0.00001,16,0.150599,0.166196,520.721687,0.2,0.000233
8179,8179,,0,11,11,0,11,11,0,0.01672,0,15040,1,0.00001,13,0.193179,0.216995,0,0.263636,0
8180,8180,,1,23,24,1,23,24,0.000003,0.005607,0,15041,2,0.000011,15,0.190743,0.21672,3002.835711,0.092391,0.000226
9411029,9411029,,6,2,8,6,2,8,0.000163,0.000008,0,1317,13,0.000026,4,0.431373,0.484848,3522.633778,0.125,0.001517
8181,8181,,5,4,9,5,4,9,0.000001,0,0,15043,22,0.000016,16,0.128267,0.137263,395.060318,0.444444,0.001162
9911014,9911014,,4,4,8,4,4,8,0,0.000009,0,15042,22,0.000017,15,0.147,0.160468,13123.287999,0.357143,0.000943
9602015,9602015,,5,5,10,5,5,10,0.000001,0.000011,0,4996,22,0.000024,7,0.226852,0.31516,1081.015646,0.355556,0.00128
8182,8182,,1,2,3,1,2,3,0,0,0,15044,20,0.000014,4,0.378378,0.464286,1,0.166667,0.000219
8183,8183,,0,1,1,0,1,1,0,0.000927,0,15045,25,0.00001,12,0.187088,0.202299,0,0,0
8184,8184,,7,4,11,7,4,11,0.000377,0.000045,0,15046,52,0.000013,15,0.162761,0.178499,13.854831,0.381818,0.001774
8186,8186,,6,32,38,6,32,38,0.000388,0.003275,0,14304,2,0.000013,12,0.231054,0.258921,55761.710076,0.127312,0.002101
8189,8189,,0,1,1,0,1,1,0,0.000001,0,15048,1,0.00001,1,1,1,0,0,0
9812204,9812204,,2,0,2,2,0,2,0.000087,0,0,15047,1,0.000019,0,0,0,0,0,0.000445
8191,8191,,11,9,20,11,9,20,0.000603,0.000351,0,15049,52,0.000015,15,0.167368,0.185888,3927.458889,0.2,0.003075
8194,8194,,15,42,57,15,42,57,0.000647,0.00437,0,12978,52,0.000015,16,0.208757,0.237664,92344.011022,0.138471,0.004866
8195,8195,,3,1,4,3,1,4,0.000056,0.000001,0,15050,10,0.000016,6,0.235772,0.272989,0,0.25,0.000732
8196,8196,,1,19,20,1,19,20,0.00001,0.002408,0,15052,4,0.000011,17,0.173161,0.205909,2640.35342,0.157895,0.00024
9907059,9907059,,3,0,3,3,0,3,0.000028,0,0,15051,4,0.000028,0,0,0,0,0,0.000664
8198,8198,,0,6,6,0,6,6,0,0.000025,0,15053,5,0.00001,16,0.153615,0.170634,0,0.166667,0
8199,8199,,12,11,23,12,11,23,0.000212,0.001956,0,15054,30,0.000017,14,0.196293,0.215359,4524.479934,0.29249,0.003756
8200,8200,,3,58,61,3,58,61,0,0.000077,0,15055,6,0.000013,16,0.157419,0.186954,11157.377622,0.05,0.000684
9809001,9809001,,4,11,15,4,11,15,0.000001,0.000008,0,14642,6,0.000013,11,0.16554,0.186049,11596.035845,0.133333,0.000943
9212150,9212150,,3,3,6,3,3,6,0,0.000002,0,1973,6,0.000064,3,0.583333,0.690476,13898.039081,0.3,0.001365
9309083,9309083,,10,4,14,10,4,14,0.000005,0.000009,0,1467,22,0.000031,2,0.75,0.833333,1968.87435,0.208791,0.002847
9301115,9301115,,5,0,5,5,0,5,0.000004,0,0,6314,22,0.000017,0,0,0,0,0.1,0.00142
9303155,9303155,,6,0,6,6,0,6,0.000001,0,0,6313,22,0.000028,0,0,0,0,0.066667,0.001554
9607165,9607165,,1,8,9,1,8,9,0,0.000013,0,14641,6,0.000011,5,0.37931,0.44072,366.868255,0.125,0.000246
9612172,9612172,,5,6,11,5,6,11,0.000006,0.000017,0,13668,9,0.000014,7,0.243323,0.289445,1434.137766,0.118182,0.001283
9710134,9710134,,2,9,11,2,9,11,0,0.00022,0,13667,22,0.000015,10,0.200425,0.223947,5345.921112,0.145455,0.000503
8201,8201,,6,15,21,6,15,21,0.001663,0.001576,0,15000,13,0.000011,17,0.205312,0.235732,44773.535441,0.130952,0.001857
8202,8202,,0,7,7,0,7,7,0,0.005855,0,15056,1,0.00001,13,0.185733,0.20431,0,0.404762,0
8203,8203,,30,26,56,30,26,56,0.001931,0.007773,0,15057,2,0.000024,13,0.22142,0.249225,41016.906392,0.098052,0.008362
8204,8204,,62,11,73,62,11,73,0.002888,0.000542,0,12946,30,0.000045,13,0.196912,0.214196,18711.177369,0.129186,0.023577
8205,8205,,54,50,104,54,50,104,0.003496,0.006152,0,13036,30,0.000036,13,0.213931,0.240465,85668.834737,0.115478,0.019545
8206,8206,,0,4,4,0,4,4,0,0.000096,0,15058,0,0.00001,14,0.173436,0.19264,0,0.083333,0
9203036,9203036,,3,0,3,3,0,3,0.000004,0,0,2923,52,0.000014,0,0,0,0,0.333333,0.000855
9410133,9410133,,1,0,1,1,0,1,0.000003,0,0,2935,2,0.000011,0,0,0,0,0,0.000368
9510130,9510130,,3,7,10,3,7,10,0.000061,0.000301,0,2934,28,0.000013,11,0.158562,0.177406,2533.447676,0.133333,0.00082
9606107,9606107,,1,5,6,1,5,6,0.000003,0.000087,0,2909,2,0.000011,10,0.195479,0.223105,6940.324137,0.333333,0.000368
8207,8207,,1,1,2,1,1,2,0.000014,0.000003,0,15059,5,0.00001,13,0.110169,0.13146,51.767388,0,0.000232
8208,8208,,9,22,31,9,22,31,0.000002,0.000141,0,15060,6,0.000015,14,0.175838,0.194699,59886.16542,0.119355,0.002097
10262,10262,,8,14,22,8,14,22,0.000002,0.000004,0,15061,6,0.000015,15,0.1554,0.170082,3757.947519,0.218615,0.001819
8209,8209,,3,14,17,3,14,17,0.000021,0.017249,0,15062,1,0.000012,13,0.217233,0.250388,7208.595354,0.180147,0.00069
8210,8210,,15,6,21,15,6,21,0.000012,0.000001,0,15078,22,0.000024,19,0.116139,0.136527,82.032062,0.259524,0.003655
9812132,9812132,,22,1,23,22,1,23,0.00002,0.000007,0,15063,22,0.000094,3,0.428571,0.5,201.934732,0.231225,0.005926
9903044,9903044,,17,2,19,17,2,19,0.000013,0,0,15068,22,0.000074,5,0.358209,0.425,378.262609,0.195906,0.004561
9903258,9903258,,20,10,30,20,10,30,0.000018,0.000014,0,15074,22,0.000067,18,0.13056,0.158336,27527.359853,0.18046,0.0053
9905061,9905061,,21,6,27,21,6,27,0.000019,0.000001,0,15076,22,0.000051,19,0.116064,0.137056,24093.929594,0.222222,0.005431
9905095,9905095,,15,4,19,15,4,19,0.000007,0.000001,0,15077,22,0.000036,19,0.115831,0.134477,8870.594602,0.283626,0.00391
9909014,9909014,,1,1,2,1,1,2,0,0,0,15069,22,0.000014,6,0.271739,0.314667,0,0.5,0.000321
9806220,9806220,,8,8,16,8,8,16,0.000001,0.000003,0,15067,28,0.000071,4,0.551724,0.703125,13534.392537,0.1,0.002133
9206050,9206050,,7,0,7,7,0,7,0.000002,0,0,3242,22,0.000135,0,0,0,0,0.261905,0.001989
9709067,9709067,,9,12,21,9,12,21,0.000002,0.000029,0,12542,22,0.000042,18,0.126981,0.15109,12220.441549,0.111905,0.002439
9807128,9807128,,3,4,7,3,4,7,0.000018,0.000203,0,15072,1,0.000019,17,0.145632,0.174007,6779.965193,0.214286,0.000815
9902199,9902199,,1,8,9,1,8,9,0,0.000013,0,15073,22,0.000016,18,0.129201,0.15446,2333,0.194444,0.000362
9904037,9904037,,14,2,16,14,2,16,0.000012,0,0,15075,22,0.000042,19,0.115727,0.133464,1402.605159,0.3,0.003691
9905008,9905008,,2,1,3,2,1,3,0,0,0,15070,22,0.000018,5,0.369565,0.428431,26.916667,0.333333,0.000659
8212,8212,,0,24,24,0,24,24,0,0.025238,0,15079,1,0.00001,14,0.227215,0.259461,0,0.277174,0
8213,8213,,4,30,34,4,30,34,0.000649,0.007212,0,15080,30,0.000011,14,0.198902,0.222211,4682.761037,0.221925,0.001229
8214,8214,,13,12,25,13,12,25,0.000904,0.0026,0,12884,3,0.000017,13,0.198612,0.217486,5699.144041,0.206667,0.006653
8215,8215,,0,12,12,0,12,12,0,0.002343,0,15081,13,0.00001,13,0.193578,0.216852,0,0.212121,0
8216,8216,,3,3,6,3,3,6,0.000069,0.00094,0,15082,25,0.000015,18,0.18414,0.203562,1448.182729,0.266667,0.000707
8217,8217,,0,1,1,0,1,1,0,0.000807,0,15083,8,0.00001,5,0.280899,0.318,0,0,0
8218,8218,,0,3,3,0,3,3,0,0.000046,0,15084,52,0.00001,14,0.158198,0.16797,0,0,0
8219,8219,,0,3,3,0,3,3,0,0.000058,0,15086,5,0.00001,7,0.204365,0.241979,0,0,0
9305121,9305121,,1,1,2,1,1,2,0.000001,0.000007,0,15085,5,0.000013,1,1,1,1,0,0.000219
9605007,9605007,,4,1,5,4,1,5,0.000167,0.000006,0,6703,41,0.000017,6,0.243176,0.27602,33237.154606,0,0.000891
8220,8220,,0,11,11,0,11,11,0,0.008299,0,15087,4,0.00001,16,0.191945,0.216693,0,0.309091,0
8221,8221,,20,20,40,20,20,40,0.001105,0.003643,0,15088,25,0.00002,13,0.199008,0.223313,40893.67879,0.083974,0.005032
8222,8222,,0,12,12,0,12,12,0,0.000003,0,15089,6,0.00001,15,0.170624,0.199108,0,0.128788,0
9211120,9211120,,9,3,12,9,3,12,0.000001,0.000002,0,1981,6,0.000025,3,0.583333,0.690476,67.769079,0.204545,0.002426
8223,8223,,0,1,1,0,1,1,0,0,0,15094,5,0.00001,2,0.571429,0.625,0,0,0
9809215,9809215,,1,3,4,1,3,4,0,0,0,15093,5,0.000019,1,1,1,3,0,0.000219
9312069,9312069,,3,0,3,3,0,3,0,0,0,15092,5,0.000022,0,0,0,0,0,0.000691
9401123,9401123,,4,0,4,4,0,4,0.000003,0,0,15091,5,0.000023,0,0,0,0,0,0.00091
9711190,9711190,,4,0,4,4,0,4,0,0,0,15090,5,0.000031,0,0,0,0,0.083333,0.00091
8224,8224,,2,10,12,2,10,12,0.000284,0.01863,0,15095,1,0.000011,14,0.189278,0.213891,12.816683,0.325758,0.000479
8225,8225,,10,12,22,10,12,22,0.001153,0.008042,0,15096,4,0.000014,16,0.189936,0.214577,1263.769291,0.272727,0.002617
8226,8226,,3,40,43,3,40,43,0.000323,0.019384,0,15097,13,0.000011,13,0.23239,0.271453,4635.55851,0.145072,0.000833
9707156,9707156,,4,14,18,4,14,18,0.000505,0.003738,0,4340,13,0.000013,11,0.190042,0.218672,18408.301755,0.104575,0.00121
8227,8227,,46,30,76,46,30,76,0.001714,0.001864,0,12923,3,0.000041,14,0.195714,0.216491,51766.938561,0.178596,0.021344
8228,8228,,1,6,7,1,6,7,0.000235,0.016774,0,15099,1,0.00001,11,0.22542,0.254445,2.5,0.452381,0.000236
9910136,9910136,,2,7,9,2,7,9,0.000432,0.018375,0,15098,1,0.000012,11,0.225429,0.254535,4.702518,0.388889,0.000462
8229,8229,,0,4,4,0,4,4,0,0.000001,0,15100,5,0.00001,17,0.122173,0.135688,0,0.333333,0
8230,8230,,16,47,63,16,47,63,0.00113,0.00341,0,15101,52,0.000015,15,0.210403,0.240313,45250.551255,0.113159,0.004889
8232,8232,,16,9,25,16,9,25,0.001408,0.000705,0,12466,0,0.000019,17,0.198773,0.221358,4928.807631,0.11,0.004761
8233,8233,,0,8,8,0,8,8,0,0.00003,0,15102,6,0.00001,18,0.137076,0.169493,0,0.125,0
9312202,9312202,,1,2,3,1,2,3,0,0.000006,0,5989,3,0.000032,1,1,1,44.703964,0,0.000263
8234,8234,,1,7,8,1,7,8,0,0.000008,0,15103,28,0.000015,13,0.157508,0.184476,581.078682,0.142857,0.000226
9511205,9511205,,2,13,15,2,13,15,0.000013,0.00002,0,3656,5,0.000013,4,0.54386,0.669355,45020.236695,0.109524,0.00046
9406010,9406010,,6,2,8,6,2,8,0,0.00001,0,10089,28,0.000028,2,0.75,0.833333,60.211402,0.071429,0.001397
9411146,9411146,,2,2,4,2,2,4,0,0.00001,0,10090,28,0.000013,2,0.666667,0.75,19,0.333333,0.0005
10232,10232,,27,28,55,27,28,55,0.003147,0.018901,0,15107,25,0.000043,12,0.204412,0.228832,73103.168456,0.10101,0.008575
9197,9197,,7,8,15,7,8,15,0.000724,0.000095,0,15106,1,0.000018,13,0.179106,0.19519,36103.619145,0.085714,0.002002
8236,8236,,0,2,2,0,2,2,0,0,0,15108,26,0.00001,16,0.134258,0.14467,0,0,0
8237,8237,,13,11,24,13,11,24,0.000004,0.000005,0,15109,6,0.000018,14,0.131745,0.149732,2311.159752,0.179348,0.003088
9404118,9404118,,4,0,4,4,0,4,0.000001,0,0,3851,6,0.000016,0,0,0,0,0.166667,0.001167
8238,8238,,0,6,6,0,6,6,0,0.001731,0,15110,0,0.00001,13,0.18065,0.200799,0,0.366667,0
8239,8239,,2,16,18,2,16,18,0.00076,0.003728,0,15117,1,0.00001,13,0.220508,0.250972,99.895491,0.205882,0.000713
9910059,9910059,,4,2,6,4,2,6,0.000983,0.000214,0,15115,1,0.000012,16,0.157597,0.17048,0,0.433333,0.001195
9911073,9911073,,4,3,7,4,3,7,0.000983,0.000325,0,15114,1,0.000012,15,0.163136,0.176279,160.558967,0.404762,0.001195
9911182,9911182,,3,9,12,3,9,12,0.000586,0.015242,0,15116,1,0.000016,14,0.177407,0.196104,15302.359937,0.19697,0.001239
9912059,9912059,,3,4,7,3,4,7,0.000803,0.005708,0,15113,1,0.000011,12,0.192762,0.211442,2982.54118,0.190476,0.000949
9907093,9907093,,2,25,27,2,25,27,0.000414,0.019981,0,15112,1,0.000012,11,0.227026,0.257601,4889.548638,0.287749,0.000462
9912003,9912003,,4,3,7,4,3,7,0.000072,0.000004,0,15111,26,0.000016,2,0.615385,0.6875,1044.203868,0.238095,0.00094
8240,8240,,5,3,8,5,3,8,0.000041,0.000002,0,15118,10,0.000015,15,0.132544,0.140743,0,0.5,0.00129
8241,8241,,39,99,138,39,99,138,0.005939,0.023794,0,15120,13,0.000031,13,0.241657,0.287494,433792.47547,0.036602,0.012033
6061,6061,,4,0,4,4,0,4,0.000289,0,0,15119,23,0.000025,0,0,0,0,0.083333,0.001203
9410187,9410187,,8,14,22,8,14,22,0.00073,0.000123,0,988,5,0.000017,7,0.336088,0.427615,10267.679179,0.136364,0.002826
9501106,9501106,,7,3,10,7,3,10,0.000325,0.000126,0,1032,5,0.000017,3,0.40566,0.445736,147.681638,0.122222,0.002037
9405103,9405103,,2,0,2,2,0,2,0.000009,0,0,981,5,0.000013,0,0,0,0,0.5,0.000862
9403002,9403002,,1,0,1,1,0,1,0.000071,0,0,1131,13,0.000014,0,0,0,0,0,0.000714
8242,8242,,2,21,23,2,21,23,0.000059,0.002109,0,15121,3,0.000011,12,0.198455,0.219808,284.760029,0.284585,0.00116
107254,107254,,3,7,10,3,7,10,0.000127,0.00134,0,15128,25,0.000012,14,0.193671,0.215809,1365.842553,0.088889,0.000677
11225,11225,,35,13,48,35,13,48,0.002554,0.002607,0,15125,25,0.000032,14,0.200245,0.223679,30197.608675,0.070479,0.009706
103211,103211,,2,11,13,2,11,13,0.000026,0.001405,0,15127,25,0.000012,13,0.194307,0.215402,3456.375498,0.185897,0.000534
104170,104170,,13,8,21,13,8,21,0.001054,0.00006,0,15124,25,0.000022,14,0.182824,0.203978,13999.594902,0.042857,0.003325
8246,8246,,0,3,3,0,3,3,0,0.000001,0,15129,23,0.00001,2,0.714286,0.8,0,0,0
9407051,9407051,,5,0,5,5,0,5,0,0,0,5867,23,0.000075,0,0,0,0,0.1,0.001167
8247,8247,,5,15,20,5,15,20,0.000831,0.001926,0,15130,30,0.000011,15,0.199695,0.222748,3024.043047,0.171053,0.001269
8248,8248,,1,1,2,1,1,2,0,0,0,15131,23,0.000011,1,1,1,0,0.5,0.000219
8249,8249,,3,52,55,3,52,55,0.000046,0.005792,0,15136,2,0.000011,18,0.20738,0.238425,9078.864038,0.115152,0.000746
9806151,9806151,,2,23,25,2,23,25,0.000135,0.008948,0,15135,2,0.00001,15,0.185381,0.219439,622.737665,0.223333,0.000465
9812011,9812011,,2,11,13,2,11,13,0.000146,0.002365,0,15133,13,0.000011,12,0.189799,0.219718,224.915182,0.205128,0.000544
9912106,9912106,,12,23,35,12,23,35,0.001197,0.00666,0,15134,2,0.000013,13,0.197539,0.22203,7646.30958,0.142017,0.003177
9905019,9905019,,3,13,16,3,13,16,0.000149,0.002363,0,15132,2,0.000011,15,0.175179,0.201584,3317.757012,0.195833,0.000743
8250,8250,,52,25,77,52,25,77,0.003117,0.006187,0,15137,0,0.000029,12,0.202531,0.225822,11324.577298,0.179426,0.020258
9612141,9612141,,1,34,35,1,34,35,0.00007,0.004738,0,5054,0,0.000011,14,0.215927,0.259935,223.407677,0.19916,0.000268
8251,8251,,3,8,11,3,8,11,0,0.000001,0,15138,5,0.000013,17,0.097435,0.106188,3256.948432,0.236364,0.00067
8252,8252,,94,25,119,94,25,119,0.002405,0.001294,0,12883,3,0.000079,15,0.191157,0.211013,179403.112482,0.136519,0.038052
8253,8253,,8,14,22,8,14,22,0.00118,0.001656,0,15139,1,0.000014,12,0.199803,0.220642,3103.070325,0.084416,0.002021
9004,9004,,3,1,4,3,1,4,0.000006,0.001757,0,15140,1,0.000016,11,0.224564,0.252811,14461.284664,0.083333,0.000684
9005,9005,,0,1,1,0,1,1,0,0.000003,0,15141,22,0.00001,1,1,1,0,0,0
9007,9007,,3,8,11,3,8,11,0.000001,0.00001,0,15142,26,0.000016,16,0.132604,0.143976,450.410517,0.163636,0.000677
9411002,9411002,,2,0,2,2,0,2,0.000001,0,0,1753,26,0.000018,0,0,0,0,0.5,0.000543
9411090,9411090,,5,0,5,5,0,5,0,0,0,1752,26,0.000051,0,0,0,0,0.2,0.001206
9008,9008,,7,9,16,7,9,16,0.000199,0.001505,0,15143,8,0.000017,12,0.19508,0.215296,2384.807366,0.141667,0.001747
9009,9009,,10,38,48,10,38,48,0.001169,0.004929,0,15144,30,0.000014,15,0.208297,0.235722,40600.552027,0.110816,0.004852
9011,9011,,5,7,12,5,7,12,0.000324,0.003001,0,15145,2,0.000011,13,0.190585,0.209274,965.834216,0.348485,0.001273
9012,9012,,0,1,1,0,1,1,0,0.000011,0,15146,0,0.00001,15,0.172069,0.18698,0,0,0
9013,9013,,2,4,6,2,4,6,0.000082,0.00001,0,15147,2,0.000012,16,0.143006,0.15704,8.694888,0.366667,0.000445
9014,9014,,2,2,4,2,2,4,0,0,0,15148,15,0.000021,17,0.160696,0.173178,14343.5,0.25,0.000445
9015,9015,,13,40,53,13,40,53,0.003306,0.019642,0,15149,1,0.000015,13,0.215969,0.242293,32852.200304,0.16836,0.004388
9016,9016,,10,29,39,10,29,39,0.000501,0.01096,0,15150,13,0.000015,14,0.201566,0.23079,17160.812516,0.103239,0.002541
9017,9017,,6,10,16,6,10,16,0.000715,0.002469,0,13022,30,0.000012,15,0.190202,0.209095,252.547505,0.254167,0.00172
9018,9018,,5,14,19,5,14,19,0.000607,0.000985,0,15151,41,0.000016,12,0.190158,0.209381,22908.988558,0.233918,0.00174
9019,9019,,25,28,53,25,28,53,0.003602,0.004914,0,15152,2,0.000021,13,0.221956,0.248455,35509.885354,0.120827,0.007075
9020,9020,,2,18,20,2,18,20,0.000387,0.000436,0,15157,41,0.00001,15,0.17197,0.196896,362.973559,0.107895,0.000458
9908170,9908170,,1,4,5,1,4,5,0.000005,0.000001,0,15156,15,0.00001,4,0.414634,0.529412,48.879762,0.1,0.000232
9209031,9209031,,4,0,4,4,0,4,0.000007,0,0,8396,22,0.000026,0,0,0,0,0.083333,0.000938
9309056,9309056,,1,3,4,1,3,4,0,0.000014,0,11215,15,0.000012,2,0.8,0.875,357.708976,0,0.000233
9703177,9703177,,3,3,6,3,3,6,0,0.000002,0,15154,15,0.000023,4,0.4,0.541667,35,0.033333,0.000677
9907042,9907042,,1,2,3,1,2,3,0,0,0,15155,15,0.000012,3,0.444444,0.513889,7.833333,0.166667,0.000226
9021,9021,,5,37,42,5,37,42,0.000369,0.0056,0,15158,30,0.000013,12,0.210576,0.240157,34468.993374,0.091173,0.0015
9409006,9409006,,4,0,4,4,0,4,0.000044,0,0,12435,26,0.000019,0,0,0,0,0.083333,0.000959
9612183,9612183,,6,11,17,6,11,17,0.000043,0.000006,0,12432,22,0.000017,8,0.265866,0.342896,42927.587799,0.088235,0.001453
9801193,9801193,,1,3,4,1,3,4,0.000043,0.000001,0,12436,26,0.000011,10,0.17295,0.199499,16682.453294,0.25,0.000287
9023,9023,,16,13,29,16,13,29,0.000338,0.002382,0,15161,25,0.000021,16,0.196485,0.219996,15543.606569,0.149015,0.00389
9912211,9912211,,3,6,9,3,6,9,0.000055,0.000037,0,15160,25,0.000013,16,0.15706,0.171679,2048.368978,0.263889,0.00078
9904209,9904209,,2,4,6,2,4,6,0.000005,0.000021,0,15159,25,0.000012,17,0.139828,0.151305,0.45,0.4,0.00046
9025,9025,,12,21,33,12,21,33,0.000631,0.005461,0,12980,3,0.000015,12,0.21997,0.24425,5528.531249,0.162879,0.004225
9026,9026,,4,13,17,4,13,17,0.000202,0.000125,0,15162,3,0.000012,13,0.176341,0.189528,983.055576,0.165441,0.000981
9027,9027,,2,4,6,2,4,6,0.000043,0.000003,0,15163,15,0.000012,3,0.48,0.597222,1438.46438,0.166667,0.000638
9028,9028,,7,12,19,7,12,19,0.000446,0.003332,0,15164,30,0.000015,13,0.196013,0.215909,930.128594,0.312865,0.002413
9029,9029,,5,2,7,5,2,7,0.000375,0.00115,0,15165,2,0.000012,13,0.178339,0.19169,1.245479,0.261905,0.001183
9702147,9702147,,2,0,2,2,0,2,0.00006,0,0,9446,26,0.000016,0,0,0,0,0,0.000512
9031,9031,,3,7,10,3,7,10,0,0.000007,0,15166,23,0.000019,13,0.152288,0.16611,44897.427162,0.233333,0.000724
9033,9033,,0,6,6,0,6,6,0,0,0,15167,23,0.00001,11,0.166743,0.212254,0,0.5,0
9034,9034,,1,3,4,1,3,4,0.000002,0.000144,0,15169,13,0.000013,16,0.125119,0.132944,1,0.333333,0.000219
9910231,9910231,,2,3,5,2,3,5,0.000003,0.000148,0,15168,13,0.000017,15,0.142979,0.154757,12359,0.2,0.000445
9035,9035,,0,1,1,0,1,1,0,0,0,15170,26,0.00001,9,0.180089,0.208481,0,0,0
9036,9036,,0,1,1,0,1,1,0,0,0,15171,26,0.00001,18,0.121015,0.129489,0,0,0
9037,9037,,10,13,23,10,13,23,0.000281,0.00117,0,15172,30,0.000024,13,0.197796,0.216125,6045.688814,0.231225,0.003352
9038,9038,,38,62,100,38,62,100,0.002243,0.005594,0,12922,3,0.00004,14,0.211313,0.238846,135361.995382,0.142222,0.020646
9809144,9809144,,3,7,10,3,7,10,0.001012,0.006333,0,12458,1,0.000012,14,0.174632,0.196617,12042.225448,0.111111,0.00107
9705060,9705060,,3,8,11,3,8,11,0.000078,0.00004,0,12457,5,0.000012,13,0.165504,0.190581,1238.976205,0.181818,0.000683
9808107,9808107,,1,2,3,1,2,3,0.000074,0.000012,0,12456,1,0.000011,16,0.153373,0.169217,2770.166701,0,0.000244
9040,9040,,0,2,2,0,2,2,0,0.006279,0,15173,13,0.00001,14,0.178738,0.200253,0,0,0
9041,9041,,1,10,11,1,10,11,0,0.000004,0,15174,20,0.00001,13,0.164551,0.178279,79.906479,0.245455,0.000219
9042,9042,,17,28,45,17,28,45,0.001314,0.002892,0,15007,52,0.000016,13,0.194934,0.221028,12529.305494,0.118687,0.004783
9043,9043,,3,13,16,3,13,16,0.000151,0.002793,0,15175,30,0.000011,15,0.190208,0.209953,2338.859738,0.15,0.000966
9044,9044,,2,10,12,2,10,12,0,0.000006,0,15182,5,0.000016,11,0.140321,0.181449,80.5,0.083333,0.000438
9803223,9803223,,1,3,4,1,3,4,0,0,0,15181,5,0.000011,1,1,1,9,0,0.000232
9810190,9810190,,2,2,4,2,2,4,0.000015,0.000002,0,15179,5,0.000012,5,0.295918,0.361494,114.523007,0.25,0.000465
9912237,9912237,,1,3,4,1,3,4,0,0.000003,0,15178,5,0.000011,10,0.157603,0.187567,431,0.083333,0.000232
9404087,9404087,,1,0,1,1,0,1,0,0,0,15180,5,0.000013,0,0,0,0,0,0.000226
9905039,9905039,,3,2,5,3,2,5,0,0.000001,0,15177,5,0.000017,4,0.394366,0.4375,33.747409,0.05,0.000684
9045,9045,,10,3,13,10,3,13,0.000637,0.000106,0,15183,52,0.000013,13,0.175154,0.190366,1798.164948,0.25,0.002643
9046,9046,,2,7,9,2,7,9,0.000014,0.000111,0,15185,5,0.000019,17,0.134471,0.167672,7223.143124,0.013889,0.000452
9409143,9409143,,1,0,1,1,0,1,0.000001,0,0,15184,5,0.000012,0,0,0,0,0,0.000232
9503102,9503102,,2,0,2,2,0,2,0.000022,0,0,5431,15,0.000013,0,0,0,0,0,0.000479
9047,9047,,30,13,43,30,13,43,0.003686,0.01921,0,15186,1,0.000025,17,0.216284,0.249723,14198.561149,0.139535,0.010426
9048,9048,,7,12,19,7,12,19,0.000792,0.003338,0,15187,1,0.000014,14,0.217614,0.24994,18178.21022,0.116959,0.00178
9049,9049,,0,6,6,0,6,6,0,0.000015,0,15188,2,0.00001,12,0.189551,0.207274,0,0.066667,0
9050,9050,,11,26,37,11,26,37,0.000491,0.002404,0,15192,5,0.000015,14,0.170731,0.20064,4424.238014,0.124625,0.002773
9412014,9412014,,5,5,10,5,5,10,0.000152,0.000108,0,15191,13,0.000012,5,0.322097,0.372868,1570.169189,0.1,0.001233
9811052,9811052,,12,8,20,12,8,20,0.000447,0.002296,0,14700,5,0.000028,13,0.175784,0.198963,15685.490762,0.171053,0.003135
9910198,9910198,,9,18,27,9,18,27,0.000783,0.000226,0,15189,5,0.000014,15,0.159978,0.18418,5357.827008,0.155271,0.002391
9410068,9410068,,5,5,10,5,5,10,0.000129,0.000565,0,15190,13,0.000014,5,0.333333,0.381458,131.736768,0.122222,0.00115
9051,9051,,6,18,24,6,18,24,0.001222,0.009814,0,15193,1,0.000013,14,0.218711,0.249632,31791.323104,0.143116,0.001817
9712116,9712116,,9,12,21,9,12,21,0.000218,0.000562,0,8279,4,0.000014,13,0.167752,0.189662,2518.612438,0.240476,0.002307
9804061,9804061,,5,46,51,5,46,51,0.000124,0.004802,0,9631,4,0.000013,15,0.159327,0.191236,7684.373731,0.155686,0.001245
9052,9052,,10,2,12,10,2,12,0.000031,0.000019,0,15194,8,0.000027,12,0.185945,0.201265,19762.463215,0.136364,0.002567
9053,9053,,1,3,4,1,3,4,0.000002,0.000001,0,15196,5,0.000011,24,0.100878,0.135866,107.532642,0.166667,0.000219
9403132,9403132,,3,2,5,3,2,5,0.000002,0,0,15195,5,0.000019,2,0.75,0.833333,8.5,0.1,0.000664
9311087,9311087,,8,2,10,8,2,10,0.000002,0,0,4520,5,0.000052,1,1,1,983.195855,0.111111,0.001869
9054,9054,,12,31,43,12,31,43,0.000425,0.004552,0,11579,0,0.000017,15,0.186611,0.217885,7933.610017,0.114064,0.003924
9055,9055,,4,7,11,4,7,11,0.000009,0.000017,0,15199,22,0.000014,14,0.15644,0.1711,541.359428,0.118182,0.000929
9609025,9609025,,2,1,3,2,1,3,0,0,0,15198,22,0.000012,3,0.5,0.611111,15.866667,0,0.000465
9705141,9705141,,2,1,3,2,1,3,0.000002,0.000004,0,15197,22,0.000012,1,1,1,0.25,0.166667,0.000471
9510096,9510096,,3,1,4,3,1,4,0,0,0,11021,22,0.000025,2,0.666667,0.75,2468.266667,0,0.000693
9057,9057,,1,18,19,1,18,19,0.000275,0.006592,0,15200,25,0.00001,19,0.200247,0.226735,1034.705035,0.05848,0.000262
9058,9058,,0,1,1,0,1,1,0,0.000001,0,15201,5,0.00001,4,0.4,0.46875,0,0,0
9060,9060,,7,33,40,7,33,40,0.000801,0.004029,0,14333,4,0.000012,18,0.183958,0.219603,13216.905225,0.182692,0.00193
9061,9061,,66,30,96,66,30,96,0.003412,0.002341,0,12998,3,0.000046,15,0.197223,0.221336,50424.744755,0.123684,0.027559
9910159,9910159,,13,10,23,13,10,23,0.000599,0.006966,0,12846,3,0.000017,14,0.201207,0.22946,23154.438582,0.128458,0.006175
9806112,9806112,,2,24,26,2,24,26,0.000026,0.007207,0,12843,2,0.000013,14,0.2023,0.235421,55650.348487,0.118462,0.000595
9806054,9806054,,8,4,12,8,4,12,0.000451,0.000024,0,12845,41,0.000015,8,0.233208,0.27018,11774.836211,0.121212,0.001985
9062,9062,,9,35,44,9,35,44,0.001469,0.002685,0,15202,13,0.000014,17,0.211388,0.246467,12280.605484,0.124736,0.002775
9063,9063,,7,8,15,7,8,15,0.000537,0.007021,0,15203,8,0.000022,14,0.16604,0.184405,6647.325454,0.161905,0.002175
9066,9066,,1,10,11,1,10,11,0.000008,0.000292,0,15205,2,0.000011,16,0.178165,0.198882,1956.980668,0.227273,0.000219
9902003,9902003,,5,11,16,5,11,16,0.0001,0.000405,0,15204,2,0.000014,13,0.177277,0.197298,1423.66731,0.183333,0.001143
9503036,9503036,,3,12,15,3,12,15,0.000047,0.002271,0,1517,4,0.000033,6,0.297345,0.346875,153571.06498,0.147619,0.001696
9503145,9503145,,2,1,3,2,1,3,0.00001,0.000311,0,1602,4,0.000026,7,0.217778,0.24406,153.907731,0.166667,0.001166
9410216,9410216,,1,3,4,1,3,4,0.000001,0.000002,0,2873,23,0.000021,2,0.8,0.875,9890.445373,0,0.000436
9807029,9807029,,7,14,21,7,14,21,0.000208,0.00046,0,10634,2,0.000019,12,0.198588,0.222329,40130.207748,0.085714,0.00177
9610187,9610187,,7,4,11,7,4,11,0.000175,0.000019,0,9067,8,0.000031,11,0.177927,0.193864,6895.222726,0.118182,0.001641
9703002,9703002,,5,1,6,5,1,6,0.000179,0.000002,0,9068,8,0.000014,12,0.151115,0.160343,5128.734808,0.266667,0.001184
9704010,9704010,,2,7,9,2,7,9,0.000104,0.000177,0,9069,8,0.000011,12,0.200726,0.22564,1007.460327,0.236111,0.000485
9067,9067,,12,17,29,12,17,29,0.000516,0.002447,0,15206,30,0.000015,13,0.209188,0.234549,7016.480841,0.237685,0.003552
9068,9068,,9,9,18,9,9,18,0.000408,0.001301,0,15207,30,0.000016,18,0.19088,0.210707,6704.382089,0.107843,0.002638
9070,9070,,4,13,17,4,13,17,0.000092,0.001384,0,15208,30,0.000014,14,0.189882,0.208415,712.371903,0.235294,0.00106
10106,10106,,4,13,17,4,13,17,0.000586,0.01812,0,15209,41,0.000012,11,0.225787,0.255722,6365.180053,0.231618,0.001037
9601002,9601002,,6,1,7,6,1,7,0.000691,0,0,3875,26,0.000022,1,1,1,12082,0,0.00149
9071,9071,,4,3,7,4,3,7,0.000106,0.0065,0,15210,8,0.000021,14,0.177784,0.197661,10737.966477,0.166667,0.000896
9072,9072,,8,34,42,8,34,42,0.000221,0.0014,0,15211,52,0.000012,14,0.207024,0.233706,26491.164288,0.148664,0.002499
9073,9073,,5,3,8,5,3,8,0.000002,0,0,15217,17,0.000031,5,0.346939,0.461765,59.5,0.232143,0.001162
9708102,9708102,,9,4,13,9,4,13,0.000021,0.000011,0,15214,17,0.000057,4,0.423077,0.583333,1349.307668,0.115385,0.002199
9905152,9905152,,5,2,7,5,2,7,0,0,0,15215,17,0.000035,5,0.340909,0.44,55.104336,0.261905,0.001196
9912129,9912129,,4,3,7,4,3,7,0,0,0,15216,17,0.000027,5,0.355556,0.475,55.104336,0.261905,0.00095
9410032,9410032,,5,0,5,5,0,5,0.000002,0,0,15213,20,0.000026,0,0,0,0,0.2,0.00124
9806023,9806023,,3,1,4,3,1,4,0,0,0,15212,17,0.000035,2,0.666667,0.75,61.208672,0.166667,0.000718
9074,9074,,13,17,30,13,17,30,0.000299,0.003436,0,15218,25,0.000019,15,0.190352,0.212755,19205.841915,0.171264,0.003359
9077,9077,,2,10,12,2,10,12,0.000296,0.000108,0,15221,52,0.00001,11,0.198585,0.217992,100.330816,0.19697,0.000485
9707046,9707046,,3,11,14,3,11,14,0.000274,0.000093,0,15220,52,0.000011,5,0.404494,0.481944,132.225314,0.087912,0.000698
9705149,9705149,,3,5,8,3,5,8,0.000021,0.000018,0,15219,52,0.000014,4,0.432836,0.511494,64.509502,0.071429,0.000691
9078,9078,,0,8,8,0,8,8,0,0.002058,0,15222,0,0.00001,15,0.178941,0.208433,0,0.178571,0
9079,9079,,0,6,6,0,6,6,0,0.000002,0,15225,5,0.00001,5,0.341772,0.461111,0,0.033333,0
9802055,9802055,,4,0,4,4,0,4,0,0,0,15224,5,0.000022,0,0,0,0,0,0.000883
9909204,9909204,,3,1,4,3,1,4,0,0,0,15223,5,0.000016,1,1,1,0,0.25,0.000658
9080,9080,,0,3,3,0,3,3,0,0,0,15226,5,0.00001,1,1,1,0,0.166667,0
9081,9081,,0,4,4,0,4,4,0,0,0,15228,5,0.00001,15,0.129934,0.145368,0,0.166667,0
9903253,9903253,,3,3,6,3,3,6,0,0.000004,0,15227,5,0.000018,14,0.148975,0.17181,3866.75,0.133333,0.000664
9082,9082,,3,31,34,3,31,34,0.000716,0.005664,0,15229,30,0.000011,15,0.195948,0.220326,2684.361493,0.157754,0.000762
9084,9084,,5,21,26,5,21,26,0.000263,0.000716,0,15230,5,0.000013,14,0.17166,0.19471,2843.797698,0.103077,0.001261
9412124,9412124,,3,1,4,3,1,4,0.000039,0.000006,0,3277,22,0.000012,1,1,1,301.048717,0.083333,0.000806
9512123,9512123,,2,10,12,2,10,12,0.000076,0.000647,0,2115,13,0.000015,9,0.213534,0.25967,50532.030717,0.136364,0.0009
9085,9085,,0,2,2,0,2,2,0,0.000002,0,15232,30,0.00001,3,0.5,0.595238,0,0,0
9508032,9508032,,5,1,6,5,1,6,0.000055,0.000003,0,15231,30,0.000019,2,0.666667,0.75,66.428783,0.033333,0.001143
9086,9086,,7,4,11,7,4,11,0,0,0,15235,6,0.000026,15,0.141488,0.154234,1882.956885,0.2,0.001587
9710135,9710135,,4,5,9,4,5,9,0,0.000098,0,15234,6,0.000022,14,0.164608,0.185392,8507.317027,0.111111,0.000942
9704063,9704063,,3,4,7,3,4,7,0.000001,0.000006,0,12616,22,0.000017,4,0.438596,0.513333,3501.860721,0.142857,0.000711
9706014,9706014,,3,4,7,3,4,7,0.000227,0.000116,0,15233,13,0.000015,9,0.178838,0.196513,266.172135,0.190476,0.000711
9088,9088,,0,4,4,0,4,4,0,0.000124,0,15238,5,0.00001,9,0.219538,0.253209,0,0.166667,0
9602129,9602129,,1,8,9,1,8,9,0.000001,0.000183,0,15237,5,0.000012,8,0.266272,0.314054,78.960889,0.222222,0.000219
9604130,9604130,,1,9,10,1,9,10,0.000001,0.000187,0,15236,5,0.000012,8,0.263907,0.311339,107.539111,0.211111,0.000219
9089,9089,,11,25,36,11,25,36,0.000131,0.001403,0,15239,0,0.000019,14,0.198148,0.223829,40031.141327,0.094444,0.002774
9090,9090,,13,23,36,13,23,36,0.0007,0.003218,0,12934,3,0.000017,15,0.197442,0.219849,5333.592578,0.199206,0.006028
9091,9091,,1,4,5,1,4,5,0.000028,0.001154,0,15240,25,0.00001,16,0.180608,0.199464,0,0.4,0.000219
9092,9092,,1,6,7,1,6,7,0.000002,0.000012,0,15242,23,0.000011,15,0.159728,0.1758,1929.743037,0.309524,0.000232
7199,7199,,6,0,6,6,0,6,0.000202,0,0,15241,23,0.000018,0,0,0,0,0.033333,0.001348
9093,9093,,0,8,8,0,8,8,0,0.000002,0,15243,23,0.00001,16,0.104784,0.112897,0,0.125,0
9606055,9606055,,6,0,6,6,0,6,0,0,0,13940,23,0.000053,0,0,0,0,0.066667,0.001369
9094,9094,,0,3,3,0,3,3,0,0.000001,0,15244,26,0.00001,13,0.157599,0.176752,0,0.5,0
9407125,9407125,,4,0,4,4,0,4,0,0,0,12028,26,0.000026,0,0,0,0,0.083333,0.000976
9510090,9510090,,13,3,16,13,3,16,0.000002,0.000001,0,7303,26,0.000032,4,0.428571,0.516667,1620.127098,0.175,0.003129
9608101,9608101,,2,1,3,2,1,3,0,0,0,12027,26,0.000014,1,1,1,50.545238,0.166667,0.000511
9608102,9608102,,3,0,3,3,0,3,0,0,0,9733,26,0.000015,0,0,0,0,0.166667,0.000738
9804205,9804205,,5,29,34,5,29,34,0,0.000023,0,12040,26,0.000018,11,0.217259,0.269787,7394.240026,0.080214,0.001161
9095,9095,,3,40,43,3,40,43,0.000248,0.004836,0,13050,30,0.000011,12,0.215106,0.240499,21648.90288,0.14175,0.000987
9096,9096,,18,41,59,18,41,59,0.000812,0.016689,0,15245,9,0.000017,13,0.201201,0.227763,29803.068575,0.158679,0.004982
9809073,9809073,,1,16,17,1,16,17,0.000168,0.014176,0,7709,1,0.00001,12,0.199355,0.224059,11781.387224,0.224265,0.000254
9097,9097,,0,3,3,0,3,3,0,0,0,15246,23,0.00001,3,0.526316,0.616667,0,0.5,0
9098,9098,,4,31,35,4,31,35,0.000233,0.004931,0,15247,30,0.000011,15,0.197538,0.219943,2749.05311,0.154622,0.001245
9099,9099,,0,7,7,0,7,7,0,0.000049,0,15249,22,0.00001,14,0.159356,0.170502,0,0.095238,0
9605161,9605161,,9,1,10,9,1,10,0.000001,0.000001,0,15248,15,0.000031,1,1,1,91.640909,0.288889,0.002118
9100,9100,,3,11,14,3,11,14,0.000026,0.000359,0,15250,52,0.000011,16,0.159113,0.176925,350.065913,0.274725,0.000739
9101,9101,,32,28,60,32,28,60,0.00209,0.002686,0,12982,30,0.000032,15,0.216753,0.244182,64234.90005,0.117797,0.011565
9102,9102,,4,8,12,4,8,12,0.000001,0.000001,0,15257,52,0.000016,4,0.454545,0.586667,16.166667,0.181818,0.00089
9302130,9302130,,7,1,8,7,1,8,0.000001,0,0,2578,23,0.000033,1,1,1,5.583333,0.25,0.001707
9601144,9601144,,4,0,4,4,0,4,0,0,0,15255,52,0.000017,0,0,0,0,0.416667,0.000936
9808173,9808173,,8,6,14,8,6,14,0.000001,0,0,15253,52,0.000027,3,0.533333,0.645833,101.5,0.126374,0.001832
9912216,9912216,,3,8,11,3,8,11,0,0.000002,0,15256,52,0.000015,4,0.44898,0.598485,8.666667,0.218182,0.000697
9503147,9503147,,4,0,4,4,0,4,0,0,0,10859,52,0.000035,0,0,0,0,0.5,0.00103
9205053,9205053,,1,0,1,1,0,1,0,0,0,15252,52,0.000014,0,0,0,0,0,0.000272
9303081,9303081,,1,1,2,1,1,2,0,0.000001,0,15251,52,0.000014,2,0.666667,0.75,18,0,0.000272
9809151,9809151,,3,3,6,3,3,6,0.000001,0.000001,0,15254,52,0.000015,4,0.391304,0.481481,2,0.3,0.000678
9104,9104,,3,2,5,3,2,5,0.000007,0.000007,0,15258,0,0.000015,13,0.176194,0.19329,118.801225,0.25,0.000698
9105,9105,,40,24,64,40,24,64,0.001143,0.001571,0,12992,3,0.000035,14,0.191174,0.210963,9167.407985,0.261409,0.020857
9106,9106,,24,51,75,24,51,75,0.004946,0.0212,0,15259,1,0.000019,12,0.209572,0.237025,11353.467119,0.182703,0.007281
9107,9107,,8,32,40,8,32,40,0.000458,0.0163,0,15261,1,0.000014,14,0.197302,0.22255,16523.72959,0.18141,0.002272
9912042,9912042,,1,22,23,1,22,23,0.000192,0.0158,0,15260,9,0.00001,12,0.198846,0.222731,2394.139071,0.13834,0.000278
9108,9108,,1,1,2,1,1,2,0,0,0,15263,9,0.000013,1,1,1,6.5,0,0.000233
9705032,9705032,,3,0,3,3,0,3,0,0,0,15262,9,0.000023,0,0,0,0,0.166667,0.00069
9109,9109,,6,7,13,6,7,13,0.000025,0.000021,0,15264,23,0.000014,19,0.127763,0.146992,385.381481,0.269231,0.001396
9111,9111,,3,8,11,3,8,11,0.000029,0.001759,0,15265,52,0.000012,15,0.169116,0.188532,1593.901984,0.172727,0.000834
9112,9112,,19,39,58,19,39,58,0.000643,0.003054,0,12979,52,0.000019,15,0.214487,0.242085,116098.654161,0.116455,0.005987
9701067,9701067,,4,5,9,4,5,9,0.000004,0.000006,0,8667,30,0.000016,12,0.140995,0.151484,3873.977439,0.055556,0.000938
9701073,9701073,,5,12,17,5,12,17,0.000058,0.000029,0,8665,30,0.00002,11,0.163587,0.181024,24076.834379,0.113971,0.001178
9708052,9708052,,1,2,3,1,2,3,0,0.000001,0,8666,30,0.000013,12,0.140683,0.150696,217.146232,0.333333,0.000267
9113,9113,,3,10,13,3,10,13,0.000032,0.000756,0,15268,3,0.000012,13,0.184744,0.202073,11880.157283,0.121795,0.00087
9811138,9811138,,2,6,8,2,6,8,0.000011,0.000021,0,15267,6,0.000011,8,0.255376,0.335238,5922.040434,0.160714,0.000461
9706150,9706150,,1,4,5,1,4,5,0,0.000019,0,15266,6,0.000012,7,0.248021,0.312563,2349.430797,0.3,0.000232
9114,9114,,0,1,1,0,1,1,0,0,9,15270,31,0.00001,1,1,1,0,0,0
9906008,9906008,,2,0,2,2,0,2,0,0,9,15269,31,0.000028,0,0,0,0,0,0.000438
9115,9115,,1,4,5,1,4,5,0.000026,0.00001,0,15271,0,0.000011,15,0.150302,0.168809,15.458333,0.2,0.000219
9116,9116,,2,6,8,2,6,8,0,0.000004,0,15279,2,0.000012,14,0.16588,0.184047,0,0.267857,0.000445
9911188,9911188,,3,18,21,3,18,21,0,0.000101,0,15278,2,0.000014,15,0.178677,0.204458,5114.532933,0.045238,0.000677
9702200,9702200,,1,14,15,1,14,15,0.000001,0.000601,0,15277,4,0.000011,12,0.171246,0.194144,87.886293,0.233333,0.000239
9707140,9707140,,1,4,5,1,4,5,0.000001,0.001335,0,15276,0,0.000011,11,0.20673,0.231257,1937.624046,0.15,0.000239
9810017,9810017,,1,5,6,1,5,6,0.000001,0.000145,0,15275,2,0.000011,15,0.15499,0.173295,936.894214,0.3,0.000239
9811105,9811105,,1,4,5,1,4,5,0.000001,0.001999,0,15274,26,0.000011,15,0.160351,0.179584,420.838161,0.15,0.000239
9908097,9908097,,1,10,11,1,10,11,0.000001,0.000406,0,15272,4,0.000011,15,0.135497,0.152395,167.944988,0.254545,0.000239
9117,9117,,11,23,34,11,23,34,0.000307,0.00175,0,15280,25,0.000016,16,0.189102,0.211511,9993.164254,0.132799,0.00299
9118,9118,,1,26,27,1,26,27,0.000069,0.018272,0,15283,1,0.00001,11,0.227089,0.259811,1529.578031,0.269231,0.000361
9909146,9909146,,3,37,40,3,37,40,0.000302,0.019708,0,15282,1,0.000011,11,0.230241,0.263336,3043.133536,0.207051,0.000821
9204050,9204050,,4,0,4,4,0,4,0.000232,0,0,1065,0,0.000047,0,0,0,0,0.083333,0.001092
9304029,9304029,,5,1,6,5,1,6,0.000232,0.000003,0,2913,0,0.000037,1,1,1,2191.466945,0.066667,0.001214
9909063,9909063,,3,9,12,3,9,12,0.000282,0.001738,0,15281,1,0.000011,13,0.179705,0.199144,40.254115,0.25,0.000839
9119,9119,,2,15,17,2,15,17,0.000008,0.001593,0,15284,1,0.000012,14,0.193171,0.21257,3724.963635,0.176471,0.000451
9120,9120,,5,12,17,5,12,17,0.000183,0.001037,0,15286,30,0.000015,13,0.192397,0.210141,10803.948485,0.117647,0.001252
9907110,9907110,,16,7,23,16,7,23,0.000172,0.000088,0,15285,30,0.000043,13,0.174115,0.190198,16559.06908,0.092885,0.004103
9405079,9405079,,3,1,4,3,1,4,0,0,0,5439,15,0.000042,1,1,1,11150,0,0.000795
9121,9121,,3,4,7,3,4,7,0.000002,0.000006,0,15287,15,0.000012,13,0.148623,0.160377,83.245801,0.119048,0.000677
9124,9124,,3,6,9,3,6,9,0.000005,0.000008,0,15288,23,0.000011,17,0.138908,0.151014,488.737451,0.208333,0.000684
9125,9125,,2,14,16,2,14,16,0.000056,0.000017,0,15289,23,0.000011,15,0.160541,0.179611,24929.05547,0.104167,0.00051
9404084,9404084,,2,5,7,2,5,7,0.000002,0,0,9282,5,0.000026,1,1,1,1495.332868,0.071429,0.000502
9410098,9410098,,5,2,7,5,2,7,0,0,0,11737,23,0.000036,3,0.555556,0.666667,4300.793263,0.166667,0.001177
9505154,9505154,,3,1,4,3,1,4,0,0,0,11738,23,0.000017,4,0.4,0.486111,0,0.416667,0.000712
9811166,9811166,,2,2,4,2,2,4,0,0.000002,0,11741,23,0.000012,5,0.322581,0.382222,2529.466353,0.25,0.000452
9126,9126,,27,22,49,27,22,49,0.003015,0.020766,0,15291,1,0.00003,14,0.216575,0.25089,38530.051263,0.13818,0.007849
9907163,9907163,,8,2,10,8,2,10,0.000955,0.000099,0,15290,25,0.000019,14,0.162311,0.178325,202.677206,0.255556,0.002654
9128,9128,,1,11,12,1,11,12,0.000007,0.00058,0,15292,1,0.000011,14,0.176671,0.195462,131.762802,0.242424,0.000219
9129,9129,,0,3,3,0,3,3,0,0.000059,0,15294,26,0.00001,10,0.17761,0.208695,0,0.166667,0
9912078,9912078,,2,9,11,2,9,11,0.000001,0.000052,0,15293,4,0.000018,9,0.198473,0.233493,683.240837,0.209091,0.000445
9130,9130,,6,3,9,6,3,9,0.000056,0.000164,0,15295,23,0.000016,12,0.192044,0.209619,16744.998404,0.138889,0.001407
9131,9131,,1,18,19,1,18,19,0.000024,0.007189,0,15296,2,0.00001,14,0.188472,0.210723,38.207235,0.195906,0.000253
9133,9133,,3,23,26,3,23,26,0.00001,0.000171,0,15299,0,0.000011,16,0.154906,0.184909,1655.324026,0.238462,0.00067
9801200,9801200,,1,15,16,1,15,16,0.000002,0.00054,0,15298,0,0.00001,12,0.210724,0.245159,1379.184528,0.2875,0.000239
9901064,9901064,,2,7,9,2,7,9,0.000005,0.000143,0,15297,0,0.000011,12,0.16847,0.18966,147.072747,0.291667,0.000497
9134,9134,,0,19,19,0,19,19,0,0.005178,0,15300,2,0.00001,15,0.179768,0.20908,0,0.245614,0
9412242,9412242,,5,11,16,5,11,16,0.000035,0.000098,0,2856,28,0.00002,5,0.356021,0.414461,886.266797,0.175,0.001454
9504121,9504121,,4,4,8,4,4,8,0.000037,0.000035,0,4692,28,0.000013,6,0.319853,0.372414,2135.717061,0.178571,0.000995
9504122,9504122,,5,1,6,5,1,6,0.000062,0.000001,0,4690,28,0.000013,7,0.244275,0.271652,25.528875,0.233333,0.001256
9508100,9508100,,2,8,10,2,8,10,0.000025,0.000108,0,4194,28,0.000012,6,0.320158,0.372531,272.903904,0.255556,0.000586
9611066,9611066,,3,10,13,3,10,13,0.00016,0.000248,0,4689,0,0.000011,11,0.200614,0.228533,2403.895326,0.128205,0.000753
9135,9135,,13,50,63,13,50,63,0.00124,0.006078,0,15301,0,0.000015,13,0.218349,0.248405,19780.579252,0.138249,0.005082
9138,9138,,19,11,30,19,11,30,0.000507,0.000302,0,15302,52,0.000025,13,0.190143,0.209751,79053.394388,0.148276,0.005738
9139,9139,,25,74,99,25,74,99,0.006629,0.042538,0,12962,1,0.000019,11,0.229453,0.262636,179490.200695,0.076376,0.006945
9140,9140,,29,21,50,29,21,50,0.003011,0.004986,0,15303,30,0.000023,12,0.212812,0.236987,105963.718699,0.107347,0.009616
9141,9141,,13,43,56,13,43,56,0.001224,0.005238,0,13051,30,0.000014,12,0.212155,0.238788,33639.742792,0.146429,0.005166
9143,9143,,1,15,16,1,15,16,0,0.000026,0,15304,23,0.000011,15,0.150451,0.165998,633.345666,0.291667,0.000239
9807157,9807157,,1,7,8,1,7,8,0,0.00001,0,13602,23,0.000011,10,0.165838,0.190571,749.033833,0.089286,0.000248
9144,9144,,9,8,17,9,8,17,0.000163,0.000095,0,15305,28,0.000013,14,0.159229,0.177808,1089.907483,0.246324,0.002521
9146,9146,,3,22,25,3,22,25,0.000595,0.006276,0,15306,1,0.000011,12,0.212814,0.237057,2051.564906,0.178333,0.000866
9147,9147,,6,18,24,6,18,24,0.000599,0.002213,0,15307,30,0.000011,15,0.203347,0.22803,980.154151,0.173913,0.001633
9149,9149,,1,11,12,1,11,12,0.000058,0.002609,0,15308,4,0.00001,19,0.139487,0.157088,59.349398,0.310606,0.000226
9410203,9410203,,10,9,19,10,9,19,0.000094,0.00001,0,1459,9,0.000025,5,0.402597,0.483602,200206.054994,0.084795,0.003195
9150,9150,,3,11,14,3,11,14,0.000413,0.001617,0,15309,0,0.000012,16,0.189297,0.214839,5648.211737,0.181319,0.000898
9151,9151,,0,4,4,0,4,4,0,0.000108,0,15310,5,0.00001,13,0.174196,0.189918,0,0.083333,0
9152,9152,,9,35,44,9,35,44,0.000009,0.000552,0,15312,23,0.000019,14,0.178323,0.202528,78503.918871,0.123679,0.002361
9909209,9909209,,7,39,46,7,39,46,0.000089,0.001151,0,15311,23,0.000017,15,0.140305,0.164487,41337.287524,0.097101,0.001798
9305175,9305175,,4,1,5,4,1,5,0,0.000007,0,4322,23,0.000034,1,1,1,4.258741,0.05,0.000972
9509114,9509114,,2,2,4,2,2,4,0.000001,0.000005,0,11417,23,0.000014,3,0.5,0.566667,2738,0.25,0.000493
9605031,9605031,,5,0,5,5,0,5,0.000018,0,0,12664,23,0.000015,0,0,0,0,0.3,0.0013
9605044,9605044,,6,0,6,6,0,6,0.000018,0,0,12663,23,0.000017,0,0,0,0,0.333333,0.001577
9605045,9605045,,7,1,8,7,1,8,0.000018,0,0,12662,23,0.000031,1,1,1,275.900789,0.232143,0.001825
9606195,9606195,,5,8,13,5,8,13,0.000016,0.000167,0,12666,23,0.000015,8,0.205839,0.261981,3314.191254,0.121795,0.001322
9612005,9612005,,6,30,36,6,30,36,0.000018,0.000024,0,12661,9,0.000019,12,0.171171,0.196804,57029.719263,0.084127,0.001465
9701026,9701026,,4,1,5,4,1,5,0.000016,0,0,12678,23,0.000015,2,0.666667,0.75,2,0.2,0.001044
9703050,9703050,,4,5,9,4,5,9,0.000016,0.000077,0,12677,23,0.000015,13,0.161188,0.181185,11475.244821,0.236111,0.001085
9804030,9804030,,3,6,9,3,6,9,0.00002,0.000026,0,12675,23,0.000012,8,0.186047,0.231581,437.217774,0.333333,0.000721
9153,9153,,17,11,28,17,11,28,0.00059,0.00262,0,15314,30,0.000022,13,0.189374,0.207668,5659.393236,0.216931,0.004729
7072,7072,,2,0,2,2,0,2,0.00005,0,0,15313,30,0.000013,0,0,0,0,0.5,0.000622
9154,9154,,1,14,15,1,14,15,0,0.000011,0,15319,23,0.00001,16,0.136004,0.159025,89.69418,0.204762,0.000219
9805130,9805130,,3,12,15,3,12,15,0,0.000017,0,15318,23,0.000025,9,0.211775,0.246468,908.280746,0.171429,0.00067
9811068,9811068,,6,15,21,6,15,21,0.000001,0.000014,0,15317,23,0.000015,18,0.139005,0.175106,2289.165709,0.2,0.001328
9203013,9203013,,4,0,4,4,0,4,0.000023,0,0,4718,30,0.000061,0,0,0,0,0.083333,0.000934
9503101,9503101,,7,1,8,7,1,8,0.000035,0,0,4736,23,0.000026,1,1,1,1721.816324,0.125,0.001937
9505040,9505040,,4,10,14,4,10,14,0,0.000024,0,6617,23,0.000015,7,0.297952,0.344301,3311.982116,0.142857,0.000992
9608057,9608057,,2,8,10,2,8,10,0,0.000018,0,6624,23,0.000012,6,0.262877,0.315878,83.521429,0.233333,0.000472
9307006,9307006,,5,0,5,5,0,5,0.000001,0,0,6619,23,0.000026,0,0,0,0,0.1,0.001149
9408128,9408128,,3,4,7,3,4,7,0,0.000005,0,6620,23,0.000017,7,0.203125,0.23954,123.595146,0.047619,0.000691
9307047,9307047,,1,0,1,1,0,1,0,0,0,15316,23,0.000011,0,0,0,0,0,0.000258
9611147,9611147,,3,8,11,3,8,11,0,0.000004,0,15315,23,0.000012,9,0.195263,0.228988,345.559493,0.163636,0.000697
9155,9155,,1,13,14,1,13,14,0.000074,0.000752,0,15320,3,0.00001,15,0.208618,0.232987,317.530538,0.203297,0.000264
9156,9156,,21,55,76,21,55,76,0.004907,0.025842,0,15321,1,0.000017,13,0.229688,0.264192,112785.791153,0.145439,0.006485
9157,9157,,2,9,11,2,9,11,0.000004,0.000175,0,15323,2,0.000012,14,0.163013,0.184549,224.352573,0.254545,0.000438
9806005,9806005,,4,31,35,4,31,35,0.000004,0.000848,0,15322,23,0.000014,13,0.192101,0.22636,7641.791762,0.079832,0.00089
9803222,9803222,,2,3,5,2,3,5,0.000001,0.000005,0,14488,23,0.000014,8,0.265734,0.295883,825.273341,0.05,0.000479
9159,9159,,8,14,22,8,14,22,0.001496,0.002908,0,15324,1,0.000014,13,0.200315,0.22331,2490.442726,0.231602,0.002734
9161,9161,,1,13,14,1,13,14,0,0.000009,0,15325,23,0.00001,18,0.152889,0.167406,2765.326276,0.313187,0.000226
9162,9162,,2,10,12,2,10,12,0.000074,0.000041,0,15332,15,0.000011,13,0.165817,0.179899,3106.440718,0.136364,0.000505
9310097,9310097,,8,0,8,8,0,8,0.000001,0,0,5444,15,0.000035,0,0,0,0,0,0.001855
9709106,9709106,,4,18,22,4,18,22,0.000013,0.002023,0,15331,15,0.000014,14,0.169591,0.196796,10311.470007,0.145022,0.000937
9911191,9911191,,5,13,18,5,13,18,0.000017,0.000839,0,15326,15,0.000014,14,0.172321,0.193396,4145.990067,0.098039,0.001164
9308136,9308136,,9,0,9,9,0,9,0.000047,0,0,6197,15,0.000046,0,0,0,0,0.138889,0.002175
9405054,9405054,,10,0,10,10,0,10,0.000047,0,0,6196,15,0.000047,0,0,0,0,0.111111,0.002394
9508076,9508076,,9,2,11,9,2,11,0.000072,0.000001,0,15327,15,0.00003,1,1,1,16.852381,0.127273,0.002059
9606023,9606023,,5,3,8,5,3,8,0.000024,0.000002,0,15329,15,0.000017,1,1,1,0.9,0.25,0.001143
9612082,9612082,,5,10,15,5,10,15,0.000051,0.00002,0,7714,15,0.000018,12,0.170126,0.189053,1088.681527,0.233333,0.001236
9703053,9703053,,4,7,11,4,7,11,0.000073,0.001971,0,15328,15,0.000015,13,0.173517,0.196975,8146.393066,0.181818,0.000923
9703132,9703132,,2,6,8,2,6,8,0.000024,0.000004,0,15330,15,0.000012,14,0.147986,0.162455,0.4,0.357143,0.000465
9808086,9808086,,4,23,27,4,23,27,0.000875,0.009977,0,7839,1,0.000012,13,0.196427,0.225348,3841.096938,0.217949,0.001123
9163,9163,,13,11,24,13,11,24,0.000477,0.001608,0,15334,30,0.000022,13,0.185837,0.203791,38634.109285,0.099638,0.003066
4033,4033,,2,0,2,2,0,2,0.000038,0,0,15333,30,0.000012,0,0,0,0,0.5,0.000532
9164,9164,,0,14,14,0,14,14,0,0.016593,0,15337,5,0.00001,13,0.197706,0.22524,0,0.153846,0
9806078,9806078,,6,11,17,6,11,17,0.000273,0.017133,0,8328,5,0.000018,13,0.197795,0.231476,18057.223839,0.161765,0.001429
9910006,9910006,,2,10,12,2,10,12,0.000221,0.001024,0,15336,5,0.000011,14,0.167848,0.190421,56.890564,0.234848,0.000438
9809049,9809049,,3,3,6,3,3,6,0.000286,0.000029,0,15335,5,0.000012,14,0.165901,0.185374,605.902388,0.333333,0.000756
9165,9165,,1,9,10,1,9,10,0.000011,0.000006,0,15338,23,0.000012,15,0.139387,0.153055,220.374292,0.111111,0.000239
9166,9166,,5,16,21,5,16,21,0.000061,0.001397,0,15339,2,0.000012,13,0.195889,0.222468,3277.251039,0.180952,0.001136
9612176,9612176,,6,1,7,6,1,7,0.000018,0.000003,0,6968,28,0.000022,9,0.173844,0.210434,2342.925827,0.238095,0.001553
9168,9168,,17,8,25,17,8,25,0.001518,0.000578,0,15340,2,0.000022,14,0.166697,0.183274,2589.220125,0.141667,0.004131
9169,9169,,1,9,10,1,9,10,0.000005,0.005612,0,15341,0,0.000012,12,0.195113,0.2207,139.101782,0.166667,0.000219
9506020,9506020,,4,4,8,4,4,8,0.000178,0.000281,0,4531,0,0.000016,8,0.21002,0.237286,31046.20803,0.178571,0.001193
9170,9170,,0,1,1,0,1,1,0,0.000003,0,15345,0,0.00001,14,0.119349,0.126061,0,0,0
9803052,9803052,,3,5,8,3,5,8,0.000234,0.000012,0,15344,0,0.00002,13,0.135437,0.145951,1688.659317,0.035714,0.000685
9609178,9609178,,1,1,2,1,1,2,0,0,0,15343,0,0.000014,12,0.155915,0.168751,3149.155039,0,0.000239
9171,9171,,28,38,66,28,38,66,0.003664,0.019429,0,15346,41,0.000046,12,0.206798,0.231588,44694.519584,0.122378,0.014432
9172,9172,,10,13,23,10,13,23,0.000517,0.000581,0,15347,25,0.000014,17,0.186693,0.207934,2988.299629,0.23913,0.00276
10004,10004,,8,44,52,8,44,52,0.001603,0.019528,0,15348,25,0.000012,16,0.209916,0.240779,19765.679298,0.133484,0.0027
11153,11153,,12,23,35,12,23,35,0.001102,0.000868,0,15349,25,0.000015,17,0.198332,0.224863,17306.060884,0.139496,0.003724
9807049,9807049,,4,25,29,4,25,29,0.00013,0.000386,0,11492,0,0.000012,15,0.168963,0.200889,775.160433,0.172414,0.001148
9174,9174,,5,19,24,5,19,24,0.000658,0.004267,0,15350,30,0.000012,16,0.184129,0.206737,17996.69545,0.175725,0.003633
9502085,9502085,,1,1,2,1,1,2,0.000054,0.001027,0,3457,4,0.00001,6,0.262295,0.292839,0,0.5,0.000449
9178,9178,,8,4,12,8,4,12,0.000424,0.000999,0,15351,25,0.000017,18,0.180566,0.199006,1133.070239,0.166667,0.001979
9179,9179,,0,9,9,0,9,9,0,0.001409,0,15354,2,0.00001,13,0.166025,0.187553,0,0.138889,0
9601131,9601131,,1,2,3,1,2,3,0.000017,0,0,15353,23,0.000011,4,0.4375,0.559524,7,0,0.000219
9311017,9311017,,5,2,7,5,2,7,0,0,0,11796,23,0.00007,2,0.75,0.833333,1602.118206,0.119048,0.001205
9312166,9312166,,1,0,1,1,0,1,0,0,0,15352,23,0.000015,0,0,0,0,0,0.000226
9506044,9506044,,4,6,10,4,6,10,0,0.000004,0,2699,30,0.00003,2,0.875,0.928571,347.093411,0.177778,0.001149
9181,9181,,28,20,48,28,20,48,0.002621,0.010366,0,15355,30,0.000022,12,0.197147,0.217934,25387.756303,0.122784,0.00772
9182,9182,,29,52,81,29,52,81,0.002946,0.014896,0,15356,30,0.000021,12,0.207562,0.233595,105255.145066,0.115741,0.008177
9185,9185,,14,17,31,14,17,31,0.001849,0.017498,0,15357,1,0.000016,12,0.224832,0.256211,21804.277905,0.231183,0.003327
9186,9186,,6,12,18,6,12,18,0.000929,0.005707,0,15358,1,0.000012,12,0.194556,0.216108,224.190922,0.205882,0.001396
9187,9187,,6,25,31,6,25,31,0.000128,0.023097,0,15359,1,0.000014,15,0.213237,0.249054,24975.534319,0.147312,0.001526
9188,9188,,17,7,24,17,7,24,0.000428,0.000319,0,15360,4,0.000022,12,0.191767,0.21017,220.06473,0.298913,0.005715
9189,9189,,11,63,74,11,63,74,0.000787,0.007542,0,15361,3,0.000014,15,0.21989,0.253103,74502.699678,0.122177,0.003926
9190,9190,,4,19,23,4,19,23,0.000085,0.002731,0,15362,30,0.000013,13,0.199991,0.219438,1621.93901,0.211462,0.000883
9191,9191,,62,27,89,62,27,89,0.00225,0.001576,0,12927,3,0.000052,16,0.192766,0.214167,13536.755323,0.167135,0.030325
9192,9192,,3,4,7,3,4,7,0.00002,0.000003,0,15363,23,0.000013,17,0.149076,0.162429,2490.859247,0.166667,0.000791
9193,9193,,8,18,26,8,18,26,0.000311,0.002991,0,15364,2,0.000014,13,0.203022,0.225216,5830.560335,0.141538,0.002072
9194,9194,,0,27,27,0,27,27,0,0.000113,0,15371,9,0.00001,13,0.169834,0.192743,0,0.054131,0
9306035,9306035,,20,7,27,20,7,27,0.000009,0,0,1292,9,0.000042,2,0.733333,0.818182,4881.698157,0.132479,0.005187
9401058,9401058,,6,10,16,6,10,16,0.000008,0.000001,0,1293,9,0.000019,2,0.708333,0.794118,2913.108658,0.2125,0.001548
9407112,9407112,,8,13,21,8,13,21,0.000008,0.000001,0,1452,9,0.000019,2,0.69697,0.782609,6608.132257,0.204762,0.002078
9408104,9408104,,13,10,23,13,10,23,0.000008,0.000001,0,1455,9,0.000033,3,0.586957,0.67284,84946.312645,0.116601,0.003184
9607234,9607234,,3,41,44,3,41,44,0.000002,0.000482,0,15370,9,0.000013,12,0.203044,0.257784,13152.573078,0.059197,0.000677
9905103,9905103,,2,9,11,2,9,11,0.000002,0.00001,0,15365,6,0.00001,15,0.163885,0.180731,828.329056,0.136364,0.000438
9207027,9207027,,4,0,4,4,0,4,0.000166,0,0,245,6,0.00003,0,0,0,0,0,0.000984
9201024,9201024,,12,0,12,12,0,12,0,0,0,1287,9,0.000056,0,0,0,0,0.121212,0.003179
9208013,9208013,,13,0,13,13,0,13,0,0,0,1286,9,0.000056,0,0,0,0,0.192308,0.003552
9302125,9302125,,7,2,9,7,2,9,0.000006,0,0,1289,9,0.000023,1,1,1,5.076984,0.277778,0.001865
9307147,9307147,,6,11,17,6,11,17,0.000006,0.000001,0,1291,9,0.00002,2,0.823529,0.892857,38564.504951,0.176471,0.001594
9301053,9301053,,8,1,9,8,1,9,0.000006,0,0,1295,9,0.000025,1,1,1,1561.662062,0.138889,0.002127
9312144,9312144,,4,14,18,4,14,18,0.000006,0.000002,0,1451,9,0.000016,2,0.791667,0.868421,15206.072859,0.163399,0.00109
9210071,9210071,,3,0,3,3,0,3,0,0,0,1454,9,0.000017,0,0,0,0,0,0.000795
9407017,9407017,,6,5,11,6,5,11,0,0,0,1296,9,0.000023,3,0.512821,0.591667,7595.89852,0.190909,0.001591
9407038,9407038,,8,1,9,8,1,9,0.000006,0,0,1453,9,0.000024,2,0.666667,0.75,902.8502,0.194444,0.0021
9501018,9501018,,6,15,21,6,15,21,0.00001,0.000001,0,3965,9,0.000015,4,0.52381,0.630682,61988.465157,0.128571,0.001543
9210155,9210155,,5,0,5,5,0,5,0.000007,0,0,1499,9,0.000016,0,0,0,0,0.2,0.001156
9311067,9311067,,3,7,10,3,7,10,0.000006,0.000027,0,1501,9,0.000012,5,0.312,0.394017,96350.280694,0.1,0.000712
9404032,9404032,,2,0,2,2,0,2,0.000006,0,0,3961,9,0.000011,0,0,0,0,0.5,0.0005
9411005,9411005,,3,4,7,3,4,7,0.000006,0,0,3960,9,0.000012,3,0.466667,0.52381,13.9,0.238095,0.000732
9412006,9412006,,6,9,15,6,9,15,0.000006,0.000014,0,1300,4,0.000016,6,0.285036,0.355139,33154.415116,0.095238,0.001398
9507089,9507089,,1,1,2,1,1,2,0.000006,0.000017,0,15369,9,0.00001,1,1,1,0.945798,0,0.000239
9511172,9511172,,2,7,9,2,7,9,0.000006,0,0,15368,9,0.000011,7,0.24031,0.309773,19.476923,0.236111,0.000458
9602068,9602068,,2,12,14,2,12,14,0.000006,0.000044,0,15367,9,0.000011,6,0.301031,0.385388,3757.066898,0.10989,0.000478
9603112,9603112,,7,10,17,7,10,17,0.000007,0.000006,0,10850,22,0.000032,7,0.309456,0.403329,2898.294175,0.180147,0.001608
9301080,9301080,,10,0,10,10,0,10,0.000002,0,0,3969,9,0.000022,0,0,0,0,0.066667,0.002411
9403043,9403043,,4,0,4,4,0,4,0,0,0,3178,9,0.000015,0,0,0,0,0.166667,0.001138
9195,9195,,12,6,18,12,6,18,0.000054,0.000018,0,15372,23,0.000028,13,0.152578,0.167151,16193.370723,0.153595,0.002841
9196,9196,,27,22,49,27,22,49,0.00186,0.003328,0,15373,30,0.000024,14,0.205979,0.228487,13283.04598,0.185799,0.010377
9501121,9501121,,2,7,9,2,7,9,0.000002,0.000031,0,15105,5,0.000013,4,0.463636,0.522876,3348.126844,0.166667,0.00049
9912040,9912040,,2,4,6,2,4,6,0.000002,0.000034,0,15104,1,0.000014,14,0.141185,0.154118,3285.428552,0.2,0.000497
9406127,9406127,,3,6,9,3,6,9,0.000001,0.000032,0,7467,5,0.000014,3,0.586207,0.666667,289.515914,0.152778,0.000706
9501067,9501067,,5,8,13,5,8,13,0.000401,0.000048,0,7468,5,0.000016,3,0.523077,0.593137,8145.616101,0.128205,0.001262
9198,9198,,6,24,30,6,24,30,0.001157,0.023165,0,15374,1,0.000012,12,0.227355,0.258456,2574.149565,0.252874,0.001868
9200,9200,,0,1,1,0,1,1,0,0,0,15375,5,0.00001,9,0.169107,0.184371,0,0,0
9201,9201,,2,1,3,2,1,3,0.000001,0.000008,0,15376,0,0.000015,16,0.13915,0.152011,0,0.5,0.000445
9202,9202,,18,157,175,18,157,175,0.001463,0.034046,0,15384,1,0.000017,11,0.252516,0.297364,220214.957805,0.039934,0.004574
9311045,9311045,,7,4,11,7,4,11,0.000404,0.000013,0,4185,5,0.00002,2,0.666667,0.75,586.758946,0.154545,0.00188
9405059,9405059,,4,6,10,4,6,10,0.000401,0.000019,0,7469,5,0.000014,3,0.555556,0.633333,256.322733,0.144444,0.001029
9501015,9501015,,3,24,27,3,24,27,0.0004,0.000137,0,7473,5,0.000013,3,0.611765,0.714744,779.548018,0.064103,0.00079
9907143,9907143,,1,22,23,1,22,23,0.0004,0.019423,0,15383,1,0.00001,12,0.208181,0.232026,9204.528016,0.373518,0.000344
9909138,9909138,,1,8,9,1,8,9,0.0004,0.00029,0,15382,5,0.00001,14,0.18364,0.216069,19667.50327,0.111111,0.000344
208206,208206,,2,11,13,2,11,13,0.000017,0.001069,0,16350,5,0.000011,15,0.18142,0.209774,19.777774,0.24359,0.000445
204253,204253,,19,159,178,19,159,178,0.000108,0.018168,0,16349,5,0.000026,14,0.207418,0.249529,169021.287358,0.027169,0.004275
9205049,9205049,,1,0,1,1,0,1,0.000001,0,0,6525,5,0.000012,0,0,0,0,0,0.000271
9206043,9206043,,6,0,6,6,0,6,0.000005,0,0,1989,5,0.000026,0,0,0,0,0.033333,0.001503
9204042,9204042,,2,0,2,2,0,2,0.000002,0,0,6516,5,0.000011,0,0,0,0,0,0.000514
9208080,9208080,,3,5,8,3,5,8,0.000008,0.000045,0,1961,5,0.000012,1,1,1,128.763451,0.160714,0.000781
9404064,9404064,,8,1,9,8,1,9,0.000007,0.000006,0,3642,5,0.00003,1,1,1,14.166329,0.125,0.002127
9204058,9204058,,2,0,2,2,0,2,0.000007,0,0,1995,5,0.00002,0,0,0,0,0,0.000796
9305165,9305165,,3,4,7,3,4,7,0.000014,0.000025,0,1819,5,0.000014,2,0.833333,0.9,51.591451,0.285714,0.001107
9401102,9401102,,7,26,33,7,26,33,0.000034,0.000141,0,986,5,0.000029,3,0.593023,0.722222,6432.965602,0.085227,0.002457
9409039,9409039,,1,16,17,1,16,17,0.000007,0.000096,0,1992,5,0.000011,3,0.692308,0.790123,46631.169809,0.128676,0.000576
9410045,9410045,,1,2,3,1,2,3,0.000007,0.000002,0,1987,6,0.000011,4,0.341176,0.393678,6951.944048,0,0.000576
9412224,9412224,,3,34,37,3,34,37,0.000011,0.000473,0,1963,5,0.000013,4,0.494505,0.630556,41589.558608,0.09009,0.001028
9303170,9303170,,2,4,6,2,4,6,0.000009,0.000036,0,6241,5,0.000012,2,0.833333,0.9,4.530636,0.166667,0.00064
9305137,9305137,,3,2,5,3,2,5,0.00001,0.000002,0,13439,0,0.000012,1,1,1,151.902039,0.05,0.000714
9502115,9502115,,5,11,16,5,11,16,0.000091,0.000064,0,6251,5,0.000013,2,0.823529,0.892857,16993.329339,0.129167,0.001225
9508108,9508108,,2,2,4,2,2,4,0.000002,0.000025,0,13438,5,0.000013,2,0.75,0.833333,2400.231067,0.083333,0.000461
9511031,9511031,,1,6,7,1,6,7,0.000001,0.000022,0,7474,5,0.000014,6,0.313725,0.379167,70422.409615,0.190476,0.000307
9810055,9810055,,6,16,22,6,16,22,0.000503,0.006539,0,11613,5,0.000015,13,0.183984,0.207446,12881.746156,0.112554,0.001569
9902093,9902093,,3,7,10,3,7,10,0.000037,0.001207,0,11614,5,0.000013,14,0.162849,0.184398,221.480374,0.177778,0.000766
9604056,9604056,,3,36,39,3,36,39,0.000004,0.000404,0,15381,5,0.000014,11,0.211266,0.255304,20118.800568,0.040486,0.000685
9203,9203,,1,20,21,1,20,21,0.000211,0.020393,0,16351,1,0.000011,12,0.205202,0.228889,925.476845,0.238095,0.000226
9204,9204,,1,1,2,1,1,2,0,0,0,16352,28,0.000012,7,0.201613,0.243714,0,0.5,0.000226
10211,10211,,1,5,6,1,5,6,0,0.000005,0,16353,28,0.000011,6,0.267327,0.383951,2.166667,0.2,0.000219
9205,9205,,3,11,14,3,11,14,0,0.000006,0,16354,23,0.000015,20,0.128225,0.142336,6474.475202,0.274725,0.00067
9206,9206,,0,28,28,0,28,28,0,0.00311,0,16355,4,0.00001,12,0.192624,0.218694,0,0.133598,0
106176,106176,,7,23,30,7,23,30,0.000435,0.003267,0,16356,4,0.000014,13,0.170192,0.191623,4456.918484,0.17931,0.001938
9208,9208,,0,5,5,0,5,5,0,0,0,16357,17,0.00001,13,0.145215,0.169603,0,0.5,0
9209,9209,,18,16,34,18,16,34,0.001308,0.017332,0,15433,52,0.000017,17,0.20802,0.233257,3999.14898,0.176471,0.004505
9210,9210,,9,11,20,9,11,20,0.001727,0.017245,0,16358,1,0.000015,13,0.19226,0.213509,2317.828651,0.357895,0.002327
9211,9211,,58,28,86,58,28,86,0.008777,0.02112,0,15416,1,0.000039,12,0.214561,0.241934,57337.981386,0.106019,0.020351
9213,9213,,11,58,69,11,58,69,0.000646,0.014713,0,12987,3,0.000015,11,0.239525,0.273186,282796.23026,0.125746,0.004295
9214,9214,,3,20,23,3,20,23,0.000139,0.001297,0,15796,3,0.000011,16,0.178948,0.201274,15217.254869,0.162055,0.00174
9215,9215,,5,26,31,5,26,31,0.000328,0.004574,0,16143,30,0.000011,15,0.19204,0.215877,1514.648415,0.168817,0.0013
9216,9216,,0,7,7,0,7,7,0,0.000004,0,16360,9,0.00001,15,0.11748,0.126515,0,0.285714,0
9505064,9505064,,3,1,4,3,1,4,0,0,0,16359,9,0.000013,1,1,1,1,0.166667,0.000684
9209002,9209002,,4,4,8,4,4,8,0,0.000002,0,6962,9,0.000039,1,1,1,1004.327934,0.071429,0.00102
9301017,9301017,,13,0,13,13,0,13,0.000008,0,0,947,4,0.000055,0,0,0,0,0.070513,0.003191
9303086,9303086,,2,0,2,2,0,2,0,0,0,6961,9,0.000024,0,0,0,0,0,0.000562
9402056,9402056,,3,0,3,3,0,3,0,0,0,6960,6,0.000027,0,0,0,0,0,0.000788
9309021,9309021,,8,0,8,8,0,8,0.000002,0,0,14781,9,0.000033,0,0,0,0,0.107143,0.001812
9217,9217,,9,10,19,9,10,19,0.001751,0.00637,0,16361,1,0.000013,15,0.195091,0.218121,1788.518275,0.251462,0.002505
9218,9218,,1,1,2,1,1,2,0.000009,0,0,16362,22,0.000011,1,1,1,5,0,0.000239
9219,9219,,14,9,23,14,9,23,0.000185,0.000137,0,15446,52,0.000037,13,0.170249,0.185804,5107.880364,0.160079,0.003786
9220,9220,,4,4,8,4,4,8,0.000001,0,0,16363,17,0.000022,5,0.36,0.491667,51.97619,0.178571,0.000916
9221,9221,,2,17,19,2,17,19,0.000011,0.00054,0,16364,4,0.000013,13,0.223179,0.250647,9263.860022,0.108187,0.000458
9222,9222,,2,6,8,2,6,8,0.000002,0,0,16369,26,0.000013,5,0.392405,0.494086,11.833333,0.196429,0.000445
3172,3172,,2,0,2,2,0,2,0.000002,0,0,16368,26,0.000013,0,0,0,0,0.5,0.000458
9907118,9907118,,3,6,9,3,6,9,0.000002,0.000002,0,16367,26,0.000016,4,0.468085,0.575758,43.583333,0.138889,0.000677
9401106,9401106,,6,3,9,6,3,9,0.000055,0.000002,0,3822,26,0.000026,3,0.538462,0.666667,2071.285124,0.069444,0.001449
9702085,9702085,,1,4,5,1,4,5,0,0.000002,0,16366,26,0.000012,4,0.461538,0.597222,18,0.05,0.000239
9223,9223,,1,20,21,1,20,21,0,0.000013,0,16373,23,0.000011,13,0.185344,0.252234,131.571429,0.1,0.000219
9511020,9511020,,1,7,8,1,7,8,0,0.000001,0,16372,23,0.00001,9,0.186603,0.256127,1.025,0.267857,0.000226
9810001,9810001,,9,2,11,9,2,11,0.000003,0,0,16371,23,0.000016,3,0.545455,0.638889,7.5,0.2,0.002044
9909064,9909064,,6,8,14,6,8,14,0.000002,0.000009,0,16370,23,0.000016,12,0.174895,0.222601,1276.967628,0.142857,0.001367
104189,104189,,3,31,34,3,31,34,0,0.000014,0,16379,23,0.000011,13,0.170414,0.185251,16063.754844,0.125668,0.000677
101089,101089,,9,1,10,9,1,10,0.000088,0.000002,0,16378,23,0.000023,14,0.162735,0.172717,2576.115756,0.077778,0.002051
102106,102106,,4,13,17,4,13,17,0,0.000009,0,16377,23,0.000013,13,0.169587,0.209625,720.146713,0.161765,0.000896
103005,103005,,6,11,17,6,11,17,0.000041,0.000031,0,16376,23,0.000013,13,0.18492,0.202514,22578.788183,0.102941,0.001407
9305181,9305181,,23,2,25,23,2,25,0.000034,0.000001,0,748,23,0.000073,1,1,1,527.513031,0.07,0.005611
9811110,9811110,,5,11,16,5,11,16,0.000001,0.000055,0,16374,23,0.000013,12,0.189919,0.221086,2305.655528,0.0875,0.001216
9304025,9304025,,2,1,3,2,1,3,0.000024,0.000001,0,4466,23,0.000012,1,1,1,0.4125,0.166667,0.000516
9509012,9509012,,4,10,14,4,10,14,0.000001,0.002181,0,3820,23,0.000015,7,0.301484,0.34844,4902.236748,0.175824,0.000967
9224,9224,,5,43,48,5,43,48,0.000769,0.003824,0,16263,3,0.000011,15,0.216349,0.246503,7429.547379,0.16844,0.001653
9225,9225,,7,6,13,7,6,13,0.000402,0.001379,0,15805,30,0.000014,19,0.182398,0.201713,799.543101,0.237179,0.00185
9226,9226,,8,30,38,8,30,38,0.001666,0.009722,0,16380,41,0.000013,11,0.20752,0.231666,23054.015169,0.144381,0.002049
9227,9227,,7,12,19,7,12,19,0.000924,0.011371,0,15612,1,0.000013,13,0.188908,0.209657,1472.958314,0.239766,0.002275
9228,9228,,1,24,25,1,24,25,0.000035,0.002131,0,16381,0,0.00001,14,0.192432,0.219758,344.785569,0.168333,0.000226
9229,9229,,6,11,17,6,11,17,0.000005,0.000017,0,16319,22,0.00002,12,0.171566,0.19809,11172.234752,0.084559,0.001452
9808179,9808179,,2,21,23,2,21,23,0,0.000029,0,16318,22,0.000013,10,0.214326,0.264119,2640.696878,0.132411,0.000479
9508110,9508110,,1,7,8,1,7,8,0,0.000039,0,6803,6,0.00001,7,0.268392,0.326867,61.379896,0.25,0.000254
9312041,9312041,,2,2,4,2,2,4,0,0,0,3181,9,0.000012,1,1,1,205.082792,0,0.000553
9404037,9404037,,8,8,16,8,8,16,0.000002,0.000022,0,3197,9,0.000022,4,0.45614,0.576923,13066.757325,0.1375,0.001963
9230,9230,,2,5,7,2,5,7,0.000051,0.001055,0,15853,30,0.000011,13,0.187886,0.203882,443.388907,0.261905,0.00063
9231,9231,,12,8,20,12,8,20,0.00084,0.001462,0,15793,30,0.000016,15,0.190646,0.209445,11436.166955,0.207895,0.004872
9232,9232,,2,5,7,2,5,7,0,0,0,16383,23,0.000015,3,0.590909,0.679487,21.333333,0.142857,0.000445
9801185,9801185,,1,0,1,1,0,1,0,0,0,16382,23,0.000013,0,0,0,0,0,0.000232
9233,9233,,29,66,95,29,66,95,0.001355,0.005392,0,15817,30,0.000023,13,0.217914,0.245114,54494.057189,0.104143,0.0098
9234,9234,,12,24,36,12,24,36,0.001025,0.001396,0,15504,13,0.00002,17,0.203835,0.230997,38637.794797,0.148413,0.002876
9235,9235,,1,6,7,1,6,7,0.000004,0.000018,0,16384,9,0.00001,17,0.146225,0.159779,148.698075,0.261905,0.000293
9236,9236,,5,3,8,5,3,8,0.000088,0.000006,0,15473,30,0.000014,19,0.128588,0.142953,34436.971707,0.160714,0.001424
9910200,9910200,,3,15,18,3,15,18,0.000029,0.000218,0,15472,20,0.000017,18,0.137611,0.157231,9924.890194,0.081699,0.000724
9237,9237,,3,19,22,3,19,22,0.000001,0.000011,0,16386,17,0.000012,13,0.16804,0.211991,3489.51159,0.177489,0.000759
9611157,9611157,,1,3,4,1,3,4,0,0.00001,0,16385,22,0.00001,8,0.235781,0.265487,2683.507479,0.25,0.00024
9608068,9608068,,2,36,38,2,36,38,0,0.000153,0,11540,22,0.000014,7,0.306964,0.379631,4805.155199,0.051209,0.000452
9601041,9601041,,3,18,21,3,18,21,0.000023,0.000072,0,10478,4,0.000022,5,0.334586,0.464419,2651.54215,0.083333,0.000673
9238,9238,,0,7,7,0,7,7,0,0.000059,0,16387,22,0.00001,7,0.252481,0.299896,0,0.190476,0
9206033,9206033,,21,0,21,21,0,21,0.000059,0,0,744,22,0.00021,0,0,0,0,0.1,0.005646
9212126,9212126,,10,1,11,10,1,11,0.000035,0.000001,0,749,22,0.000052,1,1,1,2.083333,0.190909,0.002649
9501145,9501145,,9,2,11,9,2,11,0.000003,0,0,10811,22,0.00003,2,0.6,0.666667,77.542146,0.072727,0.002038
9206010,9206010,,4,0,4,4,0,4,0.000031,0,0,745,4,0.000025,0,0,0,0,0.166667,0.001241
9212071,9212071,,5,0,5,5,0,5,0.000096,0,0,771,4,0.000025,0,0,0,0,0.05,0.001424
9305077,9305077,,6,2,8,6,2,8,0.000033,0.000039,0,2620,22,0.000024,1,1,1,6.063492,0.267857,0.001696
9310138,9310138,,8,3,11,8,3,11,0.000033,0.00004,0,2616,22,0.000059,1,1,1,101.799754,0.2,0.002201
9311144,9311144,,5,6,11,5,6,11,0.000033,0.000041,0,2622,22,0.000017,3,0.611111,0.742424,1643.250804,0.209091,0.001402
9406068,9406068,,10,7,17,10,7,17,0.000514,0.000014,0,2621,4,0.000032,2,0.818182,0.888889,2552.13705,0.066176,0.002677
9409116,9409116,,8,1,9,8,1,9,0.000032,0,0,2617,22,0.000029,2,0.571429,0.625,6.166667,0.152778,0.002052
9239,9239,,5,15,20,5,15,20,0.00001,0.0001,0,16388,2,0.000013,15,0.150706,0.168512,8738.349227,0.107895,0.001223
9803230,9803230,,4,8,12,4,8,12,0.000027,0.000008,0,10405,4,0.000013,11,0.189336,0.210467,2794.507565,0.204545,0.000952
9405074,9405074,,1,10,11,1,10,11,0.000001,0.000127,0,2940,2,0.000012,2,0.8125,0.884615,2.619608,0.227273,0.000293
9240,9240,,6,15,21,6,15,21,0.000106,0.003027,0,15509,1,0.000013,16,0.189233,0.214929,549.624321,0.2,0.001718
9241,9241,,2,3,5,2,3,5,0,0,0,16392,23,0.000018,3,0.583333,0.690476,36,0.15,0.000465
9123,9123,,4,0,4,4,0,4,0,0,0,16391,23,0.000024,0,0,0,0,0.416667,0.000923
9508087,9508087,,3,1,4,3,1,4,0,0,0,16390,23,0.000022,1,1,1,7,0.25,0.000677
9406151,9406151,,3,0,3,3,0,3,0,0,0,16389,23,0.000036,0,0,0,0,0.5,0.000684
9242,9242,,19,64,83,19,64,83,0.001689,0.005884,0,16102,1,0.000018,14,0.214673,0.247984,161349.189408,0.109315,0.005516
9810140,9810140,,1,9,10,1,9,10,0.000069,0.002105,0,16101,1,0.00001,13,0.181916,0.204291,37.149564,0.333333,0.000361
9206014,9206014,,6,1,7,6,1,7,0.000001,0,0,940,23,0.000034,1,1,1,35.896723,0.02381,0.001449
9244,9244,,42,7,49,42,7,49,0.005254,0.003681,0,15442,8,0.000049,14,0.2227,0.252855,78140.614468,0.201956,0.017237
9245,9245,,1,10,11,1,10,11,0,0.000031,0,16393,6,0.00001,11,0.179408,0.22352,8.888889,0.263636,0.000232
9246,9246,,67,36,103,67,36,103,0.00302,0.002121,0,12993,3,0.000046,16,0.188602,0.211336,42807.207813,0.146202,0.028626
9248,9248,,1,8,9,1,8,9,0.000151,0.000035,0,16394,3,0.00001,14,0.162666,0.174405,162.884794,0.208333,0.000226
9249,9249,,0,4,4,0,4,4,0,0.000011,0,16395,5,0.00001,14,0.155953,0.170545,0,0.083333,0
9410078,9410078,,4,1,5,4,1,5,0.000237,0.000006,0,13437,5,0.000018,1,1,1,32.926751,0.05,0.00089
9250,9250,,7,22,29,7,22,29,0.000025,0.000016,0,16114,6,0.000014,15,0.133362,0.14885,39193.10543,0.119458,0.001717
9251,9251,,1,9,10,1,9,10,0.000005,0.002232,0,16396,0,0.000011,14,0.177198,0.200255,8.759716,0.288889,0.000219
9252,9252,,6,44,50,6,44,50,0.000279,0.00312,0,16249,3,0.000011,16,0.202753,0.227879,4306.896677,0.159184,0.001567
10001,10001,,0,27,27,0,27,27,0,0.003894,0,16397,30,0.00001,13,0.19881,0.219752,0,0.321937,0
10002,10002,,9,35,44,9,35,44,0.00044,0.018173,0,15508,52,0.000014,16,0.197954,0.228508,5040.711019,0.113636,0.002444
9305037,9305037,,10,1,11,10,1,11,0.000236,0,0,646,0,0.000042,1,1,1,1183.927326,0.027273,0.002768
10003,10003,,9,15,24,9,15,24,0.000722,0.002357,0,15833,30,0.000014,14,0.193378,0.212435,2148.012441,0.230072,0.004608
10005,10005,,4,24,28,4,24,28,0.001012,0.018246,0,16398,1,0.000011,13,0.200446,0.224155,51.909448,0.337302,0.001232
10007,10007,,0,23,23,0,23,23,0,0.002535,0,16399,3,0.00001,12,0.205968,0.228335,0,0.270751,0
10008,10008,,2,8,10,2,8,10,0,0.000002,0,16402,23,0.000013,11,0.163118,0.179742,1777.814339,0.233333,0.000458
9911131,9911131,,3,6,9,3,6,9,0,0,0,16401,23,0.000014,11,0.159297,0.17283,1729.746142,0.194444,0.00069
9805036,9805036,,6,0,6,6,0,6,0,0,0,16400,28,0.000033,0,0,0,0,0.066667,0.001374
10009,10009,,1,1,2,1,1,2,0.000065,0.000001,0,16010,30,0.00001,14,0.159272,0.168744,0,0.5,0.000484
10010,10010,,41,25,66,41,25,66,0.006341,0.019391,0,15417,1,0.000032,13,0.213223,0.24008,40126.737016,0.127273,0.015101
10012,10012,,3,13,16,3,13,16,0.000001,0.000006,0,16403,6,0.000011,15,0.156236,0.171811,45.881587,0.266667,0.000664
10013,10013,,0,3,3,0,3,3,0,0.000008,0,16407,5,0.00001,15,0.15981,0.177865,0,0.166667,0
9804015,9804015,,1,0,1,1,0,1,0,0,0,16406,5,0.000013,0,0,0,0,0,0.000219
9811196,9811196,,1,18,19,1,18,19,0,0.004094,0,16405,2,0.000013,14,0.189909,0.222224,4850.671426,0.078947,0.000219
9206065,9206065,,2,0,2,2,0,2,0.000048,0,0,16404,2,0.000015,0,0,0,0,0,0.000445
10014,10014,,18,27,45,18,27,45,0.001352,0.004459,0,15653,25,0.000019,15,0.199633,0.226895,36488.500734,0.117677,0.00564
10015,10015,,6,31,37,6,31,37,0.000701,0.004618,0,15832,4,0.000013,17,0.222947,0.258511,62477.523566,0.117117,0.003142
10016,10016,,20,48,68,20,48,68,0.001031,0.003891,0,12988,3,0.00002,12,0.211595,0.235965,45436.905746,0.147937,0.008216
9602146,9602146,,7,0,7,7,0,7,0.000002,0,0,12838,30,0.000023,0,0,0,0,0.047619,0.001635
10020,10020,,0,13,13,0,13,13,0,0.001017,0,16409,8,0.00001,13,0.168069,0.189393,0,0.115385,0
9304016,9304016,,6,0,6,6,0,6,0.000052,0,0,16408,52,0.000021,0,0,0,0,0.033333,0.001328
9201048,9201048,,12,0,12,12,0,12,0.000032,0,0,1466,22,0.000175,0,0,0,0,0.090909,0.003095
10021,10021,,26,20,46,26,20,46,0.001199,0.002291,0,12935,3,0.000027,15,0.194317,0.216282,4692.355784,0.242995,0.013923
10022,10022,,3,19,22,3,19,22,0.000539,0.005302,0,16410,2,0.00001,16,0.194571,0.220414,2233.454235,0.274892,0.000744
10023,10023,,10,33,43,10,33,43,0.001177,0.00399,0,15434,52,0.000013,13,0.213395,0.239039,22229.62895,0.161683,0.002686
10025,10025,,12,16,28,12,16,28,0.001676,0.000947,0,15530,1,0.000016,15,0.187709,0.212146,12107.493578,0.17328,0.003725
10026,10026,,8,34,42,8,34,42,0.000451,0.004129,0,15462,30,0.000013,15,0.206549,0.23265,29088.738203,0.164344,0.002709
10027,10027,,0,20,20,0,20,20,0,0.002913,0,16411,30,0.00001,14,0.198653,0.219158,0,0.35,0
10028,10028,,26,27,53,26,27,53,0.001137,0.004967,0,12937,3,0.000027,16,0.202634,0.227802,29757.557357,0.163643,0.01303
10029,10029,,0,4,4,0,4,4,0,0.001504,0,16413,30,0.00001,13,0.189118,0.204597,0,0.25,0
9508013,9508013,,2,0,2,2,0,2,0.000036,0,0,16412,30,0.000014,0,0,0,0,0,0.000464
10030,10030,,1,1,2,1,1,2,0,0,0,16415,6,0.000014,1,1,1,0,0.5,0.000219
9808103,9808103,,3,0,3,3,0,3,0,0,0,16414,6,0.000033,0,0,0,0,0.166667,0.000671
10031,10031,,2,6,8,2,6,8,0,0.000001,0,16416,23,0.000016,10,0.173488,0.1972,59.498121,0.267857,0.000491
10032,10032,,4,4,8,4,4,8,0.000089,0.00318,0,15696,25,0.000017,10,0.204642,0.227595,101.161111,0.25,0.001099
10033,10033,,0,7,7,0,7,7,0,0.000012,0,16422,22,0.00001,15,0.152625,0.167312,0,0.142857,0
9811109,9811109,,2,10,12,2,10,12,0.000002,0.000016,0,16421,22,0.000012,7,0.302198,0.392965,103.17232,0.166667,0.000438
9910123,9910123,,1,14,15,1,14,15,0,0.000161,0,16420,22,0.000011,14,0.179368,0.202514,6083.675588,0.090476,0.000219
9507110,9507110,,7,7,14,7,7,14,0.000001,0.000016,0,9636,22,0.000029,7,0.295082,0.373236,6014.589955,0.126374,0.001689
9709210,9709210,,3,5,8,3,5,8,0.000005,0.00001,0,16419,22,0.000012,5,0.357143,0.430741,23.067779,0.321429,0.00071
9908127,9908127,,1,6,7,1,6,7,0.000002,0.000152,0,16417,22,0.000011,14,0.17679,0.198219,0,0.190476,0.000226
10034,10034,,27,28,55,27,28,55,0.001038,0.003144,0,12933,3,0.000032,16,0.201549,0.225693,14328.970185,0.165993,0.014531
10035,10035,,1,4,5,1,4,5,0.000018,0.000001,0,16423,21,0.000011,15,0.138313,0.146397,99.238531,0.1,0.000219
9404100,9404100,,5,2,7,5,2,7,0,0,0,14037,21,0.000028,1,1,1,327,0.214286,0.00154
10036,10036,,0,9,9,0,9,9,0,0.000063,0,16424,52,0.00001,14,0.151186,0.1636,0,0.291667,0
9505125,9505125,,1,7,8,1,7,8,0.000001,0.000014,0,2922,52,0.000012,6,0.282167,0.3282,326.64548,0.303571,0.000268
10038,10038,,4,14,18,4,14,18,0.000099,0.002879,0,16426,30,0.000013,14,0.184504,0.203198,2005.944671,0.254902,0.001017
9911212,9911212,,2,3,5,2,3,5,0.000043,0.001887,0,16425,30,0.000011,14,0.165317,0.183039,9.732699,0.35,0.000473
10039,10039,,1,1,2,1,1,2,0.000001,0.00002,0,16427,22,0.00001,2,0.538462,0.571429,0,0.5,0.000252
10040,10040,,9,15,24,9,15,24,0.00078,0.004717,0,16429,30,0.000013,15,0.195216,0.217622,12686.42574,0.115942,0.00242
9305151,9305151,,1,1,2,1,1,2,0.000055,0.000001,0,16428,9,0.000011,1,1,1,247.328085,0,0.000283
10041,10041,,2,4,6,2,4,6,0.000012,0.000004,0,16430,25,0.000013,13,0.15952,0.169607,13348.822623,0.3,0.000458
10042,10042,,14,17,31,14,17,31,0.000589,0.001241,0,15862,2,0.000024,16,0.188249,0.214043,14602.405571,0.12043,0.003709
9711173,9711173,,4,2,6,4,2,6,0.000019,0.000086,0,15861,3,0.000025,12,0.189823,0.214335,5877.45491,0.1,0.000996
10043,10043,,5,4,9,5,4,9,0.000004,0.000016,0,16433,5,0.00002,14,0.157093,0.181638,2952.320418,0.166667,0.001136
9912202,9912202,,6,17,23,6,17,23,0.000001,0.000025,0,16432,9,0.000019,13,0.183135,0.219741,6139.852098,0.092885,0.001381
9308146,9308146,,3,4,7,3,4,7,0.000001,0.000047,0,16431,9,0.000014,2,0.642857,0.722222,133.860018,0.02381,0.00075
10044,10044,,3,36,39,3,36,39,0.000055,0.00117,0,16436,2,0.000011,18,0.190931,0.21829,1809.954474,0.1417,0.000739
9406164,9406164,,1,12,13,1,12,13,0.000014,0.000148,0,16435,2,0.00001,5,0.540541,0.743333,1.302567,0.25641,0.00024
9807202,9807202,,2,38,40,2,38,40,0.000031,0.002138,0,16434,2,0.00001,12,0.198353,0.22956,300.973486,0.164103,0.000515
10045,10045,,9,35,44,9,35,44,0.000861,0.008139,0,15951,3,0.000013,15,0.213979,0.241661,15089.171389,0.175476,0.00247
10046,10046,,1,29,30,1,29,30,0.000297,0.007273,0,16437,0,0.00001,18,0.22937,0.273828,244.329923,0.093103,0.000234
10047,10047,,0,22,22,0,22,22,0,0.011848,0,16438,2,0.00001,13,0.207024,0.233697,0,0.073593,0
10048,10048,,12,47,59,12,47,59,0.002906,0.023221,0,15922,1,0.000014,14,0.216326,0.245898,44600.071174,0.179427,0.003636
10049,10049,,2,11,13,2,11,13,0.000067,0.000681,0,16439,2,0.000011,14,0.164348,0.182739,308.739024,0.147436,0.000438
10050,10050,,7,8,15,7,8,15,0.000028,0.000003,0,16440,23,0.000017,20,0.15495,0.172993,42755.266616,0.109524,0.001596
10051,10051,,12,9,21,12,9,21,0.000017,0.00004,0,16441,5,0.000021,13,0.176322,0.190556,23250.07894,0.269048,0.002967
10052,10052,,0,16,16,0,16,16,0,0.00007,0,16445,4,0.00001,16,0.137465,0.157417,0,0.129167,0
9702172,9702172,,5,3,8,5,3,8,0.000074,0.000047,0,16443,15,0.000015,3,0.5,0.611111,12.166667,0.25,0.001162
9804138,9804138,,4,5,9,4,5,9,0.000073,0.000048,0,16444,15,0.000013,3,0.541667,0.653846,33.75,0.208333,0.000916
9605228,9605228,,5,1,6,5,1,6,0.000073,0,0,16442,15,0.000019,2,0.571429,0.625,31.916667,0.333333,0.001195
10053,10053,,1,4,5,1,4,5,0,0.000001,0,16446,23,0.00001,3,0.516129,0.59375,1.237302,0.2,0.000226
10054,10054,,6,94,100,6,94,100,0.001724,0.032811,0,15427,1,0.000011,16,0.237464,0.279337,149802.782873,0.081616,0.001912
9605236,9605236,,3,37,40,3,37,40,0.000522,0.010673,0,3524,13,0.000011,10,0.234768,0.279277,361.816516,0.164103,0.000854
11182,11182,,9,42,51,9,42,51,0.002378,0.020924,0,15445,1,0.000013,16,0.225447,0.258862,28712.294673,0.176863,0.002813
11115,11115,,44,41,85,44,41,85,0.005729,0.019238,0,15444,8,0.000037,15,0.207,0.234647,86999.221695,0.137535,0.017194
9704075,9704075,,5,16,21,5,16,21,0.000396,0.007218,0,9112,2,0.000013,14,0.195589,0.230997,1123.184254,0.204762,0.001223
10055,10055,,3,7,10,3,7,10,0.000042,0.000223,0,16187,10,0.000014,16,0.17895,0.201239,887.333432,0.133333,0.001246
9610069,9610069,,6,1,7,6,1,7,0.000073,0.000001,0,4686,15,0.000019,4,0.375,0.458333,785.997455,0.071429,0.001592
9603001,9603001,,6,0,6,6,0,6,0.000013,0,0,5129,10,0.000058,0,0,0,0,0.066667,0.001523
9402063,9402063,,2,0,2,2,0,2,0.000031,0,0,5151,2,0.000012,0,0,0,0,0.5,0.000663
10056,10056,,0,7,7,0,7,7,0,0.000009,0,16448,28,0.00001,16,0.17653,0.195806,0,0.285714,0
9510235,9510235,,6,2,8,6,2,8,0.000001,0.000001,0,6957,28,0.000027,4,0.47619,0.558333,8.516667,0.25,0.001514
9704036,9704036,,6,5,11,6,5,11,0.000002,0.000005,0,6967,28,0.000025,9,0.17817,0.238925,400.551135,0.163636,0.001463
9804052,9804052,,2,3,5,2,3,5,0,0.000003,0,16447,28,0.000014,16,0.141923,0.157299,0,0.4,0.000475
9306163,9306163,,13,3,16,13,3,16,0.000029,0.000002,0,3227,28,0.000077,2,0.8,0.875,4010.676724,0.145833,0.003284
9509099,9509099,,6,5,11,6,5,11,0.000019,0.000016,0,3683,28,0.000031,3,0.642857,0.759259,3301.122862,0.2,0.001523
9501061,9501061,,8,2,10,8,2,10,0.000019,0.000001,0,3682,28,0.00003,3,0.538462,0.619048,11269.388271,0.166667,0.001898
9602058,9602058,,2,3,5,2,3,5,0.000013,0,0,6958,28,0.000015,3,0.5,0.590909,218.912709,0.25,0.000485
9207089,9207089,,14,0,14,14,0,14,0.000118,0,0,2889,28,0.000085,0,0,0,0,0.071429,0.00369
9310071,9310071,,7,3,10,7,3,10,0.000016,0.000002,0,3228,28,0.000029,2,0.714286,0.8,4611.39363,0.111111,0.001722
10057,10057,,7,3,10,7,3,10,0.000008,0,0,16454,23,0.00002,2,0.714286,0.8,276.5,0.122222,0.001806
9601159,9601159,,4,0,4,4,0,4,0,0,0,16451,23,0.000042,0,0,0,0,0.083333,0.000959
9707077,9707077,,6,0,6,6,0,6,0,0,0,16450,23,0.000045,0,0,0,0,0.233333,0.001417
9901071,9901071,,3,3,6,3,3,6,0,0,0,16453,23,0.000023,2,0.8,0.875,114,0.266667,0.000713
9802112,9802112,,2,0,2,2,0,2,0,0,0,16449,23,0.000028,0,0,0,0,0.5,0.000485
9805052,9805052,,4,3,7,4,3,7,0,0,0,16452,23,0.000037,1,1,1,7.5,0.190476,0.00091
10058,10058,,12,26,38,12,26,38,0.000582,0.004604,0,13021,3,0.000015,12,0.209484,0.232747,9880.273899,0.186344,0.00391
10059,10059,,12,34,46,12,34,46,0.00003,0.000108,0,16455,22,0.000023,15,0.193296,0.214174,141308.294079,0.106763,0.002788
9406134,9406134,,5,0,5,5,0,5,0.000002,0,0,9774,23,0.00011,0,0,0,0,0,0.001304
10065,10065,,4,7,11,4,7,11,0.000103,0.002904,0,15559,25,0.000013,12,0.189133,0.208204,1919.073083,0.163636,0.000945
10066,10066,,7,9,16,7,9,16,0.000157,0.001255,0,15784,30,0.000014,14,0.18923,0.206647,2464.049823,0.158333,0.001872
10067,10067,,0,2,2,0,2,2,0,0.000005,0,16456,26,0.00001,7,0.276786,0.349539,0,0,0
10068,10068,,2,13,15,2,13,15,0.000228,0.001307,0,15769,4,0.00001,16,0.196905,0.221923,23579.965077,0.104762,0.000625
10069,10069,,8,21,29,8,21,29,0.002398,0.018872,0,16457,1,0.000013,13,0.218472,0.249527,12926.808518,0.237685,0.002155
10071,10071,,24,13,37,24,13,37,0.000955,0.00315,0,12471,25,0.000028,13,0.18867,0.207723,9620.84603,0.108859,0.00604
10072,10072,,12,27,39,12,27,39,0.001626,0.021042,0,15804,30,0.000015,12,0.220452,0.247342,16960.174809,0.134953,0.003614
10073,10073,,5,2,7,5,2,7,0.000057,0.000001,0,16458,23,0.000014,15,0.137586,0.156467,15.497994,0.404762,0.001161
10074,10074,,0,3,3,0,3,3,0,0,0,16463,2,0.00001,2,0.714286,0.8,0,0.333333,0
9711167,9711167,,3,2,5,3,2,5,0,0,0,16460,2,0.000036,1,1,1,6,0.1,0.00067
9802044,9802044,,1,1,2,1,1,2,0,0,0,16462,2,0.000013,2,0.6,0.666667,0,0.5,0.000219
9908087,9908087,,1,1,2,1,1,2,0,0,0,16461,2,0.000013,2,0.6,0.666667,0,0.5,0.000219
9611166,9611166,,1,0,1,1,0,1,0,0,0,16459,2,0.000026,0,0,0,0,0,0.000239
10075,10075,,4,7,11,4,7,11,0,0.000001,0,16464,23,0.000014,3,0.65,0.75641,33.45,0.236364,0.000896
10076,10076,,19,7,26,19,7,26,0.002422,0.000738,0,16465,1,0.000026,14,0.177576,0.197519,4198.169256,0.112308,0.004737
10077,10077,,1,13,14,1,13,14,0.000215,0.002835,0,16468,1,0.00001,12,0.199731,0.220416,127.419969,0.17033,0.000219
9410158,9410158,,4,12,16,4,12,16,0.000037,0.000204,0,16467,13,0.000014,7,0.293333,0.374845,210.370603,0.079167,0.00089
9304024,9304024,,3,4,7,3,4,7,0.000009,0.000039,0,222,13,0.00002,3,0.636364,0.761905,349.435309,0.02381,0.000896
9308108,9308108,,1,3,4,1,3,4,0.000002,0.000029,0,16466,41,0.000011,3,0.571429,0.666667,6.055556,0.166667,0.000245
10078,10078,,2,38,40,2,38,40,0.000077,0.004515,0,16469,4,0.00001,13,0.196208,0.226508,768.838946,0.225641,0.000458
9704079,9704079,,4,4,8,4,4,8,0.000576,0.000044,0,14858,4,0.000011,12,0.16739,0.187329,21960.614097,0.303571,0.001002
10079,10079,,3,5,8,3,5,8,0.000001,0.002316,0,16475,4,0.000019,15,0.134468,0.147067,6164.567294,0.160714,0.000671
9903103,9903103,,1,14,15,1,14,15,0.000027,0.000733,0,16474,4,0.000013,14,0.154192,0.171962,11273.038254,0.238095,0.000239
9811119,9811119,,3,33,36,3,33,36,0.000035,0.000834,0,16472,4,0.000011,13,0.177607,0.200504,18330.813244,0.215873,0.00069
9812155,9812155,,3,28,31,3,28,31,0.00004,0.001146,0,16473,4,0.000011,14,0.155694,0.175609,384.929292,0.31828,0.000671
10080,10080,,1,6,7,1,6,7,0,0.000003,0,16478,23,0.00001,12,0.169362,0.200234,265.88719,0.119048,0.000226
9804005,9804005,,1,6,7,1,6,7,0,0,0,16477,26,0.000011,8,0.229079,0.271222,111.231349,0.285714,0.000226
9804098,9804098,,2,7,9,2,7,9,0,0.000002,0,16476,23,0.000013,11,0.174394,0.210574,634.524325,0.083333,0.000445
9609131,9609131,,3,8,11,3,8,11,0,0.000003,0,11788,26,0.000017,8,0.230308,0.278505,2653.023262,0.109091,0.000699
10081,10081,,0,5,5,0,5,5,0,0.000001,0,16479,23,0.00001,16,0.1393,0.150784,0,0.3,0
10082,10082,,12,10,22,12,10,22,0.000259,0.000168,0,15447,6,0.00002,17,0.17156,0.189795,86379.72074,0.142857,0.003164
10083,10083,,2,9,11,2,9,11,0.000052,0.002133,0,16480,1,0.000011,13,0.170882,0.19085,260.951259,0.218182,0.000459
9411166,9411166,,5,6,11,5,6,11,0.00025,0.000547,0,8400,22,0.000014,3,0.578947,0.727273,58445.989751,0.109091,0.001216
9212078,9212078,,8,0,8,8,0,8,0.000007,0,0,5581,22,0.000032,0,0,0,0,0.071429,0.001963
9409074,9409074,,1,5,6,1,5,6,0.000006,0.000001,0,8399,22,0.000012,2,0.692308,0.777778,31364.669601,0.1,0.000253
9505139,9505139,,9,5,14,9,5,14,0.000153,0.000055,0,6244,5,0.000026,6,0.296037,0.336089,6120.132644,0.164835,0.002377
10084,10084,,0,21,21,0,21,21,0,0.001747,0,16485,13,0.00001,14,0.175516,0.206152,0,0.254762,0
9803175,9803175,,7,6,13,7,6,13,0.000044,0.000073,0,12507,13,0.000016,16,0.14547,0.166447,117.858963,0.326923,0.001614
9803201,9803201,,3,5,8,3,5,8,0.000021,0.000041,0,16484,13,0.000018,16,0.145254,0.165727,5593.302498,0.267857,0.000658
9812048,9812048,,4,36,40,4,36,40,0.000027,0.000582,0,16482,13,0.000012,15,0.184648,0.22292,3673.666562,0.155769,0.000923
9906163,9906163,,3,22,25,3,22,25,0.000024,0.000221,0,16483,13,0.000011,14,0.175751,0.206486,1325.187308,0.236667,0.000684
9503071,9503071,,5,1,6,5,1,6,0.000017,0,0,5834,13,0.000014,1,1,1,241.203476,0.333333,0.00131
9612034,9612034,,7,7,14,7,7,14,0.000031,0.000088,0,5835,13,0.000013,15,0.168876,0.214826,44.595875,0.401099,0.001761
9705233,9705233,,6,17,23,6,17,23,0.000028,0.000213,0,5836,13,0.000013,15,0.168865,0.200823,100.460019,0.335968,0.0015
9301093,9301093,,5,0,5,5,0,5,0.000007,0,0,6050,6,0.000028,0,0,0,0,0.1,0.001151
9304116,9304116,,2,3,5,2,3,5,0.000007,0,0,16481,6,0.000011,1,1,1,16.153846,0.2,0.000465
9402122,9402122,,6,0,6,6,0,6,0.000031,0,0,1728,0,0.000016,0,0,0,0,0.066667,0.001482
10085,10085,,0,12,12,0,12,12,0,0.000172,0,16486,0,0.00001,13,0.18611,0.208712,0,0.280303,0
10086,10086,,2,24,26,2,24,26,0.000154,0.002568,0,16487,0,0.00001,14,0.184842,0.209989,10074.077145,0.155385,0.000653
10087,10087,,11,20,31,11,20,31,0.000614,0.002258,0,16488,0,0.000015,14,0.19274,0.220175,5640.848226,0.196774,0.002974
10088,10088,,54,38,92,54,38,92,0.008238,0.022993,0,15436,1,0.000041,13,0.217379,0.248363,50710.895298,0.10774,0.0192
10091,10091,,18,36,54,18,36,54,0.000929,0.002372,0,15411,0,0.000016,14,0.21288,0.240311,8373.644768,0.187631,0.007528
10092,10092,,0,13,13,0,13,13,0,0.002321,0,16489,2,0.00001,12,0.207018,0.240844,0,0.141026,0
10094,10094,,6,15,21,6,15,21,0.000001,0.000007,0,16490,6,0.000014,13,0.142052,0.159564,3996.722256,0.25,0.001441
10095,10095,,10,13,23,10,13,23,0.000002,0.000008,0,16491,20,0.000016,13,0.165523,0.178869,84.936288,0.237154,0.002529
9505172,9505172,,10,4,14,10,4,14,0.000002,0.000003,0,9777,20,0.000021,3,0.588235,0.683333,36.814873,0.164835,0.002598
10096,10096,,9,14,23,9,14,23,0.000027,0.000832,0,16495,5,0.000013,13,0.18848,0.206314,12261.452215,0.167984,0.002085
9604167,9604167,,4,8,12,4,8,12,0.000022,0.00002,0,16493,23,0.000013,12,0.161746,0.198666,1206.830823,0.128788,0.001057
9910133,9910133,,9,9,18,9,9,18,0.000027,0.000038,0,16494,5,0.000015,17,0.138801,0.161661,4778.357289,0.173203,0.002132
9212134,9212134,,3,0,3,3,0,3,0,0,0,2590,23,0.000018,0,0,0,0,0.333333,0.00073
9504137,9504137,,1,6,7,1,6,7,0,0.000004,0,16492,23,0.000011,3,0.692308,0.814815,48.441419,0.190476,0.000248
10097,10097,,4,4,8,4,4,8,0.000235,0.000016,0,16335,5,0.000015,8,0.254842,0.294824,313.269938,0.178571,0.001064
9510128,9510128,,1,3,4,1,3,4,0.000001,0.00002,0,5271,5,0.000012,2,0.636364,0.714286,0,0.25,0.000259
10098,10098,,4,15,19,4,15,19,0.000137,0.001854,0,16497,25,0.000012,16,0.188425,0.211394,7207.95898,0.108187,0.00098
9706092,9706092,,4,3,7,4,3,7,0.000052,0.000009,0,16496,23,0.000013,5,0.342342,0.40614,91.927857,0.285714,0.00097
10099,10099,,3,11,14,3,11,14,0.000097,0.001818,0,16498,25,0.000011,12,0.195824,0.216362,2896.504545,0.137363,0.000741
9911035,9911035,,3,10,13,3,10,13,0.000051,0.009142,0,15856,0,0.000013,14,0.185058,0.21056,11869.34248,0.089744,0.000868
9801126,9801126,,5,1,6,5,1,6,0.000015,0.000001,0,10635,5,0.000043,4,0.4,0.46875,32.939115,0.266667,0.001225
10100,10100,,4,19,23,4,19,23,0.000001,0.000009,0,16499,20,0.000013,13,0.17015,0.185518,2037.591869,0.158103,0.000984
9212083,9212083,,11,0,11,11,0,11,0.000074,0,0,7359,20,0.0001,0,0,0,0,0.009091,0.002612
10101,10101,,30,31,61,30,31,61,0.001593,0.00428,0,13005,30,0.000024,14,0.2106,0.235912,31144.563159,0.128962,0.011611
10102,10102,,19,14,33,19,14,33,0.000689,0.000399,0,15495,4,0.000023,16,0.196706,0.216807,12230.554676,0.235795,0.006829
9205082,9205082,,4,0,4,4,0,4,0.000008,0,0,148,26,0.000108,0,0,0,0,0.083333,0.00139
10103,10103,,1,23,24,1,23,24,0.000034,0.003142,0,16501,4,0.00001,14,0.183364,0.210619,150.065193,0.137681,0.000219
9910209,9910209,,2,12,14,2,12,14,0.00007,0.001769,0,16500,4,0.000011,16,0.149388,0.178174,44.682717,0.197802,0.000445
9704032,9704032,,2,22,24,2,22,24,0.000078,0.00238,0,6041,4,0.000011,12,0.210055,0.245857,252.247047,0.228261,0.000592
10104,10104,,13,22,35,13,22,35,0.001667,0.016805,0,16502,41,0.000015,12,0.193851,0.216946,14599.66191,0.22521,0.003235
10105,10105,,28,20,48,28,20,48,0.000735,0.024163,0,15458,30,0.000057,13,0.230236,0.263648,190886.549388,0.098404,0.009271
9507106,9507106,,1,0,1,1,0,1,0,0,0,3874,26,0.00003,0,0,0,0,0,0.00026
10107,10107,,4,16,20,4,16,20,0.000001,0.000011,0,16508,15,0.000016,15,0.154266,0.17701,6680.137217,0.068421,0.000897
9312180,9312180,,4,2,6,4,2,6,0,0,0,16506,30,0.000019,1,1,1,879.333333,0.1,0.000937
9405125,9405125,,5,1,6,5,1,6,0.000011,0,0,16504,30,0.000021,1,1,1,2.333333,0.133333,0.001217
9606011,9606011,,5,3,8,5,3,8,0.000011,0,0,16507,30,0.000018,2,0.8,0.875,1752.5,0.160714,0.00119
9212052,9212052,,6,0,6,6,0,6,0,0,0,16505,22,0.000039,0,0,0,0,0,0.001342
9307102,9307102,,4,0,4,4,0,4,0.00001,0,0,16503,30,0.000045,0,0,0,0,0.333333,0.001019
10108,10108,,129,32,161,129,32,161,0.005279,0.002238,0,12994,3,0.000067,13,0.201472,0.224294,95801.662686,0.096778,0.047143
10109,10109,,0,11,11,0,11,11,0,0.000006,0,16509,20,0.00001,14,0.146864,0.158181,0,0.236364,0
10110,10110,,1,21,22,1,21,22,0.000218,0.001267,0,16510,3,0.00001,15,0.199713,0.221462,1277.687218,0.125541,0.000315
10111,10111,,0,1,1,0,1,1,0,0,0,16511,2,0.00001,18,0.119781,0.127884,0,0,0
10112,10112,,22,9,31,22,9,31,0.000671,0.002495,0,12474,25,0.000025,14,0.185526,0.206676,8382.057815,0.11828,0.005584
10113,10113,,31,24,55,31,24,55,0.000578,0.002854,0,15455,30,0.000035,13,0.198874,0.219152,25589.389512,0.111111,0.009007
10114,10114,,0,4,4,0,4,4,0,0,0,16515,26,0.00001,4,0.48,0.604167,0,0.25,0
9304101,9304101,,3,1,4,3,1,4,0.000001,0,0,16513,26,0.000018,1,1,1,3,0.166667,0.00067
9601136,9601136,,9,2,11,9,2,11,0.000007,0.000003,0,7291,26,0.000024,3,0.571429,0.708333,8730.704848,0.063636,0.002138
9711174,9711174,,2,0,2,2,0,2,0.000001,0,0,16512,26,0.000015,0,0,0,0,0.5,0.000451
9712096,9712096,,2,4,6,2,4,6,0,0.000057,0,16514,26,0.000015,4,0.52381,0.643939,7,0.166667,0.000438
9202063,9202063,,9,0,9,9,0,9,0.000001,0,0,766,15,0.000055,0,0,0,0,0,0.00202
10115,10115,,3,19,22,3,19,22,0.000647,0.010103,0,16516,2,0.000011,17,0.181448,0.210586,357.342161,0.160173,0.001007
10116,10116,,9,21,30,9,21,30,0.001886,0.019264,0,15480,1,0.000012,13,0.199076,0.226607,16483.228074,0.163218,0.002719
10117,10117,,5,35,40,5,35,40,0.00101,0.019171,0,16517,1,0.000011,14,0.221117,0.256419,5116.045573,0.125641,0.001591
10118,10118,,5,12,17,5,12,17,0.000142,0.00022,0,15647,28,0.000013,14,0.183948,0.20321,17746.301789,0.253676,0.001148
9308041,9308041,,1,2,3,1,2,3,0.000003,0.000032,0,15646,28,0.000011,1,1,1,9,0.166667,0.000252
10119,10119,,23,21,44,23,21,44,0.001335,0.006085,0,13004,30,0.000018,16,0.201237,0.225026,9692.569916,0.164376,0.007307
9912258,9912258,,3,26,29,3,26,29,0.000207,0.009975,0,13003,30,0.000012,13,0.214921,0.242787,9069.612714,0.166256,0.001157
10121,10121,,5,18,23,5,18,23,0.001105,0.001564,0,15578,25,0.000012,14,0.205187,0.229045,11727.023722,0.130435,0.001252
10122,10122,,20,53,73,20,53,73,0.001946,0.012006,0,15520,2,0.000017,12,0.23692,0.268537,215991.851028,0.098935,0.00597
10123,10123,,0,6,6,0,6,6,0,0.000009,0,16518,6,0.00001,5,0.434783,0.574167,0,0.266667,0
10124,10124,,16,18,34,16,18,34,0.000677,0.00249,0,15727,0,0.000026,14,0.178069,0.20633,22211.847076,0.088235,0.004023
10125,10125,,0,2,2,0,2,2,0,0.000003,0,16519,26,0.00001,4,0.384615,0.491667,0,0.5,0
10126,10126,,0,2,2,0,2,2,0,0.001855,0,16520,0,0.00001,11,0.225977,0.25514,0,0,0
10127,10127,,35,17,52,35,17,52,0.005347,0.004417,0,15443,8,0.000033,15,0.200339,0.223675,14558.398308,0.215309,0.015426
10128,10128,,1,9,10,1,9,10,0,0.000006,0,16522,20,0.00001,16,0.145299,0.158992,19.679859,0.233333,0.000258
9906017,9906017,,2,3,5,2,3,5,0,0.000002,0,16521,20,0.000011,19,0.128696,0.159423,105.874556,0.35,0.000484
10129,10129,,10,6,16,10,6,16,0.000012,0.000001,0,16523,22,0.000018,19,0.116076,0.136269,10.395238,0.3375,0.002383
10130,10130,,2,6,8,2,6,8,0.000029,0.000306,0,16524,4,0.000019,16,0.176173,0.196973,9601.313439,0.160714,0.000478
10131,10131,,0,4,4,0,4,4,0,0.000001,0,16525,5,0.00001,9,0.182832,0.22296,0,0,0
10132,10132,,0,2,2,0,2,2,0,0,0,16526,18,0.00001,3,0.466667,0.571429,0,0.5,0
10133,10133,,10,21,31,10,21,31,0.000384,0.004468,0,15571,25,0.000015,16,0.186286,0.209688,5486.743896,0.244086,0.002706
12044,12044,,26,23,49,26,23,49,0.001502,0.004495,0,15590,25,0.000021,16,0.184427,0.207401,7096.22063,0.198554,0.006459
10215,10215,,26,29,55,26,29,55,0.00124,0.002729,0,15570,25,0.000021,15,0.194596,0.218883,20424.82464,0.158586,0.006859
11254,11254,,10,17,27,10,17,27,0.000323,0.002032,0,15572,25,0.000015,16,0.187373,0.212076,6256.247562,0.18661,0.002773
10134,10134,,2,1,3,2,1,3,0,0.000007,0,16527,0,0.000027,14,0.151723,0.16592,17612,0.166667,0.000445
10135,10135,,7,9,16,7,9,16,0.000007,0.000172,0,16528,1,0.00002,13,0.183585,0.20198,32924.695656,0.066667,0.001646
10136,10136,,0,1,1,0,1,1,0,0.000005,0,16529,5,0.00001,14,0.156265,0.16812,0,0,0
10137,10137,,31,45,76,31,45,76,0.005803,0.015321,0,15916,1,0.000021,16,0.20389,0.230488,21400.984239,0.169298,0.009499
10138,10138,,15,8,23,15,8,23,0.002911,0.006081,0,12468,1,0.000016,15,0.187419,0.207633,1420.589038,0.1917,0.005074
10139,10139,,1,6,7,1,6,7,0.000002,0.000079,0,16530,28,0.000011,11,0.187576,0.20439,3,0.214286,0.000226
10141,10141,,9,26,35,9,26,35,0.001607,0.019004,0,12467,25,0.000014,16,0.200775,0.227819,45743.938709,0.168067,0.002698
101164,101164,,11,22,33,11,22,33,0.002122,0.018339,0,15615,25,0.000014,17,0.190407,0.220991,25891.900947,0.167614,0.004027
10203,10203,,6,9,15,6,9,15,0.00048,0.0087,0,15586,25,0.000014,18,0.210984,0.245871,55854.258653,0.128571,0.001677
11156,11156,,102,23,125,102,23,125,0.009513,0.005889,0,15544,25,0.000082,15,0.22189,0.255304,270620.972373,0.041226,0.029143
11230,11230,,18,17,35,18,17,35,0.004004,0.003161,0,12469,25,0.000017,17,0.185592,0.209274,44413.695501,0.163025,0.005536
10142,10142,,0,14,14,0,14,14,0,0.001601,0,16531,25,0.00001,14,0.196229,0.219562,0,0.17033,0
10143,10143,,0,55,55,0,55,55,0,0.016834,0,16532,30,0.00001,13,0.225404,0.258969,0,0.117845,0
9712078,9712078,,2,4,6,2,4,6,0.000492,0.000189,0,6456,13,0.00001,11,0.189193,0.212091,78.44942,0.133333,0.00055
10144,10144,,6,34,40,6,34,40,0.000129,0.02339,0,16017,25,0.000015,15,0.210459,0.241364,16078.110604,0.08141,0.001646
10145,10145,,7,13,20,7,13,20,0.000835,0.00923,0,15629,8,0.000012,14,0.180962,0.202595,1483.820905,0.136842,0.001909
10146,10146,,0,5,5,0,5,5,0,0.000402,0,16533,0,0.00001,15,0.178586,0.21157,0,0.1,0
10147,10147,,0,6,6,0,6,6,0,0.000125,0,16537,22,0.00001,13,0.166853,0.186396,0,0.033333,0
9310094,9310094,,2,0,2,2,0,2,0.000001,0,0,16535,22,0.000022,0,0,0,0,0.5,0.000445
9503096,9503096,,1,1,2,1,1,2,0.000001,0,0,16536,22,0.000011,1,1,1,0,0.5,0.000219
9610244,9610244,,3,3,6,3,3,6,0.000012,0.000311,0,16534,22,0.000014,7,0.222951,0.258182,68.399136,0.033333,0.000664
9701020,9701020,,5,13,18,5,13,18,0.000087,0.000781,0,3992,4,0.000013,12,0.149718,0.172665,511.818486,0.29085,0.001316
9701155,9701155,,6,28,34,6,28,34,0.000202,0.001352,0,4058,4,0.000012,12,0.164635,0.192865,5067.163354,0.282531,0.001601
9408135,9408135,,7,6,13,7,6,13,0.000001,0,0,5891,6,0.000024,4,0.442623,0.533951,50026.043916,0.147436,0.001813
9504074,9504074,,2,8,10,2,8,10,0,0.000016,0,5883,6,0.000015,4,0.45,0.513889,911.542793,0.144444,0.000504
10149,10149,,5,6,11,5,6,11,0.000046,0.00093,0,16538,30,0.000018,14,0.186282,0.202801,4447.685357,0.154545,0.001454
10151,10151,,8,22,30,8,22,30,0.000295,0.003383,0,16255,2,0.000015,14,0.215216,0.241792,18173.546907,0.132184,0.002154
10152,10152,,3,5,8,3,5,8,0,0.000001,0,16540,23,0.000015,14,0.133434,0.145087,2004.554123,0.089286,0.000658
9806088,9806088,,4,2,6,4,2,6,0,0,0,14381,23,0.000018,14,0.133032,0.143218,2427.746631,0.1,0.00093
9907035,9907035,,2,2,4,2,2,4,0,0.000003,0,16539,23,0.000015,21,0.079007,0.085449,4,0.333333,0.000458
9702033,9702033,,1,0,1,1,0,1,0,0,0,14380,23,0.000018,0,0,0,0,0,0.000246
10153,10153,,3,11,14,3,11,14,0.000097,0.001135,0,16541,1,0.000015,12,0.178789,0.198323,14679.093173,0.115385,0.000684
9712252,9712252,,3,13,16,3,13,16,0.000069,0.002191,0,6573,13,0.000012,12,0.209647,0.241948,2517.129221,0.1375,0.0007
10154,10154,,2,10,12,2,10,12,0.000253,0.001156,0,15994,1,0.000011,13,0.199029,0.220694,25873.372447,0.113636,0.000771
10155,10155,,1,21,22,1,21,22,0.000002,0.000189,0,16542,0,0.00001,15,0.165916,0.194882,1775.03802,0.296537,0.000219
10156,10156,,1,4,5,1,4,5,0.000113,0.000097,0,16543,0,0.00001,12,0.19736,0.220997,0,0.45,0.000361
10158,10158,,7,28,35,7,28,35,0.000369,0.006082,0,16544,30,0.000014,15,0.216172,0.242682,9596.054687,0.114286,0.001735
10159,10159,,1,1,2,1,1,2,0,0,0,16546,23,0.000012,1,1,1,3,0,0.000226
3238,3238,,1,0,1,1,0,1,0,0,0,16545,23,0.000021,0,0,0,0,0,0.000226
10160,10160,,9,14,23,9,14,23,0.000283,0.002221,0,15840,30,0.000017,14,0.204947,0.230138,21344.90063,0.241107,0.002226
10161,10161,,0,3,3,0,3,3,0,0.000001,0,16547,28,0.00001,11,0.155251,0.175451,0,0.333333,0
10162,10162,,0,4,4,0,4,4,0,0,0,16551,22,0.00001,4,0.425926,0.51087,0,0.25,0
9210103,9210103,,7,0,7,7,0,7,0,0,0,12425,22,0.000042,0,0,0,0,0.071429,0.001581
9302121,9302121,,9,0,9,9,0,9,0.000001,0,0,6080,22,0.000046,0,0,0,0,0.069444,0.002188
9610177,9610177,,1,10,11,1,10,11,0,0.000017,0,16550,22,0.000012,2,0.857143,0.916667,5.5,0.045455,0.000219
9610178,9610178,,1,10,11,1,10,11,0,0.000017,0,16549,22,0.000012,3,0.606061,0.725,13.5,0.072727,0.000219
9307011,9307011,,11,0,11,11,0,11,0.000075,0,0,7129,22,0.000042,0,0,0,0,0.063636,0.002627
9403025,9403025,,2,5,7,2,5,7,0,0.000015,0,3207,22,0.000012,2,0.857143,0.916667,4752.234408,0.119048,0.000491
9503117,9503117,,3,4,7,3,4,7,0,0.000003,0,16548,22,0.000015,3,0.516129,0.59375,21.474242,0.166667,0.000677
10163,10163,,7,25,32,7,25,32,0.000415,0.003934,0,15643,25,0.000012,15,0.201525,0.227881,8122.543942,0.134073,0.00178
9307177,9307177,,10,4,14,10,4,14,0.00008,0.000176,0,1116,13,0.000032,4,0.345361,0.39801,17219.479292,0.032967,0.002413
9304013,9304013,,1,11,12,1,11,12,0.000002,0.0001,0,1114,13,0.000017,2,0.73913,0.823529,151.18958,0.030303,0.000287
10164,10164,,0,11,11,0,11,11,0,0.000001,0,16552,6,0.00001,14,0.15022,0.210118,0,0.2,0
10166,10166,,1,18,19,1,18,19,0.000004,0.00743,0,16553,1,0.000012,12,0.200175,0.221204,5362.538612,0.084795,0.000219
9903208,9903208,,7,20,27,7,20,27,0.000375,0.000933,0,15973,23,0.000014,14,0.191278,0.21444,19424.214257,0.166667,0.001796
9802056,9802056,,5,4,9,5,4,9,0.00021,0.000069,0,15972,23,0.000013,13,0.153119,0.16981,330.444725,0.305556,0.001354
9804016,9804016,,8,16,24,8,16,24,0.000219,0.000092,0,15971,23,0.000015,14,0.151694,0.173528,33258.752571,0.105072,0.002058
9810171,9810171,,7,14,21,7,14,21,0.000121,0.000542,0,15970,23,0.000015,14,0.186471,0.209339,11149.619069,0.202381,0.00169
10167,10167,,25,29,54,25,29,54,0.000904,0.002359,0,15863,2,0.000028,13,0.196156,0.222017,79484.021248,0.06464,0.006533
9411015,9411015,,9,2,11,9,2,11,0.000059,0.000065,0,5761,28,0.000029,1,1,1,315.143664,0.236364,0.002416
9708131,9708131,,2,10,12,2,10,12,0.000029,0.000107,0,15857,28,0.000011,6,0.276667,0.365863,744.82884,0.227273,0.000624
9710237,9710237,,1,14,15,1,14,15,0.000028,0.000107,0,15860,28,0.000011,6,0.294118,0.401481,7267.845971,0.214286,0.000396
9405100,9405100,,1,0,1,1,0,1,0.000001,0,0,15859,28,0.000011,0,0,0,0,0,0.000228
9611013,9611013,,1,10,11,1,10,11,0.000001,0.000038,0,15858,28,0.000011,4,0.410714,0.509058,95.650356,0.281818,0.000228
10168,10168,,4,10,14,4,10,14,0,0.000007,0,16554,23,0.000013,14,0.157152,0.17217,2497.878465,0.197802,0.000896
10169,10169,,6,26,32,6,26,32,0.000516,0.010405,0,15811,30,0.000011,12,0.222958,0.255226,4753.032469,0.148185,0.001552
10170,10170,,9,22,31,9,22,31,0.000748,0.001293,0,16142,52,0.000014,15,0.1992,0.221876,4192.60452,0.203226,0.002386
10171,10171,,5,10,15,5,10,15,0.000317,0.001256,0,16023,25,0.000014,14,0.196501,0.217777,2695.279335,0.233333,0.001129
10172,10172,,8,9,17,8,9,17,0.000506,0.000633,0,16555,30,0.000014,13,0.19387,0.212959,17544.149157,0.132353,0.002273
9312162,9312162,,6,1,7,6,1,7,0.000001,0.000008,0,6445,9,0.000073,2,0.666667,0.75,51.466926,0.166667,0.001543
9612255,9612255,,4,1,5,4,1,5,0,0,0,9159,9,0.000022,3,0.4375,0.5,7.333333,0.25,0.000944
10173,10173,,6,8,14,6,8,14,0.000284,0.001222,0,15760,3,0.000013,12,0.205924,0.225926,3045.278248,0.181319,0.001543
10175,10175,,54,14,68,54,14,68,0.001136,0.001511,0,15468,30,0.000069,13,0.195005,0.213356,24589.017917,0.070237,0.014852
10176,10176,,6,3,9,6,3,9,0,0.000004,0,16556,15,0.000022,2,0.8,0.875,0,0.430556,0.001407
10177,10177,,15,10,25,15,10,25,0.000506,0.000118,0,15801,30,0.000019,15,0.187316,0.204804,34828.576371,0.111667,0.004953
10178,10178,,0,2,2,0,2,2,0,0,0,16559,23,0.00001,11,0.137727,0.155575,0,0.5,0
9906236,9906236,,6,2,8,6,2,8,0.000001,0,0,16558,23,0.00002,10,0.158305,0.180433,843.647415,0.25,0.001405
9710227,9710227,,8,6,14,8,6,14,0.000001,0.000003,0,16557,26,0.000033,9,0.183626,0.214808,3383.4197,0.054945,0.001841
10179,10179,,9,39,48,9,39,48,0.001211,0.019462,0,15575,0,0.000012,12,0.210194,0.239702,19745.401254,0.155142,0.002783
10180,10180,,0,11,11,0,11,11,0,0.000005,0,16560,20,0.00001,20,0.13292,0.167937,0,0.218182,0
9704025,9704025,,8,7,15,8,7,15,0.00002,0.000002,0,11337,22,0.000033,1,1,1,11848.129571,0.07619,0.001995
9808034,9808034,,12,5,17,12,5,17,0.000005,0.001654,0,11339,22,0.000031,10,0.176119,0.199406,6793.853263,0.113971,0.002898
10181,10181,,9,23,32,9,23,32,0.000715,0.003205,0,12997,3,0.000014,13,0.196271,0.216636,1607.630868,0.220766,0.005148
10182,10182,,9,15,24,9,15,24,0.000345,0.001631,0,16238,2,0.000019,14,0.171382,0.192757,2289.760481,0.121377,0.002238
10183,10183,,11,8,19,11,8,19,0.000396,0.00141,0,15587,25,0.000015,16,0.177675,0.197774,2349.742673,0.283626,0.00296
10184,10184,,1,11,12,1,11,12,0.000049,0.002954,0,16561,4,0.00001,13,0.172809,0.197617,34.235021,0.25,0.000219
10185,10185,,2,4,6,2,4,6,0,0.000001,0,16567,23,0.000014,15,0.12653,0.141495,141.900923,0.166667,0.000451
9806073,9806073,,5,1,6,5,1,6,0,0,0,16562,23,0.000029,2,0.666667,0.75,6.45,0.2,0.001168
9912194,9912194,,3,5,8,3,5,8,0,0.000001,0,16566,23,0.000018,14,0.142234,0.158667,4427.591944,0.125,0.000684
9606125,9606125,,3,0,3,3,0,3,0,0,0,16565,23,0.000019,0,0,0,0,0.333333,0.00069
9607128,9607128,,1,2,3,1,2,3,0,0.000006,0,16564,26,0.000013,2,0.75,0.833333,5.25,0.166667,0.000239
9810094,9810094,,2,2,4,2,2,4,0,0,0,16563,23,0.000016,2,0.75,0.833333,3.95,0.25,0.000478
10186,10186,,32,14,46,32,14,46,0.001059,0.003295,0,15561,25,0.000037,12,0.194146,0.214202,24763.213386,0.128986,0.008859
11137,11137,,19,9,28,19,9,28,0.000532,0.00115,0,15489,30,0.000034,14,0.195699,0.213701,69481.710078,0.093915,0.007739
10188,10188,,0,1,1,0,1,1,0,0,10,16569,32,0.00001,1,1,1,0,0,0
10018,10018,,1,0,1,1,0,1,0,0,10,16568,32,0.000019,0,0,0,0,0,0.000219
10189,10189,,2,29,31,2,29,31,0.000214,0.004652,0,16570,3,0.000011,13,0.202956,0.233232,5865.3045,0.13871,0.000487
10190,10190,,27,28,55,27,28,55,0.000879,0.001842,0,12996,3,0.000026,13,0.19361,0.213356,4215.342192,0.285185,0.015098
10191,10191,,10,11,21,10,11,21,0.001583,0.006887,0,15991,2,0.000013,14,0.203912,0.22529,864.894438,0.247619,0.002588
10192,10192,,10,37,47,10,37,47,0.000923,0.002138,0,15713,0,0.000014,12,0.217896,0.248265,47353.687409,0.085106,0.002861
10193,10193,,0,12,12,0,12,12,0,0.003661,0,16571,25,0.00001,18,0.183295,0.209087,0,0.212121,0
10194,10194,,4,22,26,4,22,26,0.000144,0.001579,0,16572,13,0.000012,14,0.186626,0.213597,11634.8662,0.101538,0.001172
10195,10195,,4,26,30,4,26,30,0.00015,0.001792,0,16573,13,0.000012,14,0.188393,0.216032,1080.765306,0.11954,0.001018
10196,10196,,31,38,69,31,38,69,0.001246,0.002266,0,15005,52,0.000022,15,0.200601,0.227307,24847.070199,0.147059,0.009485
9205042,9205042,,1,0,1,1,0,1,0.000027,0,0,15004,52,0.00001,0,0,0,0,0,0.000457
10197,10197,,0,3,3,0,3,3,0,0.000003,0,16574,20,0.00001,12,0.134026,0.15552,0,0,0
10198,10198,,39,11,50,39,11,50,0.002628,0.001368,0,15414,0,0.000026,16,0.192099,0.216479,21850.418896,0.228163,0.015983
10199,10199,,1,2,3,1,2,3,0,0.000009,0,16575,5,0.00002,14,0.168794,0.181429,12141.671011,0,0.000226
10200,10200,,12,26,38,12,26,38,0.001806,0.018063,0,15531,1,0.000016,16,0.200266,0.239332,8385.728232,0.15505,0.003654
10201,10201,,18,2,20,18,2,20,0.000185,0.00045,0,15974,23,0.000052,5,0.31831,0.367109,1604.735418,0.173684,0.004409
10202,10202,,4,19,23,4,19,23,0.00007,0.003699,0,15635,25,0.000015,12,0.199847,0.222778,3808.274034,0.1917,0.001176
9807112,9807112,,2,16,18,2,16,18,0.000104,0.000017,0,15585,20,0.000012,4,0.566038,0.725,7696.369778,0.094771,0.000495
10204,10204,,44,41,85,44,41,85,0.002681,0.004248,0,15779,30,0.000037,13,0.207469,0.231155,29974.196688,0.113165,0.015474
10205,10205,,27,18,45,27,18,45,0.001408,0.016811,0,15627,25,0.000031,16,0.194393,0.218823,67689.857379,0.115657,0.007211
10206,10206,,14,14,28,14,14,28,0.001651,0.01686,0,15990,2,0.000017,12,0.214725,0.238692,30965.335983,0.161376,0.003871
10207,10207,,14,29,43,14,29,43,0.000859,0.005778,0,15506,0,0.000016,11,0.203833,0.231558,15789.807038,0.121262,0.003888
9801175,9801175,,3,33,36,3,33,36,0.000178,0.007912,0,9481,0,0.000011,12,0.221321,0.265901,3709.230248,0.123016,0.000798
10208,10208,,2,14,16,2,14,16,0.000071,0.001406,0,15556,25,0.000011,15,0.187159,0.208942,3059.171173,0.220833,0.000603
10209,10209,,1,1,2,1,1,2,0,0,0,16577,20,0.000012,3,0.5,0.611111,1,0,0.000219
9909207,9909207,,1,1,2,1,1,2,0,0,0,16576,20,0.00002,2,0.666667,0.75,2,0,0.000226
10210,10210,,0,2,2,0,2,2,0,0,0,16579,26,0.00001,3,0.5,0.633333,0,0.5,0
9804002,9804002,,4,2,6,4,2,6,0,0,0,16578,26,0.000027,2,0.666667,0.75,15.5,0.1,0.000883
10212,10212,,0,1,1,0,1,1,0,0,11,16581,33,0.00001,1,1,1,0,0,0
3079,3079,,3,0,3,3,0,3,0,0,11,16580,33,0.000036,0,0,0,0,0,0.000658
10216,10216,,0,5,5,0,5,5,0,0,0,16584,15,0.00001,4,0.45098,0.539855,0,0.1,0
9607173,9607173,,3,5,8,3,5,8,0,0.000004,0,16582,15,0.000015,3,0.571429,0.680556,6.666667,0.196429,0.00067
9610124,9610124,,2,8,10,2,8,10,0,0.000004,0,16583,15,0.000013,3,0.62963,0.72549,16.666667,0.144444,0.000438
9210024,9210024,,18,0,18,18,0,18,0.000023,0,0,5114,15,0.00006,0,0,0,0,0.042484,0.004297
9402124,9402124,,5,2,7,5,2,7,0.000001,0.000003,0,13398,15,0.000019,2,0.75,0.833333,11.166667,0.166667,0.001135
9305046,9305046,,6,1,7,6,1,7,0.000001,0,0,8526,15,0.000043,1,1,1,27.09189,0.095238,0.001394
9305067,9305067,,6,3,9,6,3,9,0,0.000001,0,10024,22,0.000037,1,1,1,4569.500564,0,0.00135
10217,10217,,26,14,40,26,14,40,0.000894,0.001607,0,15006,52,0.00002,16,0.188725,0.211879,2452.431824,0.205128,0.007836
10218,10218,,48,17,65,48,17,65,0.001918,0.001796,0,12995,3,0.000032,14,0.187834,0.207747,4433.41628,0.188702,0.01835
10219,10219,,0,5,5,0,5,5,0,0.000241,0,16585,2,0.00001,15,0.166847,0.184346,0,0.35,0
10220,10220,,30,19,49,30,19,49,0.000556,0.002369,0,15526,30,0.000045,13,0.20103,0.221546,48717.58036,0.11352,0.008721
11172,11172,,61,8,69,61,8,69,0.000985,0.00334,0,15527,30,0.000069,14,0.196664,0.217209,71502.470453,0.080989,0.015873
101081,101081,,5,14,19,5,14,19,0.000083,0.002147,0,16586,30,0.000016,15,0.193497,0.212988,9756.141954,0.190058,0.001424
12175,12175,,24,8,32,24,8,32,0.000359,0.000975,0,15469,30,0.00003,13,0.193045,0.210028,6066.189493,0.107863,0.006434
101039,101039,,9,30,39,9,30,39,0.000388,0.002198,0,15813,30,0.000015,14,0.201096,0.223194,76629.90347,0.09919,0.00223
102157,102157,,22,26,48,22,26,48,0.000443,0.00505,0,16588,30,0.00003,18,0.197874,0.22249,34148.103055,0.113032,0.005857
101029,101029,,96,12,108,96,12,108,0.00251,0.002827,0,15461,30,0.000096,17,0.20184,0.223049,90057.049221,0.051142,0.027963
9707237,9707237,,2,7,9,2,7,9,0.00006,0.000003,0,16587,22,0.000011,5,0.397849,0.496396,6572.073741,0.083333,0.000595
10221,10221,,28,48,76,28,48,76,0.001305,0.003483,0,15463,30,0.000023,13,0.211079,0.23606,82143.751341,0.161754,0.011389
10222,10222,,7,35,42,7,35,42,0.000323,0.018562,0,15505,52,0.000012,14,0.219869,0.251941,14694.589999,0.134727,0.00174
10223,10223,,33,46,79,33,46,79,0.001009,0.008451,0,15008,52,0.000023,17,0.200699,0.230764,86475.838347,0.126745,0.009927
9511152,9511152,,4,13,17,4,13,17,0.000163,0.000488,0,15003,0,0.000013,10,0.199642,0.233813,952.133391,0.102941,0.00121
10224,10224,,0,3,3,0,3,3,0,0,0,16592,6,0.00001,2,0.714286,0.8,0,0.333333,0
9211100,9211100,,5,2,7,5,2,7,0,0.000006,0,16589,6,0.000051,1,1,1,12.5,0.047619,0.001116
9811100,9811100,,2,1,3,2,1,3,0,0,0,16590,6,0.000026,2,0.6,0.666667,17.5,0.333333,0.000452
9901022,9901022,,2,1,3,2,1,3,0.000001,0,0,16591,6,0.000015,3,0.444444,0.541667,28.5,0.166667,0.000478
10225,10225,,11,1,12,11,1,12,0.000075,0.000003,0,16593,26,0.000037,3,0.5,0.611111,1881.701094,0.007576,0.0025
10226,10226,,2,25,27,2,25,27,0.000003,0.000204,0,16594,23,0.000011,16,0.143595,0.163771,2859.980173,0.165242,0.000452
9906089,9906089,,7,13,20,7,13,20,0.000513,0.000004,0,13942,23,0.000015,15,0.147192,0.160574,24909.943141,0.134211,0.00162
9403027,9403027,,4,0,4,4,0,4,0.000006,0,0,5086,6,0.000044,0,0,0,0,0.25,0.001008
9803233,9803233,,4,0,4,4,0,4,0,0,0,13314,6,0.000022,0,0,0,0,0,0.000924
9808189,9808189,,1,18,19,1,18,19,0,0.00001,0,13313,26,0.000012,15,0.15827,0.191499,19685.395478,0.114035,0.000266
9906071,9906071,,2,7,9,2,7,9,0.000134,0.004825,0,13938,6,0.000012,14,0.166932,0.18455,14474.60571,0.111111,0.000498
10227,10227,,2,3,5,2,3,5,0,0.000001,0,16597,26,0.000015,7,0.2187,0.252847,126.806151,0.15,0.000464
9711095,9711095,,3,4,7,3,4,7,0,0.001861,0,16595,26,0.000023,6,0.271084,0.314444,581.645003,0.095238,0.000684
9712126,9712126,,2,3,5,2,3,5,0,0.000001,0,16596,26,0.000019,7,0.217806,0.251043,125.154762,0.15,0.000458
9504117,9504117,,3,0,3,3,0,3,0.000022,0,0,3634,26,0.000023,0,0,0,0,0,0.000755
10228,10228,,3,5,8,3,5,8,0,0.000004,0,16598,20,0.000015,12,0.167332,0.18084,13162.88633,0.125,0.000664
10229,10229,,2,9,11,2,9,11,0,0.000018,0,16599,9,0.000014,15,0.150949,0.16477,528.163675,0.090909,0.000505
9408016,9408016,,8,1,9,8,1,9,0.000151,0,0,16067,9,0.000029,1,1,1,4,0.125,0.001869
9810221,9810221,,5,3,8,5,3,8,0.000117,0.000002,0,16068,9,0.000013,1,1,1,3041.920881,0.125,0.001191
9708056,9708056,,1,0,1,1,0,1,0,0,0,16066,9,0.000014,0,0,0,0,0,0.000253
10230,10230,,0,1,1,0,1,1,0,0,0,16600,20,0.00001,5,0.347826,0.389063,0,0,0
9501118,9501118,,1,0,1,1,0,1,0,0,0,4140,20,0.000012,0,0,0,0,0,0.000312
9501119,9501119,,2,2,4,2,2,4,0,0.000001,0,4139,20,0.000015,1,1,1,0.5,0.25,0.000568
10233,10233,,0,36,36,0,36,36,0,0.005622,0,16601,4,0.00001,13,0.187097,0.217372,0,0.284921,0
10234,10234,,0,3,3,0,3,3,0,0.000819,0,16602,8,0.00001,14,0.171427,0.185784,0,0.5,0
10235,10235,,1,2,3,1,2,3,0.000024,0.000005,0,16603,13,0.00001,8,0.201304,0.241831,381.634297,0.166667,0.000227
10236,10236,,2,1,3,2,1,3,0,0.000013,0,16604,22,0.00003,2,0.6,0.666667,9,0.166667,0.000451
10237,10237,,4,31,35,4,31,35,0.000342,0.011247,0,15851,2,0.000011,13,0.223511,0.249692,23414.396646,0.113445,0.001189
10238,10238,,5,20,25,5,20,25,0.00005,0.000106,0,15782,28,0.000015,15,0.152462,0.176026,8924.820827,0.121667,0.001317
9712191,9712191,,4,1,5,4,1,5,0.000015,0.000003,0,8270,28,0.000015,13,0.147551,0.159571,12402.874419,0.3,0.000953
9712216,9712216,,4,0,4,4,0,4,0.000016,0,0,15781,28,0.000017,0,0,0,0,0.25,0.000992
10239,10239,,16,8,24,16,8,24,0.002744,0.015561,0,16605,1,0.00002,14,0.180029,0.200088,3487.421845,0.193841,0.004798
10240,10240,,53,65,118,53,65,118,0.00314,0.003829,0,12999,3,0.000041,13,0.208685,0.235074,141652.950436,0.14653,0.023156
10241,10241,,6,21,27,6,21,27,0.000379,0.0016,0,16157,25,0.000013,14,0.169146,0.190697,9338.051817,0.236467,0.001926
9901132,9901132,,1,1,2,1,1,2,0.000019,0,0,16156,23,0.00001,3,0.470588,0.520833,5796.648473,0,0.000266
9910208,9910208,,3,10,13,3,10,13,0.000061,0.00056,0,16155,25,0.000012,15,0.173051,0.197106,300.574088,0.435897,0.001117
9801032,9801032,,3,18,21,3,18,21,0.000186,0.005804,0,4913,4,0.000012,17,0.194459,0.229965,1039.769944,0.278571,0.000947
9803155,9803155,,4,5,9,4,5,9,0,0.000002,0,9618,23,0.000024,2,0.777778,0.857143,24429.805207,0.069444,0.000919
10242,10242,,0,22,22,0,22,22,0,0.002362,0,16607,2,0.00001,13,0.201282,0.225974,0,0.123377,0
9909005,9909005,,3,5,8,3,5,8,0.000169,0.000243,0,16606,2,0.000011,15,0.173618,0.193155,217.301248,0.214286,0.000732
10243,10243,,1,14,15,1,14,15,0.000047,0.001017,0,16609,4,0.00001,16,0.162889,0.185213,288.280493,0.17619,0.000233
9909136,9909136,,1,5,6,1,5,6,0.000012,0.000125,0,16608,4,0.00001,13,0.170796,0.189258,0,0.5,0.000226
10244,10244,,13,40,53,13,40,53,0.000538,0.004159,0,15837,30,0.00002,14,0.203608,0.226367,27695.863287,0.149129,0.004946
10245,10245,,1,7,8,1,7,8,0,0.000027,0,16610,5,0.000011,14,0.151412,0.160824,21.553211,0.428571,0.000227
10246,10246,,1,8,9,1,8,9,0.000031,0.001877,0,16611,23,0.00001,16,0.10803,0.121336,580.283318,0.055556,0.000261
9906021,9906021,,3,3,6,3,3,6,0.000054,0.000002,0,15451,23,0.000021,15,0.118486,0.127697,10672.752147,0.066667,0.000794
10247,10247,,11,39,50,11,39,50,0.000565,0.002844,0,15513,3,0.000016,14,0.203348,0.229931,22217.924743,0.175102,0.006615
10248,10248,,1,18,19,1,18,19,0.000092,0.001233,0,16612,41,0.000015,12,0.209593,0.233308,11968.726758,0.116959,0.001957
10251,10251,,26,28,54,26,28,54,0.001288,0.002526,0,15464,30,0.000021,13,0.204546,0.227955,30276.916208,0.191824,0.010727
10252,10252,,69,19,88,69,19,88,0.009891,0.009626,0,15399,8,0.000078,13,0.18523,0.206394,14234.115008,0.103318,0.028883
10253,10253,,2,8,10,2,8,10,0.00004,0.000056,0,16618,30,0.000012,13,0.174964,0.187534,467.225036,0.111111,0.000478
9210098,9210098,,13,0,13,13,0,13,0.000003,0,0,10503,30,0.000039,0,0,0,0,0.076923,0.003022
9812231,9812231,,2,4,6,2,4,6,0.000028,0.00004,0,16617,30,0.000012,12,0.145385,0.158345,106.505045,0.266667,0.000472
9909026,9909026,,1,20,21,1,20,21,0.000001,0.000051,0,16615,30,0.000011,10,0.191615,0.232315,613.152864,0.1,0.000233
9803240,9803240,,1,19,20,1,19,20,0,0.00009,0,16616,30,0.000013,11,0.169827,0.191644,1933.260229,0.1,0.000233
9402047,9402047,,12,2,14,12,2,14,0.000006,0.000003,0,10502,30,0.000032,1,1,1,6.375,0.148352,0.002823
9510099,9510099,,2,4,6,2,4,6,0.000001,0.000001,0,10505,30,0.000012,2,0.833333,0.9,13.166667,0.233333,0.000478
9703213,9703213,,3,7,10,3,7,10,0.000005,0.000001,0,16614,30,0.000013,11,0.159477,0.180292,1186.960409,0.255556,0.000678
10254,10254,,0,13,13,0,13,13,0,0.000338,0,16626,15,0.00001,15,0.15218,0.175125,0,0.102564,0
9408152,9408152,,1,0,1,1,0,1,0.000004,0,0,16625,15,0.000011,0,0,0,0,0,0.000219
9804161,9804161,,4,5,9,4,5,9,0.000009,0.000002,0,16624,30,0.000021,2,0.857143,0.916667,16.616667,0.097222,0.000897
9904089,9904089,,4,16,20,4,16,20,0.000057,0.003816,0,16619,15,0.000013,14,0.171568,0.20077,7393.802316,0.105263,0.000909
9905222,9905222,,2,13,15,2,13,15,0.000005,0.001986,0,16622,15,0.000011,15,0.150302,0.173997,295.976579,0.147619,0.000445
9911228,9911228,,1,12,13,1,12,13,0.000004,0.000059,0,16623,15,0.000011,15,0.148455,0.169056,28.666667,0.121795,0.000219
9703057,9703057,,2,10,12,2,10,12,0.000036,0.001706,0,16621,4,0.000012,14,0.175262,0.209214,1773.357547,0.166667,0.000451
10255,10255,,7,14,21,7,14,21,0.000141,0.000689,0,15722,0,0.000014,16,0.191175,0.218574,11223.456458,0.192857,0.001816
10256,10256,,15,46,61,15,46,61,0.002468,0.008174,0,15794,30,0.000016,13,0.217018,0.244073,43746.379585,0.154645,0.006853
10257,10257,,5,7,12,5,7,12,0.000133,0.000009,0,16627,6,0.000012,14,0.160849,0.179036,126.204484,0.234848,0.001148
10258,10258,,3,21,24,3,21,24,0.000302,0.000292,0,16628,0,0.00001,14,0.183007,0.2058,5795.77087,0.233696,0.000861
10259,10259,,5,3,8,5,3,8,0.000005,0.000018,0,16629,17,0.000014,12,0.160685,0.181993,42.231594,0.321429,0.001197
10260,10260,,7,3,10,7,3,10,0.000022,0.000005,0,16630,23,0.000025,15,0.143061,0.156583,2493.500996,0.233333,0.001593
10261,10261,,0,7,7,0,7,7,0,0.00001,0,16631,4,0.00001,12,0.174247,0.19762,0,0.214286,0
10263,10263,,1,15,16,1,15,16,0.00019,0.017375,0,16632,1,0.00001,13,0.223786,0.255671,1607.807393,0.354167,0.000232
10264,10264,,30,8,38,30,8,38,0.000902,0.001636,0,15456,30,0.000043,16,0.192347,0.210569,16066.596819,0.147937,0.011018
10265,10265,,5,6,11,5,6,11,0.000023,0.000005,0,16633,23,0.000016,16,0.134029,0.14519,6947.063368,0.172727,0.001141
10266,10266,,3,13,16,3,13,16,0.000086,0.0006,0,16634,2,0.000011,18,0.160294,0.185162,402.022545,0.195833,0.000698
10267,10267,,0,6,6,0,6,6,0,0,0,16637,22,0.00001,12,0.138965,0.164299,0,0.433333,0
9410241,9410241,,8,12,20,8,12,20,0.000032,0.000008,0,5447,22,0.000028,3,0.789474,0.888889,61877.756765,0.084211,0.001977
9703111,9703111,,5,7,12,5,7,12,0,0.000001,0,16635,22,0.000021,12,0.137829,0.162101,372.346289,0.212121,0.001129
9703137,9703137,,4,8,12,4,8,12,0.000001,0.000001,0,16636,22,0.000014,12,0.139046,0.166688,391.64958,0.166667,0.000896
9210152,9210152,,13,0,13,13,0,13,0,0,0,5446,6,0.000047,0,0,0,0,0.192308,0.003157
9308148,9308148,,4,2,6,4,2,6,0,0.000005,0,5445,15,0.000018,1,1,1,1,0.233333,0.000932
9402067,9402067,,1,5,6,1,5,6,0,0.000006,0,5441,15,0.000012,2,0.857143,0.916667,215.685087,0.1,0.000274
9405161,9405161,,5,8,13,5,8,13,0,0.000009,0,3084,15,0.000017,2,0.9,0.944444,21710.511548,0.108974,0.001142
10268,10268,,8,10,18,8,10,18,0.000246,0.002824,0,16638,30,0.000017,13,0.190124,0.207741,387.36419,0.156863,0.002051
10269,10269,,18,22,40,18,22,40,0.000531,0.000897,0,15497,52,0.000019,16,0.198321,0.224613,44613.641391,0.132051,0.0057
9307009,9307009,,1,0,1,1,0,1,0.000003,0,0,1277,4,0.00002,0,0,0,0,0,0.000685
10270,10270,,0,31,31,0,31,31,0,0.007651,0,16640,0,0.00001,11,0.219153,0.260109,0,0.082796,0
9412077,9412077,,2,9,11,2,9,11,0.000112,0.000314,0,1733,0,0.000011,4,0.44697,0.515537,89.123841,0.136364,0.000564
9602139,9602139,,1,3,4,1,3,4,0.00009,0.000001,0,16639,15,0.00001,1,1,1,3,0.083333,0.000219
10271,10271,,7,29,36,7,29,36,0.0008,0.003449,0,15905,0,0.000013,14,0.208392,0.237611,23468.814054,0.115873,0.002051
10272,10272,,8,11,19,8,11,19,0.00003,0.002252,0,16641,10,0.000019,14,0.153423,0.169122,8937.008626,0.157895,0.001966
9707226,9707226,,1,6,7,1,6,7,0,0.001607,0,14221,4,0.000013,7,0.2509,0.29566,92.91152,0.261905,0.000242
10273,10273,,2,1,3,2,1,3,0,0,0,16643,22,0.000014,1,1,1,1,0.166667,0.000445
9308150,9308150,,3,0,3,3,0,3,0,0,0,16642,22,0.000027,0,0,0,0,0.166667,0.000671
10274,10274,,27,7,34,27,7,34,0.004438,0.007683,0,15814,1,0.000025,12,0.191973,0.211308,1369.048002,0.182709,0.008491
10275,10275,,23,26,49,23,26,49,0.001156,0.003005,0,15802,30,0.000021,14,0.206768,0.229435,26068.474802,0.165391,0.00762
10276,10276,,2,3,5,2,3,5,0.000275,0.000994,0,15555,25,0.000011,14,0.18355,0.200633,0,0.45,0.000514
10277,10277,,1,4,5,1,4,5,0,0,0,16646,22,0.000013,14,0.130787,0.140365,214.370851,0.05,0.000245
9706188,9706188,,3,8,11,3,8,11,0,0.000003,0,16645,22,0.000017,3,0.684211,0.794872,79.928571,0.109091,0.000664
9402075,9402075,,9,1,10,9,1,10,0.000009,0,0,4384,22,0.000055,1,1,1,236.464028,0.044444,0.002144
9308014,9308014,,4,0,4,4,0,4,0,0,0,16644,22,0.00002,0,0,0,0,0.083333,0.000903
9311100,9311100,,7,0,7,7,0,7,0.000025,0,0,4375,22,0.000049,0,0,0,0,0.142857,0.001929
9401065,9401065,,5,0,5,5,0,5,0.000199,0,0,4394,22,0.000056,0,0,0,0,0.1,0.001277
9503061,9503061,,9,2,11,9,2,11,0,0.000002,0,9646,22,0.000065,1,1,1,669.208553,0.054545,0.002079
9510114,9510114,,5,2,7,5,2,7,0.000002,0.000002,0,9650,22,0.000019,1,1,1,669.861151,0.047619,0.001157
9307165,9307165,,4,0,4,4,0,4,0.000006,0,0,4385,22,0.000031,0,0,0,0,0.166667,0.000955
10278,10278,,2,17,19,2,17,19,0,0.000073,0,16647,6,0.000011,17,0.161177,0.179672,4567.398062,0.166667,0.000465
10279,10279,,38,42,80,38,42,80,0.002282,0.006453,0,15413,0,0.000024,16,0.209151,0.243508,23956.066403,0.150791,0.014435
10280,10280,,2,31,33,2,31,33,0.000158,0.00401,0,16648,0,0.00001,12,0.215243,0.243019,79.791602,0.194129,0.000596
10281,10281,,6,14,20,6,14,20,0.000261,0.001058,0,15432,52,0.000014,18,0.180307,0.205287,25156.736415,0.126316,0.001817
10282,10282,,20,21,41,20,21,41,0.002265,0.00325,0,15564,10,0.000024,13,0.209052,0.234728,34010.541235,0.094512,0.0066
10283,10283,,4,12,16,4,12,16,0.000023,0.001033,0,16649,25,0.000014,12,0.190226,0.208017,9863.862137,0.158333,0.000916
9610189,9610189,,9,0,9,9,0,9,0.000025,0,0,4973,26,0.000054,0,0,0,0,0.055556,0.002083
10285,10285,,8,23,31,8,23,31,0,0.000017,0,16651,22,0.000024,14,0.164887,0.180368,109725.322315,0.092473,0.001973
9905172,9905172,,3,8,11,3,8,11,0,0.000006,0,16650,22,0.000013,7,0.246175,0.313707,1446.322121,0.127273,0.000726
9204015,9204015,,1,0,1,1,0,1,0,0,0,4133,22,0.000029,0,0,0,0,0,0.000306
10286,10286,,10,23,33,10,23,33,0.001327,0.005201,0,15632,25,0.000014,15,0.195601,0.219213,3711.31283,0.138258,0.00337
10287,10287,,2,13,15,2,13,15,0.000001,0.000007,0,16652,6,0.00001,15,0.156262,0.171943,34.893352,0.204762,0.000445
10288,10288,,0,2,2,0,2,2,0,0,0,16653,5,0.00001,16,0.13735,0.154954,0,0.5,0
9511109,9511109,,2,0,2,2,0,2,0.000024,0,0,9237,5,0.000025,0,0,0,0,0,0.000514
10289,10289,,0,9,9,0,9,9,0,0.000104,0,16654,26,0.00001,16,0.149848,0.165114,0,0.222222,0
10290,10290,,1,4,5,1,4,5,0.000198,0.000015,0,16655,1,0.00001,12,0.16518,0.17695,219.685594,0.15,0.000219
10291,10291,,1,3,4,1,3,4,0.000005,0.00009,0,16656,2,0.000011,17,0.139481,0.157533,4.37816,0.333333,0.000253
10292,10292,,6,17,23,6,17,23,0.000642,0.006427,0,16657,0,0.000012,13,0.210207,0.237981,15813.642775,0.142292,0.001507
10293,10293,,13,10,23,13,10,23,0.000489,0.001557,0,15002,52,0.000019,16,0.180393,0.200678,15556.185936,0.112648,0.004232
11001,11001,,4,15,19,4,15,19,0.000102,0.006923,0,16203,1,0.000016,13,0.205031,0.229985,17990.11614,0.166667,0.000981
11002,11002,,17,31,48,17,31,48,0.000738,0.003526,0,15519,3,0.000017,14,0.187666,0.208601,1008.276279,0.230496,0.007222
11003,11003,,0,43,43,0,43,43,0,0.002215,0,16658,30,0.00001,14,0.205116,0.228183,0,0.227575,0
11004,11004,,2,10,12,2,10,12,0.000001,0.000003,0,16662,6,0.00001,17,0.138437,0.158308,142.723993,0.174242,0.000445
9812115,9812115,,2,7,9,2,7,9,0,0.000003,0,16661,6,0.000012,12,0.146724,0.164257,207.544356,0.166667,0.000451
9802188,9802188,,3,5,8,3,5,8,0,0.000003,0,16659,52,0.000014,6,0.249513,0.299219,177.76619,0.321429,0.000684
9810189,9810189,,2,9,11,2,9,11,0,0.000008,0,16660,52,0.000012,6,0.252446,0.316279,191.76619,0.236364,0.000451
11005,11005,,2,1,3,2,1,3,0,0.000001,0,16663,22,0.000016,1,1,1,1,0.166667,0.000451
11006,11006,,25,26,51,25,26,51,0.001412,0.002503,0,12479,25,0.000023,14,0.209636,0.235898,63844.386155,0.114118,0.006548
11007,11007,,1,12,13,1,12,13,0,0.000011,0,16665,23,0.000012,20,0.126143,0.143138,5876.602691,0.134615,0.000219
9812023,9812023,,2,6,8,2,6,8,0.000209,0.000014,0,16664,23,0.000011,14,0.15871,0.181371,152.636539,0.160714,0.000445
11008,11008,,13,20,33,13,20,33,0.00149,0.009967,0,15602,2,0.000015,13,0.219559,0.247522,5723.783059,0.148674,0.003884
11009,11009,,43,22,65,43,22,65,0.002819,0.003563,0,13000,3,0.000029,14,0.189502,0.210005,23006.401245,0.154087,0.017842
11010,11010,,2,10,12,2,10,12,0.000154,0.002004,0,16667,1,0.000011,12,0.191393,0.210463,686.823772,0.234848,0.000491
9910105,9910105,,5,30,35,5,30,35,0.000419,0.021463,0,16666,1,0.000015,11,0.22899,0.261753,18736.807153,0.171429,0.001142
11011,11011,,7,7,14,7,7,14,0.000001,0.000004,0,16670,23,0.000042,14,0.160334,0.178532,17764.913077,0.126374,0.001639
9711137,9711137,,2,4,6,2,4,6,0,0.000001,0,16668,23,0.000022,6,0.33871,0.461111,153.269073,0.066667,0.000492
9807015,9807015,,1,2,3,1,2,3,0,0.000002,0,16669,23,0.000015,7,0.275862,0.360813,0,0.333333,0.000266
11012,11012,,1,7,8,1,7,8,0.000013,0.000159,0,16671,28,0.000011,11,0.187586,0.204445,5679.203141,0.196429,0.000239
11013,11013,,7,19,26,7,19,26,0.000554,0.002014,0,16672,15,0.000014,13,0.197876,0.218037,8268.37788,0.093846,0.001634
9612241,9612241,,2,25,27,2,25,27,0.000034,0.00368,0,6993,15,0.000012,10,0.221311,0.258061,37202.508069,0.021368,0.000482
11014,11014,,4,6,10,4,6,10,0.000001,0,0,16676,26,0.000015,15,0.138687,0.149599,849.554385,0.311111,0.00093
9912203,9912203,,3,15,18,3,15,18,0,0.000004,0,16675,26,0.000014,15,0.128906,0.145633,874.046136,0.183007,0.00071
9707221,9707221,,2,0,2,2,0,2,0,0,0,16673,26,0.000029,0,0,0,0,0.5,0.000478
9811222,9811222,,3,1,4,3,1,4,0.000162,0,0,16674,26,0.000021,1,1,1,29,0.083333,0.000698
11015,11015,,1,1,2,1,1,2,0,0,0,16677,23,0.000019,6,0.289474,0.381818,11,0,0.000219
11016,11016,,12,35,47,12,35,47,0.001845,0.020221,0,15532,1,0.000015,16,0.210295,0.247674,19772.65965,0.154487,0.003583
11017,11017,,64,37,101,64,37,101,0.00226,0.003841,0,15009,52,0.000042,16,0.204603,0.232705,115044.58702,0.086535,0.018221
11018,11018,,27,20,47,27,20,47,0.001196,0.002386,0,15809,2,0.000027,15,0.21045,0.236982,44275.651927,0.127197,0.007216
11019,11019,,3,37,40,3,37,40,0.000144,0.003344,0,15819,30,0.000011,13,0.205039,0.227278,966.115886,0.203205,0.00085
11020,11020,,10,13,23,10,13,23,0.000301,0.001116,0,16678,2,0.000015,15,0.187073,0.206764,3888.107208,0.22332,0.002603
11021,11021,,16,3,19,16,3,19,0.000166,0.000039,0,15873,52,0.00003,13,0.168014,0.181444,5316.180429,0.157895,0.003924
11022,11022,,0,2,2,0,2,2,0,0,0,16679,26,0.00001,3,0.5,0.633333,0,0.5,0
11023,11023,,46,26,72,46,26,72,0.005751,0.004016,0,15595,1,0.000038,14,0.210881,0.239892,35725.199684,0.083333,0.017196
9903001,9903001,,2,10,12,2,10,12,0.000083,0.00809,0,15594,13,0.000012,14,0.181752,0.208781,2190.82912,0.151515,0.000845
11024,11024,,11,25,36,11,25,36,0.000775,0.005692,0,15654,25,0.000014,16,0.199622,0.22989,7018.270043,0.134127,0.002651
11026,11026,,0,4,4,0,4,4,0,0,0,16680,22,0.00001,18,0.123296,0.131437,0,0.5,0
11027,11027,,9,9,18,9,9,18,0.000011,0.000147,0,16681,5,0.000018,13,0.18084,0.196173,22769.91036,0.143791,0.002196
11028,11028,,0,9,9,0,9,9,0,0.001154,0,16682,30,0.00001,13,0.191789,0.210142,0,0.208333,0
11029,11029,,4,72,76,4,72,76,0.000099,0.006481,0,16683,3,0.000011,13,0.217569,0.246005,3622.068468,0.144386,0.000965
11030,11030,,1,5,6,1,5,6,0.000004,0.00005,0,15649,1,0.00001,13,0.172567,0.186914,188.878833,0.3,0.000255
11031,11031,,5,19,24,5,19,24,0.00022,0.002214,0,16684,0,0.000012,14,0.187649,0.211133,2710.358934,0.262681,0.001294
11032,11032,,0,64,64,0,64,64,0,0.020017,0,16695,0,0.00001,11,0.248947,0.290791,0,0.071181,0
9607119,9607119,,7,2,9,7,2,9,0.000252,0.000591,0,5751,41,0.000028,6,0.281491,0.312557,6589.0224,0.194444,0.001784
9702081,9702081,,8,5,13,8,5,13,0.000249,0.000026,0,11243,41,0.000029,7,0.227129,0.284788,6800.566966,0.147436,0.00189
9707183,9707183,,6,8,14,6,8,14,0.000251,0.000011,0,16688,41,0.000016,8,0.209208,0.246899,132.52965,0.236264,0.001449
9711136,9711136,,5,6,11,5,6,11,0.000243,0.000267,0,16685,0,0.000021,11,0.210369,0.238324,13749.900939,0.181818,0.001218
9806134,9806134,,3,3,6,3,3,6,0.000243,0.000014,0,16686,41,0.000017,12,0.174897,0.191042,4377.402435,0.266667,0.000719
9809176,9809176,,2,13,15,2,13,15,0.000236,0.000049,0,16694,41,0.000011,13,0.166813,0.204951,5.292857,0.204762,0.000438
9901153,9901153,,3,2,5,3,2,5,0.000243,0.000006,0,16687,41,0.000012,13,0.149426,0.159672,1959.299308,0.4,0.000732
9901160,9901160,,3,3,6,3,3,6,0.000256,0.000014,0,16692,0,0.000011,12,0.174897,0.191042,250.055471,0.2,0.000744
9904208,9904208,,6,8,14,6,8,14,0.000299,0.000033,0,16691,41,0.000014,12,0.177733,0.196794,781.261788,0.186813,0.001422
9909092,9909092,,5,9,14,5,9,14,0.000296,0.000033,0,16690,41,0.000013,14,0.139224,0.156493,921.174649,0.203297,0.001196
9911210,9911210,,6,10,16,6,10,16,0.000544,0.000631,0,16693,41,0.000013,12,0.18055,0.20367,3366.25216,0.154167,0.001443
9604023,9604023,,3,11,14,3,11,14,0.000149,0.002944,0,2195,4,0.000015,14,0.198017,0.239413,7178.64506,0.274725,0.00098
9601102,9601102,,4,9,13,4,9,13,0.000257,0.005252,0,1542,0,0.000015,10,0.203629,0.235337,30.376745,0.269231,0.001156
9608113,9608113,,1,14,15,1,14,15,0.000065,0.006653,0,4631,0,0.000011,9,0.221671,0.25603,113.275596,0.209524,0.00025
9309086,9309086,,5,0,5,5,0,5,0.000002,0,0,6123,41,0.000016,0,0,0,0,0.25,0.001252
9410143,9410143,,9,4,13,9,4,13,0.000087,0.000058,0,6120,41,0.000035,6,0.279352,0.335266,2043.58135,0.115385,0.00217
9503062,9503062,,5,2,7,5,2,7,0.000061,0.000024,0,11241,41,0.000022,1,1,1,0.25,0.285714,0.001177
9609169,9609169,,1,4,5,1,4,5,0,0.000026,0,11242,41,0.000015,7,0.224684,0.274715,0,0.45,0.000273
9812198,9812198,,2,6,8,2,6,8,0.000001,0.000017,0,16689,41,0.000013,8,0.201299,0.230457,15.6864,0.25,0.000512
11033,11033,,70,20,90,70,20,90,0.003288,0.001352,0,15514,3,0.000046,14,0.190759,0.212066,47419.498683,0.097253,0.026119
11034,11034,,9,13,22,9,13,22,0.000756,0.002801,0,15806,30,0.000016,12,0.20908,0.230198,24117.114434,0.151515,0.003086
11035,11035,,7,7,14,7,7,14,0.000155,0.00182,0,16207,30,0.000025,15,0.183844,0.202229,20765.738962,0.175824,0.001633
9912044,9912044,,5,20,25,5,20,25,0.000318,0.003413,0,15011,0,0.000016,12,0.208402,0.232355,14092.270763,0.143333,0.001317
11036,11036,,2,7,9,2,7,9,0,0.000002,0,16696,28,0.000014,11,0.166943,0.202302,156.371429,0.180556,0.000445
11037,11037,,4,23,27,4,23,27,0.000163,0.002962,0,15841,30,0.000011,13,0.208568,0.234984,21707.132744,0.216524,0.001115
211079,211079,,1,1,2,1,1,2,0.000015,0,0,16697,5,0.00001,1,1,1,6.325498,0,0.000232
11038,11038,,6,23,29,6,23,29,0.000531,0.006034,0,16009,30,0.000012,13,0.204967,0.229941,1987.005453,0.236453,0.002475
11039,11039,,0,15,15,0,15,15,0,0.005584,0,16699,13,0.00001,11,0.228117,0.26016,0,0.180952,0
9912261,9912261,,1,14,15,1,14,15,0.000066,0.003758,0,16698,13,0.00001,14,0.154342,0.176177,12.394673,0.228571,0.000219
11040,11040,,10,21,31,10,21,31,0.00184,0.007233,0,16198,1,0.000017,13,0.197892,0.219617,4134.491715,0.231183,0.003255
11041,11041,,9,47,56,9,47,56,0.001717,0.009916,0,15597,1,0.000015,13,0.215359,0.244596,9855.102774,0.152273,0.003074
11043,11043,,2,15,17,2,15,17,0.000003,0.0001,0,16700,26,0.000011,16,0.148226,0.164979,1525.807425,0.275735,0.000452
11044,11044,,4,44,48,4,44,48,0.000826,0.020475,0,15917,1,0.000011,11,0.21729,0.245408,23519.298873,0.179521,0.00101
11045,11045,,18,8,26,18,8,26,0.001088,0.000544,0,15636,25,0.000017,15,0.191761,0.213245,5742.91438,0.124615,0.004971
11046,11046,,5,15,20,5,15,20,0.00094,0.001539,0,16266,1,0.000011,15,0.199979,0.22627,1145.631791,0.223684,0.001164
11047,11047,,0,19,19,0,19,19,0,0.003349,0,16701,3,0.00001,18,0.194076,0.220024,0,0.248538,0
11048,11048,,11,71,82,11,71,82,0.000564,0.008969,0,15410,0,0.000014,15,0.210721,0.244852,20045.840832,0.088528,0.004444
11073,11073,,82,57,139,82,57,139,0.004417,0.007174,0,15412,0,0.000043,17,0.210774,0.244157,160777.736713,0.095715,0.028372
9702179,9702179,,5,23,28,5,23,28,0.000422,0.001149,0,6364,4,0.000013,11,0.169553,0.195606,504.617273,0.322751,0.001448
11049,11049,,6,11,17,6,11,17,0.000035,0.000114,0,15694,15,0.00002,20,0.159395,0.174056,22138.422573,0.117647,0.00146
11050,11050,,2,10,12,2,10,12,0.000004,0.000075,0,16702,26,0.000011,11,0.176996,0.218961,13.655844,0.242424,0.000445
11051,11051,,6,16,22,6,16,22,0.000409,0.003219,0,15674,25,0.000013,19,0.193626,0.217903,726.067657,0.151515,0.00143
11052,11052,,3,1,4,3,1,4,0,0,0,16704,9,0.000018,1,1,1,31,0.083333,0.000671
4164,4164,,2,0,2,2,0,2,0,0,0,16703,9,0.000027,0,0,0,0,0,0.000458
11053,11053,,4,13,17,4,13,17,0.000099,0.001276,0,16705,30,0.000012,14,0.192285,0.210631,1994.865384,0.147059,0.000978
11054,11054,,4,12,16,4,12,16,0.000747,0.000797,0,15915,30,0.000011,12,0.193712,0.21266,186.912746,0.295833,0.001071
11055,11055,,0,1,1,0,1,1,0,0,0,16706,9,0.00001,3,0.454545,0.533333,0,0,0
9403189,9403189,,2,2,4,2,2,4,0.000033,0.000002,0,13207,9,0.000019,2,0.666667,0.75,37.944048,0,0.000445
9303034,9303034,,3,2,5,3,2,5,0,0.000003,0,9354,9,0.000027,1,1,1,63.207873,0.15,0.000697
11056,11056,,3,18,21,3,18,21,0.000024,0.001655,0,16707,9,0.000011,14,0.197198,0.222841,1250.989482,0.190476,0.000917
111228,111228,,20,74,94,20,74,94,0.00011,0.000854,0,16724,9,0.000022,13,0.209516,0.241071,167000.277327,0.110959,0.004909
11102,11102,,6,39,45,6,39,45,0.000241,0.0105,0,16118,25,0.000012,12,0.217058,0.245858,30009.074475,0.107071,0.001798
12128,12128,,20,20,40,20,20,40,0.000555,0.019791,0,16105,9,0.000019,14,0.208513,0.237333,50267.509738,0.124359,0.00521
103064,103064,,13,45,58,13,45,58,0.000356,0.000714,0,16120,9,0.000013,14,0.204845,0.233508,8984.137385,0.239564,0.003409
103197,103197,,16,13,29,16,13,29,0.000448,0.00017,0,16116,9,0.000015,15,0.17854,0.195872,72607.588016,0.238916,0.004164
105248,105248,,11,29,40,11,29,40,0.000291,0.001626,0,16104,9,0.000013,16,0.197664,0.225544,38401.547879,0.16859,0.002935
106124,106124,,10,7,17,10,7,17,0.000275,0.001998,0,16723,9,0.000014,11,0.226023,0.255125,63889.182066,0.110294,0.002523
106146,106146,,8,37,45,8,37,45,0.000186,0.001289,0,16719,9,0.000012,12,0.213918,0.242923,76736.310622,0.110606,0.002095
106259,106259,,7,26,33,7,26,33,0.000101,0.000949,0,16711,9,0.000012,13,0.194743,0.221791,7003.242284,0.169508,0.001867
107150,107150,,8,6,14,8,6,14,0.000056,0.000105,0,16710,9,0.000012,16,0.171327,0.192521,8.743469,0.445055,0.002119
107160,107160,,11,55,66,11,55,66,0.000398,0.01575,0,16121,9,0.000013,13,0.205782,0.236106,124256.623844,0.199534,0.003154
107242,107242,,11,71,82,11,71,82,0.000068,0.000805,0,16722,9,0.000013,13,0.207377,0.237327,47531.686468,0.177657,0.002809
9708160,9708160,,6,24,30,6,24,30,0.000045,0.000128,0,16108,9,0.000012,14,0.18619,0.213716,4435.525629,0.103448,0.001674
9909129,9909129,,3,43,46,3,43,46,0.000072,0.007575,0,16709,2,0.000011,12,0.222339,0.251954,8789.455034,0.088889,0.000849
11057,11057,,5,40,45,5,40,45,0.000408,0.003831,0,15807,30,0.000012,12,0.229073,0.256783,37852.576116,0.112121,0.001696
11058,11058,,2,4,6,2,4,6,0.000056,0.000002,0,16725,25,0.000011,14,0.139059,0.146906,10895.595677,0.233333,0.000466
11059,11059,,2,32,34,2,32,34,0.000057,0.004477,0,15507,0,0.00001,12,0.208021,0.235105,25520.493778,0.142602,0.000603
11060,11060,,29,48,77,29,48,77,0.002953,0.00814,0,15435,52,0.00002,13,0.225414,0.256641,185161.855513,0.095865,0.008918
11077,11077,,65,30,95,65,30,95,0.010669,0.011335,0,15437,1,0.000037,12,0.225866,0.254954,200468.848526,0.11467,0.020252
11063,11063,,1,1,2,1,1,2,0.000014,0,0,16084,5,0.00001,1,1,1,1607,0,0.000232
9810207,9810207,,2,0,2,2,0,2,0,0,0,16083,5,0.000023,0,0,0,0,0,0.000445
11064,11064,,0,2,2,0,2,2,0,0,0,16727,5,0.00001,1,1,1,0,0,0
11061,11061,,2,0,2,2,0,2,0,0,0,16726,5,0.000023,0,0,0,0,0,0.000438
11065,11065,,0,5,5,0,5,5,0,0.001911,0,16730,2,0.00001,17,0.155735,0.184235,0,0.15,0
9707225,9707225,,2,11,13,2,11,13,0.000124,0.007459,0,16728,2,0.000013,11,0.196778,0.22645,257.039833,0.179487,0.000452
9803152,9803152,,2,11,13,2,11,13,0.000051,0.008612,0,16729,2,0.000012,11,0.195122,0.2232,1480.435372,0.179487,0.000462
11066,11066,,8,17,25,8,17,25,0.001349,0.01792,0,15563,25,0.000013,12,0.211171,0.235492,19844.308666,0.143333,0.002183
11067,11067,,1,11,12,1,11,12,0,0.000188,0,16731,26,0.000012,12,0.151168,0.169119,19.5,0.121212,0.000219
11068,11068,,0,5,5,0,5,5,0,0.000001,0,16732,23,0.00001,21,0.114693,0.125902,0,0.4,0
11070,11070,,6,9,15,6,9,15,0.000001,0.000071,0,16734,22,0.000016,6,0.287154,0.358772,56.020058,0.314286,0.001361
9907111,9907111,,7,6,13,7,6,13,0.000002,0.00007,0,16733,22,0.000018,6,0.277143,0.342612,48.620058,0.301282,0.00162
9609105,9609105,,4,5,9,4,5,9,0.000011,0.000001,0,5583,22,0.000018,3,0.666667,0.791667,6078.76913,0.277778,0.000984
11071,11071,,0,11,11,0,11,11,0,0.000935,0,16735,3,0.00001,16,0.177641,0.197028,0,0.145455,0
11072,11072,,6,26,32,6,26,32,0.000001,0.000007,0,16736,17,0.000013,12,0.174541,0.217567,2095.292629,0.197581,0.001416
11075,11075,,7,34,41,7,34,41,0.000349,0.002809,0,15409,0,0.000013,17,0.211404,0.244037,41009.257784,0.120732,0.002483
9904218,9904218,,2,17,19,2,17,19,0.000091,0.003069,0,15408,0,0.00001,16,0.192105,0.228397,115.87395,0.216374,0.000553
11076,11076,,2,5,7,2,5,7,0,0.000001,0,16737,15,0.000013,14,0.15432,0.16633,1223.444583,0.214286,0.000438
12035,12035,,23,37,60,23,37,60,0.002414,0.011211,0,15966,1,0.000017,13,0.228982,0.258246,45967.738852,0.155932,0.006411
11166,11166,,14,55,69,14,55,69,0.002149,0.026342,0,15906,1,0.000015,12,0.23857,0.273091,169694.929952,0.12809,0.004297
11193,11193,,47,45,92,47,45,92,0.007281,0.025472,0,15438,1,0.000028,13,0.216964,0.246844,30165.13796,0.125896,0.014507
11279,11279,,14,18,32,14,18,32,0.002293,0.009855,0,15439,1,0.000016,14,0.203588,0.230377,12836.970699,0.115927,0.004488
11078,11078,,1,1,2,1,1,2,0.000339,0.000038,0,16738,2,0.00001,15,0.143504,0.153912,14.501018,0,0.000226
11079,11079,,37,26,63,37,26,63,0.001652,0.01935,0,15481,30,0.000027,13,0.211062,0.236379,83509.894638,0.079365,0.011881
12054,12054,,38,30,68,38,30,68,0.001475,0.005078,0,15482,30,0.000029,13,0.205751,0.229778,167776.55658,0.086918,0.012991
11080,11080,,3,15,18,3,15,18,0.000073,0.00231,0,16739,30,0.000011,13,0.195599,0.214057,332.271457,0.156863,0.000697
11081,11081,,1,14,15,1,14,15,0.000031,0.00401,0,16740,4,0.000011,13,0.187979,0.215446,5727.527904,0.171429,0.000234
11082,11082,,0,1,1,0,1,1,0,0.000005,0,16741,5,0.00001,13,0.134656,0.155511,0,0,0
11083,11083,,2,15,17,2,15,17,0,0.000011,0,16744,20,0.000014,16,0.1534,0.174252,3924.206926,0.077206,0.000484
9511175,9511175,,8,0,8,8,0,8,0.000071,0,0,5960,4,0.000025,0,0,0,0,0.160714,0.002021
9709175,9709175,,3,2,5,3,2,5,0.000001,0.000003,0,15610,20,0.000013,2,0.75,0.833333,15.225389,0.2,0.000731
9904119,9904119,,2,12,14,2,12,14,0.000001,0.001078,0,16743,4,0.000011,15,0.161881,0.18479,3804.056272,0.115385,0.000491
9702156,9702156,,2,8,10,2,8,10,0.000055,0.000012,0,5992,4,0.000011,10,0.181186,0.219197,12501.375235,0.1,0.000557
9902162,9902162,,2,21,23,2,21,23,0.000241,0.003002,0,16742,4,0.000011,14,0.186309,0.215549,8602.07518,0.134387,0.000481
11084,11084,,4,1,5,4,1,5,0.000042,0.00001,0,16745,30,0.000013,1,1,1,11,0.1,0.00091
11085,11085,,2,12,14,2,12,14,0.000037,0.009077,0,16746,2,0.000012,13,0.218844,0.247848,13379.19757,0.131868,0.000445
11086,11086,,16,40,56,16,40,56,0.003127,0.024957,0,15426,1,0.000014,15,0.220518,0.256509,49459.750187,0.12987,0.004608
11087,11087,,0,1,1,0,1,1,0,0,0,16748,21,0.00001,6,0.26,0.332051,0,0,0
9607232,9607232,,3,2,5,3,2,5,0.000011,0,0,16747,21,0.000032,5,0.324324,0.422222,31.885965,0.05,0.000658
9410079,9410079,,3,1,4,3,1,4,0,0.000001,0,14046,21,0.000052,4,0.4,0.466667,202.567907,0.166667,0.000806
9411230,9411230,,2,1,3,2,1,3,0,0,0,14047,21,0.000028,5,0.305556,0.369697,0,0.333333,0.000572
11088,11088,,37,41,78,37,41,78,0.001297,0.004667,0,15839,30,0.000028,13,0.206713,0.230476,19886.815242,0.119214,0.010709
11089,11089,,100,18,118,100,18,118,0.005846,0.00293,0,15429,10,0.00009,15,0.220111,0.248382,109397.096626,0.090033,0.038833
11090,11090,,3,17,20,3,17,20,0.000102,0.002286,0,16749,30,0.000013,13,0.197151,0.217222,2197.103607,0.207895,0.000734
11091,11091,,7,32,39,7,32,39,0.000137,0.000844,0,15511,52,0.000013,16,0.204123,0.233204,29402.634444,0.196356,0.002278
11092,11092,,0,18,18,0,18,18,0,0.018308,0,16750,1,0.00001,13,0.216787,0.248384,0,0.310458,0
11093,11093,,2,49,51,2,49,51,0.000055,0.004159,0,16751,4,0.000011,13,0.198007,0.231022,931.217468,0.145882,0.000474
9510166,9510166,,1,9,10,1,9,10,0.000001,0.000041,0,10852,4,0.00001,9,0.205516,0.268233,204.534129,0.144444,0.000278
9510242,9510242,,4,6,10,4,6,10,0.000002,0.000014,0,2763,6,0.000014,6,0.273657,0.330997,2552.64551,0.222222,0.001092
9604009,9604009,,2,4,6,2,4,6,0.000002,0.000005,0,10851,22,0.000011,7,0.287599,0.34917,5359.131291,0.3,0.000497
9604158,9604158,,1,13,14,1,13,14,0.000001,0.000052,0,10849,22,0.00001,6,0.326984,0.420874,7228.184576,0.082418,0.000278
11094,11094,,11,63,74,11,63,74,0.000525,0.009126,0,15795,3,0.000016,13,0.21763,0.246906,23687.580661,0.119215,0.003839
9911099,9911099,,8,12,20,8,12,20,0.000706,0.000664,0,12837,4,0.000014,14,0.189655,0.212641,31338.717844,0.105263,0.002644
11096,11096,,5,4,9,5,4,9,0.000001,0,0,16757,22,0.000018,7,0.230189,0.290749,153.401984,0.097222,0.001148
9611086,9611086,,7,2,9,7,2,9,0.000001,0.00002,0,16756,22,0.000026,2,0.583333,0.642857,19.458333,0.166667,0.001632
9807081,9807081,,3,1,4,3,1,4,0.000001,0,0,16755,22,0.000024,6,0.257576,0.286928,202.302513,0.083333,0.000771
9904052,9904052,,2,2,4,2,2,4,0,0,0,16754,22,0.000024,6,0.261307,0.300641,215.36865,0,0.000518
9803253,9803253,,2,3,5,2,3,5,0,0.000006,0,16752,9,0.000042,5,0.340136,0.394667,457.671163,0.1,0.000473
9310172,9310172,,4,0,4,4,0,4,0,0,0,16753,22,0.000032,0,0,0,0,0,0.000891
11097,11097,,6,17,23,6,17,23,0.000476,0.00486,0,16758,1,0.000013,14,0.221042,0.252687,12192.804725,0.126482,0.001504
11098,11098,,2,16,18,2,16,18,0.000094,0.00247,0,16759,25,0.000011,16,0.198804,0.22274,16480.879072,0.117647,0.000445
11099,11099,,40,19,59,40,19,59,0.001843,0.00063,0,15465,30,0.000031,13,0.198092,0.217564,109887.383879,0.132379,0.014656
11100,11100,,1,3,4,1,3,4,0,0.000002,0,16763,1,0.000014,14,0.147579,0.161717,2458,0.083333,0.000219
9702120,9702120,,5,1,6,5,1,6,0,0,0,16762,1,0.000031,1,1,1,6,0.033333,0.001109
9702121,9702121,,3,0,3,3,0,3,0.000072,0,0,16760,13,0.000015,0,0,0,0,0,0.000692
9702073,9702073,,1,0,1,1,0,1,0,0,0,16761,1,0.000037,0,0,0,0,0,0.000252
11101,11101,,2,44,46,2,44,46,0.000056,0.002872,0,15510,52,0.00001,13,0.213671,0.242553,29906.52067,0.167633,0.000733
11103,11103,,3,10,13,3,10,13,0.000017,0.000023,0,16764,23,0.000012,18,0.156038,0.174994,57.423518,0.205128,0.00067
11104,11104,,1,4,5,1,4,5,0,0,0,16765,6,0.000011,14,0.146486,0.156148,4698.751161,0.25,0.000239
11105,11105,,3,8,11,3,8,11,0.000437,0.000799,0,16766,3,0.000011,15,0.17739,0.195093,3230.938636,0.209091,0.00069
11106,11106,,2,20,22,2,20,22,0.000006,0.007957,0,16767,26,0.000011,11,0.20134,0.224262,1104.536785,0.255411,0.000484
11107,11107,,7,47,54,7,47,54,0.00022,0.001842,0,15503,52,0.000012,17,0.19983,0.230082,42989.492668,0.113208,0.002063
9312188,9312188,,5,15,20,5,15,20,0.000024,0.000068,0,1266,4,0.000015,3,0.75,0.849206,3134.380481,0.021053,0.00125
9403183,9403183,,9,9,18,9,9,18,0.000063,0.000012,0,1067,9,0.000019,3,0.4875,0.568376,9460.022669,0.091503,0.002268
9409069,9409069,,6,17,23,6,17,23,0.00004,0.000054,0,1075,9,0.000015,5,0.390438,0.489286,185261.750022,0.073123,0.001513
9512183,9512183,,1,27,28,1,27,28,0.000022,0.000089,0,15502,6,0.00001,7,0.319605,0.419256,6621.670609,0.070106,0.000272
9211108,9211108,,6,0,6,6,0,6,0.000004,0,0,1061,9,0.000015,0,0,0,0,0.133333,0.00157
9302086,9302086,,16,5,21,16,5,21,0.000006,0.000031,0,442,9,0.000038,1,1,1,2839.692329,0.116667,0.00419
9210143,9210143,,1,0,1,1,0,1,0.000001,0,0,1074,9,0.000011,0,0,0,0,0,0.000261
9311137,9311137,,8,2,10,8,2,10,0.00001,0.00001,0,1037,9,0.000017,2,0.75,0.833333,6658.199332,0.144444,0.001889
9405049,9405049,,4,16,20,4,16,20,0.000001,0.000007,0,1062,9,0.000014,4,0.520833,0.623333,62334.643967,0.078947,0.000973
9312032,9312032,,2,5,7,2,5,7,0.000015,0.000014,0,15501,6,0.000011,1,1,1,224.457033,0.071429,0.000446
11108,11108,,9,14,23,9,14,23,0.00029,0.001586,0,15518,3,0.000014,14,0.18691,0.20572,977.714774,0.300395,0.003568
11109,11109,,10,20,30,10,20,30,0.000534,0.001,0,16113,52,0.000015,15,0.184077,0.208213,31009.093576,0.071264,0.002864
9301118,9301118,,2,2,4,2,2,4,0.000002,0,0,3830,52,0.000019,1,1,1,787.72581,0.333333,0.000542
11110,11110,,5,36,41,5,36,41,0.000753,0.004755,0,16768,0,0.000013,18,0.225389,0.262325,11843.755569,0.07622,0.001352
11111,11111,,13,51,64,13,51,64,0.00156,0.024088,0,16046,0,0.000015,18,0.197905,0.233808,31390.790137,0.176091,0.003671
11112,11112,,5,20,25,5,20,25,0.000979,0.001633,0,16769,41,0.000012,13,0.186319,0.207766,2033.887589,0.258333,0.001392
11113,11113,,14,17,31,14,17,31,0.001228,0.000324,0,16158,25,0.000015,13,0.183161,0.201573,23843.980055,0.178495,0.003731
9608077,9608077,,11,3,14,11,3,14,0.000208,0.00041,0,3670,4,0.000017,10,0.175698,0.210745,5.673296,0.324176,0.003256
9701191,9701191,,7,30,37,7,30,37,0.0001,0.001146,0,3991,4,0.000014,11,0.170289,0.198211,471.303118,0.287538,0.00185
9709161,9709161,,3,13,16,3,13,16,0.000076,0.001134,0,6362,4,0.000012,13,0.16928,0.191739,278.509591,0.291667,0.000855
11114,11114,,19,18,37,19,18,37,0.001423,0.003297,0,15596,10,0.000023,13,0.208101,0.233536,27111.096745,0.138138,0.007476
9707186,9707186,,9,18,27,9,18,27,0.000341,0.002344,0,9482,0,0.000015,15,0.182927,0.221018,2711.64555,0.112536,0.002908
11117,11117,,24,13,37,24,13,37,0.000813,0.00116,0,15748,3,0.000021,13,0.186218,0.205255,1525.545988,0.221471,0.010378
11118,11118,,24,5,29,24,5,29,0.001828,0.001296,0,15577,25,0.000023,14,0.18763,0.206107,717.071929,0.179803,0.006172
11119,11119,,3,38,41,3,38,41,0.000387,0.00533,0,16770,30,0.000011,16,0.210894,0.236594,6348.399755,0.192683,0.000783
11120,11120,,2,27,29,2,27,29,0.000001,0.000043,0,16772,23,0.000011,17,0.147699,0.172847,193.55733,0.12931,0.000458
9912247,9912247,,2,8,10,2,8,10,0.000001,0.000019,0,16771,23,0.000011,17,0.137358,0.16116,0.190909,0.355556,0.000465
11121,11121,,8,13,21,8,13,21,0.000782,0.016712,0,16773,1,0.000015,13,0.190672,0.212004,732.116557,0.216667,0.001982
11122,11122,,3,28,31,3,28,31,0.000321,0.021165,0,15958,2,0.000011,12,0.215549,0.241585,2018.527548,0.177419,0.000832
11123,11123,,4,7,11,4,7,11,0.000005,0.000049,0,16777,30,0.000013,11,0.164385,0.181332,492.949179,0.236364,0.000909
9803199,9803199,,1,10,11,1,10,11,0.000001,0.000057,0,16776,30,0.000012,11,0.164208,0.181739,31.043193,0.172727,0.000246
9812065,9812065,,2,9,11,2,9,11,0.000006,0.000001,0,16774,30,0.000012,13,0.132007,0.144072,802.786782,0.127273,0.000471
9510215,9510215,,6,4,10,6,4,10,0.000054,0.000007,0,3315,30,0.000027,4,0.46875,0.572222,8256.57928,0.077778,0.001473
9801143,9801143,,2,4,6,2,4,6,0.000001,0.000047,0,16775,30,0.000012,11,0.16245,0.175633,1.090909,0.333333,0.000471
9510039,9510039,,2,5,7,2,5,7,0,0.000002,0,16613,30,0.000013,2,0.857143,0.916667,4.45,0.238095,0.000471
11124,11124,,0,3,3,0,3,3,0,0.000004,0,16778,23,0.00001,17,0.107828,0.117415,0,0.333333,0
11125,11125,,72,41,113,72,41,113,0.003967,0.006106,0,15803,30,0.000049,14,0.208965,0.234929,72886.113321,0.084308,0.023789
11126,11126,,3,1,4,3,1,4,0,0,0,16779,22,0.00002,6,0.288288,0.344271,32,0.166667,0.000677
11127,11127,,34,35,69,34,35,69,0.003565,0.022672,0,15940,1,0.000034,14,0.218142,0.253784,81751.500511,0.108483,0.009373
9204025,9204025,,2,0,2,2,0,2,0.000001,0,0,599,13,0.000187,0,0,0,0,0,0.000562
11128,11128,,2,8,10,2,8,10,0.000074,0.001559,0,15665,25,0.00001,16,0.180308,0.200528,460.717003,0.366667,0.000601
11130,11130,,22,24,46,22,24,46,0.000935,0.002224,0,15430,10,0.00003,16,0.196326,0.220443,16392.234766,0.117874,0.010183
9407183,9407183,,3,1,4,3,1,4,0.000213,0.000007,0,908,10,0.000028,1,1,1,20.305793,0.333333,0.001819
11131,11131,,39,55,94,39,55,94,0.003984,0.024131,0,15800,30,0.000025,14,0.225899,0.256185,106105.570091,0.122283,0.013629
11132,11132,,6,14,20,6,14,20,0.000195,0.000014,0,16784,22,0.000013,14,0.136495,0.151799,21317.738857,0.118421,0.002055
9406049,9406049,,10,1,11,10,1,11,0.000003,0.000004,0,1764,22,0.000029,1,1,1,1945.571847,0.218182,0.002479
9408061,9408061,,8,4,12,8,4,12,0.000003,0.000004,0,4388,22,0.00002,3,0.636364,0.761905,1327.04302,0.19697,0.001946
9411124,9411124,,5,5,10,5,5,10,0.000002,0.000001,0,4396,22,0.000014,5,0.407407,0.524242,7410.471115,0.211111,0.001214
9506093,9506093,,5,6,11,5,6,11,0,0.000005,0,16780,22,0.000015,3,0.692308,0.814815,105.948514,0.227273,0.001199
9611046,9611046,,2,8,10,2,8,10,0,0.000008,0,16781,22,0.000012,3,0.652174,0.755556,43.796141,0.3,0.000501
9710221,9710221,,2,8,10,2,8,10,0,0,0,16782,22,0.000011,6,0.373494,0.517742,1,0.333333,0.000494
9904043,9904043,,1,15,16,1,15,16,0,0.000011,0,16783,22,0.000011,9,0.201538,0.240943,1769.194317,0.179167,0.000268
9406086,9406086,,5,2,7,5,2,7,0,0.000002,0,4144,22,0.000038,2,0.75,0.833333,1657.981976,0.095238,0.001307
9611185,9611185,,3,2,5,3,2,5,0,0,0,12431,26,0.000014,8,0.236434,0.276493,191.890849,0.3,0.000711
9612028,9612028,,3,5,8,3,5,8,0,0,0,12430,22,0.000013,3,0.571429,0.680556,23142.931578,0.089286,0.000712
11133,11133,,0,2,2,0,2,2,0,0.000001,0,16785,26,0.00001,4,0.466667,0.583333,0,0,0
11134,11134,,2,8,10,2,8,10,0,0.000046,0,16786,26,0.000014,14,0.16937,0.190515,9064.896536,0.088889,0.000445
9310146,9310146,,3,0,3,3,0,3,0.000005,0,0,15379,5,0.000021,0,0,0,0,0.166667,0.000684
9404135,9404135,,5,11,16,5,11,16,0.000032,0.000399,0,990,5,0.000015,7,0.30273,0.389227,275.616565,0.191667,0.001335
9405032,9405032,,1,5,6,1,5,6,0.000005,0.00002,0,15380,5,0.00001,1,1,1,3,0.1,0.000239
9406201,9406201,,2,7,9,2,7,9,0.000005,0.000422,0,15378,5,0.000021,4,0.418919,0.513441,105.677645,0.069444,0.000478
9510124,9510124,,2,4,6,2,4,6,0.000043,0.000033,0,5279,13,0.000011,5,0.291845,0.341422,1454.157729,0.033333,0.000521
9511097,9511097,,1,0,1,1,0,1,0.000005,0,0,15377,5,0.00001,0,0,0,0,0,0.000239
11135,11135,,0,4,4,0,4,4,0,0.000016,0,16787,6,0.00001,5,0.28125,0.353086,0,0.083333,0
9311052,9311052,,3,2,5,3,2,5,0.000279,0.000068,0,8462,6,0.000014,4,0.31405,0.368421,2691.789268,0.1,0.000786
9703045,9703045,,4,8,12,4,8,12,0.00028,0.000011,0,8463,6,0.000014,5,0.286517,0.395098,48200.880342,0.143939,0.000978
9609030,9609030,,3,4,7,3,4,7,0,0.000007,0,8461,6,0.000014,3,0.588235,0.683333,0.5,0.428571,0.000691
11136,11136,,4,10,14,4,10,14,0.000457,0.000062,0,16294,5,0.000012,14,0.158239,0.18849,462.729421,0.175824,0.001043
9302067,9302067,,1,0,1,1,0,1,0,0,0,3839,5,0.000019,0,0,0,0,0,0.000309
9606134,9606134,,12,5,17,12,5,17,0.000241,0.000036,0,6443,5,0.000028,4,0.423529,0.497685,778.601916,0.106618,0.003324
11138,11138,,40,13,53,40,13,53,0.001476,0.00092,0,15539,25,0.000084,17,0.183734,0.201547,57232.065398,0.087083,0.011021
11141,11141,,40,12,52,40,12,52,0.003483,0.001934,0,15551,25,0.000035,17,0.19217,0.213256,9846.831517,0.087104,0.011215
11139,11139,,14,14,28,14,14,28,0.000564,0.001906,0,15765,30,0.000018,13,0.195175,0.213726,9278.821458,0.25,0.0063
11140,11140,,22,31,53,22,31,53,0.001469,0.003635,0,15821,30,0.00002,14,0.208179,0.231745,30526.785854,0.190131,0.0088
11143,11143,,1,13,14,1,13,14,0.000018,0.001203,0,15683,25,0.00001,17,0.186226,0.20724,69.182777,0.263736,0.000259
11144,11144,,2,18,20,2,18,20,0.000089,0.002524,0,16788,25,0.00001,16,0.186837,0.207899,2562.453497,0.107895,0.000496
11145,11145,,2,21,23,2,21,23,0.000084,0.000441,0,16789,4,0.000011,12,0.191827,0.216388,162.810366,0.1917,0.000458
9607170,9607170,,6,8,14,6,8,14,0.000221,0.000062,0,7600,4,0.000017,9,0.195298,0.245503,15992.210063,0.181319,0.001551
11146,11146,,24,34,58,24,34,58,0.004661,0.023682,0,15599,1,0.000021,12,0.233768,0.266721,78621.511654,0.15487,0.006971
11147,11147,,9,29,38,9,29,38,0.000816,0.006033,0,15818,30,0.000013,13,0.220549,0.249606,11462.802704,0.145804,0.002856
11148,11148,,10,58,68,10,58,68,0.000523,0.003474,0,16141,52,0.000014,16,0.203348,0.238298,27738.568165,0.088455,0.002673
11149,11149,,10,19,29,10,19,29,0.000571,0.001238,0,16790,2,0.000017,16,0.193412,0.214328,11472.412106,0.12931,0.002683
11151,11151,,0,17,17,0,17,17,0,0.000005,0,16791,5,0.00001,15,0.134164,0.146291,0,0.110294,0
11152,11152,,40,8,48,40,8,48,0.001826,0.001363,0,15540,25,0.000076,17,0.18672,0.204726,18079.205657,0.103723,0.010827
11154,11154,,0,19,19,0,19,19,0,0.000009,0,16797,23,0.00001,15,0.133916,0.158948,0,0.146199,0
9612129,9612129,,3,0,3,3,0,3,0,0,0,16796,23,0.000012,0,0,0,0,0,0.00067
9709150,9709150,,1,0,1,1,0,1,0,0,0,16795,23,0.00001,0,0,0,0,0,0.000219
9711175,9711175,,1,15,16,1,15,16,0,0.000072,0,16794,23,0.00001,12,0.163694,0.201917,239.761456,0.104167,0.000219
9410035,9410035,,8,2,10,8,2,10,0.000001,0.000008,0,4734,23,0.00004,6,0.24569,0.27617,11626.647357,0.122222,0.002003
9206038,9206038,,10,0,10,10,0,10,0.000287,0,0,3243,22,0.000136,0,0,0,0,0.144444,0.002793
9508070,9508070,,2,1,3,2,1,3,0.000001,0,0,16793,23,0.000012,1,1,1,0,0.333333,0.000451
9604069,9604069,,3,1,4,3,1,4,0.000015,0,0,16792,23,0.000022,3,0.5,0.566667,20,0,0.000664
11155,11155,,5,2,7,5,2,7,0.000133,0.000559,0,15459,30,0.000023,14,0.187872,0.205223,167.256422,0.333333,0.001891
11160,11160,,23,8,31,23,8,31,0.001499,0.001834,0,15550,25,0.000026,16,0.190427,0.211686,4687.301874,0.12043,0.006022
11157,11157,,1,1,2,1,1,2,0.000014,0.000008,0,16082,5,0.00001,9,0.200929,0.223793,24.089715,0,0.000232
11158,11158,,1,4,5,1,4,5,0.000002,0.001503,0,16798,30,0.000011,13,0.184766,0.200385,341.775625,0.1,0.000219
11159,11159,,7,10,17,7,10,17,0.000201,0.001584,0,15588,25,0.000015,17,0.175208,0.199351,10099.737578,0.099265,0.001988
9409067,9409067,,1,0,1,1,0,1,0.000018,0,0,860,13,0.000014,0,0,0,0,0,0.000437
11161,11161,,2,6,8,2,6,8,0.000002,0.000031,0,16799,22,0.000014,18,0.124532,0.134419,69.010806,0.285714,0.000451
11162,11162,,0,6,6,0,6,6,0,0.000002,0,16800,23,0.00001,15,0.141754,0.150483,0,0.033333,0
9406161,9406161,,3,0,3,3,0,3,0,0,0,8379,23,0.000037,0,0,0,0,0,0.000678
11163,11163,,0,9,9,0,9,9,0,0,0,16802,23,0.00001,17,0.136741,0.158365,0,0.055556,0
9804088,9804088,,2,2,4,2,2,4,0,0.000005,0,16801,23,0.000015,5,0.333333,0.378571,36.279221,0.083333,0.000438
12187,12187,,0,4,4,0,4,4,0,0.000001,0,16803,23,0.00001,8,0.234965,0.262419,0,0.083333,0
11164,11164,,0,10,10,0,10,10,0,0.017034,0,16804,1,0.00001,15,0.184645,0.204872,0,0.377778,0
11165,11165,,0,8,8,0,8,8,0,0.008303,0,16805,1,0.00001,11,0.227251,0.256406,0,0.303571,0
11167,11167,,12,24,36,12,24,36,0.001618,0.018021,0,15634,25,0.000016,14,0.201352,0.226713,15118.077869,0.156349,0.003451
11168,11168,,1,6,7,1,6,7,0,0.000013,0,16812,17,0.000011,8,0.202116,0.228934,1,0.309524,0.000219
9702126,9702126,,3,8,11,3,8,11,0.000001,0.000032,0,16811,4,0.000013,6,0.2832,0.339736,210.451587,0.172727,0.000664
9705002,9705002,,1,4,5,1,4,5,0,0.000023,0,16807,17,0.000012,8,0.194613,0.218838,1.111111,0.3,0.000226
9706038,9706038,,2,5,7,2,5,7,0,0.000035,0,16806,17,0.000013,8,0.194783,0.220326,2.527778,0.309524,0.000445
9503190,9503190,,7,7,14,7,7,14,0.000008,0.000064,0,2791,17,0.000016,4,0.470588,0.583333,43.275819,0.263736,0.001695
9504094,9504094,,5,11,16,5,11,16,0.000007,0.000068,0,2790,17,0.000014,4,0.508197,0.629032,2300.863996,0.316667,0.001237
9410015,9410015,,4,3,7,4,3,7,0.000001,0.000025,0,16808,4,0.000017,5,0.3125,0.366111,211.527778,0.333333,0.000942
9508009,9508009,,4,3,7,4,3,7,0.000002,0.000008,0,16809,4,0.000014,6,0.24898,0.301093,44.611111,0.333333,0.000916
9511220,9511220,,3,9,12,3,9,12,0.000028,0.000012,0,16810,4,0.000013,5,0.303213,0.360486,370.808359,0.136364,0.000677
11169,11169,,1,7,8,1,7,8,0,0.000059,0,16813,4,0.000011,14,0.152446,0.171613,831.481683,0.107143,0.000219
11170,11170,,7,36,43,7,36,43,0.000589,0.002816,0,15786,30,0.000014,12,0.216415,0.240235,43746.219531,0.150055,0.004281
11171,11171,,7,11,18,7,11,18,0.000168,0.004297,0,16814,2,0.000015,12,0.179914,0.199839,2632.797106,0.140523,0.001819
11173,11173,,6,13,19,6,13,19,0.000342,0.000358,0,16815,2,0.000012,13,0.194813,0.216236,3076.20772,0.146199,0.001487
11174,11174,,4,5,9,4,5,9,0.000004,0.000001,0,16816,23,0.000014,18,0.132284,0.145746,4766.583154,0.222222,0.000896
11175,11175,,14,28,42,14,28,42,0.000756,0.004782,0,15957,30,0.000017,12,0.210218,0.233827,11503.940391,0.159117,0.00374
11176,11176,,2,13,15,2,13,15,0.000112,0.000172,0,16817,5,0.000012,12,0.174802,0.202328,203.732227,0.152381,0.000465
11177,11177,,24,11,35,24,11,35,0.001811,0.016704,0,15552,25,0.000025,16,0.192712,0.215279,6928.759334,0.12605,0.006395
11178,11178,,0,10,10,0,10,10,0,0.001849,0,16818,2,0.00001,16,0.19217,0.214833,0,0.166667,0
11179,11179,,10,15,25,10,15,25,0.002613,0.018707,0,15600,1,0.000014,13,0.204803,0.228527,2814.03608,0.28,0.003064
11180,11180,,0,1,1,0,1,1,0,0,0,16819,4,0.00001,1,1,1,0,0,0
11181,11181,,0,5,5,0,5,5,0,0.001712,0,16820,0,0.00001,13,0.178145,0.196822,0,0.4,0
11183,11183,,6,1,7,6,1,7,0.000001,0,0,16821,23,0.000018,15,0.138206,0.149175,39.609537,0.285714,0.001367
11184,11184,,1,8,9,1,8,9,0.000014,0.001467,0,16822,25,0.000012,12,0.194336,0.214079,517.059111,0.069444,0.000219
9206067,9206067,,1,2,3,1,2,3,0.000003,0.000011,0,2299,13,0.000019,1,1,1,61.050342,0.166667,0.000607
9312167,9312167,,3,2,5,3,2,5,0.000219,0.000211,0,2295,0,0.00002,2,0.75,0.833333,2.785397,0.2,0.00115
11185,11185,,1,24,25,1,24,25,0.000359,0.009959,0,16823,1,0.00001,14,0.203604,0.231611,931.328327,0.153333,0.000296
11186,11186,,2,17,19,2,17,19,0.000174,0.008933,0,16824,1,0.000011,12,0.205662,0.229225,1652.093632,0.216374,0.000445
11187,11187,,6,24,30,6,24,30,0.000127,0.000522,0,16825,6,0.000014,13,0.182853,0.205152,12878.246886,0.125287,0.001341
11188,11188,,2,10,12,2,10,12,0.000003,0.000314,0,16826,13,0.000015,13,0.174706,0.191494,6941.661764,0.181818,0.000438
11189,11189,,4,4,8,4,4,8,0,0.000168,0,16829,6,0.000025,13,0.171026,0.187475,37004.852255,0.071429,0.000909
9909046,9909046,,6,4,10,6,4,10,0.000002,0.000004,0,16828,6,0.000031,1,1,1,114.157937,0.055556,0.001394
9405003,9405003,,5,0,5,5,0,5,0,0,0,2793,6,0.000071,0,0,0,0,0.15,0.001191
9310063,9310063,,2,0,2,2,0,2,0,0,0,16827,41,0.00002,0,0,0,0,0,0.000478
11190,11190,,39,24,63,39,24,63,0.004284,0.009235,0,15701,10,0.000031,15,0.205266,0.23603,18764.703222,0.161546,0.015448
12195,12195,,35,14,49,35,14,49,0.004657,0.001429,0,15704,10,0.000026,20,0.186448,0.216265,5147.281208,0.208759,0.012663
11288,11288,,28,26,54,28,26,54,0.003597,0.003267,0,15702,10,0.000024,19,0.19712,0.230249,48478.230666,0.162474,0.010799
11191,11191,,8,35,43,8,35,43,0.001125,0.01908,0,16830,41,0.000018,14,0.188156,0.219161,6242.278208,0.162237,0.0044
11192,11192,,8,31,39,8,31,39,0.000854,0.00122,0,16831,52,0.000012,13,0.212309,0.236285,8021.997048,0.174764,0.00197
11256,11256,,113,9,122,113,9,122,0.007638,0.003038,0,15431,10,0.000088,16,0.220123,0.250738,174982.698603,0.091925,0.0437
11194,11194,,8,8,16,8,8,16,0.000392,0.000038,0,16832,17,0.000015,13,0.144536,0.16154,429.319061,0.254167,0.001953
11195,11195,,0,5,5,0,5,5,0,0.001443,0,16833,25,0.00001,12,0.193086,0.210989,0,0.45,0
11197,11197,,19,180,199,19,180,199,0.001,0.018825,0,15770,4,0.000019,16,0.212286,0.261949,156363.487203,0.056139,0.005765
9810091,9810091,,4,10,14,4,10,14,0.000683,0.000145,0,10879,4,0.000011,5,0.313433,0.393333,236.864456,0.093407,0.0012
9312132,9312132,,2,0,2,2,0,2,0,0,0,553,4,0.000035,0,0,0,0,0,0.000493
9403135,9403135,,2,1,3,2,1,3,0.000001,0.000001,0,557,4,0.000026,1,1,1,12029.739004,0,0.000516
11198,11198,,3,3,6,3,3,6,0.000018,0.000009,0,16334,5,0.000013,18,0.105386,0.125073,3004.177827,0.2,0.000679
11199,11199,,0,1,1,0,1,1,0,0,0,16834,6,0.00001,11,0.163537,0.204757,0,0,0
11200,11200,,1,7,8,1,7,8,0,0.000004,0,16836,15,0.000012,12,0.173223,0.189233,5504,0.267857,0.000219
9711139,9711139,,1,3,4,1,3,4,0,0.000008,0,16835,15,0.000011,3,0.464286,0.551282,4,0.416667,0.000226
11201,11201,,0,1,1,0,1,1,0,0,12,16838,34,0.00001,1,1,1,0,0,0
9909165,9909165,,1,0,1,1,0,1,0,0,12,16837,34,0.000019,0,0,0,0,0,0.000219
11202,11202,,1,21,22,1,21,22,0.000093,0.001929,0,16839,2,0.00001,16,0.19512,0.226329,236.633367,0.145022,0.000288
11203,11203,,0,3,3,0,3,3,0,0.000026,0,16840,13,0.00001,14,0.170229,0.187009,0,0.5,0
11204,11204,,8,27,35,8,27,35,0.002051,0.021803,0,15601,1,0.000012,14,0.198816,0.225155,3448.475545,0.226891,0.002382
11205,11205,,11,17,28,11,17,28,0.00045,0.002597,0,15466,30,0.000015,13,0.198454,0.218123,610.171618,0.30291,0.003954
11206,11206,,4,12,16,4,12,16,0.000108,0.002067,0,15780,30,0.000012,13,0.206563,0.227679,9181.209183,0.133333,0.001129
12200,12200,,10,22,32,10,22,32,0.000331,0.002297,0,15783,30,0.000013,14,0.198696,0.219361,6056.022403,0.144153,0.002768
12077,12077,,10,11,21,10,11,21,0.00031,0.001228,0,15778,30,0.000014,14,0.193105,0.211716,49473.896325,0.247619,0.002787
11207,11207,,3,24,27,3,24,27,0.000654,0.015792,0,15441,1,0.000011,12,0.217457,0.245363,2091.740404,0.213675,0.000866
11208,11208,,4,17,21,4,17,21,0.000162,0.000023,0,16841,9,0.000013,13,0.183179,0.219768,2308.551454,0.109524,0.000923
11209,11209,,5,2,7,5,2,7,0.000003,0,0,16843,22,0.000015,4,0.40625,0.480769,84.214056,0.047619,0.001148
9402121,9402121,,3,0,3,3,0,3,0,0,0,16842,22,0.000034,0,0,0,0,0,0.000691
11210,11210,,0,3,3,0,3,3,0,0,0,16844,22,0.00001,15,0.123785,0.132605,0,0,0
11211,11211,,3,14,17,3,14,17,0.000103,0.001054,0,16845,2,0.000011,13,0.186509,0.206266,787.77301,0.308824,0.000766
11212,11212,,0,1,1,0,1,1,0,0.000099,0,16846,0,0.00001,10,0.206235,0.229362,0,0,0
11213,11213,,0,1,1,0,1,1,0,0,13,16848,35,0.00001,1,1,1,0,0,0
9909036,9909036,,1,0,1,1,0,1,0,0,13,16847,35,0.000019,0,0,0,0,0,0.000219
11214,11214,,3,8,11,3,8,11,0.000024,0.000003,0,16851,5,0.000012,15,0.149986,0.161148,521.437756,0.109091,0.000703
9307003,9307003,,3,0,3,3,0,3,0.000006,0,0,16850,5,0.000025,0,0,0,0,0,0.000678
9309131,9309131,,1,0,1,1,0,1,0,0,0,16849,5,0.000011,0,0,0,0,0,0.000239
11215,11215,,13,8,21,13,8,21,0.000534,0.00165,0,16852,23,0.00002,13,0.184502,0.203769,5859.536825,0.092857,0.003395
11216,11216,,4,5,9,4,5,9,0.000019,0.000008,0,16857,15,0.000014,14,0.172555,0.184658,106.271958,0.263889,0.000996
9604039,9604039,,1,4,5,1,4,5,0,0,0,16856,5,0.000012,3,0.47619,0.616667,93.186243,0.05,0.000247
9807212,9807212,,1,0,1,1,0,1,0,0,0,16853,15,0.000012,0,0,0,0,0,0.000247
9404154,9404154,,1,0,1,1,0,1,0,0,0,16855,5,0.000013,0,0,0,0,0,0.000226
9405152,9405152,,6,0,6,6,0,6,0,0,0,16854,5,0.000053,0,0,0,0,0,0.001322
11217,11217,,22,33,55,22,33,55,0.004268,0.010013,0,15989,1,0.000018,14,0.205676,0.234905,29074.559241,0.085522,0.006012
9612031,9612031,,1,1,2,1,1,2,0.000312,0,0,6093,28,0.000011,1,1,1,9755.409841,0,0.000865
11218,11218,,24,22,46,24,22,46,0.001306,0.003063,0,15834,30,0.000021,13,0.20726,0.229787,16501.416088,0.183575,0.009556
11219,11219,,2,18,20,2,18,20,0.000458,0.0159,0,16858,1,0.000011,16,0.202085,0.23983,1973.903463,0.192105,0.000438
11220,11220,,12,16,28,12,16,28,0.000804,0.001226,0,15499,3,0.000016,17,0.199467,0.220986,24190.020148,0.140212,0.003781
11221,11221,,1,12,13,1,12,13,0.000115,0.001614,0,16859,30,0.00001,13,0.185852,0.203869,36.448116,0.185897,0.000219
11222,11222,,0,26,26,0,26,26,0,0.004152,0,16860,4,0.00001,13,0.186331,0.214609,0,0.210769,0
9404126,9404126,,1,11,12,1,11,12,0.000064,0.000099,0,10882,4,0.00001,2,0.789474,0.866667,2700.731197,0.075758,0.000248
11223,11223,,5,22,27,5,22,27,0.000192,0.004777,0,15478,3,0.000012,13,0.204469,0.227503,2792.131429,0.239316,0.002336
11224,11224,,1,9,10,1,9,10,0,0.00001,0,16862,26,0.000011,9,0.195925,0.224363,190.448725,0.133333,0.000219
9901029,9901029,,3,2,5,3,2,5,0.000034,0.000001,0,15911,26,0.000013,8,0.183511,0.233989,121.302016,0.1,0.000685
9910114,9910114,,2,2,4,2,2,4,0,0.000001,0,16861,26,0.000012,9,0.189968,0.20828,178.248725,0.25,0.000445
9307051,9307051,,6,0,6,6,0,6,0.000001,0,0,7301,26,0.00003,0,0,0,0,0.266667,0.001687
9505069,9505069,,3,4,7,3,4,7,0.000001,0.000018,0,4441,26,0.000021,6,0.242678,0.322126,317.608244,0.047619,0.000822
9601045,9601045,,2,2,4,2,2,4,0,0,0,7936,26,0.000013,9,0.185316,0.205424,3.708892,0.25,0.000559
9609154,9609154,,3,2,5,3,2,5,0,0.000012,0,7934,26,0.000016,8,0.217514,0.239709,80.63978,0.4,0.000799
9610050,9610050,,2,6,8,2,6,8,0,0.000012,0,7933,26,0.000013,8,0.223479,0.253465,18605.638538,0.25,0.00058
9701013,9701013,,4,11,15,4,11,15,0,0.000012,0,7935,26,0.000016,8,0.230957,0.265987,1887.740008,0.180952,0.000997
11226,11226,,41,52,93,41,52,93,0.001875,0.002976,0,15745,3,0.000027,14,0.194335,0.219168,20133.487344,0.176718,0.017197
11228,11228,,0,5,5,0,5,5,0,0.001513,0,16863,30,0.00001,13,0.182524,0.198225,0,0.35,0
11229,11229,,4,1,5,4,1,5,0.000113,0.000002,0,16208,8,0.000013,16,0.155307,0.165834,0,0.5,0.000942
11231,11231,,2,1,3,2,1,3,0.000004,0.00012,0,16864,2,0.000012,15,0.160368,0.179276,218.319388,0,0.000438
11232,11232,,1,7,8,1,7,8,0,0.00004,0,16865,26,0.000013,15,0.154573,0.173321,687.724385,0.107143,0.000219
11233,11233,,12,40,52,12,40,52,0.000796,0.004237,0,15820,30,0.000015,15,0.209525,0.235141,15065.702419,0.19721,0.003855
11234,11234,,4,5,9,4,5,9,0.00034,0.000218,0,16866,1,0.000012,16,0.152158,0.167849,119.362472,0.138889,0.000958
11235,11235,,1,13,14,1,13,14,0.00001,0.008215,0,16869,8,0.000011,14,0.205167,0.236058,3603.732304,0.065934,0.000219
9808154,9808154,,3,2,5,3,2,5,0.000097,0,0,16868,8,0.000016,1,1,1,8,0,0.000664
9812040,9812040,,3,1,4,3,1,4,0.000097,0.000003,0,16867,23,0.000013,11,0.18055,0.207459,0,0.25,0.00067
9505019,9505019,,2,0,2,2,0,2,0,0,0,13736,8,0.000065,0,0,0,0,0,0.000485
11236,11236,,12,24,36,12,24,36,0.001774,0.005542,0,16870,30,0.000013,14,0.2027,0.228625,2250.7599,0.149206,0.002981
11237,11237,,3,1,4,3,1,4,0.000505,0.00003,0,16871,1,0.000013,12,0.182027,0.197531,0,0.416667,0.000749
11238,11238,,23,14,37,23,14,37,0.00063,0.000761,0,15747,3,0.000024,13,0.188823,0.205614,2587.40194,0.307808,0.01283
11239,11239,,9,16,25,9,16,25,0.000717,0.004091,0,16872,0,0.000016,13,0.211402,0.241064,48754.796457,0.106667,0.002364
11240,11240,,8,53,61,8,53,61,0.000234,0.000691,0,16301,5,0.000014,13,0.175824,0.208719,5932.379061,0.044536,0.001921
9301029,9301029,,10,1,11,10,1,11,0.000261,0.000006,0,15387,5,0.000019,1,1,1,0.826923,0.190909,0.002531
9302040,9302040,,10,1,11,10,1,11,0.000282,0.000009,0,2257,5,0.000021,1,1,1,40.147702,0.236364,0.002716
9303176,9303176,,1,8,9,1,8,9,0.000008,0.000036,0,16300,5,0.00001,1,1,1,33.770847,0,0.000273
9304043,9304043,,6,1,7,6,1,7,0.000223,0.000006,0,8199,5,0.000017,1,1,1,3.410256,0.238095,0.001602
9307018,9307018,,2,0,2,2,0,2,0.000008,0,0,16299,22,0.000012,0,0,0,0,0,0.000492
9307160,9307160,,9,3,12,9,3,12,0.000038,0.000478,0,15386,5,0.000019,2,0.714286,0.8,16.514423,0.19697,0.002236
9308155,9308155,,6,4,10,6,4,10,0.000013,0.000014,0,2255,5,0.000015,2,0.833333,0.9,7121.326795,0.133333,0.00159
9404034,9404034,,4,5,9,4,5,9,0.000223,0.000013,0,8201,5,0.000012,2,0.647059,0.727273,54.438556,0.180556,0.001111
9404045,9404045,,5,4,9,5,4,9,0.000275,0.000013,0,8200,5,0.000012,2,0.7,0.785714,5.716667,0.291667,0.001381
9405132,9405132,,1,11,12,1,11,12,0.000008,0.000042,0,16298,5,0.00001,3,0.561644,0.626016,46.687542,0.075758,0.000273
9710051,9710051,,7,17,24,7,17,24,0.000276,0.002189,0,15385,5,0.000013,13,0.181583,0.210624,6911.485278,0.172101,0.001853
9803059,9803059,,4,3,7,4,3,7,0.000026,0.000019,0,16297,5,0.000011,8,0.209245,0.226247,30.018521,0.119048,0.000937
9807007,9807007,,7,12,19,7,12,19,0.000277,0.000032,0,15389,5,0.000013,14,0.160139,0.184845,627.124762,0.184211,0.001804
9809082,9809082,,2,3,5,2,3,5,0.00001,0.000171,0,16296,5,0.000012,13,0.170071,0.187617,152.502592,0.2,0.000492
9906230,9906230,,6,15,21,6,15,21,0.000276,0.000067,0,15390,5,0.000012,14,0.157229,0.178656,36.273068,0.22619,0.001543
9302041,9302041,,4,4,8,4,4,8,0.000029,0.000014,0,2246,5,0.00005,1,1,1,8936.889211,0.178571,0.00106
9304041,9304041,,7,3,10,7,3,10,0.000003,0.000001,0,8197,5,0.000027,1,1,1,318.965033,0.022222,0.001641
9511087,9511087,,6,9,15,6,9,15,0.000003,0.000014,0,5979,4,0.00002,4,0.428571,0.539352,16397.336363,0.095238,0.001462
9510202,9510202,,12,7,19,12,7,19,0.000153,0.00034,0,8317,25,0.000021,13,0.175207,0.213298,9992.59688,0.076023,0.003161
9704164,9704164,,3,8,11,3,8,11,0.000015,0.000034,0,8315,5,0.000014,7,0.238963,0.261835,15.0021,0.236364,0.000734
9509174,9509174,,7,3,10,7,3,10,0.000137,0.000006,0,4426,0,0.000028,3,0.529412,0.62963,1286.605524,0.144444,0.001819
9708126,9708126,,6,6,12,6,6,12,0.000075,0.000215,0,14944,5,0.000027,12,0.182464,0.201126,11305.533622,0.05303,0.00142
9410003,9410003,,5,4,9,5,4,9,0.000215,0.000013,0,15388,5,0.000014,2,0.625,0.7,21.601623,0.208333,0.001304
11241,11241,,28,39,67,28,39,67,0.001229,0.006034,0,15838,30,0.000037,16,0.217001,0.2442,198359.147337,0.082768,0.009551
11242,11242,,7,7,14,7,7,14,0.000467,0.006573,0,15849,2,0.000013,13,0.216419,0.240377,3339.019591,0.164835,0.001841
11243,11243,,3,12,15,3,12,15,0.000033,0.002751,0,16873,6,0.000012,13,0.168997,0.196288,755.512061,0.157143,0.000664
11244,11244,,15,30,45,15,30,45,0.00096,0.004189,0,15483,30,0.000019,13,0.204045,0.226753,14669.471301,0.142424,0.005105
11245,11245,,4,36,40,4,36,40,0.000732,0.006352,0,16047,0,0.000011,18,0.192364,0.22289,75.479041,0.303846,0.001082
11246,11246,,0,2,2,0,2,2,0,0.000004,0,16874,23,0.00001,12,0.179466,0.20535,0,0,0
11247,11247,,11,25,36,11,25,36,0.00104,0.004617,0,15891,2,0.000013,15,0.205849,0.23419,13955.94039,0.147619,0.0032
11248,11248,,1,16,17,1,16,17,0.000213,0.00008,0,16348,5,0.00001,5,0.45098,0.596739,199.67524,0.088235,0.000344
9306032,9306032,,1,1,2,1,1,2,0.000001,0,0,16347,5,0.00001,1,1,1,33,0,0.000227
9304084,9304084,,1,0,1,1,0,1,0,0,0,16346,5,0.000019,0,0,0,0,0,0.000226
11249,11249,,2,11,13,2,11,13,0,0.000016,0,16875,23,0.000014,19,0.143748,0.160156,1811.024318,0.282051,0.000438
11250,11250,,0,1,1,0,1,1,0,0,0,16876,5,0.00001,18,0.118562,0.139042,0,0,0
11251,11251,,12,43,55,12,43,55,0.001009,0.003752,0,16261,0,0.000014,16,0.206473,0.23852,85184.194828,0.073737,0.004679
9711051,9711051,,1,5,6,1,5,6,0.000044,0.003036,0,16260,2,0.00001,12,0.204638,0.231968,15.191674,0.3,0.000325
9803162,9803162,,3,36,39,3,36,39,0.000081,0.004326,0,16259,13,0.000011,14,0.201095,0.241794,2192.340791,0.142375,0.00077
9912213,9912213,,1,6,7,1,6,7,0.000044,0.002747,0,16258,2,0.00001,13,0.188831,0.207923,105.520657,0.119048,0.000325
11252,11252,,5,17,22,5,17,22,0.000097,0.003172,0,16877,30,0.000013,14,0.196956,0.218221,9243.719525,0.209957,0.001156
9605209,9605209,,5,8,13,5,8,13,0.000041,0.000041,0,5639,5,0.000015,7,0.263672,0.313254,41257.39296,0.128205,0.001161
11253,11253,,1,57,58,1,57,58,0.000014,0.00412,0,16880,4,0.00001,11,0.207275,0.238639,887.090866,0.137326,0.000226
9712218,9712218,,2,16,18,2,16,18,0.000076,0.002605,0,16879,4,0.000011,13,0.181732,0.219801,60.381105,0.22549,0.000452
9812145,9812145,,2,4,6,2,4,6,0.000065,0.000306,0,16878,4,0.00001,13,0.162135,0.183483,1.338821,0.266667,0.000445
9603075,9603075,,1,20,21,1,20,21,0.000041,0.003215,0,6072,4,0.00001,14,0.197733,0.242038,9763.049495,0.321429,0.000293
9612161,9612161,,3,0,3,3,0,3,0.000041,0,0,6070,9,0.000015,0,0,0,0,0.166667,0.000744
9712232,9712232,,3,9,12,3,9,12,0.000041,0.000027,0,6069,4,0.000016,9,0.199194,0.234648,1424.122648,0.090909,0.000737
9801039,9801039,,3,21,24,3,21,24,0.000105,0.002882,0,6068,4,0.000012,12,0.189766,0.224392,22548.991634,0.13587,0.000797
9801112,9801112,,1,4,5,1,4,5,0.000041,0.000556,0,6060,4,0.00001,12,0.20666,0.239715,1.100822,0.35,0.000293
9801179,9801179,,1,7,8,1,7,8,0.000041,0.000247,0,6058,4,0.00001,4,0.44086,0.51626,52.366201,0.071429,0.000293
11255,11255,,10,15,25,10,15,25,0.000808,0.002928,0,15420,8,0.00002,13,0.185191,0.204913,5083.251643,0.068333,0.003441
11257,11257,,9,17,26,9,17,26,0.000123,0.000547,0,15498,52,0.000015,16,0.190199,0.212915,9211.475878,0.189231,0.003165
11258,11258,,12,12,24,12,12,24,0.000032,0.000041,0,16881,5,0.000025,13,0.177899,0.192654,51539.462246,0.233696,0.003024
11259,11259,,3,8,11,3,8,11,0.000106,0.000523,0,16209,30,0.000011,15,0.175624,0.190446,1776.868607,0.227273,0.000703
11260,11260,,2,6,8,2,6,8,0.000015,0.0011,0,16081,4,0.000012,14,0.168975,0.192403,2516.217527,0.053571,0.000458
9408116,9408116,,4,7,11,4,7,11,0.000042,0.000388,0,6054,4,0.00002,4,0.438202,0.519231,938.785558,0.072727,0.001023
11261,11261,,4,20,24,4,20,24,0.000136,0.004218,0,13062,30,0.000015,15,0.204654,0.22819,8773.073187,0.146739,0.001132
11262,11262,,15,6,21,15,6,21,0.000304,0.000162,0,16025,25,0.000028,13,0.192149,0.212058,34295.893791,0.059524,0.003645
11263,11263,,1,3,4,1,3,4,0.000002,0.000025,0,16883,23,0.000011,5,0.293617,0.353623,39.45,0.083333,0.000219
9412019,9412019,,3,1,4,3,1,4,0.000001,0,0,16882,23,0.00002,1,1,1,0,0.333333,0.00067
11264,11264,,12,19,31,12,19,31,0.000387,0.003251,0,16254,2,0.000019,15,0.209068,0.235403,9919.073144,0.174194,0.003428
11265,11265,,1,1,2,1,1,2,0,0,0,16884,23,0.000015,2,0.571429,0.625,0,0.5,0.000226
11266,11266,,2,3,5,2,3,5,0.000351,0.000093,0,16885,1,0.00001,14,0.166402,0.183731,203.9149,0.15,0.000458
9405093,9405093,,8,9,17,8,9,17,0.000003,0.000078,0,1475,22,0.000022,3,0.606061,0.708333,13790.881888,0.154412,0.002165
9406111,9406111,,3,7,10,3,7,10,0.000001,0.000003,0,2780,22,0.000015,4,0.430556,0.526882,1516.631914,0.366667,0.000839
11268,11268,,2,3,5,2,3,5,0.000048,0.001528,0,16886,30,0.000011,13,0.187002,0.20377,2.72901,0.45,0.000445
11269,11269,,34,32,66,34,32,66,0.00291,0.002563,0,15576,0,0.000023,16,0.207846,0.235458,93035.962873,0.139394,0.013005
11270,11270,,1,4,5,1,4,5,0.000029,0.000459,0,16887,1,0.00001,12,0.186966,0.20318,26.751299,0.2,0.000239
9701049,9701049,,1,0,1,1,0,1,0.000003,0,0,7868,13,0.000015,0,0,0,0,0,0.000265
11271,11271,,2,23,25,2,23,25,0.000164,0.005021,0,16888,2,0.00001,14,0.217111,0.244223,3836.966365,0.11,0.000512
11272,11272,,1,8,9,1,8,9,0.000184,0.001446,0,15914,2,0.00001,13,0.191453,0.209453,36369.17488,0.166667,0.000353
9706036,9706036,,1,2,3,1,2,3,0.000017,0.000009,0,15913,26,0.000011,7,0.217848,0.269392,510.382009,0.166667,0.000228
9910157,9910157,,2,15,17,2,15,17,0.000017,0.001472,0,15912,23,0.000014,13,0.192571,0.212252,35207.621043,0.058824,0.000447
9407123,9407123,,3,2,5,3,2,5,0.000002,0.00006,0,4433,26,0.000018,6,0.218605,0.273404,4.367022,0.2,0.000835
9906037,9906037,,2,5,7,2,5,7,0.000017,0,0,15910,26,0.000012,8,0.2173,0.294776,11346.984647,0.166667,0.000451
11273,11273,,1,10,11,1,10,11,0.000022,0.000041,0,16889,5,0.000011,13,0.176099,0.190329,37.869935,0.336364,0.00028
11275,11275,,1,2,3,1,2,3,0,0,0,16890,23,0.000012,16,0.123385,0.132369,192.988481,0.166667,0.000219
11276,11276,,9,12,21,9,12,21,0.000397,0.000042,0,16891,17,0.000018,12,0.164727,0.185155,4880.314159,0.192857,0.002198
103186,103186,,10,8,18,10,8,18,0.000574,0.000037,0,16892,17,0.000017,12,0.161758,0.179324,1943.690681,0.19281,0.002363
105267,105267,,8,15,23,8,15,23,0.000391,0.000124,0,16893,17,0.000014,12,0.166305,0.189254,1113.746251,0.187747,0.001846
106082,106082,,5,28,33,5,28,33,0.000389,0.000151,0,16894,17,0.000013,14,0.152636,0.171378,15175.05745,0.108902,0.001148
9303042,9303042,,4,1,5,4,1,5,0.000001,0,0,4173,5,0.000023,1,1,1,0,0.2,0.001027
9307063,9307063,,8,4,12,8,4,12,0.000006,0.000012,0,1552,4,0.000027,2,0.7,0.785714,7259.43561,0.159091,0.002091
9404174,9404174,,8,7,15,8,7,15,0.000001,0.000001,0,3003,17,0.000019,5,0.277193,0.342616,10977.536438,0.185714,0.001855
11278,11278,,10,2,12,10,2,12,0.000614,0.000039,0,15541,25,0.000039,18,0.161891,0.172848,1485.134161,0.212121,0.002693
11280,11280,,0,2,2,0,2,2,0,0,0,16901,28,0.00001,3,0.5,0.583333,0,0,0
9706084,9706084,,2,1,3,2,1,3,0,0.000001,0,16900,20,0.000016,1,1,1,1,0.166667,0.000438
9910024,9910024,,1,3,4,1,3,4,0,0,0,16899,28,0.000014,2,0.714286,0.8,5,0,0.000219
9810241,9810241,,2,1,3,2,1,3,0,0,0,16898,28,0.000015,1,1,1,3,0,0.000445
9812146,9812146,,1,1,2,1,1,2,0,0,0,16896,28,0.000014,1,1,1,2,0,0.000226
9812150,9812150,,1,0,1,1,0,1,0,0,0,16895,28,0.000014,0,0,0,0,0,0.000226
11281,11281,,6,32,38,6,32,38,0.000229,0.004242,0,16252,0,0.000012,13,0.227184,0.25824,34476.293727,0.112376,0.001745
9911019,9911019,,2,18,20,2,18,20,0.000439,0.001386,0,16251,0,0.00001,12,0.20382,0.22989,242.549486,0.134211,0.000493
11282,11282,,19,54,73,19,54,73,0.00217,0.013628,0,15907,30,0.000016,12,0.235432,0.268027,174101.26212,0.109209,0.006683
11283,11283,,9,82,91,9,82,91,0.00084,0.018219,0,15904,30,0.000012,12,0.242845,0.278895,39980.893263,0.078999,0.002453
11284,11284,,4,6,10,4,6,10,0.000146,0.000843,0,16902,8,0.000012,12,0.190606,0.207729,339.129443,0.188889,0.000929
11285,11285,,0,24,24,0,24,24,0,0.001491,0,16903,3,0.00001,13,0.1961,0.223736,0,0.230072,0
11286,11286,,0,13,13,0,13,13,0,0.008348,0,16904,13,0.00001,15,0.205957,0.229623,0,0.378205,0
11287,11287,,2,5,7,2,5,7,0.000029,0.001449,0,16905,2,0.000012,16,0.162952,0.186499,1542.824322,0.095238,0.000549
11289,11289,,16,12,28,16,12,28,0.000406,0.000912,0,16906,0,0.000017,18,0.189252,0.214108,2839.216141,0.181217,0.004889
11290,11290,,14,17,31,14,17,31,0.001245,0.002539,0,15655,25,0.000015,16,0.202742,0.227858,16523.469052,0.17957,0.003716
11291,11291,,0,1,1,0,1,1,0,0.000004,0,16907,30,0.00001,1,1,1,0,0,0
11292,11292,,1,30,31,1,30,31,0.000105,0.015451,0,16908,1,0.00001,14,0.202615,0.235117,681.298276,0.096774,0.00024
9804167,9804167,,4,7,11,4,7,11,0.00059,0.000447,0,6641,28,0.000012,14,0.167933,0.190102,6509.50482,0.081818,0.001081
11293,11293,,0,3,3,0,3,3,0,0,0,16911,28,0.00001,2,0.666667,0.75,0,0,0
9611001,9611001,,5,3,8,5,3,8,0,0,0,16910,28,0.00002,2,0.8,0.875,11.5,0.125,0.001129
9611002,9611002,,5,1,6,5,1,6,0,0,0,16909,28,0.00002,2,0.666667,0.75,3.5,0.066667,0.001129
11294,11294,,1,16,17,1,16,17,0,0.001268,0,16912,0,0.000012,17,0.181815,0.203817,19841.842685,0.147059,0.000259
12001,12001,,0,1,1,0,1,1,0,0,0,16913,5,0.00001,1,1,1,0,0,0
12002,12002,,2,6,8,2,6,8,0,0.000023,0,16914,6,0.000012,15,0.159495,0.176669,6591.979985,0.214286,0.000464
12003,12003,,4,4,8,4,4,8,0.000203,0.000014,0,16915,23,0.000014,19,0.127702,0.146381,2737.304593,0.214286,0.000932
12004,12004,,0,5,5,0,5,5,0,0.000001,0,16916,23,0.00001,19,0.135268,0.147256,0,0.25,0
12005,12005,,0,4,4,0,4,4,0,0.00111,0,16917,4,0.00001,16,0.162418,0.187878,0,0.083333,0
12006,12006,,0,4,4,0,4,4,0,0.00579,0,16918,41,0.00001,13,0.179361,0.196842,0,0.416667,0
12007,12007,,11,22,33,11,22,33,0.000987,0.001277,0,15500,3,0.000015,14,0.202123,0.225812,55147.339144,0.100379,0.003654
12008,12008,,0,14,14,0,14,14,0,0.000004,0,16919,6,0.00001,14,0.151692,0.165293,0,0.153846,0
12009,12009,,30,36,66,30,36,66,0.001354,0.003846,0,15835,30,0.000024,14,0.208622,0.232239,26977.164207,0.167133,0.010759
12010,12010,,5,11,16,5,11,16,0.000143,0.002607,0,16920,13,0.000013,14,0.182592,0.207054,503.307264,0.158333,0.001292
9406150,9406150,,4,3,7,4,3,7,0.000058,0.000461,0,578,13,0.000029,5,0.318966,0.372222,168.579993,0.261905,0.001343
12011,12011,,52,22,74,52,22,74,0.00589,0.002083,0,15598,1,0.000046,13,0.204487,0.228569,68041.144321,0.077749,0.018896
12012,12012,,0,10,10,0,10,10,0,0.000011,0,16921,26,0.00001,15,0.150635,0.161824,0,0.222222,0
9411008,9411008,,3,1,4,3,1,4,0.000001,0.000009,0,6257,26,0.000027,2,0.571429,0.625,0,0.333333,0.000854
12013,12013,,9,13,22,9,13,22,0.000207,0.001214,0,15553,25,0.000016,15,0.186669,0.206251,2865.089522,0.238095,0.002243
12014,12014,,7,6,13,7,6,13,0.000014,0.000982,0,15542,25,0.000035,18,0.187513,0.205122,12951.160347,0.198718,0.001949
12015,12015,,1,5,6,1,5,6,0.000163,0.000958,0,16923,25,0.000011,18,0.180248,0.198694,97.051614,0.1,0.000245
9911069,9911069,,1,3,4,1,3,4,0.000011,0.000469,0,16922,1,0.000012,15,0.146431,0.158967,103.078734,0.166667,0.000226
12016,12016,,6,6,12,6,6,12,0.000095,0.000067,0,16924,2,0.000015,13,0.185734,0.202326,3599.497401,0.136364,0.001577
12017,12017,,1,9,10,1,9,10,0.000001,0.000307,0,16310,5,0.000011,14,0.169704,0.188233,1205.259047,0.122222,0.000239
12018,12018,,4,9,13,4,9,13,0.000138,0.001887,0,16925,30,0.000011,14,0.190645,0.21001,157.865899,0.288462,0.000963
12019,12019,,0,3,3,0,3,3,0,0.000016,0,16926,5,0.00001,15,0.152448,0.166996,0,0.5,0
12020,12020,,0,3,3,0,3,3,0,0.000462,0,16927,13,0.00001,12,0.178283,0.199116,0,0.166667,0
12021,12021,,3,7,10,3,7,10,0.000131,0.00009,0,16930,1,0.000013,12,0.185761,0.201783,5860.109007,0.133333,0.000723
9911100,9911100,,6,11,17,6,11,17,0.000705,0.011408,0,16929,1,0.000016,11,0.197307,0.216573,58919.91654,0.136029,0.001473
9812251,9812251,,5,9,14,5,9,14,0.000268,0.000005,0,13934,6,0.00002,12,0.168776,0.213357,11480.892771,0.10989,0.001229
9911027,9911027,,1,6,7,1,6,7,0.000134,0.006065,0,16928,1,0.000011,15,0.168951,0.190048,408.332009,0.095238,0.00026
12022,12022,,0,9,9,0,9,9,0,0.00007,0,16931,22,0.00001,6,0.288221,0.36,0,0.333333,0
12023,12023,,18,21,39,18,21,39,0.000062,0.001708,0,16934,22,0.000028,15,0.171342,0.190939,77398.440574,0.112686,0.00454
9609193,9609193,,4,3,7,4,3,7,0.00002,0,0,16933,22,0.000019,4,0.45,0.592593,438.649145,0.142857,0.001035
9511138,9511138,,12,1,13,12,1,13,0.000004,0,0,13415,22,0.000073,3,0.444444,0.541667,284.813919,0.160256,0.003135
9603103,9603103,,3,3,6,3,3,6,0,0,0,16932,22,0.000018,4,0.444444,0.604167,57.849145,0.2,0.000692
12024,12024,,14,68,82,14,68,82,0.000497,0.004614,0,15842,30,0.000017,17,0.223801,0.253608,166840.21028,0.131587,0.003883
12025,12025,,19,20,39,19,20,39,0.003831,0.003778,0,15992,1,0.000018,12,0.226161,0.256086,75915.836733,0.107287,0.005529
12026,12026,,3,21,24,3,21,24,0.000387,0.016692,0,16935,41,0.000011,13,0.188971,0.2126,1027.463219,0.306159,0.000732
12027,12027,,0,2,2,0,2,2,0,0.000001,0,16936,26,0.00001,2,0.75,0.833333,0,0.5,0
12028,12028,,5,7,12,5,7,12,0.00001,0.001791,0,16937,15,0.000021,13,0.195022,0.211948,55621.883973,0.075758,0.001228
12238,12238,,33,3,36,33,3,36,0.000105,0.000789,0,16939,15,0.000076,13,0.172403,0.189063,35972.193,0.111905,0.008671
12216,12216,,7,6,13,7,6,13,0.000191,0.002756,0,16938,9,0.000038,12,0.201318,0.22294,31833.208831,0.115385,0.001867
12029,12029,,2,30,32,2,30,32,0.000119,0.006111,0,15579,25,0.000011,13,0.203029,0.228121,54824.27711,0.196573,0.000862
12030,12030,,1,29,30,1,29,30,0.000608,0.011349,0,16940,1,0.00001,13,0.204002,0.233959,133.162208,0.12069,0.000245
12031,12031,,4,12,16,4,12,16,0,0.000014,0,16941,5,0.000014,15,0.139725,0.152984,7455.165604,0.1125,0.000916
12032,12032,,7,11,18,7,11,18,0.000507,0.000398,0,15847,13,0.000013,15,0.181229,0.206794,10658.439054,0.183007,0.001797
9910020,9910020,,3,18,21,3,18,21,0.000057,0.000785,0,15846,13,0.000013,15,0.196096,0.237109,17395.630028,0.138095,0.000749
9702039,9702039,,3,11,14,3,11,14,0.000055,0.000979,0,12011,13,0.000012,11,0.205387,0.240394,6194.237777,0.153846,0.000719
9807012,9807012,,4,17,21,4,17,21,0.000024,0.000272,0,15845,13,0.000015,11,0.201402,0.236113,1242.176474,0.078571,0.000944
12033,12033,,12,34,46,12,34,46,0.001153,0.022185,0,12470,25,0.000016,18,0.19119,0.224202,22594.692037,0.099034,0.003337
12034,12034,,24,25,49,24,25,49,0.003537,0.018582,0,15606,1,0.00002,13,0.205029,0.231647,8601.731891,0.135629,0.006871
12169,12169,,1,37,38,1,37,38,0.000083,0.00467,0,16942,3,0.00001,11,0.22457,0.251381,1754.432703,0.16074,0.000226
12042,12042,,10,58,68,10,58,68,0.000729,0.009257,0,15630,25,0.000014,12,0.234597,0.266973,53799.691821,0.06014,0.002634
12193,12193,,7,33,40,7,33,40,0.000833,0.008862,0,16279,1,0.000012,14,0.217455,0.244744,4580.538195,0.151923,0.002438
12036,12036,,2,1,3,2,1,3,0.000047,0,0,16943,25,0.000011,15,0.14405,0.154308,121.186316,0,0.000438
12037,12037,,22,19,41,22,19,41,0.00191,0.010856,0,15949,3,0.000032,14,0.198147,0.222756,119070.397081,0.05,0.006968
12039,12039,,4,3,7,4,3,7,0,0.000001,0,16944,22,0.000015,20,0.104181,0.118776,0.65,0.404762,0.001084
12040,12040,,0,1,1,0,1,1,0,0,0,16945,15,0.00001,1,1,1,0,0,0
12041,12041,,56,18,74,56,18,74,0.00302,0.000974,0,15496,4,0.000037,17,0.200004,0.224914,36927.779076,0.112736,0.019247
12043,12043,,4,9,13,4,9,13,0.000028,0.00001,0,16946,20,0.000013,4,0.507937,0.601562,1956.876823,0.128205,0.000932
12045,12045,,0,9,9,0,9,9,0,0.000693,0,16947,52,0.00001,15,0.196911,0.219408,0,0.194444,0
12046,12046,,12,5,17,12,5,17,0.000943,0.000385,0,15477,3,0.000017,14,0.183266,0.199202,41172.157556,0.238971,0.003811
12047,12047,,0,1,1,0,1,1,0,0.000036,0,16948,25,0.00001,17,0.169948,0.182252,0,0,0
12048,12048,,7,6,13,7,6,13,0.000217,0.000036,0,16127,5,0.00002,15,0.147692,0.164286,7603.765682,0.25641,0.001723
12049,12049,,7,33,40,7,33,40,0.001068,0.005658,0,16048,0,0.000012,18,0.191711,0.220042,9722.329244,0.282051,0.001809
12050,12050,,5,32,37,5,32,37,0.000693,0.017239,0,16949,52,0.000011,16,0.211197,0.24017,7713.776307,0.145646,0.001291
12051,12051,,3,21,24,3,21,24,0.000266,0.004217,0,15848,2,0.000011,16,0.176984,0.207472,22191.721495,0.164855,0.000853
9712055,9712055,,1,11,12,1,11,12,0.00011,0.002427,0,5587,2,0.000011,16,0.171641,0.197947,45878.700921,0.280303,0.000563
12052,12052,,59,11,70,59,11,70,0.009013,0.007877,0,15402,8,0.000061,13,0.177097,0.195269,9924.426936,0.124845,0.024342
12053,12053,,3,28,31,3,28,31,0.000009,0.000356,0,15648,5,0.000012,14,0.186508,0.20864,33764.371446,0.133333,0.000694
9505104,9505104,,3,4,7,3,4,7,0.000002,0.000007,0,4251,5,0.000014,3,0.526316,0.65,1626.808955,0.071429,0.000813
12055,12055,,2,1,3,2,1,3,0.000048,0.000009,0,16950,13,0.000011,4,0.35,0.440476,5.211111,0,0.000445
12056,12056,,6,8,14,6,8,14,0.000093,0.000865,0,16032,30,0.000018,14,0.181553,0.199334,13433.091292,0.076923,0.001437
9405076,9405076,,4,1,5,4,1,5,0.000035,0,0,16031,30,0.00002,1,1,1,2400,0.05,0.001049
9310027,9310027,,2,0,2,2,0,2,0.000009,0,0,16030,30,0.000029,0,0,0,0,0,0.00048
12057,12057,,5,7,12,5,7,12,0.000029,0.000031,0,16951,22,0.00002,16,0.163093,0.17527,31769.515401,0.174242,0.001116
12058,12058,,1,21,22,1,21,22,0,0.000199,0,16962,4,0.000011,17,0.190155,0.21845,4793.260905,0.134199,0.000245
9904167,9904167,,2,7,9,2,7,9,0.000039,0.000012,0,16961,22,0.000011,14,0.149885,0.166112,326.090916,0.166667,0.000445
9602107,9602107,,7,12,19,7,12,19,0.000003,0.000015,0,16956,22,0.000017,4,0.401163,0.490338,852.20845,0.073099,0.001647
9701097,9701097,,1,11,12,1,11,12,0,0.000012,0,16960,22,0.000011,17,0.156935,0.189651,431.826458,0.106061,0.000232
12059,12059,,2,21,23,2,21,23,0.000014,0.002549,0,16963,30,0.000011,14,0.204637,0.232159,7771.773376,0.146245,0.000458
9307159,9307159,,2,2,4,2,2,4,0.00003,0.000002,0,2966,23,0.000047,1,1,1,49.585714,0,0.00052
12060,12060,,19,12,31,19,12,31,0.000024,0.000075,0,15902,22,0.000063,16,0.161174,0.173535,169210.139702,0.053763,0.004653
9608128,9608128,,1,3,4,1,3,4,0.000001,0.000035,0,15901,5,0.000015,3,0.6,0.722222,0,0.416667,0.000349
9405147,9405147,,5,0,5,5,0,5,0,0,0,15065,22,0.000029,0,0,0,0,0.3,0.001279
9612156,9612156,,2,2,4,2,2,4,0,0,0,15066,28,0.000018,2,0.75,0.833333,0.666667,0.333333,0.000515
9703130,9703130,,1,1,2,1,1,2,0,0,0,15064,23,0.000018,2,0.666667,0.75,4680,0,0.000276
12061,12061,,5,23,28,5,23,28,0.000293,0.002333,0,16964,30,0.000015,13,0.198427,0.219755,23651.546271,0.171958,0.001906
101071,101071,,13,17,30,13,17,30,0.000297,0.002572,0,16965,30,0.000021,13,0.201793,0.222901,11250.445832,0.247126,0.003308
12062,12062,,2,77,79,2,77,79,0.000051,0.001233,0,16086,5,0.000019,15,0.211919,0.242915,161704.796495,0.003895,0.000462
2095,2095,,1,0,1,1,0,1,0.000014,0,0,16085,5,0.00001,0,0,0,0,0,0.000232
9312021,9312021,,3,5,8,3,5,8,0.000031,0.000219,0,1014,5,0.000013,1,1,1,135.279554,0.053571,0.000773
9406037,9406037,,1,0,1,1,0,1,0.000014,0,0,16080,5,0.00001,0,0,0,0,0,0.000232
9407139,9407139,,2,0,2,2,0,2,0.000015,0,0,16079,28,0.000011,0,0,0,0,0,0.000458
9504032,9504032,,2,8,10,2,8,10,0.000041,0.002641,0,16078,4,0.000011,7,0.290107,0.3535,2036.078249,0.111111,0.000452
9610027,9610027,,2,0,2,2,0,2,0.000014,0,0,16076,5,0.000019,0,0,0,0,0,0.000452
9705230,9705230,,3,3,6,3,3,6,0.000015,0.000001,0,13311,20,0.000012,3,0.55,0.621212,1463.527714,0.033333,0.000677
9706098,9706098,,1,4,5,1,4,5,0.000014,0.000003,0,16075,15,0.00001,1,1,1,1728.628001,0.1,0.000232
9807129,9807129,,2,2,4,2,2,4,0.000015,0.000184,0,16074,0,0.000011,7,0.248957,0.275306,5196.611432,0,0.000452
9808165,9808165,,1,1,2,1,1,2,0.000014,0,0,16073,23,0.00001,13,0.14762,0.166482,9720.374964,0,0.000232
9812123,9812123,,1,0,1,1,0,1,0.000014,0,0,16065,5,0.00001,0,0,0,0,0,0.000232
9902006,9902006,,1,0,1,1,0,1,0.000014,0,0,16064,5,0.00001,0,0,0,0,0,0.000232
9904079,9904079,,2,0,2,2,0,2,0.000014,0,0,16062,5,0.000019,0,0,0,0,0.5,0.000458
9904080,9904080,,1,1,2,1,1,2,0.000014,0,0,16063,5,0.00001,1,1,1,0,0.5,0.000232
9904178,9904178,,2,1,3,2,1,3,0.000015,0.000002,0,16061,4,0.000013,1,1,1,1607,0.166667,0.000452
9905113,9905113,,1,4,5,1,4,5,0.000014,0.000279,0,16059,5,0.00001,8,0.195804,0.243724,3102.91286,0.1,0.000232
9409199,9409199,,4,0,4,4,0,4,0.000053,0,0,16077,0,0.000012,0,0,0,0,0.083333,0.001043
9506188,9506188,,5,2,7,5,2,7,0,0,0,3106,20,0.000048,1,1,1,40.469301,0.190476,0.001241
9708165,9708165,,1,6,7,1,6,7,0,0.000082,0,16072,23,0.000019,12,0.173051,0.20599,9405.374964,0.047619,0.000226
9306120,9306120,,8,0,8,8,0,8,0.000163,0,0,16060,4,0.000071,0,0,0,0,0.053571,0.001832
9904023,9904023,,2,4,6,2,4,6,0.000003,0.000284,0,16058,21,0.000013,4,0.366197,0.445513,1474.730266,0.133333,0.000445
12064,12064,,1,5,6,1,5,6,0.000014,0.000997,0,16966,25,0.00001,15,0.187402,0.206574,0,0.466667,0.000219
12065,12065,,12,25,37,12,25,37,0.001632,0.009977,0,15815,30,0.000015,15,0.206799,0.231575,25532.119974,0.216967,0.005674
12066,12066,,0,3,3,0,3,3,0,0.000007,0,16967,15,0.00001,14,0.148329,0.158006,0,0.333333,0
12067,12067,,4,19,23,4,19,23,0.000091,0.000744,0,16968,2,0.000011,16,0.16244,0.190048,36707.897909,0.132411,0.000924
9712231,9712231,,3,15,18,3,15,18,0.000024,0.000954,0,8851,2,0.000012,11,0.198391,0.225061,294.652585,0.300654,0.000766
12068,12068,,4,15,19,4,15,19,0.00011,0.001778,0,16969,4,0.000013,14,0.200087,0.224136,4800.07365,0.093567,0.001089
12069,12069,,8,7,15,8,7,15,0.000002,0.000004,0,16328,20,0.000015,16,0.13145,0.144612,17.102327,0.4,0.002093
9706062,9706062,,9,9,18,9,9,18,0.000003,0.000005,0,9790,20,0.000017,8,0.208578,0.254973,1754.304931,0.166667,0.002516
9412181,9412181,,4,2,6,4,2,6,0,0.000001,0,5204,20,0.000017,1,1,1,4.932724,0.133333,0.001062
9504014,9504014,,2,7,9,2,7,9,0,0.000201,0,9788,5,0.000015,4,0.415584,0.507812,7280.617637,0.069444,0.000605
9607093,9607093,,1,2,3,1,2,3,0,0,0,9787,6,0.000012,7,0.234332,0.266805,44277.418368,0,0.000327
12071,12071,,15,16,31,15,16,31,0.00143,0.000866,0,15864,0,0.000017,17,0.190138,0.214226,37613.363217,0.13871,0.004017
12072,12072,,73,20,93,73,20,93,0.004377,0.006893,0,15950,3,0.000062,15,0.19408,0.219004,80282.616814,0.103904,0.025945
12073,12073,,10,21,31,10,21,31,0.000338,0.001854,0,15591,25,0.000014,16,0.184795,0.206587,5587.147069,0.237634,0.002647
12074,12074,,8,9,17,8,9,17,0.001089,0.001849,0,15638,25,0.000015,13,0.187893,0.206348,1344.283533,0.147059,0.002274
12076,12076,,6,37,43,6,37,43,0.001343,0.022149,0,16970,1,0.000012,16,0.214062,0.244322,2561.969327,0.079181,0.001477
9503175,9503175,,1,39,40,1,39,40,0.000023,0.001433,0,3371,13,0.00001,8,0.282051,0.380806,47257.401587,0.080769,0.000328
9804112,9804112,,1,8,9,1,8,9,0.000014,0.000084,0,15777,10,0.000011,13,0.17821,0.200268,31914.332387,0.125,0.000292
9608107,9608107,,3,13,16,3,13,16,0.000001,0.000002,0,15773,9,0.000013,13,0.175473,0.211936,23040.586047,0.1125,0.000678
9704119,9704119,,1,8,9,1,8,9,0.000001,0.000001,0,15776,9,0.000011,14,0.153884,0.184674,7006.387883,0.208333,0.000227
12078,12078,,1,20,21,1,20,21,0.000272,0.002789,0,16971,52,0.00001,17,0.19674,0.226203,0,0.278571,0.000246
12079,12079,,6,38,44,6,38,44,0.000226,0.004822,0,15494,52,0.000012,17,0.194707,0.224896,6952.541225,0.150634,0.001799
12080,12080,,17,45,62,17,45,62,0.000608,0.005358,0,15746,3,0.000017,13,0.199039,0.222949,57503.711284,0.158117,0.007089
9609173,9609173,,4,6,10,4,6,10,0.000542,0.005647,0,4125,2,0.000012,11,0.198044,0.228401,342.548646,0.233333,0.001059
12081,12081,,38,52,90,38,52,90,0.002233,0.011487,0,15517,3,0.000026,14,0.203156,0.230872,43587.735143,0.137328,0.015424
12082,12082,,2,15,17,2,15,17,0.000449,0.000335,0,16972,25,0.00001,17,0.185814,0.207557,302.870046,0.095588,0.000472
12083,12083,,1,6,7,1,6,7,0,0.000004,0,16976,26,0.000023,14,0.163036,0.178527,8568.007408,0.095238,0.000226
9908069,9908069,,1,2,3,1,2,3,0,0,0,16975,26,0.000013,18,0.125942,0.135091,70,0.166667,0.000226
9812228,9812228,,1,2,3,1,2,3,0,0.000001,0,16974,26,0.000016,3,0.466667,0.571429,67,0,0.000226
12084,12084,,2,7,9,2,7,9,0,0.000003,0,16977,9,0.000013,11,0.163912,0.185641,877.133333,0.263889,0.000451
9503068,9503068,,3,1,4,3,1,4,0,0,0,9153,9,0.00002,3,0.5,0.611111,3.333333,0.166667,0.000719
9601062,9601062,,3,3,6,3,3,6,0.000066,0.000005,0,7578,26,0.000016,3,0.5625,0.648148,979.548639,0.3,0.000761
9604150,9604150,,2,7,9,2,7,9,0.000056,0.000833,0,7579,26,0.000014,9,0.227593,0.269447,159387.185117,0.152778,0.000528
9607176,9607176,,2,5,7,2,5,7,0.000056,0.000007,0,7577,26,0.000014,10,0.175555,0.201117,31041.817726,0.095238,0.000528
9403172,9403172,,4,0,4,4,0,4,0,0,0,9154,9,0.000085,0,0,0,0,0.25,0.000973
9404001,9404001,,4,1,5,4,1,5,0,0,0,9155,9,0.000048,1,1,1,3,0.2,0.000959
9410238,9410238,,3,3,6,3,3,6,0,0,0,9156,9,0.000062,3,0.625,0.766667,296.630674,0.166667,0.000747
9612225,9612225,,3,4,7,3,4,7,0,0,0,9152,28,0.000025,1,1,1,2436.749936,0.095238,0.000713
12085,12085,,8,10,18,8,10,18,0.000013,0.000018,0,16978,23,0.000016,14,0.16574,0.185529,2637.97084,0.176471,0.001893
12086,12086,,0,1,1,0,1,1,0,0.000001,0,16979,23,0.00001,16,0.105963,0.112155,0,0,0
12087,12087,,4,5,9,4,5,9,0.000084,0.000001,0,15474,30,0.000012,19,0.128613,0.142792,17580.331901,0.097222,0.001149
12088,12088,,0,2,2,0,2,2,0,0.004818,0,16980,0,0.00001,14,0.178554,0.197593,0,0,0
12089,12089,,8,5,13,8,5,13,0.00027,0.00124,0,15493,3,0.000015,16,0.18061,0.199993,1384.126512,0.262821,0.003707
12090,12090,,4,7,11,4,7,11,0.000056,0,0,16057,23,0.000014,17,0.141756,0.160547,26492.749783,0.118182,0.00092
9907092,9907092,,5,3,8,5,3,8,0.000006,0.000003,0,16052,23,0.000015,11,0.184335,0.216918,337.398049,0.196429,0.001149
9908188,9908188,,2,18,20,2,18,20,0.000001,0.000014,0,16056,23,0.000013,16,0.160845,0.184068,13636.696005,0.076316,0.000465
9411041,9411041,,3,3,6,3,3,6,0,0.000003,0,5041,22,0.000043,2,0.666667,0.75,9214.616698,0,0.00074
9608143,9608143,,3,2,5,3,2,5,0,0,0,16055,23,0.000014,2,0.75,0.833333,249.421781,0.15,0.000678
9807088,9807088,,2,3,5,2,3,5,0.000001,0,0,16054,30,0.000012,4,0.4,0.505952,1635,0.15,0.000458
12091,12091,,5,30,35,5,30,35,0.001473,0.020898,0,15631,25,0.000011,13,0.220047,0.249585,37749.245158,0.152941,0.001359
12092,12092,,12,25,37,12,25,37,0.000899,0.013952,0,15953,2,0.000015,12,0.199192,0.224148,16500.734396,0.078829,0.002977
9906134,9906134,,8,14,22,8,14,22,0.000496,0.003632,0,11412,2,0.000021,14,0.187131,0.212156,6363.679573,0.158009,0.001924
12093,12093,,15,34,49,15,34,49,0.001277,0.005732,0,15476,30,0.000019,13,0.211363,0.236929,146751.602976,0.107143,0.00647
12094,12094,,0,7,7,0,7,7,0,0.00008,0,16981,0,0.00001,14,0.166787,0.184746,0,0.261905,0
12095,12095,,1,8,9,1,8,9,0,0,0,16982,26,0.00001,5,0.424658,0.541398,22.5,0.166667,0.000219
12096,12096,,0,19,19,0,19,19,0,0.000164,0,16983,0,0.00001,16,0.150941,0.176271,0,0.359649,0
12097,12097,,1,19,20,1,19,20,0.000238,0.015061,0,15440,1,0.00001,13,0.223439,0.254707,10219.827052,0.25,0.000322
12098,12098,,1,10,11,1,10,11,0.000202,0.000181,0,16986,2,0.00001,15,0.143573,0.163952,2037.535965,0.209091,0.000302
9707056,9707056,,3,8,11,3,8,11,0.000421,0.000165,0,16985,2,0.000012,14,0.171627,0.194532,844.225968,0.190909,0.000814
9908084,9908084,,2,6,8,2,6,8,0.000005,0.000251,0,16984,2,0.000012,12,0.18135,0.203856,491.420862,0.196429,0.000452
12099,12099,,0,5,5,0,5,5,0,0.000004,0,16987,9,0.00001,14,0.149936,0.162268,0,0.1,0
12100,12100,,6,21,27,6,21,27,0.000359,0.002524,0,16990,25,0.000013,13,0.194182,0.215763,5956.287065,0.128205,0.001509
9806017,9806017,,3,18,21,3,18,21,0.000118,0.012621,0,16989,13,0.000012,15,0.192625,0.225605,1561.900266,0.07381,0.000796
9809029,9809029,,5,0,5,5,0,5,0.000043,0,0,16988,25,0.000018,0,0,0,0,0.15,0.001198
12101,12101,,2,7,9,2,7,9,0.000044,0.007426,0,16991,13,0.000011,14,0.184034,0.210486,444.389774,0.097222,0.000459
12102,12102,,4,38,42,4,38,42,0.000236,0.005544,0,15642,25,0.000011,17,0.200748,0.22809,2222.338791,0.182346,0.001026
12103,12103,,5,2,7,5,2,7,0,0.000001,0,16992,23,0.000024,15,0.139992,0.152355,0,0.333333,0.001136
9505164,9505164,,3,5,8,3,5,8,0.000104,0.000241,0,1620,0,0.000012,8,0.206022,0.235027,289.485599,0.196429,0.001092
12105,12105,,2,26,28,2,26,28,0.000466,0.003115,0,15718,25,0.000011,16,0.201458,0.22967,6613.50486,0.178571,0.000502
12106,12106,,9,8,17,9,8,17,0.000526,0.001293,0,12480,25,0.000014,15,0.194719,0.216422,5908.089131,0.143382,0.002479
12107,12107,,0,4,4,0,4,4,0,0,0,16994,20,0.00001,9,0.182569,0.215585,0,0.166667,0
9706088,9706088,,1,4,5,1,4,5,0,0,0,16993,20,0.000012,9,0.198072,0.235382,1.833333,0.2,0.000219
12108,12108,,2,8,10,2,8,10,0.000079,0.000555,0,16138,2,0.000011,16,0.189823,0.208043,4704.905414,0.155556,0.000596
103146,103146,,8,14,22,8,14,22,0.000319,0.003551,0,15962,2,0.000016,15,0.212176,0.236365,10592.548494,0.15368,0.002179
12109,12109,,0,1,1,0,1,1,0,0,14,16996,162,0.00001,1,1,1,0,0,0
9907009,9907009,,2,0,2,2,0,2,0,0,14,16995,162,0.000023,0,0,0,0,0,0.000438
12110,12110,,12,17,29,12,17,29,0.000293,0.003133,0,15626,25,0.000017,15,0.194272,0.218794,19349.895428,0.141626,0.003406
12111,12111,,2,26,28,2,26,28,0.000024,0.001627,0,16997,20,0.000011,12,0.211855,0.236457,11701.674709,0.097884,0.000438
9902049,9902049,,5,4,9,5,4,9,0.000413,0.010545,0,15742,8,0.000014,14,0.177067,0.199344,963.235437,0.097222,0.001777
12112,12112,,10,6,16,10,6,16,0.000665,0.000232,0,15823,30,0.000018,13,0.191557,0.207628,3667.676673,0.141667,0.004352
12113,12113,,0,5,5,0,5,5,0,0.000008,0,16998,23,0.00001,12,0.164048,0.19785,0,0.2,0
12114,12114,,4,6,10,4,6,10,0.000226,0.000079,0,16999,28,0.000014,11,0.187576,0.20439,5807.275398,0.111111,0.000949
12115,12115,,0,22,22,0,22,22,0,0.000024,0,17001,23,0.00001,15,0.139607,0.174753,0,0.108225,0
9709092,9709092,,4,1,5,4,1,5,0.000001,0,0,7568,26,0.000014,3,0.5,0.583333,377.614535,0,0.000916
9812096,9812096,,4,11,15,4,11,15,0.000214,0.000047,0,15392,5,0.000013,7,0.239437,0.271549,130.56529,0.12381,0.001008
9912234,9912234,,2,17,19,2,17,19,0.000009,0.000009,0,17000,23,0.00001,14,0.144768,0.171106,2254.818244,0.146199,0.000438
9402095,9402095,,1,9,10,1,9,10,0.000001,0.00005,0,15391,5,0.000011,2,0.68,0.764706,30.695971,0.088889,0.000247
12116,12116,,6,16,22,6,16,22,0.000242,0.000422,0,17002,25,0.000012,16,0.173638,0.191786,1167.26889,0.318182,0.001641
12117,12117,,3,46,49,3,46,49,0.000416,0.011275,0,16267,1,0.000011,15,0.220708,0.258107,5664.478504,0.167942,0.00092
12118,12118,,8,53,61,8,53,61,0.001419,0.011755,0,16218,0,0.000013,13,0.221481,0.257529,38637.464914,0.072131,0.002288
9812215,9812215,,1,0,1,1,0,1,0.000138,0,0,16217,0,0.00001,0,0,0,0,0,0.000278
12119,12119,,0,1,1,0,1,1,0,0,0,17003,5,0.00001,1,1,1,0,0,0
12120,12120,,1,4,5,1,4,5,0,0,0,17005,20,0.000012,13,0.143748,0.152222,343.518389,0.15,0.000219
6187,6187,,3,0,3,3,0,3,0,0,0,17004,20,0.000016,0,0,0,0,0.166667,0.000664
12121,12121,,2,20,22,2,20,22,0.000031,0.00558,0,17009,2,0.000011,15,0.204814,0.232456,19578.455869,0.090909,0.000548
9711024,9711024,,1,9,10,1,9,10,0.000066,0.000013,0,17008,23,0.00001,15,0.147028,0.168281,7139.727818,0.155556,0.000234
9308110,9308110,,2,0,2,2,0,2,0,0,0,4733,23,0.000029,0,0,0,0,0.5,0.0005
9610123,9610123,,1,1,2,1,1,2,0,0,0,17007,23,0.000011,7,0.198618,0.217619,0,0.5,0.000226
9709163,9709163,,1,5,6,1,5,6,0,0.000003,0,17006,23,0.000011,14,0.158102,0.173477,2917.327054,0.133333,0.000226
12122,12122,,0,35,35,0,35,35,0,0.004084,0,17010,4,0.00001,13,0.189365,0.21799,0,0.132773,0
12124,12124,,1,16,17,1,16,17,0.000005,0.001653,0,17011,0,0.000011,15,0.183173,0.205885,368.503603,0.246324,0.000291
12125,12125,,2,8,10,2,8,10,0.000165,0.000906,0,17012,1,0.000011,14,0.182229,0.204638,191.108417,0.288889,0.000493
12126,12126,,0,1,1,0,1,1,0,0,0,17013,15,0.00001,4,0.361111,0.400641,0,0,0
12129,12129,,14,50,64,14,50,64,0.000595,0.022095,0,15670,25,0.000019,14,0.208181,0.237711,23097.724772,0.094246,0.003896
12130,12130,,0,5,5,0,5,5,0,0,0,17014,20,0.00001,13,0.143442,0.151937,0,0,0
12131,12131,,11,39,50,11,39,50,0.000944,0.010807,0,17015,0,0.000013,15,0.205448,0.234935,8786.839007,0.132245,0.002569
12132,12132,,3,7,10,3,7,10,0.000097,0.001104,0,17016,25,0.000011,18,0.18554,0.204866,2.835883,0.388889,0.000848
12133,12133,,7,11,18,7,11,18,0.000273,0.001538,0,17018,4,0.000013,14,0.176364,0.200996,18340.458256,0.326797,0.002126
9906023,9906023,,1,77,78,1,77,78,0.000018,0.005369,0,17017,4,0.000011,13,0.20186,0.243115,15337.067521,0.147852,0.000273
9705166,9705166,,4,70,74,4,70,74,0.000241,0.006358,0,10907,4,0.00001,12,0.211235,0.25948,29526.501404,0.186598,0.000897
12134,12134,,7,6,13,7,6,13,0.000593,0.001785,0,16345,8,0.000016,14,0.221275,0.251015,28892.738488,0.179487,0.001739
9604151,9604151,,6,0,6,6,0,6,0.000401,0,0,16344,8,0.000017,0,0,0,0,0.433333,0.001443
9907001,9907001,,17,2,19,17,2,19,0.00045,0.000034,0,16343,8,0.000053,12,0.173749,0.193543,5354.092578,0.102339,0.004034
12135,12135,,4,33,37,4,33,37,0.000795,0.024588,0,17019,1,0.000012,12,0.21124,0.2391,1563.451357,0.176426,0.001016
12136,12136,,29,12,41,29,12,41,0.001802,0.000631,0,16160,4,0.000032,16,0.199265,0.221193,9443.194453,0.168902,0.014198
12137,12137,,12,59,71,12,59,71,0.000874,0.006294,0,15850,2,0.000014,12,0.231753,0.261852,67028.601031,0.079879,0.003414
12138,12138,,2,4,6,2,4,6,0,0.000009,0,17021,20,0.000016,4,0.458333,0.606061,1256.322957,0.166667,0.000478
9905129,9905129,,1,0,1,1,0,1,0,0,0,17020,20,0.000013,0,0,0,0,0,0.000233
12139,12139,,2,16,18,2,16,18,0.000608,0.00183,0,17022,1,0.00001,16,0.189956,0.216685,96.551905,0.114379,0.000438
12140,12140,,3,7,10,3,7,10,0.000245,0.00005,0,16313,5,0.000011,16,0.136426,0.153006,564.098786,0.222222,0.00081
12141,12141,,21,48,69,21,48,69,0.000495,0.016373,0,15926,30,0.000025,15,0.214565,0.244695,139192.926727,0.061381,0.005312
12142,12142,,2,22,24,2,22,24,0.0001,0.002861,0,15812,30,0.00001,12,0.208678,0.231423,9652.066633,0.217391,0.000507
12143,12143,,59,36,95,59,36,95,0.004103,0.002984,0,15580,25,0.000049,13,0.210391,0.23419,438084.534003,0.056327,0.015975
12144,12144,,2,16,18,2,16,18,0.000002,0.000005,0,17023,17,0.000012,12,0.154796,0.190769,342.404899,0.339869,0.000445
12145,12145,,50,70,120,50,70,120,0.003021,0.009322,0,13061,30,0.000038,14,0.215209,0.249013,163355.599762,0.069188,0.017009
6012,6012,,3,0,3,3,0,3,0.00029,0,0,13056,15,0.000013,0,0,0,0,0,0.001098
12146,12146,,4,12,16,4,12,16,0.000025,0.000039,0,17024,22,0.000012,16,0.162258,0.174402,3.832698,0.341667,0.000903
12147,12147,,1,1,2,1,1,2,0,0,0,17025,26,0.000015,15,0.140199,0.149545,1735.007408,0,0.000259
12148,12148,,46,19,65,46,19,65,0.00737,0.019966,0,15405,25,0.000041,15,0.200321,0.225174,21393.007653,0.09375,0.011991
12149,12149,,10,8,18,10,8,18,0.000472,0.000124,0,16106,9,0.000013,14,0.182417,0.199906,1403.276597,0.330065,0.00271
12150,12150,,8,15,23,8,15,23,0.000204,0.000754,0,15516,3,0.000013,14,0.182376,0.20007,901.618735,0.22332,0.003174
12151,12151,,2,8,10,2,8,10,0.000069,0.000129,0,17026,0,0.000011,12,0.197973,0.22188,870.81509,0.233333,0.000445
12152,12152,,8,18,26,8,18,26,0.000491,0.00381,0,17027,0,0.000012,14,0.191477,0.215505,3190.348682,0.132308,0.002371
12153,12153,,8,12,20,8,12,20,0.001624,0.016456,0,17028,1,0.000013,12,0.19796,0.219906,744.103627,0.268421,0.002258
12154,12154,,5,15,20,5,15,20,0.000068,0.002826,0,17029,30,0.000013,15,0.184367,0.204602,7832.215595,0.173684,0.001168
12155,12155,,17,3,20,17,3,20,0.000354,0.000796,0,15460,30,0.000029,14,0.193224,0.21235,2718.463622,0.2,0.005928
12156,12156,,65,30,95,65,30,95,0.003808,0.001978,0,16257,0,0.000032,13,0.202795,0.228293,28259.792449,0.166517,0.022799
12157,12157,,18,15,33,18,15,33,0.000686,0.001669,0,16248,0,0.000018,13,0.200781,0.224244,21169.84475,0.160985,0.007674
12158,12158,,18,44,62,18,44,62,0.001483,0.02201,0,15565,25,0.000019,14,0.220289,0.257735,53261.018127,0.102591,0.004846
12159,12159,,3,8,11,3,8,11,0.0004,0.0169,0,15604,1,0.000011,13,0.222454,0.252763,6077.565454,0.327273,0.001573
12160,12160,,1,6,7,1,6,7,0.000049,0.002236,0,15664,25,0.00001,17,0.18276,0.204294,22.672498,0.238095,0.000368
12161,12161,,0,4,4,0,4,4,0,0.000007,0,17030,23,0.00001,19,0.123108,0.147225,0,0.333333,0
12162,12162,,1,6,7,1,6,7,0.000005,0.000464,0,17032,4,0.000011,12,0.174252,0.192499,608.875736,0.428571,0.000226
9808054,9808054,,5,17,22,5,17,22,0.000065,0.003117,0,9665,4,0.000015,13,0.20705,0.237715,14626.808357,0.248918,0.001169
9810192,9810192,,5,10,15,5,10,15,0.00028,0.000516,0,15678,4,0.000013,14,0.180456,0.204131,9601.948959,0.142857,0.001156
9903092,9903092,,1,35,36,1,35,36,0.000005,0.003417,0,17031,4,0.000011,11,0.20845,0.241354,3799.123564,0.134921,0.000226
9406081,9406081,,11,0,11,11,0,11,0.000209,0,0,5021,4,0.000033,0,0,0,0,0.254545,0.002693
9604021,9604021,,8,8,16,8,8,16,0.000153,0.002346,0,5023,4,0.000017,6,0.25814,0.306982,5244.151035,0.233333,0.001907
9709186,9709186,,3,15,18,3,15,18,0.000051,0.000569,0,15677,4,0.000012,13,0.178223,0.204312,331.850395,0.222222,0.000704
9810020,9810020,,1,6,7,1,6,7,0.000006,0.000554,0,15676,4,0.000011,13,0.158159,0.175691,117.613069,0.142857,0.000252
9503221,9503221,,3,0,3,3,0,3,0.000174,0,0,5028,4,0.000011,0,0,0,0,0.5,0.000746
12163,12163,,13,5,18,13,5,18,0.000724,0.000294,0,15567,25,0.000019,12,0.177953,0.192886,2883.660484,0.153595,0.003538
12164,12164,,42,51,93,42,51,93,0.001986,0.007222,0,16135,52,0.000028,15,0.2135,0.243018,61884.127875,0.100982,0.01218
12165,12165,,14,58,72,14,58,72,0.000359,0.004938,0,12485,25,0.000018,14,0.215375,0.244577,54532.785647,0.106221,0.003874
12166,12166,,1,3,4,1,3,4,0,0.000005,0,17033,5,0.000011,14,0.13313,0.143792,291.466195,0.083333,0.000219
12174,12174,,5,4,9,5,4,9,0.000556,0.000004,0,17034,23,0.000013,15,0.134661,0.149483,48843.651342,0.138889,0.001823
9508031,9508031,,3,4,7,3,4,7,0.000019,0.000005,0,9744,28,0.000014,2,0.625,0.7,38.001926,0.261905,0.000767
12167,12167,,0,18,18,0,18,18,0,0.002421,0,17035,3,0.00001,13,0.201378,0.227488,0,0.261438,0
12170,12170,,12,23,35,12,23,35,0.001333,0.004559,0,15816,30,0.000014,14,0.201476,0.223482,2228.053385,0.253782,0.005616
12171,12171,,30,15,45,30,15,45,0.001417,0.000934,0,15836,30,0.000022,14,0.190068,0.207556,2532.796717,0.160606,0.010445
12172,12172,,19,6,25,19,6,25,0.000713,0.000686,0,17036,13,0.000031,12,0.18282,0.201518,8923.038482,0.131667,0.004856
12173,12173,,2,8,10,2,8,10,0.000012,0.000002,0,17037,22,0.000011,6,0.359649,0.476829,655.5019,0.155556,0.000465
12176,12176,,2,8,10,2,8,10,0,0.000004,0,17038,23,0.000012,15,0.138839,0.150994,123.195271,0.222222,0.000445
12177,12177,,2,4,6,2,4,6,0.000003,0.000006,0,17039,1,0.000016,14,0.156812,0.168735,9257.299038,0.166667,0.000438
204108,204108,,1,13,14,1,13,14,0.000026,0.006145,0,17040,1,0.00001,13,0.185842,0.206522,41.739119,0.225275,0.000219
9311110,9311110,,8,0,8,8,0,8,0.000004,0,0,743,4,0.000031,0,0,0,0,0.107143,0.001925
12178,12178,,18,23,41,18,23,41,0.000584,0.001077,0,17041,25,0.00002,13,0.188548,0.212089,13876.755371,0.086585,0.004509
12179,12179,,35,70,105,35,70,105,0.00188,0.003647,0,15512,52,0.000026,12,0.214256,0.244504,442622.072716,0.097253,0.012142
12180,12180,,5,27,32,5,27,32,0.000255,0.003883,0,15938,2,0.000012,14,0.226538,0.256244,28980.974292,0.09375,0.001443
12181,12181,,7,5,12,7,5,12,0,0.000001,0,17043,22,0.00002,19,0.116443,0.136798,2850.962675,0.19697,0.00166
9811154,9811154,,7,0,7,7,0,7,0,0,0,17042,22,0.000026,0,0,0,0,0.142857,0.001614
12182,12182,,5,18,23,5,18,23,0.000108,0.001653,0,17044,25,0.000012,17,0.191025,0.211616,594.003705,0.233202,0.001237
12183,12183,,18,48,66,18,48,66,0.001849,0.01565,0,15918,30,0.000017,13,0.219183,0.2459,124639.356965,0.118182,0.005171
12184,12184,,7,9,16,7,9,16,0.000109,0.001441,0,15457,30,0.000023,17,0.198423,0.220773,10413.04252,0.1125,0.002831
12185,12185,,9,16,25,9,16,25,0.000027,0.000008,0,17045,5,0.000018,16,0.124012,0.135283,68519.935725,0.161667,0.00213
12186,12186,,1,2,3,1,2,3,0.000013,0.000034,0,17046,2,0.00001,15,0.155081,0.173738,10.429961,0.333333,0.000226
12188,12188,,4,15,19,4,15,19,0.000404,0.000796,0,17047,52,0.000011,14,0.166829,0.193257,6710.171909,0.187135,0.001197
12189,12189,,4,14,18,4,14,18,0.000002,0,0,17049,22,0.000014,9,0.180176,0.230542,400.140115,0.19281,0.000883
9912149,9912149,,2,3,5,2,3,5,0,0,0,17048,22,0.000011,10,0.140426,0.164638,6.983333,0.4,0.000471
12190,12190,,0,8,8,0,8,8,0,0.000054,0,17050,6,0.00001,15,0.149475,0.165771,0,0.107143,0
12191,12191,,1,6,7,1,6,7,0.000051,0.001097,0,16051,25,0.00001,12,0.197424,0.216756,22.370666,0.142857,0.000243
12192,12192,,3,6,9,3,6,9,0.000193,0.000375,0,17051,13,0.000012,13,0.183943,0.20343,194.174707,0.222222,0.000691
12194,12194,,14,51,65,14,51,65,0.001676,0.02318,0,16165,13,0.000016,16,0.224365,0.262695,43409.994425,0.116587,0.004628
9707071,9707071,,3,24,27,3,24,27,0.000183,0.004683,0,4871,4,0.000011,12,0.1919,0.220219,3499.205184,0.267806,0.001004
12196,12196,,7,18,25,7,18,25,0.001686,0.021384,0,17052,1,0.000014,16,0.206853,0.240662,17161.800912,0.238333,0.0017
12197,12197,,2,2,4,2,2,4,0.000286,0.000003,0,16205,1,0.00001,14,0.172289,0.186718,1147.621893,0.25,0.000654
12198,12198,,89,47,136,89,47,136,0.004225,0.004736,0,15515,3,0.000046,12,0.222031,0.249014,226677.848048,0.092538,0.029424
12210,12210,,82,64,146,82,64,146,0.004019,0.006526,0,15521,3,0.000041,11,0.22459,0.253119,300613.80908,0.094946,0.025714
12199,12199,,5,25,30,5,25,30,0.000422,0.000665,0,17053,2,0.000013,18,0.193807,0.221427,9096.240563,0.155172,0.001252
12201,12201,,0,27,27,0,27,27,0,0.004264,0,17054,13,0.00001,14,0.208832,0.241126,0,0.180912,0
12202,12202,,6,15,21,6,15,21,0.000227,0.000909,0,15682,25,0.000013,13,0.195609,0.215551,14672.779206,0.107143,0.001693
12203,12203,,3,8,11,3,8,11,0.000301,0.003019,0,15730,1,0.000011,15,0.211845,0.244809,5152.551051,0.218182,0.000835
12204,12204,,0,1,1,0,1,1,0,0.0001,0,17055,0,0.00001,14,0.169929,0.191305,0,0,0
12206,12206,,0,1,1,0,1,1,0,0.000001,0,17057,0,0.00001,1,1,1,0,0,0
9506129,9506129,,3,0,3,3,0,3,0.000124,0,0,17056,0,0.000025,0,0,0,0,0,0.000658
12208,12208,,1,3,4,1,3,4,0,0,0,17059,20,0.000011,15,0.124752,0.135183,4.75,0.166667,0.000219
9910167,9910167,,3,0,3,3,0,3,0,0,0,17058,20,0.000015,0,0,0,0,0.333333,0.000703
12209,12209,,1,1,2,1,1,2,0,0.000003,0,17060,15,0.000015,2,0.666667,0.75,4,0,0.000226
12211,12211,,2,27,29,2,27,29,0.000499,0.009718,0,15967,3,0.00001,11,0.230779,0.262503,16285.988517,0.173645,0.000594
12212,12212,,4,4,8,4,4,8,0,0.000009,0,17061,23,0.000018,15,0.152894,0.168492,14718.257837,0.160714,0.000903
12213,12213,,56,47,103,56,47,103,0.003175,0.00485,0,15415,0,0.000033,16,0.204123,0.235685,182002.328335,0.078907,0.018429
12214,12214,,2,24,26,2,24,26,0.000536,0.008142,0,17062,1,0.00001,12,0.206447,0.235678,343.833178,0.144615,0.000452
12215,12215,,8,4,12,8,4,12,0.000008,0.000003,0,17064,23,0.000026,18,0.104549,0.119471,89.651015,0.204545,0.001877
9709221,9709221,,3,2,5,3,2,5,0,0.000003,0,17063,23,0.000021,18,0.104211,0.117365,0,0.5,0.000776
12217,12217,,4,27,31,4,27,31,0.000145,0.002429,0,15479,30,0.000011,13,0.21154,0.235665,4328.072054,0.175269,0.001433
12218,12218,,33,43,76,33,43,76,0.002801,0.021377,0,15822,30,0.000023,14,0.21284,0.239315,24757.283918,0.151228,0.011796
12219,12219,,4,27,31,4,27,31,0.000241,0.000114,0,16324,5,0.000012,13,0.167829,0.194726,341.371114,0.113978,0.001009
9807101,9807101,,5,13,18,5,13,18,0.000249,0.000059,0,8203,5,0.000012,3,0.666667,0.8,32182.389888,0.088235,0.001346
9309062,9309062,,2,0,2,2,0,2,0.000001,0,0,8202,5,0.000014,0,0,0,0,0,0.000488
9803257,9803257,,3,14,17,3,14,17,0.000215,0.004915,0,8220,13,0.000015,15,0.212389,0.255594,60211.47407,0.080882,0.000871
9807003,9807003,,3,6,9,3,6,9,0.000216,0.000026,0,8214,5,0.000012,20,0.143455,0.188383,17366.764493,0.263889,0.000866
12220,12220,,2,14,16,2,14,16,0.000016,0.000242,0,17066,4,0.000011,14,0.183183,0.209473,376.594151,0.1625,0.000445
9711172,9711172,,2,6,8,2,6,8,0.000008,0.000001,0,17065,22,0.000012,3,0.692308,0.814815,32.833333,0.232143,0.000464
12221,12221,,6,26,32,6,26,32,0.000216,0.003491,0,15663,25,0.000013,14,0.208409,0.236673,7753.927041,0.126008,0.001825
12222,12222,,18,23,41,18,23,41,0.000725,0.001508,0,15764,3,0.000017,12,0.201448,0.222655,12521.038127,0.168293,0.00594
12223,12223,,5,8,13,5,8,13,0.000001,0.000001,0,17067,6,0.000014,14,0.147953,0.160087,1269.755415,0.121795,0.001142
12224,12224,,1,7,8,1,7,8,0,0.000002,0,17070,9,0.00001,11,0.155283,0.197463,6.25,0.214286,0.000219
9212067,9212067,,1,2,3,1,2,3,0,0,0,17069,6,0.000011,1,1,1,4,0,0.000226
9409027,9409027,,1,2,3,1,2,3,0,0.000004,0,17068,15,0.000011,2,0.75,0.833333,4.5,0,0.000226
9203035,9203035,,9,0,9,9,0,9,0,0,0,2018,6,0.00009,0,0,0,0,0,0.00214
12225,12225,,7,14,21,7,14,21,0.000238,0.001914,0,15825,30,0.000015,13,0.192707,0.211384,4328.333869,0.207143,0.001995
12226,12226,,11,6,17,11,6,17,0.00041,0.001281,0,15697,25,0.000021,12,0.190899,0.208403,3046.573396,0.139706,0.003608
12227,12227,,2,5,7,2,5,7,0.000013,0.001017,0,17071,25,0.000014,13,0.188915,0.205474,8716.940901,0.02381,0.000438
105300,105300,,5,21,26,5,21,26,0.000148,0.003862,0,16029,25,0.000012,13,0.219321,0.250485,133136.669362,0.150769,0.001219
102042,102042,,75,37,112,75,37,112,0.012041,0.020849,0,15623,8,0.000045,15,0.197435,0.225797,41435.988647,0.133285,0.025505
102159,102159,,21,12,33,21,12,33,0.002562,0.002617,0,15398,8,0.000021,17,0.198602,0.223036,14456.096532,0.116477,0.007956
103078,103078,,39,33,72,39,33,72,0.006368,0.018327,0,15651,8,0.000028,13,0.202223,0.227136,52272.396733,0.189163,0.014369
103138,103138,,7,9,16,7,9,16,0.000297,0.001182,0,16028,25,0.000014,17,0.172723,0.192518,19887.985629,0.1875,0.00176
105048,105048,,28,67,95,28,67,95,0.00524,0.024129,0,15639,25,0.000025,12,0.217745,0.246527,203668.75407,0.088242,0.008098
105052,105052,,26,24,50,26,24,50,0.004112,0.018114,0,15661,8,0.00002,13,0.209253,0.240981,28306.295633,0.257143,0.009296
105117,105117,,34,43,77,34,43,77,0.005641,0.020043,0,15668,8,0.000022,12,0.219219,0.252731,89813.573364,0.151059,0.010992
105151,105151,,3,40,43,3,40,43,0.000478,0.011254,0,16026,25,0.000011,14,0.22094,0.254266,21909.319198,0.102436,0.001244
105160,105160,,12,62,74,12,62,74,0.001257,0.021861,0,15708,25,0.000016,12,0.226448,0.260774,42271.924651,0.109774,0.003865
105256,105256,,8,50,58,8,50,58,0.001211,0.012719,0,15644,25,0.000013,13,0.221301,0.255441,45282.983601,0.140956,0.002432
12229,12229,,0,5,5,0,5,5,0,0.000001,0,17073,28,0.00001,2,0.777778,0.857143,0,0.15,0
9212091,9212091,,5,1,6,5,1,6,0,0,0,17072,28,0.000018,1,1,1,0,0.233333,0.001135
12230,12230,,4,13,17,4,13,17,0.00017,0.000304,0,16003,28,0.000012,13,0.173164,0.190653,6604.993094,0.191176,0.000913
9911194,9911194,,4,7,11,4,7,11,0.000008,0.000213,0,16002,28,0.000014,12,0.190809,0.209687,3872.250071,0.245455,0.000916
12231,12231,,2,15,17,2,15,17,0.000306,0.001767,0,17074,25,0.000011,18,0.179145,0.202265,2190.327844,0.180147,0.000776
12232,12232,,1,10,11,1,10,11,0.000021,0.000976,0,17075,13,0.00001,18,0.193339,0.214837,6.275675,0.345455,0.000219
12233,12233,,4,7,11,4,7,11,0.00003,0.00114,0,17076,0,0.000014,12,0.187234,0.209346,251.907063,0.172727,0.000916
12234,12234,,44,69,113,44,69,113,0.003469,0.017826,0,16140,52,0.000036,17,0.23585,0.277511,232719.966833,0.072219,0.013673
12236,12236,,12,13,25,12,13,25,0.000644,0.00064,0,17077,2,0.000017,15,0.196712,0.218319,5507.35863,0.238333,0.003084
12237,12237,,3,18,21,3,18,21,0,0.00001,0,17079,23,0.000013,15,0.150056,0.165562,25733.20814,0.180952,0.000714
9909078,9909078,,1,0,1,1,0,1,0,0,0,17078,23,0.000011,0,0,0,0,0,0.000239
12239,12239,,2,32,34,2,32,34,0.000059,0.004102,0,17080,30,0.00001,14,0.206203,0.229947,582.417908,0.21836,0.000478
12240,12240,,7,5,12,7,5,12,0.000657,0.000574,0,16185,1,0.000017,12,0.200222,0.220215,4203.103148,0.083333,0.002339
12242,12242,,5,7,12,5,7,12,0.000063,0.000652,0,17081,0,0.000013,18,0.176482,0.197037,440.438458,0.280303,0.00117
12244,12244,,2,1,3,2,1,3,0,0,0,17082,22,0.000019,6,0.288288,0.344271,32,0,0.000445
12245,12245,,1,1,2,1,1,2,0.000007,0.000009,0,17083,13,0.00001,13,0.165098,0.178379,0,0.5,0.000253
12246,12246,,1,10,11,1,10,11,0.000045,0.001804,0,16716,25,0.00001,15,0.184867,0.20562,472.983005,0.227273,0.000312
12247,12247,,4,30,34,4,30,34,0.000311,0.00505,0,17084,2,0.000012,13,0.209357,0.234107,16002.653349,0.11943,0.001302
12248,12248,,33,17,50,33,17,50,0.005592,0.018072,0,15406,25,0.000032,15,0.203298,0.227438,67648.329492,0.123265,0.008499
12249,12249,,3,32,35,3,32,35,0.000206,0.022759,0,16024,25,0.000011,12,0.212212,0.237535,10744.407619,0.1,0.000705
12250,12250,,14,18,32,14,18,32,0.000842,0.002615,0,17085,4,0.000018,12,0.189815,0.212198,15004.835423,0.195565,0.003409
12251,12251,,115,69,184,115,69,184,0.002344,0.003871,0,15749,3,0.000087,13,0.206236,0.232038,112845.434505,0.108607,0.043518
12252,12252,,2,10,12,2,10,12,0.000214,0.000091,0,16342,5,0.000013,16,0.141162,0.159534,505.772522,0.159091,0.000563
9603166,9603166,,2,0,2,2,0,2,0.000003,0,0,16341,8,0.000012,0,0,0,0,0,0.000551
12253,12253,,2,1,3,2,1,3,0.000112,0.000008,0,17086,15,0.000037,15,0.141794,0.151193,23856.290221,0,0.000478
12254,12254,,3,14,17,3,14,17,0.000178,0.002042,0,16137,4,0.000011,14,0.193439,0.215704,9232.807936,0.125,0.001034
12255,12255,,1,17,18,1,17,18,0.000017,0.001636,0,15126,25,0.000011,13,0.200639,0.223171,1611.983267,0.124183,0.000233
12256,12256,,0,12,12,0,12,12,0,0.000004,0,17091,28,0.00001,15,0.151592,0.182852,0,0.113636,0
9309047,9309047,,4,0,4,4,0,4,0,0,0,11733,28,0.000025,0,0,0,0,0,0.000883
9511224,9511224,,1,5,6,1,5,6,0,0.000003,0,17090,28,0.000011,3,0.459459,0.568627,12.5,0.2,0.000219
9907089,9907089,,2,3,5,2,3,5,0,0.000002,0,17088,28,0.000015,3,0.533333,0.645833,11,0.15,0.000445
9909052,9909052,,1,2,3,1,2,3,0,0,0,17089,28,0.000011,4,0.391304,0.5,0.5,0.333333,0.000219
9605115,9605115,,1,3,4,1,3,4,0,0.000006,0,10103,23,0.000011,7,0.202443,0.235858,2339.414286,0.083333,0.000239
9809112,9809112,,3,0,3,3,0,3,0,0,0,17087,28,0.000022,0,0,0,0,0.166667,0.000677
12257,12257,,1,2,3,1,2,3,0,0.000001,0,17092,52,0.000019,1,1,1,2,0,0.000219
12258,12258,,18,12,30,18,12,30,0.001491,0.001199,0,16098,1,0.000019,16,0.199471,0.221444,16332.231066,0.158621,0.005696
12259,12259,,16,15,31,16,15,31,0.000675,0.003148,0,15491,30,0.000017,13,0.196306,0.216333,1436.245282,0.209677,0.004608
12260,12260,,2,7,9,2,7,9,0,0.000067,0,17095,41,0.000015,13,0.168646,0.18054,11310.507137,0.055556,0.000472
9803158,9803158,,3,2,5,3,2,5,0.000028,0.000001,0,17094,41,0.000014,5,0.298246,0.385294,61.168645,0.1,0.000684
9811148,9811148,,2,1,3,2,1,3,0.000019,0.000001,0,17093,41,0.000013,14,0.177111,0.193636,3693.905563,0,0.000465
101138,101138,,5,4,9,5,4,9,0.000325,0.000015,0,17096,5,0.000017,17,0.158485,0.1709,10424.882607,0.138889,0.001175
12261,12261,,0,3,3,0,3,3,0,0.00122,0,17097,4,0.00001,6,0.263374,0.300651,0,0.5,0
12262,12262,,6,18,24,6,18,24,0.000349,0.002527,0,17098,30,0.000012,13,0.196368,0.216135,3157.375713,0.193841,0.001591
12263,12263,,4,28,32,4,28,32,0.001037,0.00286,0,17099,13,0.000011,18,0.191444,0.227561,1043.725089,0.1875,0.000997
9706015,9706015,,1,0,1,1,0,1,0.000038,0,0,6546,13,0.000011,0,0,0,0,0,0.000323
12264,12264,,4,7,11,4,7,11,0.000001,0.000007,0,17100,5,0.000014,11,0.138223,0.173524,67.782382,0.181818,0.000883
12265,12265,,0,41,41,0,41,41,0,0.007103,0,17101,25,0.00001,13,0.207793,0.235921,0,0.14939,0
12266,12266,,15,33,48,15,33,48,0.000473,0.002932,0,15471,30,0.000022,13,0.211425,0.234621,27311.43473,0.143174,0.0057
9503091,9503091,,2,3,5,2,3,5,0.000066,0.000006,0,15454,30,0.000011,2,0.666667,0.75,5482.732143,0.05,0.000698
9501035,9501035,,2,1,3,2,1,3,0,0,0,15453,22,0.000014,1,1,1,2696,0,0.000468
12267,12267,,0,52,52,0,52,52,0,0.015351,0,17102,2,0.00001,12,0.219006,0.250448,0,0.09276,0
9610022,9610022,,3,7,10,3,7,10,0.000266,0.000194,0,15712,2,0.000011,13,0.18022,0.204658,260.958732,0.222222,0.00082
12268,12268,,3,13,16,3,13,16,0.000307,0.001978,0,15929,30,0.000012,13,0.194413,0.212391,2014.54318,0.191667,0.002238
9205093,9205093,,5,0,5,5,0,5,0.000001,0,0,539,52,0.000094,0,0,0,0,0.05,0.001298
12269,12269,,4,1,5,4,1,5,0,0,0,17103,23,0.000017,6,0.318182,0.397619,16.25,0.2,0.000896
9608138,9608138,,7,1,8,7,1,8,0.00008,0,0,14454,23,0.000033,1,1,1,2,0.214286,0.00164
9705077,9705077,,5,3,8,5,3,8,0,0.000001,0,14456,23,0.000026,1,1,1,22.666667,0.267857,0.001174
12270,12270,,2,8,10,2,8,10,0.000029,0.000674,0,17104,0,0.000011,14,0.187435,0.212535,207.4927,0.288889,0.000445
101001,101001,,11,32,43,11,32,43,0.000451,0.004387,0,15923,3,0.000017,12,0.220885,0.246813,81787.434856,0.09856,0.002951
101002,101002,,2,30,32,2,30,32,0.000092,0.002561,0,15791,3,0.00001,12,0.203218,0.225203,1130.875839,0.199597,0.000577
101003,101003,,11,44,55,11,44,55,0.001724,0.018321,0,15633,25,0.000015,14,0.213461,0.242661,106067.850602,0.118182,0.003746
101004,101004,,0,3,3,0,3,3,0,0.000057,0,17105,0,0.00001,4,0.44,0.55303,0,0,0
101005,101005,,3,7,10,3,7,10,0.000005,0.000067,0,17106,26,0.000012,11,0.17629,0.214643,22.698701,0.288889,0.000664
101006,101006,,0,5,5,0,5,5,0,0.007465,0,17107,1,0.00001,11,0.225453,0.254432,0,0.05,0
101007,101007,,17,18,35,17,18,35,0.002125,0.009095,0,15715,25,0.000017,15,0.201905,0.229334,7040.701445,0.156303,0.004887
101008,101008,,2,1,3,2,1,3,0,0.000003,0,17108,22,0.000016,7,0.261905,0.305339,33,0.166667,0.000438
101010,101010,,5,16,21,5,16,21,0.000583,0.001303,0,16247,3,0.000011,15,0.202969,0.225835,3849.097271,0.161905,0.00132
101011,101011,,27,26,53,27,26,53,0.001111,0.000948,0,16100,1,0.000027,14,0.198416,0.222599,116509.952319,0.066763,0.007397
12228,12228,,8,0,8,8,0,8,0.000036,0,0,16099,4,0.000016,0,0,0,0,0.321429,0.00213
9611170,9611170,,4,15,19,4,15,19,0.000041,0.000049,0,4258,4,0.000013,10,0.272938,0.35757,32593.929904,0.116959,0.001117
9211079,9211079,,2,0,2,2,0,2,0,0,0,403,5,0.000015,0,0,0,0,0.5,0.000531
9309100,9309100,,5,4,9,5,4,9,0.000002,0.000002,0,720,4,0.000014,1,1,1,173.351558,0.194444,0.001219
9404096,9404096,,2,3,5,2,3,5,0.000001,0.000004,0,703,4,0.000012,1,1,1,10.296017,0.25,0.000535
9501039,9501039,,3,6,9,3,6,9,0.000044,0.000099,0,1999,5,0.000013,4,0.344156,0.422956,398.682892,0.222222,0.000765
9503172,9503172,,4,15,19,4,15,19,0.000046,0.000178,0,1998,5,0.000014,7,0.276606,0.312594,1675.045242,0.178363,0.00102
101013,101013,,20,37,57,20,37,57,0.003379,0.024959,0,15603,1,0.000017,13,0.225997,0.257366,23656.554047,0.175439,0.006488
101014,101014,,24,34,58,24,34,58,0.000741,0.002353,0,15751,3,0.000023,14,0.190652,0.212688,1549.434865,0.299758,0.012801
101015,101015,,1,3,4,1,3,4,0.000018,0.001158,0,17109,30,0.00001,13,0.186727,0.203122,5.878482,0.25,0.00024
101016,101016,,16,40,56,16,40,56,0.001532,0.007014,0,15824,30,0.000016,15,0.219701,0.24706,29867.57746,0.185065,0.006813
101017,101017,,1,13,14,1,13,14,0.000026,0.002157,0,17110,1,0.00001,10,0.227551,0.25617,33.783545,0.181319,0.000219
101018,101018,,2,18,20,2,18,20,0.000754,0.003578,0,16256,2,0.000011,13,0.19858,0.224441,24237.239131,0.192105,0.001086
101019,101019,,5,9,14,5,9,14,0.000914,0.003794,0,17111,25,0.000013,16,0.178538,0.199232,215.180509,0.241758,0.001277
101020,101020,,25,40,65,25,40,65,0.003675,0.023616,0,15605,1,0.000024,13,0.224738,0.256691,66365.292722,0.139663,0.008643
102105,102105,,23,16,39,23,16,39,0.004828,0.003514,0,15608,1,0.000019,13,0.203141,0.226382,14383.749858,0.132254,0.006557
101043,101043,,21,38,59,21,38,59,0.002854,0.021706,0,15607,1,0.000022,13,0.216774,0.244161,50561.076064,0.153419,0.006266
102172,102172,,22,23,45,22,23,45,0.004263,0.019536,0,15699,1,0.000019,13,0.205795,0.230841,10369.443581,0.168687,0.005955
101021,101021,,1,10,11,1,10,11,0.000005,0.000383,0,17112,4,0.000011,13,0.170769,0.189627,787.866234,0.290909,0.000219
101022,101022,,2,16,18,2,16,18,0.00003,0.001625,0,17114,2,0.000011,13,0.180821,0.203408,781.971747,0.120915,0.000458
9805079,9805079,,3,3,6,3,3,6,0.000052,0.000002,0,17113,2,0.000012,16,0.142471,0.155406,22.992803,0.2,0.000697
9207080,9207080,,4,0,4,4,0,4,0,0,0,1502,2,0.000057,0,0,0,0,0.083333,0.000968
9306100,9306100,,3,1,4,3,1,4,0,0,0,4470,2,0.000026,1,1,1,198.164249,0.083333,0.000761
101023,101023,,0,11,11,0,11,11,0,0.000388,0,17115,0,0.00001,14,0.178912,0.203283,0,0.245455,0
101025,101025,,2,10,12,2,10,12,0,0.000077,0,17116,28,0.000013,16,0.137211,0.157228,448.328581,0.204545,0.000445
101026,101026,,6,46,52,6,46,52,0.001199,0.025281,0,15428,1,0.000012,14,0.226669,0.260628,24472.934683,0.170437,0.00157
101027,101027,,14,24,38,14,24,38,0.0011,0.001946,0,15671,25,0.000018,15,0.193469,0.216508,9275.458181,0.14367,0.003435
101028,101028,,1,19,20,1,19,20,0.000238,0.018638,0,15425,1,0.00001,11,0.209934,0.232765,60.665205,0.242105,0.000322
101030,101030,,1,7,8,1,7,8,0.00001,0.002933,0,17117,25,0.00001,12,0.19461,0.214021,28.184208,0.196429,0.000295
101031,101031,,3,26,29,3,26,29,0.000078,0.001028,0,17118,2,0.000011,15,0.186063,0.20688,13018.11327,0.128079,0.000683
101032,101032,,4,9,13,4,9,13,0.000042,0.00154,0,17120,30,0.000019,13,0.19734,0.215349,11705.105619,0.076923,0.000877
9504051,9504051,,1,0,1,1,0,1,0.000018,0,0,17119,30,0.000012,0,0,0,0,0,0.000245
9608130,9608130,,3,3,6,3,3,6,0.000018,0.001945,0,15342,0,0.000027,11,0.184595,0.207652,6366.355961,0.066667,0.00069
9409052,9409052,,1,0,1,1,0,1,0,0,0,6979,30,0.000016,0,0,0,0,0,0.000271
101033,101033,,1,18,19,1,18,19,0.000006,0.007027,0,15488,3,0.000012,13,0.20441,0.227637,12568.645965,0.116959,0.000714
9712031,9712031,,2,1,3,2,1,3,0.000083,0.000158,0,15487,52,0.000012,15,0.183544,0.224594,240.758874,0,0.000452
101034,101034,,5,9,14,5,9,14,0,0.000001,0,17121,6,0.000018,16,0.133702,0.146837,18681.065153,0.071429,0.001136
101035,101035,,4,19,23,4,19,23,0,0.000035,0,17122,17,0.000013,12,0.167755,0.207853,1573.319126,0.20751,0.00093
101036,101036,,12,73,85,12,73,85,0.000269,0.0004,0,17131,28,0.000021,13,0.1796,0.201244,67841.37169,0.061064,0.002833
2079,2079,,1,0,1,1,0,1,0.000005,0,0,17130,28,0.00001,0,0,0,0,0,0.0003
9211076,9211076,,9,0,9,9,0,9,0.000006,0,0,10037,28,0.000025,0,0,0,0,0.152778,0.002199
9306148,9306148,,6,0,6,6,0,6,0.000005,0,0,8126,28,0.000022,0,0,0,0,0.166667,0.001467
9404078,9404078,,4,0,4,4,0,4,0.000005,0,0,4724,23,0.000027,0,0,0,0,0,0.000984
9409128,9409128,,2,6,8,2,6,8,0.000005,0.000079,0,17126,28,0.000011,6,0.235023,0.336928,1522.749025,0.053571,0.000562
9806156,9806156,,5,9,14,5,9,14,0.000006,0.000004,0,17123,28,0.000013,10,0.177762,0.218741,138.183779,0.192308,0.001227
9809053,9809053,,6,23,29,6,23,29,0.000062,0.000051,0,17127,28,0.000013,13,0.168288,0.193566,8171.681579,0.16133,0.001592
9812213,9812213,,1,21,22,1,21,22,0.000005,0.000045,0,17129,28,0.00001,14,0.14992,0.174683,884.788566,0.194805,0.0003
9906068,9906068,,1,15,16,1,15,16,0.000005,0.000031,0,17128,28,0.00001,13,0.159143,0.179177,206.646448,0.291667,0.0003
9303021,9303021,,1,0,1,1,0,1,0.000001,0,0,17125,28,0.000011,0,0,0,0,0,0.000234
9409083,9409083,,1,0,1,1,0,1,0,0,0,4147,28,0.000048,0,0,0,0,0,0.00042
9512068,9512068,,1,9,10,1,9,10,0,0.000012,0,11153,28,0.000011,4,0.588235,0.704167,367.517027,0.222222,0.000277
9707085,9707085,,1,2,3,1,2,3,0.000001,0.000002,0,17124,28,0.00001,7,0.204918,0.270381,341.248479,0.166667,0.000262
101037,101037,,9,6,15,9,6,15,0.00057,0.000038,0,17133,2,0.000017,14,0.167107,0.182985,2581.581594,0.190476,0.002243
9809064,9809064,,3,9,12,3,9,12,0.000003,0.001087,0,17132,4,0.000015,11,0.184488,0.208863,2055.215982,0.060606,0.000733
101038,101038,,4,45,49,4,45,49,0.000835,0.005557,0,15667,25,0.000011,15,0.203836,0.230433,12166.330656,0.14966,0.001608
101040,101040,,0,35,35,0,35,35,0,0.003744,0,17134,30,0.00001,13,0.204328,0.228129,0,0.207563,0
101041,101041,,1,5,6,1,5,6,0.000005,0.000449,0,17135,22,0.00001,13,0.15981,0.171794,0,0.166667,0.000219
104204,104204,,0,16,16,0,16,16,0,0.000453,0,17139,22,0.00001,12,0.195135,0.215643,0,0.1125,0
9706042,9706042,,2,1,3,2,1,3,0.000019,0.000003,0,17138,26,0.000011,5,0.3,0.352222,19.260417,0,0.000438
9808187,9808187,,2,28,30,2,28,30,0.000168,0.011912,0,17137,4,0.000011,13,0.209836,0.243002,3091.911147,0.105747,0.000438
101042,101042,,3,43,46,3,43,46,0.000113,0.003533,0,15557,25,0.000011,15,0.205193,0.233871,21192.511203,0.108213,0.00083
101044,101044,,2,9,11,2,9,11,0,0.000196,0,17140,23,0.000013,16,0.159393,0.179365,5326.036663,0.163636,0.000451
101045,101045,,1,17,18,1,17,18,0.000056,0.002495,0,17141,30,0.00001,12,0.202834,0.223805,1270.765108,0.215686,0.000232
101046,101046,,2,3,5,2,3,5,0.000035,0.000027,0,17142,30,0.000011,14,0.188742,0.205028,1041.724694,0,0.000445
101047,101047,,0,4,4,0,4,4,0,0.000961,0,17143,25,0.00001,12,0.191306,0.208749,0,0.333333,0
101048,101048,,0,5,5,0,5,5,0,0.000039,0,17144,23,0.00001,15,0.144477,0.156035,0,0.2,0
101049,101049,,13,25,38,13,25,38,0.000399,0.002567,0,11678,0,0.000017,17,0.201971,0.228986,8354.154808,0.168563,0.00432
101050,101050,,0,8,8,0,8,8,0,0.000339,0,17145,1,0.00001,14,0.195391,0.216949,0,0.125,0
101051,101051,,1,11,12,1,11,12,0.000002,0.000077,0,17147,26,0.00001,17,0.137624,0.153041,58.789921,0.378788,0.000226
9701105,9701105,,3,7,10,3,7,10,0.000002,0.000073,0,17146,26,0.000013,13,0.151539,0.178242,259.094861,0.344444,0.000671
101052,101052,,0,10,10,0,10,10,0,0.000033,0,17148,26,0.00001,16,0.152785,0.172054,0,0.244444,0
101053,101053,,3,6,9,3,6,9,0.000009,0.000019,0,17151,22,0.000013,17,0.152778,0.166736,3390.628828,0.097222,0.000684
9703024,9703024,,2,7,9,2,7,9,0.000608,0.000014,0,17150,22,0.000012,8,0.242678,0.313927,520.692424,0.097222,0.000484
9605126,9605126,,5,8,13,5,8,13,0.000002,0.000016,0,17149,9,0.00002,5,0.371951,0.451366,519.546243,0.083333,0.001143
101055,101055,,8,2,10,8,2,10,0.000132,0.001098,0,17152,4,0.000025,12,0.180272,0.203111,3025.97518,0.066667,0.001787
101056,101056,,2,14,16,2,14,16,0.000156,0.009062,0,17153,1,0.000011,13,0.210073,0.233731,2049.344993,0.2,0.000545
101057,101057,,0,21,21,0,21,21,0,0.002013,0,17154,25,0.00001,16,0.204958,0.228698,0,0.102381,0
101058,101058,,4,16,20,4,16,20,0.000063,0.002343,0,15921,30,0.000017,17,0.211506,0.236897,12145.012541,0.128947,0.001123
101059,101059,,0,5,5,0,5,5,0,0.000989,0,17155,30,0.00001,13,0.190913,0.208039,0,0.15,0
101060,101060,,10,20,30,10,20,30,0.000379,0.003549,0,15693,25,0.000016,14,0.194409,0.218385,4157.373017,0.185057,0.002513
101061,101061,,5,10,15,5,10,15,0.000371,0.003314,0,15688,25,0.000018,15,0.186165,0.207571,19534.473946,0.133333,0.001338
101064,101064,,2,26,28,2,26,28,0.000353,0.010259,0,17156,1,0.000011,12,0.218366,0.245088,2154.370963,0.14418,0.000489
101065,101065,,6,13,19,6,13,19,0.000041,0.000046,0,16375,23,0.000014,15,0.168029,0.188668,2955.9614,0.096491,0.001428
101066,101066,,1,11,12,1,11,12,0.000347,0.017072,0,17157,1,0.00001,16,0.222228,0.253797,3.44539,0.348485,0.000219
101067,101067,,4,4,8,4,4,8,0.000019,0.000003,0,17163,15,0.000016,15,0.151041,0.165685,221.000734,0.267857,0.000969
9606101,9606101,,6,6,12,6,6,12,0.000041,0.00001,0,17158,15,0.000042,8,0.214286,0.295215,325.916082,0.136364,0.001476
9811038,9811038,,6,8,14,6,8,14,0.000019,0.001877,0,17161,15,0.00004,14,0.177067,0.199621,11731.462311,0.093407,0.001455
9903075,9903075,,5,2,7,5,2,7,0.000019,0.000001,0,17162,15,0.000027,15,0.150608,0.164089,24.72619,0.285714,0.001202
9407098,9407098,,1,6,7,1,6,7,0,0.000006,0,6982,15,0.000013,7,0.226866,0.315476,10382.574851,0.047619,0.000277
9510077,9510077,,2,3,5,2,3,5,0,0.000001,0,6978,15,0.000019,2,0.714286,0.8,10242.922906,0.1,0.000537
9206058,9206058,,1,1,2,1,1,2,0.000022,0,0,17160,15,0.000014,1,1,1,43,0,0.00026
101069,101069,,3,25,28,3,25,28,0.000238,0.002008,0,17164,30,0.00001,14,0.206412,0.230008,671.728007,0.193122,0.000714
101070,101070,,6,18,24,6,18,24,0.000463,0.005101,0,17165,15,0.000013,17,0.213389,0.249502,35746.16108,0.04529,0.00142
101072,101072,,0,9,9,0,9,9,0,0.000049,0,17166,26,0.00001,15,0.15306,0.168359,0,0.291667,0
9311066,9311066,,2,1,3,2,1,3,0,0,0,3908,26,0.000021,1,1,1,2.166667,0,0.000498
9411236,9411236,,1,1,2,1,1,2,0,0,0,3902,26,0.000011,1,1,1,12195,0,0.000272
9412204,9412204,,5,1,6,5,1,6,0.000001,0,0,3900,26,0.000018,1,1,1,12129.98022,0.333333,0.001241
101073,101073,,44,24,68,44,24,68,0.006302,0.00816,0,15622,8,0.000034,16,0.189403,0.214036,12548.587566,0.176251,0.016682
9910185,9910185,,7,20,27,7,20,27,0.001178,0.017111,0,15620,8,0.000014,12,0.200493,0.223742,4343.282044,0.18661,0.002506
9911157,9911157,,5,16,21,5,16,21,0.000929,0.002028,0,15621,8,0.000013,12,0.197541,0.218362,2306.369888,0.216667,0.002013
101076,101076,,48,14,62,48,14,62,0.006245,0.003256,0,15619,8,0.000041,15,0.201044,0.224633,17369.288098,0.164992,0.017745
101083,101083,,38,20,58,38,20,58,0.005341,0.009044,0,15618,8,0.000033,15,0.197971,0.220975,11112.319898,0.18784,0.01487
101074,101074,,8,43,51,8,43,51,0.001178,0.020003,0,17167,0,0.000012,16,0.212411,0.251654,13458.497122,0.141176,0.002105
101075,101075,,2,17,19,2,17,19,0.00005,0.000994,0,17171,13,0.000012,13,0.181921,0.207313,4844.86768,0.078947,0.000543
9502054,9502054,,4,11,15,4,11,15,0.000028,0.000171,0,4529,13,0.000014,6,0.313525,0.374074,10911.699136,0.12381,0.00092
9610121,9610121,,4,5,9,4,5,9,0.000356,0.000151,0,17168,13,0.000011,6,0.306931,0.345699,134.659674,0.125,0.000904
9711086,9711086,,1,19,20,1,19,20,0.000012,0.003434,0,17170,13,0.00001,14,0.180054,0.216964,368.308774,0.152632,0.000234
9806086,9806086,,1,25,26,1,25,26,0.000012,0.005064,0,17169,13,0.00001,13,0.205777,0.244459,1356.041611,0.203077,0.000234
9406126,9406126,,2,4,6,2,4,6,0.000003,0.000096,0,4527,13,0.000014,3,0.396396,0.443182,18868.309755,0.266667,0.000524
101077,101077,,0,17,17,0,17,17,0,0.001231,0,17172,3,0.00001,11,0.216744,0.2399,0,0.139706,0
101078,101078,,10,9,19,10,9,19,0.000001,0.000007,0,17173,23,0.000032,18,0.139488,0.155266,12410.889908,0.187135,0.002426
101079,101079,,3,4,7,3,4,7,0.000001,0.000033,0,16323,23,0.000013,12,0.182295,0.198194,19628.561192,0.142857,0.000686
101080,101080,,1,25,26,1,25,26,0.000009,0.00166,0,17174,0,0.000011,12,0.210655,0.235283,4156.168469,0.290769,0.000219
101082,101082,,12,21,33,12,21,33,0.000552,0.003258,0,17175,30,0.000014,14,0.214778,0.24198,23310.248562,0.137311,0.003155
101084,101084,,4,12,16,4,12,16,0.000159,0.002687,0,17176,30,0.000012,14,0.184323,0.202118,288.103061,0.316667,0.001208
101085,101085,,2,21,23,2,21,23,0.000368,0.002778,0,17177,0,0.000011,14,0.1972,0.22259,1630.982976,0.177866,0.001175
9612060,9612060,,1,5,6,1,5,6,0,0.000024,0,4653,52,0.000011,4,0.444444,0.534722,1172.355622,0.366667,0.000247
101087,101087,,9,40,49,9,40,49,0.000337,0.007528,0,16277,3,0.000013,12,0.209274,0.23367,2796.123708,0.151786,0.002547
101088,101088,,6,14,20,6,14,20,0.000556,0.00179,0,17178,1,0.000016,13,0.186683,0.2053,13556.053911,0.202632,0.001669
101090,101090,,2,17,19,2,17,19,0.000013,0.001621,0,17179,2,0.000011,13,0.180105,0.20216,1420.765095,0.119883,0.000445
101091,101091,,18,16,34,18,16,34,0.002288,0.002514,0,15617,25,0.000018,16,0.186923,0.210148,14246.863028,0.163102,0.005938
101092,101092,,4,8,12,4,8,12,0.000002,0.001759,0,17180,30,0.000015,13,0.188483,0.205445,48585.781594,0.151515,0.000923
101094,101094,,0,8,8,0,8,8,0,0.001441,0,17181,25,0.00001,18,0.189065,0.207924,0,0.178571,0
101095,101095,,4,19,23,4,19,23,0.000406,0.003185,0,15523,30,0.000012,13,0.201482,0.221483,1515.914746,0.252964,0.003532
101096,101096,,20,26,46,20,26,46,0.002597,0.017837,0,16164,1,0.000023,13,0.210818,0.236098,23823.838096,0.175845,0.008209
101097,101097,,12,10,22,12,10,22,0.000012,0.000001,0,17183,22,0.000022,15,0.141969,0.152041,38509.216013,0.248918,0.002855
9912251,9912251,,1,3,4,1,3,4,0,0,0,17182,22,0.000012,20,0.103963,0.117452,33,0.166667,0.0003
101098,101098,,0,3,3,0,3,3,0,0,0,17187,20,0.00001,9,0.160976,0.185614,0,0.166667,0
9905086,9905086,,4,3,7,4,3,7,0,0,0,17186,20,0.000018,3,0.545455,0.694444,16,0.119048,0.000877
9404085,9404085,,5,0,5,5,0,5,0,0,0,17185,20,0.000029,0,0,0,0,0.1,0.001141
9612193,9612193,,3,1,4,3,1,4,0,0.000001,0,17184,20,0.000019,2,0.6,0.666667,15,0.166667,0.000683
101099,101099,,1,60,61,1,60,61,0.000149,0.023643,0,15641,1,0.00001,17,0.22369,0.261645,20290.502057,0.121858,0.00028
101100,101100,,4,18,22,4,18,22,0.000749,0.000341,0,15650,5,0.000012,16,0.17633,0.194367,34564.123403,0.123377,0.001639
101101,101101,,2,21,23,2,21,23,0,0.000038,0,17188,20,0.000013,13,0.172055,0.189067,8539.78213,0.225296,0.000445
101102,101102,,37,39,76,37,39,76,0.001618,0.00553,0,16011,30,0.000027,15,0.21069,0.240996,67941.156201,0.088596,0.009897
101145,101145,,21,31,52,21,31,52,0.000721,0.005066,0,16139,30,0.000018,15,0.212105,0.240173,49440.023567,0.08371,0.005661
101103,101103,,1,9,10,1,9,10,0,0,0,17192,26,0.000011,10,0.165112,0.187725,14.916667,0.211111,0.000226
9406070,9406070,,5,0,5,5,0,5,0,0,0,7571,26,0.000037,0,0,0,0,0.25,0.001248
9804047,9804047,,4,5,9,4,5,9,0,0,0,17190,26,0.000018,9,0.194353,0.219158,2354.075846,0.138889,0.000903
9807025,9807025,,5,2,7,5,2,7,0,0,0,17189,26,0.000026,3,0.538462,0.619048,37.168793,0.238095,0.001148
9907004,9907004,,1,3,4,1,3,4,0,0,0,17191,26,0.000011,10,0.163741,0.179765,3,0.166667,0.000226
101104,101104,,2,20,22,2,20,22,0.000493,0.008048,0,16200,0,0.00001,16,0.199783,0.228195,7980.320814,0.123377,0.000598
101105,101105,,16,22,38,16,22,38,0.000335,0.001104,0,15628,5,0.000024,16,0.187547,0.210648,117075.928621,0.069701,0.003908
9801054,9801054,,3,8,11,3,8,11,0.000016,0.000034,0,15122,5,0.000015,12,0.168996,0.192644,1537.286503,0.154545,0.000857
101106,101106,,1,25,26,1,25,26,0.000001,0.000012,0,17194,6,0.00001,15,0.15885,0.177937,61.972901,0.152308,0.000219
9909153,9909153,,6,5,11,6,5,11,0.000002,0.000003,0,17193,6,0.000014,13,0.152145,0.19014,77.642899,0.263636,0.001409
101107,101107,,0,7,7,0,7,7,0,0.001632,0,17197,26,0.00001,11,0.202413,0.22875,0,0.02381,0
9507097,9507097,,3,0,3,3,0,3,0.000035,0,0,17196,26,0.000016,0,0,0,0,0,0.000658
9709011,9709011,,1,0,1,1,0,1,0.000019,0,0,17195,26,0.000011,0,0,0,0,0,0.000219
101108,101108,,6,7,13,6,7,13,0.000001,0.000018,0,16330,20,0.000013,13,0.168558,0.182026,4628.1469,0.275641,0.001585
101109,101109,,15,29,44,15,29,44,0.000853,0.003107,0,15843,30,0.000016,17,0.201415,0.223478,78146.64537,0.215116,0.006101
101140,101140,,0,2,2,0,2,2,0,0,0,17198,6,0.00001,1,1,1,0,0.5,0
101110,101110,,0,27,27,0,27,27,0,0.00002,0,17199,20,0.00001,12,0.168593,0.183907,0,0.091168,0
101111,101111,,2,8,10,2,8,10,0.000001,0.000042,0,17203,30,0.000013,14,0.160067,0.170875,101.928589,0.144444,0.000451
9706189,9706189,,3,3,6,3,3,6,0.000001,0.000016,0,17202,30,0.000014,12,0.145911,0.160775,166.309364,0.1,0.000684
9607073,9607073,,2,1,3,2,1,3,0,0,0,17201,15,0.000017,2,0.666667,0.75,14,0,0.000458
101112,101112,,1,7,8,1,7,8,0,0.000004,0,17204,28,0.000012,16,0.128964,0.141207,2494.717927,0.017857,0.000219
101113,101113,,14,22,36,14,22,36,0.000844,0.002373,0,17205,2,0.000017,14,0.196216,0.222416,17466.657889,0.10873,0.003322
101114,101114,,9,57,66,9,57,66,0.000623,0.007513,0,15942,4,0.000014,12,0.225266,0.257125,26833.399321,0.117249,0.002181
101115,101115,,6,17,23,6,17,23,0.0002,0.003868,0,17206,0,0.000016,14,0.2175,0.248539,13074.769917,0.06917,0.001712
101116,101116,,8,5,13,8,5,13,0.000326,0.000041,0,17209,10,0.000016,13,0.174165,0.19187,2591.222771,0.262821,0.002233
9405025,9405025,,2,5,7,2,5,7,0.000002,0.000001,0,17208,9,0.000013,5,0.346154,0.455556,1719.222688,0.095238,0.000535
9201030,9201030,,1,0,1,1,0,1,0,0,0,17207,9,0.000012,0,0,0,0,0,0.000233
9209030,9209030,,5,0,5,5,0,5,0.000001,0,0,1041,9,0.000026,0,0,0,0,0.15,0.001303
9307031,9307031,,6,6,12,6,6,12,0.000044,0.00001,0,1488,9,0.000018,4,0.442308,0.557971,37208.34186,0.068182,0.001738
9506159,9506159,,6,46,52,6,46,52,0.000018,0.000054,0,3664,9,0.000028,6,0.52093,0.662649,191424.612018,0.036576,0.001517
101117,101117,,5,4,9,5,4,9,0.000069,0.001698,0,16284,8,0.000016,14,0.163764,0.186333,1442.726971,0.194444,0.00127
101118,101118,,6,33,39,6,33,39,0.001113,0.02047,0,16130,1,0.000013,13,0.210223,0.235524,7226.430778,0.132254,0.001805
9311025,9311025,,1,0,1,1,0,1,0.000241,0,0,16129,1,0.00001,0,0,0,0,0,0.000265
101119,101119,,13,42,55,13,42,55,0.001141,0.019145,0,15714,25,0.000015,14,0.21518,0.246472,22889.479263,0.120539,0.003777
101120,101120,,8,15,23,8,15,23,0.000563,0.015354,0,17210,26,0.000015,12,0.19962,0.221922,2074.356929,0.237154,0.001832
101121,101121,,0,1,1,0,1,1,0,0,15,17212,36,0.00001,1,1,1,0,0,0
9911059,9911059,,4,0,4,4,0,4,0,0,15,17211,36,0.000045,0,0,0,0,0,0.000877
101122,101122,,1,43,44,1,43,44,0.000013,0.006998,0,17213,0,0.00001,13,0.21928,0.252619,1325.073227,0.15222,0.000232
101123,101123,,5,23,28,5,23,28,0.000285,0.000951,0,17215,13,0.000014,16,0.198255,0.225432,15972.095226,0.108466,0.001218
9810118,9810118,,1,0,1,1,0,1,0.000011,0,0,17214,13,0.00001,0,0,0,0,0,0.000253
101124,101124,,0,2,2,0,2,2,0,0.000002,0,17216,1,0.00001,15,0.135571,0.143077,0,0.5,0
101125,101125,,6,24,30,6,24,30,0.000505,0.003094,0,15522,3,0.000013,12,0.212731,0.236276,9339.785316,0.205747,0.004629
101126,101126,,60,274,334,60,274,334,0.005683,0.052637,0,15828,2,0.000041,12,0.248611,0.304361,925971.362824,0.040639,0.017221
9711109,9711109,,2,19,21,2,19,21,0.000754,0.003983,0,6433,2,0.00001,14,0.196279,0.225711,12953.868522,0.197619,0.000943
9902043,9902043,,1,15,16,1,15,16,0.000618,0.002842,0,15827,2,0.00001,13,0.183216,0.209605,457.464684,0.258333,0.000664
9709037,9709037,,1,17,18,1,17,18,0.000047,0.004981,0,6432,2,0.00001,13,0.202073,0.231479,51.14983,0.228758,0.000239
9705065,9705065,,2,14,16,2,14,16,0.000289,0.003603,0,5543,13,0.000018,14,0.190961,0.226792,47151.126282,0.254167,0.000852
9709006,9709006,,1,22,23,1,22,23,0.000135,0.005953,0,6435,2,0.00001,13,0.2,0.229831,217.981452,0.187747,0.000279
9710242,9710242,,2,14,16,2,14,16,0.000576,0.009429,0,6434,2,0.00001,13,0.197797,0.230634,14.327341,0.2625,0.000505
101127,101127,,10,13,23,10,13,23,0.000515,0.000256,0,16720,4,0.000013,12,0.186964,0.204912,9942.768234,0.29249,0.002373
101128,101128,,0,3,3,0,3,3,0,0,0,17217,5,0.00001,4,0.342466,0.391667,0,0.166667,0
101129,101129,,3,7,10,3,7,10,0.000069,0.00025,0,17218,0,0.000011,12,0.182226,0.200375,910.900979,0.1,0.000865
101130,101130,,2,7,9,2,7,9,0.000001,0.000041,0,17219,30,0.000014,14,0.160071,0.170816,17199.928589,0.194444,0.000445
101131,101131,,4,2,6,4,2,6,0.000002,0,0,17220,5,0.000015,6,0.266304,0.308844,14.068838,0.3,0.000897
101132,101132,,3,17,20,3,17,20,0.000082,0.002515,0,15997,2,0.000013,12,0.197225,0.220473,37873.098573,0.065789,0.001016
101133,101133,,9,4,13,9,4,13,0.000747,0.000091,0,16287,1,0.00002,12,0.187874,0.204813,39.73799,0.307692,0.002301
101134,101134,,8,9,17,8,9,17,0.001215,0.01211,0,16043,1,0.000015,14,0.187856,0.209364,3464.360022,0.176471,0.002068
101135,101135,,14,44,58,14,44,58,0.000698,0.002456,0,15943,52,0.000015,13,0.218423,0.247586,61658.221232,0.107683,0.003466
101136,101136,,3,13,16,3,13,16,0.000501,0.006471,0,16022,1,0.000011,16,0.194441,0.220613,1625.281416,0.15,0.000749
101137,101137,,0,1,1,0,1,1,0,0,0,17221,4,0.00001,17,0.133877,0.148031,0,0,0
101139,101139,,0,12,12,0,12,12,0,0.002581,0,17222,4,0.00001,13,0.187769,0.207234,0,0.25,0
101141,101141,,0,5,5,0,5,5,0,0.000004,0,17223,15,0.00001,13,0.147706,0.157664,0,0.35,0
101143,101143,,7,35,42,7,35,42,0.000605,0.003092,0,17224,52,0.000012,17,0.210393,0.238762,17442.807577,0.175958,0.001766
101144,101144,,0,22,22,0,22,22,0,0.017989,0,17225,1,0.00001,14,0.193382,0.22015,0,0.164502,0
101146,101146,,0,3,3,0,3,3,0,0.000007,0,17226,25,0.00001,12,0.170351,0.182116,0,0.166667,0
9407011,9407011,,3,0,3,3,0,3,0.00002,0,0,5461,15,0.000016,0,0,0,0,0,0.000685
101147,101147,,0,25,25,0,25,25,0,0.002854,0,17227,4,0.00001,14,0.189715,0.219962,0,0.19,0
101148,101148,,2,1,3,2,1,3,0,0,0,17228,22,0.000027,2,0.6,0.666667,6,0.166667,0.000445
101149,101149,,2,3,5,2,3,5,0,0.000003,0,17229,5,0.000013,13,0.110245,0.133885,0,0.4,0.000445
101150,101150,,1,10,11,1,10,11,0.000022,0.000213,0,17231,4,0.00001,14,0.172519,0.194848,316.130469,0.127273,0.000252
9908177,9908177,,1,0,1,1,0,1,0.000003,0,0,17230,4,0.000011,0,0,0,0,0,0.000226
101151,101151,,17,16,33,17,16,33,0.000107,0.000117,0,15874,52,0.00003,13,0.167062,0.182088,50884.878755,0.110795,0.004605
9209029,9209029,,7,0,7,7,0,7,0.000001,0,0,1042,9,0.000041,0,0,0,0,0.261905,0.002084
101152,101152,,17,14,31,17,14,31,0.000424,0.006062,0,16096,52,0.000027,14,0.183643,0.206157,45397.989577,0.11828,0.005659
101153,101153,,4,3,7,4,3,7,0.000051,0.000002,0,17232,23,0.00002,8,0.216697,0.243282,214.525184,0.119048,0.000936
9701005,9701005,,8,0,8,8,0,8,0.000134,0,0,13936,6,0.000055,0,0,0,0,0.035714,0.001879
101154,101154,,5,17,22,5,17,22,0.000363,0.00327,0,17233,25,0.000012,13,0.186245,0.208626,1794.27762,0.15368,0.00121
105111,105111,,32,16,48,32,16,48,0.001976,0.00222,0,15963,25,0.000032,14,0.19376,0.216663,64556.26369,0.115691,0.008835
104010,104010,,2,8,10,2,8,10,0.000043,0.001058,0,15961,30,0.000014,14,0.193523,0.212216,38396.10103,0.111111,0.000824
104071,104071,,31,14,45,31,14,45,0.002613,0.008048,0,15960,25,0.000032,15,0.18699,0.211917,6180.167269,0.135354,0.008636
101155,101155,,5,8,13,5,8,13,0.000022,0.000005,0,17234,5,0.000016,16,0.12267,0.131711,9829.617058,0.237179,0.001162
101156,101156,,0,2,2,0,2,2,0,0,0,17242,23,0.00001,18,0.112852,0.11996,0,0.5,0
9911118,9911118,,4,8,12,4,8,12,0,0.000001,0,17240,23,0.000019,18,0.126352,0.136605,7636.237262,0.181818,0.000903
9912128,9912128,,4,7,11,4,7,11,0,0,0,17241,23,0.000018,17,0.121582,0.130192,11561.203849,0.163636,0.000877
9608193,9608193,,3,0,3,3,0,3,0,0,0,17239,23,0.000015,0,0,0,0,0.5,0.00071
9912097,9912097,,3,3,6,3,3,6,0,0,0,17237,23,0.000016,16,0.134144,0.14505,25378.930269,0.233333,0.000697
9912114,9912114,,2,4,6,2,4,6,0,0,0,17238,23,0.000013,17,0.118739,0.126896,217.576062,0.3,0.000464
101157,101157,,0,16,16,0,16,16,0,0.000076,0,17243,20,0.00001,13,0.179474,0.196052,0,0.116667,0
101158,101158,,1,8,9,1,8,9,0,0.000229,0,17244,1,0.000012,13,0.159894,0.171622,5311.628648,0.152778,0.000226
9504162,9504162,,6,8,14,6,8,14,0.00001,0.000131,0,9837,5,0.000021,4,0.445312,0.513158,878.84387,0.10989,0.001375
9610129,9610129,,2,11,13,2,11,13,0.000006,0.000315,0,9838,5,0.000012,10,0.217088,0.245823,5576.959281,0.070513,0.000472
101159,101159,,10,19,29,10,19,29,0.000389,0.000624,0,15897,30,0.000015,18,0.189251,0.207335,3690.828394,0.169951,0.003268
102101,102101,,15,24,39,15,24,39,0.000877,0.001079,0,15898,30,0.000017,18,0.19054,0.210484,5666.565028,0.212551,0.006291
102022,102022,,11,62,73,11,62,73,0.000532,0.004266,0,15896,30,0.000014,18,0.209342,0.236654,12987.485662,0.190449,0.003851
102070,102070,,15,8,23,15,8,23,0.000678,0.001268,0,15888,30,0.000018,14,0.187807,0.204839,2510.566582,0.193676,0.005996
107022,107022,,12,28,40,12,28,40,0.000581,0.001396,0,17247,30,0.000014,12,0.205066,0.227823,50017.363334,0.150641,0.003848
103069,103069,,30,40,70,30,40,70,0.001457,0.004503,0,15887,30,0.000028,14,0.201666,0.226189,25854.615706,0.149689,0.010936
103131,103131,,6,10,16,6,10,16,0.000231,0.001232,0,17246,30,0.000012,19,0.183706,0.203387,148.731111,0.304167,0.001762
104190,104190,,11,20,31,11,20,31,0.000282,0.002058,0,17245,30,0.000015,14,0.206069,0.228745,24588.728768,0.144086,0.002713
109222,109222,,12,20,32,12,20,32,0.000334,0.000968,0,17248,30,0.000014,13,0.210356,0.230251,957.411811,0.212702,0.003141
106048,106048,,220,175,395,220,175,395,0.007351,0.023699,0,15930,30,0.000148,12,0.257827,0.298221,2442441.838472,0.025259,0.056088
101160,101160,,4,8,12,4,8,12,0.000167,0.00013,0,17250,25,0.000013,18,0.189233,0.213593,7974.890852,0.098485,0.001018
10011,10011,,1,0,1,1,0,1,0.000002,0,0,17249,25,0.000011,0,0,0,0,0,0.000247
101161,101161,,17,29,46,17,29,46,0.000863,0.000867,0,15723,0,0.000019,13,0.19837,0.223784,63744.187563,0.071498,0.004515
9608074,9608074,,1,2,3,1,2,3,0.00001,0,0,15721,22,0.00001,4,0.3125,0.375,3450.577562,0,0.00034
9710072,9710072,,2,7,9,2,7,9,0.000017,0.000058,0,15720,13,0.000011,13,0.161274,0.183237,1522.452118,0.152778,0.000589
9709048,9709048,,2,5,7,2,5,7,0.000022,0.000052,0,11038,13,0.000012,12,0.171237,0.192158,2228.461872,0.261905,0.00046
101162,101162,,34,33,67,34,33,67,0.000925,0.001778,0,15752,3,0.000029,14,0.189787,0.21109,1900.528671,0.253731,0.016614
101163,101163,,5,8,13,5,8,13,0.000001,0.000019,0,17251,22,0.000017,15,0.14705,0.160916,9020.772476,0.25,0.001162
101165,101165,,3,3,6,3,3,6,0.000023,0.000002,0,17252,23,0.000022,8,0.217762,0.244773,487.822736,0.133333,0.000677
101166,101166,,2,5,7,2,5,7,0.000026,0.000003,0,17254,4,0.000013,17,0.147722,0.161495,2200.236513,0.071429,0.000471
9701024,9701024,,1,3,4,1,3,4,0,0.000023,0,17253,4,0.000012,13,0.174288,0.19892,560.330509,0.25,0.000233
9501080,9501080,,5,4,9,5,4,9,0,0.000007,0,13345,8,0.000022,2,0.75,0.833333,106.173509,0.111111,0.001142
101167,101167,,1,5,6,1,5,6,0,0.000007,0,17255,23,0.000011,18,0.129082,0.14588,63.871699,0.166667,0.000226
101169,101169,,1,18,19,1,18,19,0.000203,0.011658,0,17256,1,0.00001,15,0.215162,0.247614,3286.350279,0.178363,0.000219
9907116,9907116,,5,38,43,5,38,43,0.000526,0.021534,0,16286,1,0.000014,11,0.230723,0.263857,5641.36098,0.16113,0.001274
101170,101170,,8,14,22,8,14,22,0.000108,0.000171,0,16320,52,0.000017,16,0.173122,0.196468,30048.5392,0.075758,0.002123
101171,101171,,7,3,10,7,3,10,0.000004,0.000007,0,17257,23,0.000019,17,0.138081,0.149405,506.008437,0.344444,0.001726
101173,101173,,0,2,2,0,2,2,0,0.000036,0,17258,4,0.00001,12,0.186681,0.200862,0,0,0
101174,101174,,0,26,26,0,26,26,0,0.000018,0,17259,6,0.00001,17,0.152088,0.168661,0,0.161538,0
9212007,9212007,,22,0,22,22,0,22,0.000016,0,0,3077,15,0.000065,0,0,0,0,0.02381,0.005275
101175,101175,,0,2,2,0,2,2,0,0,0,17260,17,0.00001,6,0.327869,0.381667,0,0.5,0
9407166,9407166,,2,3,5,2,3,5,0,0.000001,0,10618,17,0.000018,2,0.8,0.875,47.644522,0.2,0.000472
101176,101176,,18,4,22,18,4,22,0.003047,0.001872,0,15401,8,0.000028,12,0.19512,0.21365,34560.262646,0.279221,0.011184
101177,101177,,11,29,40,11,29,40,0.000439,0.001776,0,15826,30,0.000019,14,0.207172,0.229184,68615.567134,0.189103,0.003382
101178,101178,,8,1,9,8,1,9,0,0,0,17262,2,0.000056,1,1,1,3,0.236111,0.001839
12235,12235,,5,0,5,5,0,5,0,0,0,17261,2,0.000076,0,0,0,0,0.3,0.001175
101179,101179,,1,14,15,1,14,15,0.000039,0.003272,0,17263,2,0.00001,13,0.192797,0.217064,84.72918,0.147619,0.000226
101180,101180,,3,8,11,3,8,11,0,0,0,17264,6,0.000014,14,0.147748,0.158727,2631.843134,0.227273,0.000704
101181,101181,,1,9,10,1,9,10,0.000035,0.017918,0,17265,1,0.00001,12,0.200009,0.221854,1508.087332,0.188889,0.000239
101182,101182,,1,18,19,1,18,19,0.000095,0.008721,0,17266,26,0.000011,16,0.179502,0.202461,10965.041202,0.114035,0.000226
101183,101183,,1,2,3,1,2,3,0,0.00002,0,17268,22,0.000013,2,0.5625,0.611111,0,0.5,0.000219
9612125,9612125,,3,2,5,3,2,5,0.000001,0.00002,0,17267,22,0.000019,2,0.571429,0.625,5,0.2,0.000677
101184,101184,,0,7,7,0,7,7,0,0.000033,0,17269,30,0.00001,14,0.159676,0.170609,0,0.214286,0
101185,101185,,5,11,16,5,11,16,0.000089,0.001349,0,15554,25,0.000013,16,0.184966,0.205929,2018.570954,0.233333,0.001222
101186,101186,,2,34,36,2,34,36,0.000044,0.001726,0,17270,0,0.000011,13,0.210342,0.239822,2367.158048,0.092857,0.000686
101187,101187,,12,17,29,12,17,29,0.000187,0.001097,0,16134,52,0.00002,17,0.170019,0.195128,84497.732538,0.102217,0.003254
5104,5104,,2,0,2,2,0,2,0.000013,0,0,16133,52,0.00002,0,0,0,0,0,0.000525
101188,101188,,4,11,15,4,11,15,0.00003,0.006311,0,17271,22,0.000012,13,0.185107,0.205927,8583.94049,0.119048,0.000943
101189,101189,,8,5,13,8,5,13,0.000143,0.000047,0,17272,30,0.000015,15,0.17859,0.193663,11517.349737,0.128205,0.001867
105087,105087,,11,33,44,11,33,44,0.000247,0.003192,0,17273,30,0.000015,14,0.215537,0.242109,11209.19995,0.093023,0.00271
101190,101190,,2,8,10,2,8,10,0.000001,0.000001,0,17274,22,0.000011,13,0.149817,0.169722,938.951973,0.244444,0.000458
101191,101191,,1,12,13,1,12,13,0.000001,0.000012,0,17275,20,0.00001,13,0.164324,0.178174,6.256746,0.346154,0.000219
9705096,9705096,,1,2,3,1,2,3,0,0,0,9798,20,0.000011,2,0.75,0.833333,30.62623,0.333333,0.000337
101192,101192,,22,14,36,22,14,36,0.001179,0.00085,0,17276,2,0.000025,15,0.189894,0.209649,9200.182104,0.163492,0.006104
101194,101194,,16,19,35,16,19,35,0.001981,0.018819,0,16288,1,0.000023,11,0.225405,0.256112,20441.437829,0.151261,0.004091
101195,101195,,13,15,28,13,15,28,0.000719,0.000424,0,17277,2,0.000017,14,0.197906,0.218233,8862.929524,0.227513,0.003208
101196,101196,,4,23,27,4,23,27,0.000088,0.000493,0,17280,30,0.000012,14,0.190002,0.208593,4464.496,0.079772,0.000903
9804022,9804022,,3,4,7,3,4,7,0.000006,0.000002,0,17279,23,0.000012,15,0.155552,0.176137,9171.448793,0.119048,0.00069
9902014,9902014,,4,4,8,4,4,8,0.000033,0.000002,0,17278,23,0.000014,2,0.75,0.833333,1093.892723,0.017857,0.000967
101197,101197,,1,1,2,1,1,2,0,0,0,17282,22,0.000013,2,0.666667,0.75,0,0.5,0.000219
9901068,9901068,,3,1,4,3,1,4,0,0,0,17281,22,0.000033,1,1,1,3,0.083333,0.000664
101198,101198,,16,19,35,16,19,35,0.000512,0.001756,0,12486,25,0.000019,15,0.191511,0.214132,21588.023221,0.119328,0.004466
9309046,9309046,,1,3,4,1,3,4,0.000004,0.000003,0,8316,5,0.000013,4,0.298969,0.367816,349.235284,0,0.000304
101199,101199,,25,53,78,25,53,78,0.001334,0.006321,0,15492,30,0.000021,13,0.215665,0.24413,52563.623277,0.104895,0.009283
101200,101200,,18,20,38,18,20,38,0.00085,0.003084,0,15868,3,0.000016,12,0.20173,0.223399,13118.591846,0.164296,0.00637
101201,101201,,13,11,24,13,11,24,0.000632,0.000053,0,17284,1,0.000021,13,0.188077,0.20357,22941.21594,0.103261,0.003499
9704132,9704132,,2,0,2,2,0,2,0.00002,0,0,17283,1,0.000012,0,0,0,0,0,0.000545
101202,101202,,9,11,20,9,11,20,0.000852,0.003182,0,15703,1,0.000018,20,0.195237,0.233997,61178.499301,0.123684,0.003105
101203,101203,,4,8,12,4,8,12,0.000239,0.000407,0,15549,25,0.000016,16,0.173844,0.192347,8925.101943,0.19697,0.00106
101204,101204,,0,3,3,0,3,3,0,0.000004,0,17285,1,0.00001,14,0.160683,0.175013,0,0.333333,0
101205,101205,,0,20,20,0,20,20,0,0.001238,0,17286,52,0.00001,16,0.188645,0.211981,0,0.189474,0
101206,101206,,27,5,32,27,5,32,0.002148,0.000294,0,16161,10,0.000024,16,0.196564,0.215968,962.097686,0.231855,0.012394
101207,101207,,15,10,25,15,10,25,0.000791,0.001338,0,15759,3,0.000015,15,0.183787,0.20314,2114.845474,0.258333,0.004281
101208,101208,,0,12,12,0,12,12,0,0.000777,0,17287,0,0.00001,13,0.191211,0.213636,0,0.272727,0
101209,101209,,16,21,37,16,21,37,0.000458,0.002377,0,15470,30,0.000021,18,0.195442,0.2173,39188.985282,0.088589,0.003911
101210,101210,,3,32,35,3,32,35,0.000047,0.003695,0,17288,0,0.000014,13,0.19609,0.222961,33587.247862,0.111765,0.000803
101211,101211,,14,68,82,14,68,82,0.000658,0.007931,0,16144,52,0.000014,14,0.233103,0.265449,61968.982825,0.087022,0.003749
101212,101212,,4,46,50,4,46,50,0.000544,0.019704,0,17289,25,0.000011,13,0.22041,0.249342,10777.142688,0.11551,0.001038
101213,101213,,2,13,15,2,13,15,0.000308,0.000447,0,15763,3,0.000011,14,0.189752,0.209965,9429.717766,0.195238,0.00104
101214,101214,,4,15,19,4,15,19,0.000672,0.002441,0,15717,25,0.000011,14,0.196317,0.218873,408.940814,0.251462,0.001098
101215,101215,,0,19,19,0,19,19,0,0.000459,0,17290,2,0.00001,16,0.162631,0.198593,0,0.140351,0
101216,101216,,3,19,22,3,19,22,0.000277,0.005877,0,17291,30,0.000011,13,0.196648,0.218076,191.128769,0.28355,0.001465
101217,101217,,1,9,10,1,9,10,0.000003,0.000054,0,17292,30,0.00001,19,0.122302,0.137892,2.395833,0.211111,0.000219
101218,101218,,9,10,19,9,10,19,0.000272,0.000919,0,17293,52,0.000013,12,0.201855,0.221346,9960.843996,0.143275,0.002471
101219,101219,,39,50,89,39,50,89,0.001808,0.010476,0,15852,30,0.000032,13,0.224777,0.254312,239198.365307,0.050562,0.010902
101220,101220,,1,26,27,1,26,27,0.000003,0.004821,0,17295,52,0.000011,15,0.19873,0.225366,22959.817897,0.136752,0.000259
9610081,9610081,,6,7,13,6,7,13,0.000067,0.00002,0,17294,52,0.000015,6,0.268561,0.309954,581.858517,0.070513,0.001401
101221,101221,,5,5,10,5,5,10,0.000565,0.000089,0,15965,13,0.000011,15,0.192084,0.211238,140.083225,0.3,0.001384
101222,101222,,0,6,6,0,6,6,0,0.000204,0,17296,30,0.00001,13,0.183963,0.198232,0,0.1,0
101224,101224,,1,7,8,1,7,8,0,0.000497,0,17297,4,0.000011,13,0.173753,0.198581,416.917876,0.125,0.000219
9401049,9401049,,2,1,3,2,1,3,0.000006,0,0,4964,4,0.000016,1,1,1,66.087109,0,0.000452
9502161,9502161,,4,1,5,4,1,5,0.000004,0.000001,0,1867,4,0.000017,1,1,1,4840.784989,0.1,0.001043
101225,101225,,8,12,20,8,12,20,0.001169,0.007672,0,17298,1,0.000014,12,0.193084,0.213438,31806.150986,0.226316,0.002209
9702188,9702188,,3,12,15,3,12,15,0.000093,0.000067,0,10609,4,0.000012,7,0.272566,0.317806,5768.832259,0.066667,0.000723
9311097,9311097,,7,1,8,7,1,8,0.000007,0.000098,0,728,4,0.000044,2,0.666667,0.75,18.220385,0.160714,0.001737
101226,101226,,5,17,22,5,17,22,0.000197,0.003126,0,17299,30,0.000011,14,0.199161,0.221842,2304.175295,0.149351,0.001345
101227,101227,,2,2,4,2,2,4,0,0.000005,0,17300,6,0.000013,19,0.113735,0.124162,5030.644481,0.083333,0.000445
9412130,9412130,,4,0,4,4,0,4,0,0,0,13316,6,0.000024,0,0,0,0,0.083333,0.000917
101228,101228,,8,12,20,8,12,20,0.000191,0.001954,0,15981,25,0.000018,13,0.195296,0.216391,3933.527989,0.2,0.002168
101229,101229,,6,8,14,6,8,14,0.0004,0.000977,0,15999,3,0.000024,16,0.187662,0.210414,35916.258804,0.104396,0.002068
101230,101230,,1,3,4,1,3,4,0,0.000001,0,17301,23,0.000013,15,0.143055,0.156439,740.425701,0.333333,0.000245
101231,101231,,2,6,8,2,6,8,0.000004,0.000014,0,17302,6,0.000012,16,0.135139,0.149525,963.579241,0.267857,0.000492
9508084,9508084,,3,13,16,3,13,16,0,0.000012,0,1503,9,0.000021,6,0.277448,0.3459,179127.550552,0.1625,0.00082
101232,101232,,1,39,40,1,39,40,0.000242,0.011817,0,15993,1,0.00001,14,0.224098,0.253672,54272.48968,0.15,0.000357
101233,101233,,22,3,25,22,3,25,0.000453,0.000992,0,17303,0,0.000033,12,0.191127,0.209076,28590.604451,0.065,0.005743
101234,101234,,26,13,39,26,13,39,0.000787,0.002032,0,15562,25,0.000026,17,0.189203,0.211542,45055.228586,0.139676,0.007592
101235,101235,,6,12,18,6,12,18,0.001193,0.011293,0,17304,1,0.000012,14,0.217422,0.250357,2309.323236,0.320261,0.001467
101236,101236,,2,33,35,2,33,35,0.000005,0.004749,0,17305,30,0.000012,15,0.202466,0.22687,10601.869515,0.094118,0.000451
102001,102001,,7,17,24,7,17,24,0.000795,0.002,0,17306,1,0.000013,15,0.182881,0.205188,363.894654,0.28442,0.002146
102002,102002,,1,10,11,1,10,11,0.000004,0.00119,0,17307,2,0.000011,12,0.197962,0.219227,1803.977102,0.127273,0.000219
102005,102005,,3,16,19,3,16,19,0.000006,0.001968,0,17309,4,0.000013,16,0.16921,0.193451,22434.907595,0.078947,0.000691
9907169,9907169,,3,17,20,3,17,20,0.000045,0.000589,0,17308,1,0.000013,15,0.168848,0.190646,14974.080853,0.121053,0.000803
9910125,9910125,,3,18,21,3,18,21,0.000187,0.003323,0,15013,4,0.000011,14,0.196672,0.22458,6790.166203,0.214286,0.000727
9804007,9804007,,2,16,18,2,16,18,0.000078,0.009834,0,15012,4,0.000011,13,0.206355,0.23368,4776.010544,0.156863,0.000459
102007,102007,,28,38,66,28,38,66,0.002041,0.006678,0,15844,30,0.000021,13,0.216757,0.245718,143029.03727,0.100699,0.009835
102008,102008,,3,7,10,3,7,10,0,0,0,17313,28,0.00002,14,0.135151,0.142385,12674.735009,0.177778,0.000677
9506175,9506175,,3,1,4,3,1,4,0,0,0,17311,28,0.000022,1,1,1,0,0.416667,0.00069
9512050,9512050,,2,2,4,2,2,4,0,0,0,17312,28,0.000015,1,1,1,0,0.416667,0.000458
9707218,9707218,,2,2,4,2,2,4,0,0,0,17310,28,0.000017,1,1,1,1,0.25,0.000471
102009,102009,,21,16,37,21,16,37,0.000566,0.002641,0,17314,2,0.000024,16,0.19817,0.222114,17819.125875,0.167417,0.005785
102010,102010,,7,20,27,7,20,27,0.000036,0.001917,0,16115,6,0.000014,14,0.197178,0.219239,115511.820303,0.075499,0.001791
9412169,9412169,,5,7,12,5,7,12,0.000043,0.000016,0,16112,6,0.000013,5,0.37013,0.445029,3064.23351,0.083333,0.001226
9806053,9806053,,2,1,3,2,1,3,0.000024,0.001016,0,16109,6,0.000013,12,0.195286,0.219301,394.330392,0.166667,0.000501
9806107,9806107,,2,4,6,2,4,6,0.000024,0.000162,0,16110,6,0.000011,12,0.189965,0.211177,242.043852,0.133333,0.000508
9304144,9304144,,2,0,2,2,0,2,0,0,0,16111,6,0.000015,0,0,0,0,0,0.000473
102011,102011,,2,14,16,2,14,16,0.000001,0.000038,0,17315,20,0.000011,13,0.170961,0.186444,178.538068,0.233333,0.000471
102012,102012,,3,1,4,3,1,4,0.000001,0.000002,0,17316,1,0.000019,17,0.145906,0.155409,0,0.25,0.000716
102013,102013,,6,6,12,6,6,12,0.000027,0.000001,0,17317,23,0.000015,13,0.16052,0.180295,6819.439631,0.189394,0.001387
102014,102014,,6,5,11,6,5,11,0.000012,0.000004,0,17318,15,0.000019,14,0.160958,0.171429,34820.454232,0.290909,0.001367
102015,102015,,4,8,12,4,8,12,0.000107,0.000506,0,15568,25,0.000012,15,0.178291,0.195143,511.193173,0.166667,0.001163
102016,102016,,16,28,44,16,28,44,0.00037,0.002723,0,15467,30,0.000022,13,0.20913,0.231869,50726.903259,0.153805,0.005348
102017,102017,,2,12,14,2,12,14,0.000012,0.000638,0,17319,3,0.000012,16,0.171135,0.188175,7472.634214,0.164835,0.000451
102018,102018,,10,38,48,10,38,48,0.000321,0.002436,0,16149,52,0.000014,14,0.197582,0.225113,14796.980404,0.133865,0.003242
102020,102020,,0,16,16,0,16,16,0,0.017192,0,17320,26,0.00001,12,0.203804,0.228194,0,0.229167,0
102021,102021,,11,18,29,11,18,29,0.000012,0.000002,0,17321,22,0.000019,17,0.147282,0.158772,22993.907471,0.198276,0.002569
102108,102108,,2,23,25,2,23,25,0,0.000016,0,17324,22,0.000012,18,0.142851,0.155282,813.212607,0.138333,0.000465
11274,11274,,1,0,1,1,0,1,0,0,0,17323,22,0.00001,0,0,0,0,0,0.000232
102096,102096,,4,3,7,4,3,7,0,0,0,17322,22,0.000015,15,0.141587,0.150789,5.754762,0.309524,0.000897
9210140,9210140,,2,0,2,2,0,2,0.000001,0,0,12541,22,0.000014,0,0,0,0,0,0.000503
9605162,9605162,,3,2,5,3,2,5,0.000002,0.000003,0,12540,22,0.000016,3,0.526316,0.583333,17.013034,0.25,0.000781
102023,102023,,19,20,39,19,20,39,0.000533,0.002066,0,15566,25,0.000021,15,0.19057,0.213283,13103.961765,0.136302,0.004942
102024,102024,,2,18,20,2,18,20,0,0.000032,0,17327,6,0.000011,15,0.112555,0.140153,262.211628,0.192105,0.000451
9904194,9904194,,3,6,9,3,6,9,0.000001,0.000026,0,17325,6,0.000013,11,0.184648,0.225942,91.818146,0.277778,0.000677
9910128,9910128,,1,9,10,1,9,10,0,0.000027,0,17326,6,0.00001,15,0.107555,0.125253,0.952381,0.3,0.000232
102026,102026,,13,14,27,13,14,27,0.000036,0.000026,0,17328,23,0.000019,14,0.163071,0.179848,78473.630729,0.146724,0.003047
102027,102027,,1,5,6,1,5,6,0,0.000005,0,17329,20,0.00001,13,0.163815,0.176527,9.029362,0.3,0.000226
102028,102028,,6,8,14,6,8,14,0.00001,0.000004,0,17330,20,0.000035,5,0.413333,0.539785,4393.517459,0.027473,0.001382
102029,102029,,0,10,10,0,10,10,0,0.000008,0,17332,28,0.00001,14,0.15302,0.165478,0,0.155556,0
9407036,9407036,,3,0,3,3,0,3,0,0,0,9615,28,0.000018,0,0,0,0,0.166667,0.000697
9809013,9809013,,1,2,3,1,2,3,0,0.000004,0,17331,26,0.000011,1,1,1,2,0.166667,0.000219
102030,102030,,1,9,10,1,9,10,0,0.005791,0,17333,22,0.000014,12,0.198756,0.218974,8400,0.055556,0.000219
102031,102031,,1,19,20,1,19,20,0.000046,0.001935,0,17334,0,0.00001,14,0.18557,0.210092,889.492482,0.147368,0.000226
102032,102032,,5,34,39,5,34,39,0.000968,0.019422,0,15637,25,0.000012,14,0.221615,0.255841,63923.606879,0.154521,0.001861
102033,102033,,2,15,17,2,15,17,0.000048,0.000659,0,16159,25,0.000011,13,0.19877,0.218994,3092.938081,0.375,0.000758
102034,102034,,1,2,3,1,2,3,0,0.00093,0,17335,21,0.000011,12,0.187106,0.202395,8018.082436,0,0.000219
102035,102035,,23,31,54,23,31,54,0.004216,0.012482,0,15616,25,0.00002,17,0.202704,0.24271,11903.855049,0.182041,0.00882
102036,102036,,1,16,17,1,16,17,0,0.000194,0,17336,4,0.000012,17,0.184393,0.212048,7132.778867,0.231618,0.000219
102037,102037,,0,5,5,0,5,5,0,0.000024,0,17337,20,0.00001,13,0.165078,0.179146,0,0.4,0
102038,102038,,1,17,18,1,17,18,0.000025,0.00254,0,17338,0,0.00001,13,0.21505,0.24233,12.131768,0.199346,0.000219
102039,102039,,5,12,17,5,12,17,0.00004,0.00007,0,17344,22,0.000014,15,0.158171,0.180707,7715.890288,0.117647,0.001195
9812157,9812157,,5,5,10,5,5,10,0.000003,0.000002,0,17343,22,0.000017,10,0.180357,0.216843,1139.16043,0.166667,0.001203
9405104,9405104,,5,1,6,5,1,6,0.000013,0.000004,0,4007,22,0.000018,1,1,1,20.378832,0.066667,0.001168
9409178,9409178,,1,0,1,1,0,1,0,0,0,16955,22,0.000011,0,0,0,0,0,0.000266
9410163,9410163,,2,1,3,2,1,3,0,0,0,16954,22,0.000012,1,1,1,95,0.166667,0.000492
9505060,9505060,,1,3,4,1,3,4,0,0.000009,0,16952,22,0.000011,2,0.666667,0.75,14.466667,0.083333,0.000266
9806006,9806006,,4,3,7,4,3,7,0.000001,0.000001,0,17342,22,0.000016,5,0.372881,0.457576,387.392857,0.142857,0.00093
9806192,9806192,,2,1,3,2,1,3,0.000001,0,0,17341,22,0.000014,2,0.666667,0.75,170,0.166667,0.000512
102040,102040,,2,15,17,2,15,17,0.000001,0.000022,0,17348,5,0.000011,16,0.125885,0.140104,50.304307,0.268382,0.000445
9809050,9809050,,3,10,13,3,10,13,0.000001,0.000022,0,17346,5,0.000012,12,0.142751,0.158644,4.810714,0.314103,0.00069
9809098,9809098,,2,11,13,2,11,13,0,0.000022,0,17347,5,0.000011,12,0.142822,0.159131,4.810714,0.314103,0.000458
9310141,9310141,,2,2,4,2,2,4,0.000001,0,0,5638,5,0.000014,1,1,1,608.639523,0.083333,0.000492
9803157,9803157,,7,0,7,7,0,7,0.000001,0,0,17345,5,0.000054,0,0,0,0,0.190476,0.001613
102041,102041,,9,40,49,9,40,49,0.000937,0.022558,0,17349,4,0.000017,12,0.240333,0.275937,70970.054502,0.110119,0.002674
102043,102043,,11,14,25,11,14,25,0.001959,0.008873,0,16219,1,0.000014,14,0.194138,0.220694,3408.228941,0.185,0.002943
102044,102044,,29,10,39,29,10,39,0.000939,0.001254,0,15830,30,0.000048,13,0.188999,0.206833,22468.230055,0.120108,0.009043
102045,102045,,20,23,43,20,23,43,0.001495,0.004308,0,15892,30,0.000018,14,0.200742,0.224512,19918.073552,0.147841,0.007628
102048,102048,,1,2,3,1,2,3,0.000001,0.000046,0,17350,30,0.000011,15,0.150718,0.16086,59.177755,0.166667,0.000219
102049,102049,,2,3,5,2,3,5,0,0.000008,0,17361,2,0.000015,16,0.126322,0.134446,14.12688,0.2,0.000459
9906065,9906065,,2,6,8,2,6,8,0,0.000001,0,17360,15,0.000016,4,0.444444,0.541667,4632.813218,0.178571,0.000472
9506008,9506008,,5,4,9,5,4,9,0,0.000001,0,17357,15,0.000015,1,1,1,91.632018,0.25,0.001129
9508011,9508011,,5,3,8,5,3,8,0,0.000001,0,17356,15,0.000015,1,1,1,73.683612,0.25,0.001129
9806057,9806057,,1,18,19,1,18,19,0,0.000006,0,17359,15,0.000012,3,0.675,0.808642,2982.929862,0.137427,0.000233
102050,102050,,6,2,8,6,2,8,0.000071,0.000799,0,17362,30,0.000015,14,0.179638,0.195232,10156.285321,0.232143,0.001436
102051,102051,,14,7,21,14,7,21,0.000087,0.000714,0,16283,8,0.000025,15,0.163213,0.182595,7879.632105,0.152381,0.003367
102052,102052,,0,5,5,0,5,5,0,0.000099,0,17363,41,0.00001,15,0.140219,0.156718,0,0.05,0
9505129,9505129,,4,21,25,4,21,25,0.000015,0.000344,0,2232,41,0.000014,6,0.334049,0.399839,12711.934534,0.13,0.000909
9503222,9503222,,17,12,29,17,12,29,0.001331,0.000358,0,2231,41,0.000032,5,0.357692,0.409767,6324.189451,0.176108,0.010067
102053,102053,,0,5,5,0,5,5,0,0.000044,0,17364,13,0.00001,12,0.151866,0.163207,0,0,0
102054,102054,,3,4,7,3,4,7,0.000001,0.000017,0,17365,20,0.000012,13,0.168347,0.181262,4.666667,0.333333,0.00071
102055,102055,,0,2,2,0,2,2,0,0,0,17368,30,0.00001,4,0.350649,0.395062,0,0.5,0
9801088,9801088,,5,4,9,5,4,9,0.000029,0.000012,0,17366,30,0.00004,3,0.5,0.553333,104.88869,0.111111,0.001116
9911162,9911162,,2,1,3,2,1,3,0,0,0,17367,30,0.000016,4,0.342105,0.371795,0,0.333333,0.000438
102056,102056,,13,28,41,13,28,41,0.000911,0.003974,0,17369,30,0.000014,14,0.208796,0.232381,5343.836277,0.178049,0.003309
102057,102057,,1,10,11,1,10,11,0.000007,0.008047,0,17370,26,0.000011,17,0.162078,0.184131,7222.911947,0.263636,0.000219
102059,102059,,0,2,2,0,2,2,0,0.000001,0,17371,26,0.00001,4,0.466667,0.583333,0,0,0
102060,102060,,9,16,25,9,16,25,0.0004,0.003395,0,17372,0,0.000016,17,0.203175,0.240918,23062.443376,0.148333,0.002239
102061,102061,,11,2,13,11,2,13,0.000367,0.000012,0,16290,5,0.000023,14,0.15116,0.166726,2031.0465,0.128205,0.002789
102062,102062,,0,14,14,0,14,14,0,0.001729,0,17373,25,0.00001,15,0.191798,0.215381,0,0.192308,0
102063,102063,,3,55,58,3,55,58,0.000071,0.002978,0,17374,3,0.000012,11,0.225538,0.25419,11593.521765,0.156987,0.000678
102064,102064,,2,28,30,2,28,30,0.000373,0.016129,0,17375,1,0.00001,12,0.202659,0.229795,298.578774,0.208046,0.000458
102065,102065,,0,11,11,0,11,11,0,0.001605,0,17376,0,0.00001,16,0.190483,0.217013,0,0.209091,0
102066,102066,,4,11,15,4,11,15,0.000321,0.001022,0,15928,30,0.000012,15,0.198218,0.219934,22558.303326,0.22381,0.002506
102067,102067,,2,3,5,2,3,5,0,0.000003,0,17378,28,0.000016,15,0.128451,0.139487,2544.693639,0.2,0.000445
9912205,9912205,,10,12,22,10,12,22,0.000228,0.001165,0,17377,28,0.000055,11,0.179956,0.204875,16771.580376,0.017316,0.002328
102069,102069,,0,9,9,0,9,9,0,0.000082,0,17379,4,0.00001,12,0.18543,0.205395,0,0.097222,0
9401117,9401117,,3,0,3,3,0,3,0.000002,0,0,2802,4,0.000014,0,0,0,0,0,0.000764
9503010,9503010,,3,0,3,3,0,3,0.000001,0,0,14904,22,0.000017,0,0,0,0,0.166667,0.000678
9709207,9709207,,3,8,11,3,8,11,0.000002,0.000024,0,5983,4,0.000014,5,0.425532,0.526667,12182.340123,0.145455,0.000672
9406078,9406078,,7,1,8,7,1,8,0.000046,0,0,5978,4,0.00002,1,1,1,1295.372296,0.160714,0.001759
102071,102071,,15,39,54,15,39,54,0.000492,0.002208,0,15750,3,0.000018,14,0.189975,0.211658,644.711156,0.307128,0.008578
102072,102072,,0,1,1,0,1,1,0,0.000002,0,17380,5,0.00001,7,0.20339,0.231002,0,0,0
9508102,9508102,,4,1,5,4,1,5,0,0,0,11750,5,0.000029,1,1,1,2003.349802,0.15,0.00095
9802146,9802146,,2,1,3,2,1,3,0,0,0,11748,26,0.000019,2,0.6,0.666667,761.955496,0.166667,0.000485
102073,102073,,7,1,8,7,1,8,0.000034,0.000001,0,17383,23,0.00004,2,0.6,0.666667,12,0.071429,0.001573
9811012,9811012,,6,2,8,6,2,8,0.000045,0,0,17382,23,0.000065,1,1,1,26,0.125,0.001394
9409018,9409018,,2,0,2,2,0,2,0,0,0,6845,23,0.000041,0,0,0,0,0,0.000499
9506049,9506049,,1,0,1,1,0,1,0,0,0,17381,23,0.000039,0,0,0,0,0,0.000259
102074,102074,,3,3,6,3,3,6,0.000064,0.00009,0,17384,52,0.000011,17,0.17786,0.193568,23.746054,0.333333,0.000672
102075,102075,,1,3,4,1,3,4,0,0.000001,0,17385,23,0.000011,15,0.140013,0.152499,0,0.5,0.000219
102076,102076,,87,84,171,87,84,171,0.00359,0.006272,0,15524,30,0.000065,12,0.221962,0.250433,327947.025935,0.058996,0.0293
102077,102077,,59,22,81,59,22,81,0.006434,0.013026,0,15400,8,0.000089,13,0.199146,0.222377,125287.905423,0.079475,0.024946
9505170,9505170,,8,11,19,8,11,19,0.000152,0.003,0,1946,13,0.000018,8,0.245129,0.294373,4263.685907,0.248538,0.002079
102078,102078,,0,11,11,0,11,11,0,0.00002,0,17389,9,0.00001,16,0.142488,0.166374,0,0.081818,0
9503042,9503042,,7,16,23,7,16,23,0.000002,0.000025,0,3208,9,0.000017,7,0.370031,0.455313,27201.190871,0.110672,0.001622
9708100,9708100,,1,2,3,1,2,3,0,0.000001,0,17388,9,0.000011,2,0.625,0.7,2.083333,0.333333,0.000219
9810059,9810059,,3,16,19,3,16,19,0.000055,0.000066,0,17386,9,0.000012,16,0.141969,0.168187,322.173242,0.102339,0.000658
9301040,9301040,,8,0,8,8,0,8,0.000002,0,0,1477,9,0.000026,0,0,0,0,0.071429,0.002155
9403012,9403012,,6,7,13,6,7,13,0.000002,0.000031,0,3173,9,0.000017,4,0.454545,0.55,1370.747792,0.147436,0.001517
9406005,9406005,,14,1,15,14,1,15,0.00001,0.00001,0,3191,9,0.00003,1,1,1,2.783333,0.2,0.003411
9410005,9410005,,8,15,23,8,15,23,0.000052,0.000023,0,3204,9,0.000017,6,0.439024,0.540046,5812.896684,0.088933,0.001828
9411168,9411168,,11,5,16,11,5,16,0.000011,0.00001,0,3194,9,0.000025,5,0.335079,0.405729,979.683396,0.183333,0.002609
9501084,9501084,,1,4,5,1,4,5,0,0.000001,0,17387,9,0.000015,1,1,1,4.083333,0.05,0.000226
102079,102079,,9,12,21,9,12,21,0.000002,0.00003,0,17390,6,0.000018,13,0.161332,0.207344,2061.993113,0.102381,0.002087
102080,102080,,24,52,76,24,52,76,0.00237,0.018437,0,17391,2,0.000019,13,0.239816,0.277788,83417.407988,0.102281,0.006131
9209063,9209063,,4,0,4,4,0,4,0,0,0,306,22,0.000121,0,0,0,0,0,0.00099
102081,102081,,1,5,6,1,5,6,0,0,0,17393,23,0.000012,15,0.126103,0.140181,11.75,0.166667,0.000226
9902076,9902076,,1,1,2,1,1,2,0,0.000003,0,17392,23,0.000012,1,1,1,0.916667,0,0.000226
102082,102082,,2,13,15,2,13,15,0.000017,0.002191,0,16040,25,0.000011,15,0.19432,0.216383,2073.470079,0.114286,0.000508
102083,102083,,3,8,11,3,8,11,0.000001,0.000001,0,17394,22,0.000013,16,0.128322,0.137747,5.893652,0.345455,0.00067
102084,102084,,1,16,17,1,16,17,0.000018,0.003221,0,17395,2,0.000011,15,0.177039,0.204715,502.075825,0.272059,0.000219
102085,102085,,74,104,178,74,104,178,0.002469,0.005268,0,15766,3,0.000048,12,0.215496,0.244462,156963.90156,0.095569,0.024018
102086,102086,,1,7,8,1,7,8,0.000003,0.000979,0,17397,30,0.000011,13,0.191367,0.20851,215.852771,0.267857,0.000219
6082,6082,,1,0,1,1,0,1,0.000012,0,0,17396,30,0.000011,0,0,0,0,0,0.000226
102087,102087,,3,9,12,3,9,12,0,0.000001,0,17398,26,0.000013,15,0.138921,0.150519,96.934897,0.333333,0.000677
102088,102088,,1,3,4,1,3,4,0,0.000006,0,17399,23,0.000012,14,0.132406,0.143772,1530.764295,0.25,0.000219
102089,102089,,2,18,20,2,18,20,0.000004,0.000106,0,17400,13,0.000011,15,0.159092,0.186974,155.974305,0.278947,0.000451
102090,102090,,1,15,16,1,15,16,0.000043,0.000262,0,17401,0,0.00001,12,0.20129,0.228139,397.02227,0.120833,0.000226
102091,102091,,3,12,15,3,12,15,0.000225,0.002797,0,16340,5,0.000012,16,0.186114,0.207511,22067.33153,0.095238,0.000801
102092,102092,,13,28,41,13,28,41,0.000209,0.002209,0,15475,30,0.000019,14,0.197746,0.219506,55559.167716,0.126829,0.003667
102181,102181,,37,10,47,37,10,47,0.001252,0.000094,0,15485,30,0.000032,14,0.189222,0.205675,33357.811495,0.095282,0.011161
102137,102137,,10,41,51,10,41,51,0.000145,0.001661,0,15484,30,0.000021,13,0.211447,0.235054,37769.373121,0.132549,0.003523
102093,102093,,14,5,19,14,5,19,0.000583,0.000158,0,15545,25,0.000029,16,0.183755,0.200894,22234.242238,0.216374,0.004049
102094,102094,,0,23,23,0,23,23,0,0.017057,0,17402,26,0.00001,12,0.203326,0.228048,0,0.20751,0
102095,102095,,10,22,32,10,22,32,0.00037,0.003966,0,16216,3,0.000014,12,0.201484,0.22465,3468.253628,0.114919,0.002688
102097,102097,,2,21,23,2,21,23,0.000186,0.01304,0,17413,1,0.000011,12,0.196742,0.219694,272.506316,0.146245,0.000451
9905220,9905220,,5,7,12,5,7,12,0.000234,0.000123,0,17411,8,0.000016,15,0.158096,0.174684,2082.499133,0.174242,0.001195
9910158,9910158,,6,2,8,6,2,8,0.000251,0.000107,0,17409,8,0.000017,14,0.159515,0.173164,920.719145,0.303571,0.001441
9910247,9910247,,5,3,8,5,3,8,0.000264,0.000067,0,17412,8,0.000012,16,0.144809,0.15828,23.783333,0.321429,0.001168
9911062,9911062,,1,12,13,1,12,13,0.000153,0.000834,0,17408,1,0.00001,12,0.188111,0.206395,115.743316,0.205128,0.000232
9611212,9611212,,1,1,2,1,1,2,0.000001,0.000004,0,17410,8,0.000012,1,1,1,0,0.5,0.000253
9605114,9605114,,4,2,6,4,2,6,0.000031,0.000469,0,17405,1,0.000014,1,1,1,0,0.466667,0.000943
9610008,9610008,,5,4,9,5,4,9,0.000039,0.000922,0,17404,1,0.000015,8,0.22891,0.26573,1291.53825,0.25,0.001162
9706170,9706170,,4,8,12,4,8,12,0.000031,0.000639,0,17406,1,0.000013,8,0.201293,0.232658,24.195398,0.272727,0.000916
9810245,9810245,,3,9,12,3,9,12,0.000024,0.000583,0,17407,1,0.000013,8,0.202656,0.236049,172.97747,0.295455,0.00069
102098,102098,,16,3,19,16,3,19,0.000095,0.000006,0,17414,15,0.000033,14,0.147159,0.157318,4.378211,0.248538,0.004242
102099,102099,,7,28,35,7,28,35,0.00015,0.002848,0,17416,0,0.000014,13,0.200471,0.228555,8073.640567,0.114286,0.001675
9703025,9703025,,2,0,2,2,0,2,0.000081,0,0,17415,0,0.000011,0,0,0,0,0.5,0.000486
102100,102100,,1,13,14,1,13,14,0,0.000007,0,17417,6,0.000012,13,0.137313,0.159386,2037.211655,0.148352,0.000226
104217,104217,,29,24,53,29,24,53,0.001366,0.001748,0,15890,30,0.000024,14,0.192016,0.213403,18446.662917,0.13389,0.009949
103020,103020,,9,8,17,9,8,17,0.001004,0.001903,0,15889,30,0.000014,15,0.184223,0.201996,246.596622,0.224265,0.004858
104097,104097,,25,15,40,25,15,40,0.000839,0.00213,0,15886,30,0.000028,13,0.18951,0.208255,12114.286788,0.164744,0.007802
102103,102103,,15,5,20,15,5,20,0.000378,0.000896,0,15831,30,0.000024,13,0.184167,0.200114,944.46767,0.215789,0.004237
102104,102104,,7,11,18,7,11,18,0.000078,0.000381,0,17418,4,0.000015,13,0.191185,0.220099,8498.634075,0.107843,0.001693
9607090,9607090,,6,8,14,6,8,14,0.000078,0.004195,0,5695,2,0.000018,10,0.213437,0.245702,3231.173622,0.115385,0.001429
102107,102107,,1,3,4,1,3,4,0,0.000026,0,17419,1,0.000014,14,0.157134,0.16998,11,0.083333,0.000219
102109,102109,,2,21,23,2,21,23,0.000025,0.001208,0,17423,13,0.000011,13,0.192577,0.214707,7511.788898,0.08498,0.000451
9705201,9705201,,1,6,7,1,6,7,0.000014,0.002242,0,17422,4,0.00001,6,0.267663,0.309898,59.956537,0.071429,0.000232
9707007,9707007,,3,13,16,3,13,16,0.00004,0.00292,0,17420,13,0.000012,13,0.206048,0.244794,1336.310564,0.129167,0.000684
9711199,9711199,,2,9,11,2,9,11,0.000032,0.000654,0,17421,13,0.000011,14,0.187586,0.222194,84.327181,0.227273,0.000451
9310135,9310135,,6,1,7,6,1,7,0.000541,0.000032,0,1389,13,0.000017,1,1,1,5.45157,0.142857,0.001719
102110,102110,,12,39,51,12,39,51,0.001212,0.012796,0,17424,0,0.000014,17,0.21775,0.257985,23910.675778,0.117647,0.003558
102111,102111,,2,19,21,2,19,21,0.00001,0.005805,0,17427,22,0.000011,13,0.167165,0.190311,4101.900327,0.054762,0.000438
9701180,9701180,,1,2,3,1,2,3,0.000068,0.000001,0,17426,22,0.00001,4,0.411765,0.547619,2.716667,0,0.000232
9911171,9911171,,2,3,5,2,3,5,0.000077,0.000004,0,17425,22,0.000011,6,0.322404,0.379096,0,0.35,0.000451
102112,102112,,94,36,130,94,36,130,0.002115,0.00186,0,15753,3,0.000076,13,0.19689,0.217748,22556.490462,0.139654,0.035958
102113,102113,,51,20,71,51,20,71,0.008117,0.017746,0,15624,8,0.000033,16,0.19153,0.217959,13247.481664,0.190141,0.018018
102114,102114,,12,78,90,12,78,90,0.000507,0.018028,0,15731,13,0.000018,12,0.23366,0.271046,87906.402635,0.059675,0.003076
102115,102115,,0,2,2,0,2,2,0,0.000001,0,17428,21,0.00001,2,0.75,0.833333,0,0,0
102116,102116,,1,25,26,1,25,26,0.000001,0.000061,0,17429,23,0.00001,13,0.179036,0.198732,0,0.152308,0.000226
102117,102117,,0,1,1,0,1,1,0,0,0,17430,21,0.00001,2,0.666667,0.75,0,0,0
102120,102120,,3,23,26,3,23,26,0.000112,0.000058,0,17431,20,0.000012,13,0.170522,0.186481,190.906324,0.184615,0.00069
102121,102121,,4,57,61,4,57,61,0.00009,0.00414,0,17432,4,0.000014,14,0.208328,0.237316,21334.592475,0.107104,0.000937
102122,102122,,11,26,37,11,26,37,0.000159,0.001173,0,16147,52,0.000016,13,0.204881,0.227945,30792.176519,0.15015,0.003508
102123,102123,,10,25,35,10,25,35,0.000511,0.001458,0,16239,0,0.000016,13,0.200232,0.226045,19538.116902,0.085714,0.002453
102124,102124,,1,6,7,1,6,7,0,0.000032,0,17433,22,0.000011,3,0.580645,0.657407,3,0.285714,0.000219
102125,102125,,6,50,56,6,50,56,0.001078,0.025801,0,16049,0,0.000012,14,0.211022,0.23997,24475.437578,0.166883,0.001744
102126,102126,,1,14,15,1,14,15,0.000249,0.003156,0,15673,25,0.00001,14,0.195998,0.218782,25.781459,0.219048,0.000281
102127,102127,,1,7,8,1,7,8,0.000037,0.001095,0,17435,13,0.00001,12,0.191707,0.210496,1112.305436,0.107143,0.000316
9305018,9305018,,1,0,1,1,0,1,0.000013,0,0,17434,13,0.000011,0,0,0,0,0,0.000227
102128,102128,,11,34,45,11,34,45,0.000753,0.017975,0,15724,25,0.000015,14,0.217111,0.248627,47379.56174,0.124242,0.003151
102129,102129,,23,35,58,23,35,58,0.000511,0.003392,0,15854,30,0.000032,12,0.206225,0.228875,109931.937932,0.096189,0.006681
102130,102130,,0,24,24,0,24,24,0,0.018323,0,17436,1,0.00001,16,0.190733,0.217364,0,0.217391,0
102131,102131,,0,3,3,0,3,3,0,0,0,17438,23,0.00001,15,0.125112,0.136329,0,0.5,0
9807217,9807217,,8,2,10,8,2,10,0,0,0,8972,23,0.000058,9,0.207447,0.229752,2495.961314,0.111111,0.001853
9902065,9902065,,4,1,5,4,1,5,0,0,0,8973,23,0.000019,10,0.172535,0.186344,0,0.25,0.000897
9912285,9912285,,1,11,12,1,11,12,0,0.000011,0,17437,23,0.000013,14,0.141965,0.158969,3173.969048,0.068182,0.000219
102132,102132,,0,26,26,0,26,26,0,0.003376,0,17439,3,0.00001,14,0.196326,0.222561,0,0.121538,0
102133,102133,,1,16,17,1,16,17,0.000023,0.000896,0,17440,52,0.00001,14,0.197116,0.220902,5491.50034,0.191176,0.000367
102134,102134,,2,5,7,2,5,7,0.000042,0.001748,0,17441,2,0.000011,13,0.165413,0.183805,29.946628,0.285714,0.000438
102135,102135,,7,13,20,7,13,20,0.000401,0.002217,0,17442,25,0.000014,12,0.203088,0.223609,4908.175712,0.089474,0.001837
102136,102136,,0,4,4,0,4,4,0,0.000012,0,17443,8,0.00001,14,0.148385,0.161135,0,0.5,0
9310099,9310099,,2,0,2,2,0,2,0,0,0,1770,22,0.000016,0,0,0,0,0,0.000509
102138,102138,,39,25,64,39,25,64,0.006711,0.007657,0,15625,8,0.000027,14,0.197393,0.219318,28557.595789,0.209821,0.014479
102139,102139,,0,2,2,0,2,2,0,0.000001,0,17444,21,0.00001,2,0.75,0.833333,0,0,0
102140,102140,,3,36,39,3,36,39,0.000245,0.002264,0,16339,5,0.000011,13,0.177699,0.211781,618.464497,0.088394,0.000782
9610061,9610061,,1,2,3,1,2,3,0.000003,0.000002,0,14943,5,0.000014,1,1,1,65.25,0.166667,0.000259
102141,102141,,0,18,18,0,18,18,0,0.003697,0,17445,30,0.00001,13,0.202106,0.223935,0,0.232026,0
102142,102142,,3,4,7,3,4,7,0.000013,0.000067,0,17446,25,0.00002,14,0.180801,0.200777,10423.762489,0.142857,0.000784
102143,102143,,0,1,1,0,1,1,0,0.000008,0,17447,5,0.00001,9,0.200929,0.223793,0,0,0
102144,102144,,9,11,20,9,11,20,0.000238,0.002012,0,15589,25,0.000017,15,0.190226,0.212556,6853.531311,0.142105,0.00236
102145,102145,,17,36,53,17,36,53,0.000616,0.003371,0,17448,25,0.000022,14,0.207177,0.234273,66507.664049,0.120464,0.004321
102146,102146,,6,35,41,6,35,41,0.00031,0.002402,0,17449,52,0.000012,18,0.193165,0.222099,2169.088211,0.12622,0.001598
102147,102147,,10,23,33,10,23,33,0.000254,0.001483,0,15558,25,0.000015,16,0.190978,0.212417,13340.030467,0.179924,0.002476
102148,102148,,1,18,19,1,18,19,0,0.00001,0,17450,6,0.000011,20,0.123605,0.159554,482.013876,0.201754,0.000226
102149,102149,,8,7,15,8,7,15,0.000098,0.012309,0,17452,13,0.000021,14,0.212691,0.245294,47016.204178,0.07619,0.002084
9909158,9909158,,1,2,3,1,2,3,0.000145,0.00186,0,17451,4,0.000013,6,0.263804,0.29832,18.364797,0.166667,0.000276
102150,102150,,0,16,16,0,16,16,0,0.002426,0,17453,4,0.00001,13,0.186791,0.2094,0,0.208333,0
102151,102151,,4,42,46,4,42,46,0.000246,0.003592,0,16013,2,0.000012,13,0.227582,0.256247,67392.412078,0.097585,0.001202
102152,102152,,0,6,6,0,6,6,0,0.000018,0,17454,23,0.00001,14,0.144541,0.162859,0,0,0
102153,102153,,2,14,16,2,14,16,0.000002,0.000072,0,17455,4,0.000012,13,0.174064,0.197136,2733.746687,0.245833,0.000471
102154,102154,,2,30,32,2,30,32,0.000744,0.006102,0,17456,25,0.000011,13,0.227615,0.261599,7578.571197,0.110887,0.000514
102155,102155,,7,53,60,7,53,60,0.000376,0.025658,0,16289,1,0.000015,14,0.218422,0.257301,52281.645084,0.125989,0.001837
9708072,9708072,,2,3,5,2,3,5,0.00018,0.000494,0,6584,1,0.000012,6,0.231602,0.269626,1418.652758,0.25,0.001041
102156,102156,,12,37,49,12,37,49,0.00035,0.000667,0,16119,9,0.000012,13,0.202682,0.229624,4661.786074,0.269983,0.003172
9411040,9411040,,2,1,3,2,1,3,0,0,0,13102,17,0.000106,2,0.6,0.666667,2040.651695,0,0.000593
9208016,9208016,,2,0,2,2,0,2,0,0,0,13544,52,0.000016,0,0,0,0,0,0.000467
102158,102158,,5,26,31,5,26,31,0.000266,0.019153,0,15883,30,0.000012,14,0.210041,0.233855,1896.672965,0.180645,0.001266
102160,102160,,3,14,17,3,14,17,0.000072,0.000877,0,15787,30,0.000011,13,0.197743,0.215751,2947.724353,0.268382,0.000993
102161,102161,,6,10,16,6,10,16,0.000113,0.001243,0,15574,25,0.000014,13,0.1904,0.208864,1343.156062,0.179167,0.001502
102162,102162,,3,6,9,3,6,9,0.001135,0.002406,0,17457,1,0.00001,13,0.218958,0.249942,191.651451,0.319444,0.000938
102163,102163,,2,15,17,2,15,17,0,0.00001,0,17458,6,0.000011,13,0.145884,0.166079,56.212694,0.268382,0.000484
9409076,9409076,,15,20,35,15,20,35,0.000003,0.000006,0,3857,6,0.000032,5,0.510417,0.652721,41825.105402,0.07479,0.003558
102164,102164,,1,31,32,1,31,32,0.000037,0.001882,0,17459,30,0.00001,14,0.203734,0.227548,221.157849,0.162298,0.000234
102165,102165,,2,4,6,2,4,6,0.000039,0.000976,0,16179,10,0.000011,14,0.163855,0.183825,216.513749,0.2,0.000601
102166,102166,,16,3,19,16,3,19,0.000914,0.000025,0,15543,1,0.000042,19,0.16627,0.179605,18242.681372,0.143275,0.004352
102167,102167,,1,2,3,1,2,3,0,0.00002,0,17460,5,0.000012,15,0.137182,0.153967,24.286406,0.166667,0.000239
102168,102168,,22,23,45,22,23,45,0.002155,0.001466,0,17461,30,0.00002,15,0.200108,0.224985,57261.338634,0.125758,0.006099
102169,102169,,0,23,23,0,23,23,0,0.002964,0,17462,4,0.00001,14,0.19825,0.222537,0,0.20751,0
102173,102173,,8,53,61,8,53,61,0.000213,0.006187,0,15792,3,0.000013,12,0.213139,0.23883,30075.998726,0.12459,0.002727
102174,102174,,14,42,56,14,42,56,0.000888,0.004394,0,15790,3,0.000015,12,0.208884,0.234708,18831.001031,0.151623,0.00432
102175,102175,,0,9,9,0,9,9,0,0.000017,0,17466,23,0.00001,18,0.139248,0.162313,0,0.125,0
9906001,9906001,,2,2,4,2,2,4,0.000001,0.000003,0,17465,28,0.000012,14,0.134276,0.143763,209.282635,0.25,0.000438
9907181,9907181,,1,1,2,1,1,2,0,0,0,17464,2,0.000011,1,1,1,1,0,0.000219
9911108,9911108,,1,2,3,1,2,3,0,0.000022,0,17463,1,0.000011,2,0.571429,0.625,8,0,0.000219
102176,102176,,7,19,26,7,19,26,0.000415,0.000801,0,16224,1,0.000013,16,0.193759,0.22047,3410.642249,0.207692,0.001919
102177,102177,,1,2,3,1,2,3,0.000002,0.000001,0,17467,28,0.000011,14,0.148537,0.171138,123.348779,0.166667,0.000219
102178,102178,,5,11,16,5,11,16,0.000587,0.002109,0,17468,52,0.000012,16,0.195132,0.216709,148.764684,0.291667,0.001164
102179,102179,,1,5,6,1,5,6,0,0.001111,0,17469,25,0.000014,11,0.191227,0.208102,8609,0.1,0.000219
102180,102180,,2,11,13,2,11,13,0.000008,0.000022,0,16095,4,0.000013,17,0.153404,0.165809,9284.68953,0.064103,0.000617
9310084,9310084,,2,0,2,2,0,2,0.000001,0,0,4822,4,0.000012,0,0,0,0,0,0.000483
9212050,9212050,,17,0,17,17,0,17,0,0,0,1841,6,0.000166,0,0,0,0,0.025735,0.004028
101093,101093,,12,0,12,12,0,12,0.00056,0,0,12830,30,0.000018,0,0,0,0,0.068182,0.004891
102183,102183,,15,22,37,15,22,37,0.000247,0.000971,0,16148,52,0.00002,14,0.200942,0.222949,31719.750942,0.145646,0.0044
102184,102184,,23,18,41,23,18,41,0.004164,0.002659,0,15645,8,0.000021,15,0.1881,0.210753,1415.234033,0.30122,0.009791
102185,102185,,32,28,60,32,28,60,0.001972,0.018143,0,16186,10,0.000039,14,0.201283,0.228798,39275.144108,0.109887,0.012566
9910003,9910003,,5,8,13,5,8,13,0.000276,0.000433,0,16184,10,0.000017,12,0.176715,0.20015,4216.45917,0.141026,0.001432
102186,102186,,2,11,13,2,11,13,0.000002,0.000081,0,16004,28,0.000012,15,0.184284,0.206586,13997.448923,0.205128,0.00046
102187,102187,,1,1,2,1,1,2,0.000008,0.000005,0,17470,2,0.000011,17,0.158022,0.170963,352.66226,0,0.000239
102188,102188,,25,24,49,25,24,49,0.00062,0.001936,0,15486,30,0.000029,14,0.198712,0.220106,50922.078678,0.112245,0.00748
102189,102189,,1,2,3,1,2,3,0,0.000001,0,17471,26,0.000011,12,0.14599,0.171097,102.272269,0.166667,0.000226
102190,102190,,5,11,16,5,11,16,0.000233,0.001795,0,17472,4,0.000011,15,0.170088,0.193208,125.786977,0.3375,0.001531
102191,102191,,3,6,9,3,6,9,0.000001,0.000002,0,17473,23,0.000014,14,0.160235,0.178111,923.847383,0.236111,0.000684
102192,102192,,15,26,41,15,26,41,0.000571,0.001192,0,15761,3,0.000015,12,0.197538,0.217567,14511.711859,0.169512,0.004346
102193,102193,,3,9,12,3,9,12,0,0.000001,0,17474,5,0.000013,16,0.117352,0.130937,712.023667,0.151515,0.00067
102194,102194,,6,10,16,6,10,16,0.000088,0.00144,0,15982,25,0.000016,13,0.194645,0.215054,8008.482615,0.216667,0.001437
102195,102195,,1,9,10,1,9,10,0,0.000006,0,17475,23,0.000011,21,0.150997,0.16933,13441.302003,0.122222,0.000226
102196,102196,,0,1,1,0,1,1,0,0,16,17477,37,0.00001,1,1,1,0,0,0
3260,3260,,1,0,1,1,0,1,0,0,16,17476,37,0.000019,0,0,0,0,0,0.000219
102197,102197,,3,4,7,3,4,7,0.000064,0.000104,0,17478,3,0.000013,14,0.171726,0.184838,2103.609582,0.166667,0.000718
102198,102198,,8,26,34,8,26,34,0.000233,0.001877,0,17479,52,0.000013,17,0.186928,0.211829,627.72554,0.173797,0.002405
102199,102199,,2,22,24,2,22,24,0.000022,0.000133,0,17483,20,0.000015,18,0.178494,0.197733,9546.425301,0.065217,0.000438
9601165,9601165,,1,2,3,1,2,3,0.000002,0.000001,0,17482,20,0.00001,1,1,1,0,0.5,0.000232
9603164,9603164,,1,6,7,1,6,7,0.000002,0.000004,0,17481,20,0.00001,1,1,1,6.75,0.095238,0.000232
9611062,9611062,,4,2,6,4,2,6,0.000044,0.000001,0,5994,20,0.00003,1,1,1,9535.517055,0.2,0.001015
9501040,9501040,,4,2,6,4,2,6,0,0.000001,0,17480,20,0.000045,1,1,1,16,0.066667,0.00091
102200,102200,,3,25,28,3,25,28,0.000105,0.004632,0,16146,2,0.000012,13,0.227804,0.255315,96253.393857,0.134921,0.001163
102201,102201,,10,22,32,10,22,32,0.000448,0.002946,0,17484,30,0.000014,15,0.204633,0.22917,6275.896074,0.160282,0.002489
102202,102202,,13,73,86,13,73,86,0.001362,0.009619,0,16253,0,0.000019,14,0.215127,0.253894,70035.979425,0.073187,0.004121
102203,102203,,0,3,3,0,3,3,0,0.00001,0,17485,9,0.00001,5,0.324219,0.369076,0,0.333333,0
9302039,9302039,,4,1,5,4,1,5,0,0.00001,0,1060,9,0.000016,1,1,1,0.666667,0.2,0.000927
9205117,9205117,,3,0,3,3,0,3,0,0,0,1294,9,0.000035,0,0,0,0,0,0.000859
9210117,9210117,,8,0,8,8,0,8,0.00007,0,0,1450,9,0.000025,0,0,0,0,0.017857,0.001981
9210118,9210118,,2,0,2,2,0,2,0,0,0,1489,9,0.000013,0,0,0,0,0,0.000589
102207,102207,,3,76,79,3,76,79,0.000819,0.004322,0,16087,25,0.000011,12,0.222312,0.251244,238905.158409,0.072217,0.000995
102208,102208,,11,4,15,11,4,15,0.000548,0.000025,0,15927,5,0.000019,16,0.17678,0.192608,46275.538689,0.12381,0.004318
102209,102209,,0,8,8,0,8,8,0,0.000003,0,17486,6,0.00001,13,0.156544,0.196674,0,0.285714,0
102210,102210,,3,17,20,3,17,20,0.000108,0.001961,0,15573,25,0.000011,19,0.182198,0.206544,1377.99973,0.176316,0.000718
102211,102211,,6,14,20,6,14,20,0.000315,0.002488,0,17487,52,0.000013,19,0.163476,0.184604,2440.571444,0.110526,0.001441
102212,102212,,18,16,34,18,16,34,0.000302,0.001599,0,17488,30,0.000019,13,0.209934,0.233622,10410.09535,0.187166,0.004589
103001,103001,,6,26,32,6,26,32,0.000835,0.009946,0,17489,2,0.000012,16,0.212236,0.241438,4129.442356,0.165323,0.001477
103002,103002,,0,3,3,0,3,3,0,0.000009,0,17491,26,0.00001,9,0.173832,0.227347,0,0.5,0
9805049,9805049,,1,5,6,1,5,6,0,0.000011,0,17490,26,0.000013,8,0.206742,0.285274,89,0.2,0.000219
103003,103003,,8,18,26,8,18,26,0.000588,0.011135,0,17492,30,0.000014,16,0.212175,0.249029,23364.147385,0.170769,0.001939
103004,103004,,6,22,28,6,22,28,0.000199,0.000578,0,17494,4,0.000013,16,0.191773,0.219332,17813.859404,0.121693,0.001571
9704074,9704074,,3,5,8,3,5,8,0.000012,0.000009,0,17493,4,0.000012,9,0.203125,0.252971,235.236275,0.053571,0.000713
103006,103006,,2,9,11,2,9,11,0.000001,0.000075,0,17495,26,0.000014,14,0.17078,0.184413,9271.20886,0.090909,0.000452
9410016,9410016,,6,7,13,6,7,13,0.000014,0.000006,0,7018,26,0.000039,2,0.64,0.71875,14847.12601,0.115385,0.001442
9311170,9311170,,3,1,4,3,1,4,0.000014,0,0,7016,26,0.000017,1,1,1,0.392857,0.416667,0.000712
9406177,9406177,,2,9,11,2,9,11,0.000014,0.000009,0,7017,26,0.000015,2,0.764706,0.846154,54.554164,0.154545,0.000479
103007,103007,,13,21,34,13,21,34,0.000645,0.00031,0,16317,52,0.000019,17,0.16841,0.192615,37622.529106,0.108734,0.003782
103008,103008,,2,7,9,2,7,9,0.00005,0.001583,0,17496,52,0.000011,19,0.158169,0.176478,175.359784,0.152778,0.000445
103009,103009,,3,16,19,3,16,19,0.000053,0.002259,0,17497,25,0.000012,17,0.189564,0.212021,384.163975,0.269006,0.000744
103010,103010,,8,6,14,8,6,14,0.000003,0.000008,0,17498,5,0.000019,14,0.125792,0.155615,107.621453,0.230769,0.001966
103011,103011,,34,44,78,34,44,78,0.002103,0.003251,0,16162,25,0.000032,13,0.210557,0.238524,87872.359699,0.090243,0.014408
103012,103012,,2,5,7,2,5,7,0.000032,0.001117,0,17499,30,0.000011,18,0.182288,0.199704,125.226917,0.309524,0.000471
103013,103013,,66,31,97,66,31,97,0.001591,0.000508,0,15490,30,0.000066,13,0.207671,0.229361,231420.537221,0.056271,0.019329
103014,103014,,5,20,25,5,20,25,0.000002,0.001139,0,17502,6,0.000013,13,0.173623,0.19115,37584.001928,0.111667,0.001116
9809074,9809074,,2,16,18,2,16,18,0.000014,0.000003,0,17501,6,0.000011,10,0.190344,0.257375,2385.961526,0.101307,0.000477
9909174,9909174,,3,20,23,3,20,23,0.000014,0.000008,0,17500,6,0.000011,13,0.140472,0.161421,171.429895,0.284585,0.000697
103015,103015,,11,23,34,11,23,34,0.000343,0.004499,0,17503,2,0.000018,14,0.202515,0.227701,32587.078463,0.172014,0.003158
103016,103016,,0,4,4,0,4,4,0,0.000171,0,17504,5,0.00001,13,0.170118,0.187889,0,0.333333,0
9205098,9205098,,2,0,2,2,0,2,0,0,0,1648,5,0.000019,0,0,0,0,0,0.000517
9206100,9206100,,2,0,2,2,0,2,0,0,0,1646,5,0.000023,0,0,0,0,0,0.000517
103017,103017,,1,2,3,1,2,3,0,0,0,17505,23,0.000012,16,0.123385,0.132369,192.988481,0.166667,0.000219
103018,103018,,5,6,11,5,6,11,0.000114,0.001011,0,17506,30,0.000015,14,0.198484,0.218819,4129.569222,0.163636,0.001309
103019,103019,,2,4,6,2,4,6,0.000001,0.000029,0,17507,0,0.000013,15,0.164911,0.181287,604.766653,0.066667,0.000451
103021,103021,,8,70,78,8,70,78,0.000628,0.00558,0,16280,3,0.000012,13,0.226565,0.25544,22875.199843,0.113387,0.001986
103022,103022,,12,19,31,12,19,31,0.001956,0.018519,0,15700,1,0.000015,13,0.219052,0.249613,17724.253346,0.197849,0.003639
103023,103023,,19,25,44,19,25,44,0.000329,0.000688,0,15881,30,0.000024,13,0.211569,0.236347,44695.917066,0.124736,0.00508
9607101,9607101,,2,0,2,2,0,2,0.000019,0,0,15880,30,0.000011,0,0,0,0,0.5,0.000621
103024,103024,,6,12,18,6,12,18,0.000219,0.001954,0,17508,30,0.000013,14,0.192859,0.212419,499.018241,0.19281,0.001575
103025,103025,,3,5,8,3,5,8,0.000291,0.000022,0,15611,4,0.000012,14,0.149159,0.165812,4153.976375,0.142857,0.000784
9203010,9203010,,1,0,1,1,0,1,0.000001,0,0,3773,9,0.000013,0,0,0,0,0,0.000401
103026,103026,,9,9,18,9,9,18,0,0.00002,0,17509,23,0.000035,13,0.154107,0.172348,26000.32323,0.114379,0.002025
103027,103027,,0,1,1,0,1,1,0,0,17,17511,38,0.00001,1,1,1,0,0,0
9910141,9910141,,1,0,1,1,0,1,0,0,17,17510,38,0.000019,0,0,0,0,0,0.000219
103028,103028,,7,12,19,7,12,19,0.000709,0.00485,0,17512,1,0.000015,13,0.182697,0.198636,12979.671037,0.154971,0.002054
103029,103029,,10,16,26,10,16,26,0.000013,0.000007,0,17513,6,0.000017,15,0.13347,0.147688,12857.617397,0.133846,0.002406
103030,103030,,43,9,52,43,9,52,0.001746,0.001426,0,16007,2,0.000041,13,0.198775,0.219655,7707.585131,0.120287,0.012709
103031,103031,,8,60,68,8,60,68,0.000681,0.024468,0,16050,0,0.000012,14,0.208537,0.239738,17896.901159,0.163301,0.002193
103032,103032,,15,19,34,15,19,34,0.002128,0.003517,0,17514,1,0.000024,15,0.208587,0.243524,33151.063771,0.093583,0.00359
103033,103033,,6,38,44,6,38,44,0.0002,0.003803,0,16265,0,0.000012,13,0.226883,0.258297,61860.014441,0.086681,0.001763
103034,103034,,0,6,6,0,6,6,0,0.000001,0,17515,23,0.00001,18,0.112873,0.120445,0,0.3,0
103035,103035,,0,8,8,0,8,8,0,0.001665,0,17516,25,0.00001,13,0.187365,0.20502,0,0.232143,0
103036,103036,,0,15,15,0,15,15,0,0.001797,0,17517,1,0.00001,15,0.183193,0.207415,0,0.1,0
9603043,9603043,,4,8,12,4,8,12,0.000074,0.000638,0,8136,5,0.000012,11,0.186881,0.218914,897.689615,0.098485,0.000912
9806223,9806223,,5,0,5,5,0,5,0.000582,0,0,8133,1,0.000023,0,0,0,0,0.2,0.001303
103037,103037,,4,10,14,4,10,14,0.000029,0.000019,0,17518,5,0.000013,15,0.175779,0.192945,40277.240522,0.153846,0.000911
103038,103038,,3,7,10,3,7,10,0.000011,0.002731,0,17519,23,0.000015,21,0.186076,0.227969,43937.994482,0.144444,0.000684
103040,103040,,1,10,11,1,10,11,0.000183,0.000013,0,17521,22,0.00001,16,0.153075,0.166658,1165.943308,0.145455,0.000245
9903102,9903102,,2,7,9,2,7,9,0,0.000004,0,17520,9,0.000012,13,0.150804,0.163307,258.163849,0.083333,0.000445
9807143,9807143,,4,2,6,4,2,6,0.000001,0,0,14921,9,0.000023,12,0.174069,0.188572,16430.908578,0.133333,0.000936
103041,103041,,2,28,30,2,28,30,0.000085,0.017401,0,17522,25,0.000011,14,0.210616,0.240928,1663.063481,0.078161,0.000451
103042,103042,,10,18,28,10,18,28,0.00078,0.000306,0,17523,0,0.000017,13,0.183291,0.201315,23714.082817,0.231481,0.002778
104135,104135,,7,28,35,7,28,35,0.000587,0.00268,0,17524,0,0.000015,16,0.200591,0.223048,45944.824758,0.168067,0.002148
103043,103043,,1,5,6,1,5,6,0,0,0,17525,23,0.000027,2,0.777778,0.857143,14,0.2,0.000226
103044,103044,,2,10,12,2,10,12,0.000001,0.006107,0,17526,1,0.000012,13,0.179301,0.199329,6261.51892,0.181818,0.000438
103045,103045,,2,13,15,2,13,15,0.000147,0.001908,0,15687,25,0.000011,16,0.189968,0.213214,993.510868,0.147619,0.000545
103046,103046,,1,3,4,1,3,4,0,0,0,17528,23,0.000011,19,0.099308,0.112459,2,0.166667,0.000226
9708146,9708146,,2,1,3,2,1,3,0,0,0,17527,23,0.000014,2,0.666667,0.75,7,0.166667,0.000451
9412146,9412146,,5,1,6,5,1,6,0.000014,0.000002,0,11244,23,0.000047,1,1,1,39,0.066667,0.001148
103047,103047,,1,39,40,1,39,40,0.000039,0.023235,0,17529,1,0.00001,13,0.223505,0.253747,2679.079366,0.142949,0.000229
103048,103048,,2,6,8,2,6,8,0.000025,0.000872,0,17530,30,0.000011,16,0.181496,0.200119,49.818384,0.285714,0.000499
103049,103049,,2,14,16,2,14,16,0.000003,0.000226,0,17532,28,0.000012,15,0.169158,0.190743,657.103148,0.1375,0.000465
9506036,9506036,,1,10,11,1,10,11,0.000003,0.000253,0,17531,2,0.000011,6,0.346154,0.406481,8.253546,0.172727,0.000232
103050,103050,,1,6,7,1,6,7,0,0.000005,0,17533,5,0.000011,18,0.089016,0.097194,2.333333,0.285714,0.000219
103051,103051,,20,11,31,20,11,31,0.000031,0.000002,0,17534,6,0.000047,14,0.158008,0.171328,58079.18387,0.129032,0.004836
104119,104119,,11,9,20,11,9,20,0.000004,0.000002,0,17535,6,0.000028,15,0.162019,0.177078,44803.869598,0.118421,0.002583
103052,103052,,10,10,20,10,10,20,0.000369,0.002129,0,17536,25,0.000015,17,0.187613,0.209366,7154.026465,0.236842,0.002315
103054,103054,,7,2,9,7,2,9,0.000002,0,0,17537,22,0.000022,7,0.213439,0.251279,190.835317,0.055556,0.001652
103055,103055,,1,28,29,1,28,29,0.000001,0.000035,0,17538,6,0.00001,15,0.15305,0.169694,9.2501,0.108374,0.000219
103056,103056,,10,24,34,10,24,34,0.000579,0.001757,0,15744,3,0.000015,13,0.194272,0.213892,1715.610506,0.213904,0.004183
103057,103057,,0,3,3,0,3,3,0,0,0,17539,26,0.00001,4,0.461538,0.5625,0,0.333333,0
103058,103058,,9,22,31,9,22,31,0.002313,0.019552,0,17540,1,0.000014,16,0.205831,0.239188,16736.948117,0.295699,0.002336
103059,103059,,0,5,5,0,5,5,0,0.000368,0,17541,0,0.00001,17,0.168942,0.189995,0,0.05,0
103060,103060,,0,15,15,0,15,15,0,0.001578,0,17542,25,0.00001,16,0.196455,0.220611,0,0.114286,0
103061,103061,,6,10,16,6,10,16,0.000001,0.000009,0,17544,23,0.000015,14,0.135028,0.147374,5747.012781,0.170833,0.001402
9903255,9903255,,5,0,5,5,0,5,0,0,0,17543,23,0.000016,0,0,0,0,0.15,0.001142
103062,103062,,5,3,8,5,3,8,0.000164,0.000994,0,15936,25,0.000012,14,0.18355,0.200633,1415.345801,0.285714,0.001256
103063,103063,,7,10,17,7,10,17,0.000046,0.00079,0,17546,15,0.000021,18,0.172696,0.193025,43074.323636,0.110294,0.001606
9305169,9305169,,2,1,3,2,1,3,0.000009,0.000002,0,6981,15,0.000014,1,1,1,8.262195,0.166667,0.000492
9505093,9505093,,13,22,35,13,22,35,0.000028,0.000002,0,3973,9,0.000029,5,0.320946,0.402544,134059.122164,0.110084,0.003069
9511091,9511091,,3,7,10,3,7,10,0.000009,0.000001,0,15774,9,0.000014,6,0.251316,0.299476,88.562592,0.288889,0.00071
9712081,9712081,,5,3,8,5,3,8,0.000009,0.000249,0,17545,2,0.000029,11,0.191251,0.211486,9272.33358,0.089286,0.001169
9210029,9210029,,9,1,10,9,1,10,0,0,0,2046,9,0.00004,1,1,1,1358.468645,0.133333,0.002378
9307071,9307071,,7,2,9,7,2,9,0.000002,0,0,3968,9,0.000019,1,1,1,338.515578,0.069444,0.001729
9307119,9307119,,2,0,2,2,0,2,0,0,0,3972,9,0.000012,0,0,0,0,0.5,0.000532
9403019,9403019,,18,1,19,18,1,19,0.000016,0,0,3180,9,0.000045,1,1,1,12793,0.166667,0.004783
9403129,9403129,,2,11,13,2,11,13,0,0.000082,0,960,4,0.000014,4,0.38172,0.474178,98538.210254,0.032051,0.000601
9405111,9405111,,8,6,14,8,6,14,0,0,0,3951,9,0.000021,3,0.583333,0.690476,182.694418,0.263736,0.001939
9406214,9406214,,14,9,23,14,9,23,0.000019,0.000001,0,3958,9,0.000026,5,0.317536,0.422637,62213.532588,0.15415,0.003432
9408049,9408049,,8,6,14,8,6,14,0.000001,0,0,3952,9,0.000019,3,0.555556,0.666667,258.648602,0.274725,0.002144
9504030,9504030,,9,14,23,9,14,23,0,0.000001,0,3970,9,0.00002,6,0.278388,0.413596,463.275929,0.156126,0.002153
9505041,9505041,,4,11,15,4,11,15,0,0.000001,0,3971,9,0.000014,6,0.275,0.390909,27.398343,0.290476,0.000997
103066,103066,,1,21,22,1,21,22,0,0.000866,0,17548,13,0.000011,14,0.204303,0.243104,7148.6046,0.080087,0.000219
9805072,9805072,,2,6,8,2,6,8,0.00002,0.00029,0,17547,13,0.000011,14,0.176317,0.199319,1134.000174,0.196429,0.000471
105038,105038,,65,44,109,65,44,109,0.002936,0.002589,0,16150,52,0.000045,12,0.229141,0.258062,447881.540645,0.068722,0.018352
104043,104043,,12,20,32,12,20,32,0.000366,0.002009,0,16136,52,0.000015,14,0.2068,0.23299,49453.929417,0.197581,0.003543
104054,104054,,12,30,42,12,30,42,0.00057,0.002862,0,16145,52,0.000016,15,0.209515,0.235573,61663.005658,0.16144,0.004191
103067,103067,,106,40,146,106,40,146,0.005325,0.006683,0,16154,4,0.000066,15,0.212201,0.240238,60539.719678,0.092395,0.043491
103068,103068,,23,23,46,23,23,46,0.001053,0.002484,0,17549,0,0.000018,14,0.201394,0.22858,25852.860352,0.119807,0.007117
103070,103070,,1,3,4,1,3,4,0.000198,0.000083,0,17550,30,0.00001,17,0.17825,0.194126,3.958333,0.25,0.000226
103071,103071,,8,23,31,8,23,31,0.00139,0.018856,0,15614,25,0.000015,16,0.206144,0.230946,34766.91439,0.13871,0.002306
103072,103072,,0,2,2,0,2,2,0,0,0,17552,5,0.00001,3,0.555556,0.666667,0,0,0
1095,1095,,1,0,1,1,0,1,0,0,0,17551,5,0.000014,0,0,0,0,0,0.000219
103073,103073,,1,6,7,1,6,7,0.000133,0.000268,0,17553,28,0.00001,15,0.16989,0.186812,164.532937,0.309524,0.000232
103074,103074,,11,15,26,11,15,26,0.000115,0.00082,0,17554,30,0.000022,15,0.191964,0.210768,17220.804743,0.103077,0.002557
103075,103075,,5,10,15,5,10,15,0.000001,0.000005,0,17555,23,0.000017,16,0.132718,0.14507,9889.356111,0.257143,0.001254
103076,103076,,0,3,3,0,3,3,0,0,0,17556,26,0.00001,18,0.121039,0.129863,0,0,0
103077,103077,,8,6,14,8,6,14,0.000288,0.000986,0,16027,25,0.000016,18,0.182135,0.200318,2938.245097,0.274725,0.002076
103079,103079,,1,43,44,1,43,44,0.000076,0.002465,0,17557,3,0.00001,14,0.224393,0.252851,1420.05303,0.186047,0.000219
103080,103080,,32,41,73,32,41,73,0.004185,0.020469,0,15705,1,0.000024,14,0.208466,0.239759,96670.534,0.128044,0.011604
103167,103167,,67,30,97,67,30,97,0.005715,0.003696,0,16166,10,0.000046,14,0.210416,0.238401,74310.93748,0.141001,0.026368
103115,103115,,55,41,96,55,41,96,0.003844,0.008732,0,16163,10,0.000042,14,0.219755,0.259138,147209.502935,0.10625,0.023123
103081,103081,,0,32,32,0,32,32,0,0.002669,0,17558,25,0.00001,15,0.19962,0.226911,0,0.179435,0
103082,103082,,2,18,20,2,18,20,0.000402,0.018605,0,15424,1,0.000011,15,0.218505,0.251949,2186.010581,0.210526,0.000866
103083,103083,,3,8,11,3,8,11,0.000036,0.000021,0,17559,30,0.000013,19,0.148318,0.16145,184.362664,0.154545,0.000684
9202040,9202040,,10,0,10,10,0,10,0.000001,0,0,3217,9,0.000089,0,0,0,0,0.066667,0.002345
103084,103084,,0,16,16,0,16,16,0,0.002137,0,17560,0,0.00001,13,0.214994,0.242017,0,0.216667,0
103085,103085,,45,20,65,45,20,65,0.001774,0.000873,0,15754,3,0.000035,13,0.193103,0.211537,33761.3441,0.177644,0.019277
103086,103086,,4,44,48,4,44,48,0.000344,0.005535,0,17561,13,0.000012,14,0.204854,0.234475,35390.753487,0.088652,0.000992
103087,103087,,3,1,4,3,1,4,0,0,0,17562,5,0.000021,1,1,1,0,0.5,0.000677
103088,103088,,2,23,25,2,23,25,0.000535,0.001623,0,17563,41,0.00001,12,0.194084,0.215459,2909.272511,0.245,0.000501
103089,103089,,31,26,57,31,26,57,0.001209,0.001503,0,15757,3,0.000022,12,0.197488,0.217196,4862.513047,0.189536,0.01069
103090,103090,,13,50,63,13,50,63,0.001192,0.026062,0,17564,30,0.000016,16,0.223228,0.259937,25180.766259,0.082181,0.003587
103091,103091,,0,3,3,0,3,3,0,0.000787,0,17565,30,0.00001,13,0.186846,0.20159,0,0.166667,0
103092,103092,,2,8,10,2,8,10,0,0.000001,0,17566,26,0.000012,15,0.138233,0.148881,501.731206,0.288889,0.000438
103093,103093,,3,24,27,3,24,27,0,0.000135,0,17572,22,0.000021,15,0.163582,0.187094,10900.719895,0.037037,0.000677
9406122,9406122,,3,0,3,3,0,3,0.000002,0,0,17567,22,0.000035,0,0,0,0,0.333333,0.000717
9712198,9712198,,1,0,1,1,0,1,0.000002,0,0,17571,22,0.000011,0,0,0,0,0,0.000239
9805138,9805138,,3,1,4,3,1,4,0.000002,0,0,17569,22,0.000024,1,1,1,2,0.166667,0.000684
9910168,9910168,,1,2,3,1,2,3,0.000002,0,0,17570,22,0.000011,11,0.165725,0.182892,0,0.333333,0.000239
9910180,9910180,,3,5,8,3,5,8,0.000002,0,0,17568,22,0.000015,8,0.213699,0.293193,85.046825,0.125,0.000677
9502111,9502111,,8,4,12,8,4,12,0.00006,0.000005,0,8721,5,0.000026,3,0.472222,0.558824,7453.123801,0.060606,0.001846
9503132,9503132,,11,2,13,11,2,13,0.000023,0,0,1915,5,0.00004,3,0.571429,0.708333,135.458062,0.121795,0.002574
103094,103094,,24,6,30,24,6,30,0.000789,0.000062,0,17574,13,0.000034,12,0.186648,0.207546,23833.430766,0.1,0.006452
9909150,9909150,,6,28,34,6,28,34,0.000353,0.007276,0,17573,13,0.000019,14,0.219495,0.25924,31667.492552,0.108734,0.00153
103095,103095,,2,33,35,2,33,35,0.00015,0.003756,0,17575,0,0.00001,12,0.217067,0.245189,3054.141274,0.181513,0.000624
103096,103096,,3,2,5,3,2,5,0.000067,0,0,17576,6,0.000016,14,0.148858,0.159618,383.730983,0.15,0.000664
103097,103097,,1,7,8,1,7,8,0,0.000894,0,17578,13,0.000019,11,0.198729,0.218718,8663,0.089286,0.000219
9911037,9911037,,1,37,38,1,37,38,0.000011,0.006526,0,17577,4,0.000012,19,0.196731,0.240827,4381.702,0.135846,0.000226
103098,103098,,9,24,33,9,24,33,0.000777,0.003221,0,17579,2,0.000028,17,0.203724,0.233445,36941.325789,0.10322,0.004886
103099,103099,,19,29,48,19,29,48,0.002189,0.002878,0,15865,0,0.000018,14,0.208472,0.233016,135454.808013,0.102837,0.00522
103100,103100,,10,4,14,10,4,14,0.0002,0.000262,0,16177,4,0.000016,18,0.17066,0.187265,373.475988,0.324176,0.003017
103101,103101,,9,29,38,9,29,38,0.000452,0.004543,0,17580,2,0.000014,15,0.204299,0.229712,23472.534822,0.073257,0.002188
9612213,9612213,,2,14,16,2,14,16,0.000001,0.001641,0,11621,0,0.000014,11,0.215709,0.246747,10079.069232,0.15,0.000479
9706114,9706114,,3,0,3,3,0,3,0.000072,0,0,11620,41,0.000014,0,0,0,0,0.166667,0.000734
103102,103102,,34,14,48,34,14,48,0.001382,0.00065,0,15758,3,0.000022,12,0.19232,0.20982,28377.647313,0.162234,0.011072
9704191,9704191,,2,6,8,2,6,8,0.000038,0.002034,0,5498,2,0.000014,13,0.183131,0.207712,2630.553951,0.196429,0.00051
103103,103103,,21,40,61,21,40,61,0.000794,0.00172,0,15755,3,0.000019,14,0.190135,0.211866,1468.340472,0.257104,0.009829
103104,103104,,0,14,14,0,14,14,0,0.000005,0,17581,23,0.00001,14,0.167642,0.184079,0,0.28022,0
103105,103105,,0,5,5,0,5,5,0,0,0,17582,15,0.00001,14,0.151353,0.161887,0,0.15,0
103106,103106,,5,37,42,5,37,42,0.000253,0.023117,0,15719,25,0.000013,17,0.217033,0.254486,20614.120103,0.146341,0.001497
103107,103107,,4,14,18,4,14,18,0.000143,0.007231,0,15528,30,0.000012,15,0.196174,0.217857,17040.699473,0.156863,0.00134
103108,103108,,34,21,55,34,21,55,0.004652,0.017555,0,15652,8,0.000025,13,0.191911,0.214466,2195.73971,0.26229,0.012549
103109,103109,,1,10,11,1,10,11,0,0,0,17583,26,0.000011,15,0.141866,0.154593,28.379611,0.336364,0.000219
103110,103110,,4,23,27,4,23,27,0.000114,0.000381,0,16204,23,0.000012,14,0.202465,0.228638,77107.836694,0.064103,0.000951
103111,103111,,13,39,52,13,39,52,0.003212,0.020271,0,15448,1,0.000014,13,0.214361,0.239423,99095.214004,0.176471,0.004261
103112,103112,,11,66,77,11,66,77,0.002397,0.02612,0,16201,1,0.000013,14,0.224597,0.259635,71877.329655,0.136364,0.003491
103113,103113,,0,3,3,0,3,3,0,0.000087,0,17584,15,0.00001,16,0.142738,0.155329,0,0.166667,0
103114,103114,,8,23,31,8,23,31,0.000191,0.001733,0,17585,52,0.000013,13,0.19171,0.215342,6414.496606,0.145161,0.00246
103116,103116,,5,36,41,5,36,41,0.000343,0.012942,0,17586,2,0.000012,15,0.226073,0.260684,9658.369466,0.164024,0.001155
103117,103117,,1,23,24,1,23,24,0.000005,0.001715,0,17587,52,0.00001,13,0.204839,0.228925,1688.134152,0.181159,0.000219
103118,103118,,2,11,13,2,11,13,0,0.000037,0,17588,9,0.000013,15,0.159951,0.172786,11246.582276,0.064103,0.000438
9307188,9307188,,2,0,2,2,0,2,0,0,0,1868,4,0.000037,0,0,0,0,0,0.000617
103119,103119,,0,2,2,0,2,2,0,0.000058,0,17591,4,0.00001,8,0.200995,0.227045,0,0.5,0
9909034,9909034,,1,4,5,1,4,5,0.000001,0.000414,0,17590,4,0.000014,7,0.222099,0.259133,77.693585,0.2,0.000219
9812241,9812241,,1,2,3,1,2,3,0.000005,0.000103,0,17589,4,0.000013,7,0.215781,0.244598,0,0.5,0.000226
103120,103120,,3,5,8,3,5,8,0.000026,0.000868,0,17592,30,0.000013,13,0.1846,0.2,3759.920482,0.196429,0.000658
103121,103121,,0,1,1,0,1,1,0,0,0,17593,26,0.00001,10,0.179122,0.197701,0,0,0
103122,103122,,1,8,9,1,8,9,0.000048,0.000124,0,17594,9,0.00001,12,0.199874,0.219364,4,0.194444,0.000219
9805120,9805120,,11,33,44,11,33,44,0.000259,0.002779,0,16195,9,0.000016,14,0.208499,0.243334,9998.645612,0.115222,0.002691
103123,103123,,2,10,12,2,10,12,0.000011,0.001771,0,17595,2,0.000011,14,0.182801,0.207049,239.214553,0.181818,0.000438
103124,103124,,19,71,90,19,71,90,0.001414,0.011597,0,15829,30,0.000019,11,0.227796,0.258558,61086.623843,0.12784,0.006512
103125,103125,,1,1,2,1,1,2,0,0,0,17596,28,0.000011,3,0.444444,0.541667,0,0.5,0.000226
103126,103126,,1,3,4,1,3,4,0,0.000003,0,17597,23,0.000013,14,0.133739,0.14536,2579.466134,0.333333,0.000219
103127,103127,,2,7,9,2,7,9,0.000012,0.000792,0,17600,30,0.000011,13,0.184383,0.200179,151.661887,0.125,0.000438
9412114,9412114,,8,4,12,8,4,12,0.000025,0.000003,0,17599,15,0.000029,2,0.7,0.785714,183.083333,0.106061,0.00205
9406146,9406146,,5,1,6,5,1,6,0.000013,0,0,14520,15,0.00003,1,1,1,5.698413,0.066667,0.001288
9411033,9411033,,2,2,4,2,2,4,0.000002,0.000003,0,17598,15,0.000018,2,0.75,0.833333,2.305556,0.25,0.000556
103128,103128,,2,29,31,2,29,31,0.000024,0.00325,0,17601,30,0.000011,12,0.202928,0.226299,7740.300136,0.148387,0.000438
103129,103129,,0,11,11,0,11,11,0,0.000001,0,17603,15,0.00001,3,0.645161,0.758333,0,0.136364,0
9404134,9404134,,13,0,13,13,0,13,0,0,0,11720,15,0.00005,0,0,0,0,0.108974,0.003008
9601047,9601047,,6,0,6,6,0,6,0,0,0,17354,15,0.00003,0,0,0,0,0.1,0.001341
9905125,9905125,,1,15,16,1,15,16,0,0.000002,0,17602,15,0.000011,2,0.894737,0.941176,7.333333,0.1875,0.000219
9509058,9509058,,3,4,7,3,4,7,0,0.000001,0,17355,15,0.000012,1,1,1,0,0.333333,0.000677
9605021,9605021,,3,3,6,3,3,6,0,0,0,17353,15,0.000012,1,1,1,0,0.333333,0.000677
103130,103130,,1,1,2,1,1,2,0.000001,0,0,17605,26,0.000011,1,1,1,1,0,0.000219
1181,1181,,1,0,1,1,0,1,0,0,0,17604,26,0.000019,0,0,0,0,0,0.000226
103132,103132,,0,10,10,0,10,10,0,0.000019,0,17606,28,0.00001,16,0.139044,0.158227,0,0.255556,0
103133,103133,,12,18,30,12,18,30,0.002105,0.000894,0,15734,1,0.000014,17,0.182715,0.20907,13148.970743,0.14023,0.002921
103136,103136,,12,19,31,12,19,31,0.000634,0.000353,0,17607,2,0.000022,14,0.197594,0.220045,38497.208916,0.163441,0.002891
103152,103152,,8,31,39,8,31,39,0.000291,0.00148,0,17608,2,0.000013,16,0.197527,0.223906,21514.981244,0.189609,0.00204
103139,103139,,13,26,39,13,26,39,0.000307,0.002095,0,17609,30,0.000015,13,0.202559,0.223042,8485.498561,0.130229,0.003117
103140,103140,,0,5,5,0,5,5,0,0.001504,0,17614,30,0.00001,13,0.184836,0.200595,0,0.15,0
9410173,9410173,,4,2,6,4,2,6,0.000037,0.000001,0,17610,30,0.000024,1,1,1,18.6,0.2,0.000916
9503025,9503025,,2,2,4,2,2,4,0.000036,0.000002,0,17613,30,0.000012,2,0.75,0.833333,0.666667,0.25,0.000438
9707004,9707004,,4,3,7,4,3,7,0.000062,0.000002,0,17612,30,0.000023,2,0.8,0.875,68.816606,0.071429,0.000897
9302005,9302005,,3,0,3,3,0,3,0,0,0,17611,22,0.000024,0,0,0,0,0,0.00071
103141,103141,,1,11,12,1,11,12,0,0.00002,0,17615,23,0.00001,19,0.151648,0.168633,90.132375,0.287879,0.000219
103142,103142,,1,41,42,1,41,42,0.000055,0.005299,0,17616,52,0.00001,14,0.212437,0.241193,4813.199167,0.122532,0.000219
103143,103143,,7,12,19,7,12,19,0.000188,0.000068,0,17617,1,0.000016,13,0.188167,0.203785,9348.831585,0.149123,0.001751
103144,103144,,2,8,10,2,8,10,0,0.000003,0,17618,6,0.000012,13,0.131445,0.14998,2453.957672,0.144444,0.000438
103145,103145,,1,25,26,1,25,26,0.000064,0.001657,0,17619,2,0.00001,12,0.221149,0.24636,289.300592,0.150769,0.000233
103147,103147,,1,15,16,1,15,16,0.000025,0.001644,0,17620,25,0.00001,11,0.198527,0.220019,3588.257415,0.0625,0.000233
9603055,9603055,,2,9,11,2,9,11,0.000028,0.000216,0,8135,5,0.000011,8,0.267788,0.316005,35.966728,0.190909,0.00046
103148,103148,,32,20,52,32,20,52,0.001264,0.003774,0,16008,2,0.000033,13,0.207691,0.230964,48285.948044,0.109351,0.009735
103149,103149,,2,14,16,2,14,16,0.000024,0.003456,0,17621,13,0.000011,12,0.216933,0.239622,1043.975563,0.2,0.000445
103150,103150,,2,15,17,2,15,17,0.000067,0.001898,0,17622,30,0.000011,15,0.19633,0.217834,186.120466,0.238971,0.000466
103151,103151,,0,5,5,0,5,5,0,0.001118,0,17623,25,0.00001,13,0.186884,0.20616,0,0.45,0
103153,103153,,17,32,49,17,32,49,0.000721,0.004866,0,15716,0,0.00002,15,0.217417,0.252779,37293.891403,0.097789,0.004922
104056,104056,,29,44,73,29,44,73,0.002414,0.005206,0,15725,25,0.000024,15,0.212029,0.240312,107564.760402,0.092466,0.007992
103233,103233,,17,32,49,17,32,49,0.000565,0.007669,0,15711,2,0.000022,15,0.203407,0.234729,30098.168714,0.076956,0.005061
103154,103154,,7,39,46,7,39,46,0.000327,0.001168,0,17624,41,0.000015,13,0.198816,0.227131,23967.486317,0.054106,0.001594
103155,103155,,50,19,69,50,19,69,0.002129,0.002036,0,16188,10,0.000044,14,0.201205,0.2271,28090.260604,0.107417,0.018019
103156,103156,,3,24,27,3,24,27,0.000058,0.012696,0,17625,0,0.000013,11,0.214749,0.241642,8183.075575,0.082621,0.001006
103157,103157,,1,25,26,1,25,26,0.000026,0.002869,0,17627,4,0.000011,15,0.179385,0.205906,3788.403587,0.241538,0.000219
9904214,9904214,,2,13,15,2,13,15,0.00006,0.002229,0,17626,4,0.000011,16,0.168942,0.19321,301.742151,0.304762,0.000445
103158,103158,,2,14,16,2,14,16,0.000028,0.002222,0,17628,25,0.000011,17,0.189166,0.212143,124.012782,0.320833,0.000458
103159,103159,,9,33,42,9,33,42,0.000196,0.005798,0,17629,30,0.000016,13,0.206302,0.236153,39707.158327,0.202671,0.002242
103161,103161,,5,12,17,5,12,17,0.000065,0.000452,0,17630,2,0.000014,16,0.159187,0.184141,1838.516954,0.150735,0.001216
103162,103162,,4,59,63,4,59,63,0.000878,0.027724,0,15609,1,0.000012,12,0.226747,0.262866,55507.576807,0.120072,0.00142
103163,103163,,20,67,87,20,67,87,0.004133,0.023829,0,17631,1,0.000018,14,0.226221,0.261221,76130.269396,0.091286,0.005677
103164,103164,,6,16,22,6,16,22,0.000228,0.000967,0,17634,30,0.000015,14,0.196929,0.218224,29154.692977,0.075758,0.001865
9301092,9301092,,3,0,3,3,0,3,0.000011,0,0,17633,15,0.000016,0,0,0,0,0.166667,0.000711
9404054,9404054,,3,3,6,3,3,6,0.000011,0.000005,0,17632,15,0.000015,1,1,1,191.18627,0.1,0.000704
9312129,9312129,,2,0,2,2,0,2,0,0,0,10547,15,0.000014,0,0,0,0,0.5,0.000472
9404029,9404029,,2,1,3,2,1,3,0,0.000003,0,10546,30,0.000015,1,1,1,1.5,0.166667,0.000465
9412058,9412058,,3,2,5,3,2,5,0,0.000004,0,10545,15,0.000017,2,0.75,0.833333,15.214768,0.1,0.000684
103165,103165,,6,24,30,6,24,30,0.000811,0.007703,0,15810,2,0.000014,12,0.213539,0.239619,26321.878642,0.152874,0.003292
103166,103166,,3,10,13,3,10,13,0.000075,0.000108,0,17636,25,0.000012,17,0.163024,0.17819,133.346812,0.25641,0.000677
9905184,9905184,,6,6,12,6,6,12,0.000244,0.000074,0,17635,25,0.000016,16,0.162538,0.178599,782.259234,0.151515,0.001355
103168,103168,,13,37,50,13,37,50,0.000582,0.020405,0,17640,30,0.000015,14,0.212518,0.239345,12736.235984,0.11102,0.003854
9804057,9804057,,4,24,28,4,24,28,0.00074,0.012056,0,17637,26,0.000012,14,0.196234,0.226923,995.205134,0.100529,0.00106
9903014,9903014,,3,17,20,3,17,20,0.000288,0.019576,0,17639,4,0.000012,13,0.201534,0.231059,5544.97383,0.092105,0.000863
9903021,9903021,,1,20,21,1,20,21,0.00024,0.018588,0,17638,26,0.00001,14,0.202755,0.232543,271.894636,0.114286,0.000318
9303076,9303076,,5,1,6,5,1,6,0.000035,0,0,186,26,0.000038,1,1,1,13982.781392,0.1,0.001647
103169,103169,,10,29,39,10,29,39,0.002112,0.021264,0,16131,1,0.000014,13,0.219272,0.25243,26834.466878,0.17004,0.002877
103170,103170,,28,72,100,28,72,100,0.001335,0.006302,0,16220,0,0.000023,13,0.215288,0.247437,150231.480828,0.047071,0.008376
103183,103183,,18,22,40,18,22,40,0.000675,0.003419,0,16246,3,0.000018,17,0.206441,0.231768,11881.686764,0.114103,0.00486
9303131,9303131,,17,2,19,17,2,19,0.000002,0,0,1767,22,0.000069,1,1,1,17960.925196,0.035088,0.00403
9307139,9307139,,6,2,8,6,2,8,0,0,0,9979,22,0.000027,1,1,1,2,0.232143,0.001412
9502079,9502079,,2,2,4,2,2,4,0,0,0,9978,22,0.000013,1,1,1,0,0.416667,0.000529
9502080,9502080,,2,5,7,2,5,7,0,0.000023,0,9977,22,0.000013,2,0.777778,0.857143,4829.838811,0.285714,0.000529
103171,103171,,75,37,112,75,37,112,0.010497,0.014439,0,15403,8,0.000054,10,0.233898,0.265792,137172.459846,0.108189,0.030099
103172,103172,,1,5,6,1,5,6,0,0,0,17641,23,0.000013,15,0.126245,0.140448,51.478701,0.166667,0.000226
103173,103173,,0,2,2,0,2,2,0,0.000009,0,17642,0,0.00001,13,0.170827,0.185281,0,0.5,0
103174,103174,,0,12,12,0,12,12,0,0.00223,0,17643,4,0.00001,16,0.159952,0.182237,0,0.386364,0
103175,103175,,0,9,9,0,9,9,0,0.000003,0,17644,2,0.00001,14,0.165219,0.187111,0,0.152778,0
103176,103176,,1,1,2,1,1,2,0,0.000006,0,17645,52,0.000012,1,1,1,1,0,0.000219
103177,103177,,4,38,42,4,38,42,0.000444,0.00567,0,17646,0,0.000011,18,0.204931,0.238157,11607.843348,0.124855,0.002093
103178,103178,,5,19,24,5,19,24,0.000002,0.000142,0,17648,22,0.000022,13,0.18765,0.211094,30889.999842,0.085145,0.001129
9411017,9411017,,1,5,6,1,5,6,0.000002,0.000004,0,17647,22,0.000011,5,0.316667,0.373392,53.963851,0.1,0.000252
103179,103179,,42,12,54,42,12,54,0.001124,0.001643,0,15525,30,0.000045,13,0.204405,0.224723,70168.652506,0.107617,0.0128
103180,103180,,1,2,3,1,2,3,0.000002,0.000017,0,17652,5,0.000011,9,0.200828,0.222161,2,0.166667,0.000219
9704039,9704039,,2,4,6,2,4,6,0.000002,0,0,17651,9,0.000016,8,0.24773,0.28051,339.292718,0.133333,0.000445
9509072,9509072,,5,8,13,5,8,13,0.000008,0.00001,0,3209,9,0.000017,7,0.309603,0.356914,1016.789582,0.205128,0.001137
9609038,9609038,,2,7,9,2,7,9,0.000008,0.000001,0,17650,9,0.000014,7,0.288786,0.334802,173.47026,0.194444,0.000451
9701063,9701063,,1,1,2,1,1,2,0,0,0,17649,5,0.000013,1,1,1,2.5,0,0.000232
103181,103181,,2,28,30,2,28,30,0.000407,0.004328,0,17654,4,0.000011,16,0.204074,0.241298,2148.331497,0.252874,0.000558
9911255,9911255,,6,18,24,6,18,24,0.000791,0.002749,0,17653,4,0.000012,15,0.170051,0.192299,1629.853631,0.262681,0.00156
103182,103182,,0,13,13,0,13,13,0,0.001524,0,17655,2,0.00001,12,0.209646,0.231921,0,0.102564,0
103184,103184,,4,20,24,4,20,24,0.000097,0.001407,0,15560,25,0.000014,16,0.188822,0.210295,15362.393907,0.175725,0.001009
103185,103185,,1,7,8,1,7,8,0,0.000003,0,17656,23,0.000012,22,0.137767,0.155836,14168.710608,0.089286,0.000232
103187,103187,,10,36,46,10,36,46,0.002517,0.023156,0,15449,1,0.000013,12,0.222252,0.254099,50885.981649,0.219324,0.003436
103188,103188,,15,47,62,15,47,62,0.000905,0.007141,0,17657,30,0.000016,13,0.216928,0.243686,46955.466364,0.127181,0.003868
103189,103189,,2,1,3,2,1,3,0,0,0,17658,23,0.000016,1,1,1,0,0.5,0.000445
103190,103190,,4,13,17,4,13,17,0.000039,0.000081,0,17659,22,0.000013,16,0.146251,0.170384,1602.381198,0.117647,0.000949
103191,103191,,9,33,42,9,33,42,0.000296,0.000709,0,17660,2,0.000014,17,0.192556,0.219443,8984.459544,0.168409,0.0023
104236,104236,,24,21,45,24,21,45,0.000669,0.003865,0,17661,2,0.000025,15,0.203499,0.22971,48443.707081,0.147475,0.006353
103192,103192,,12,34,46,12,34,46,0.000603,0.005859,0,16012,30,0.000015,14,0.20812,0.235605,34187.625769,0.123671,0.003063
103193,103193,,0,11,11,0,11,11,0,0.000582,0,17662,25,0.00001,17,0.177367,0.197336,0,0.172727,0
104221,104221,,8,8,16,8,8,16,0.000002,0.000003,0,17663,20,0.000014,14,0.14961,0.160572,233.060747,0.329167,0.001993
107020,107020,,9,17,26,9,17,26,0.000002,0.000018,0,17665,20,0.000014,13,0.165014,0.179074,1632.355456,0.258462,0.002218
106230,106230,,8,13,21,8,13,21,0.000001,0.000007,0,17664,20,0.000015,13,0.163108,0.177034,477.940973,0.233333,0.002016
103196,103196,,16,43,59,16,43,59,0.000459,0.003072,0,15785,30,0.000016,13,0.208906,0.23287,93843.949239,0.152835,0.004634
9604126,9604126,,9,0,9,9,0,9,0.000131,0,0,10803,30,0.000064,0,0,0,0,0.152778,0.002336
9802122,9802122,,6,1,7,6,1,7,0.000153,0.000002,0,15772,30,0.000016,1,1,1,38.710089,0.285714,0.001749
9312192,9312192,,9,3,12,9,3,12,0.000004,0.000009,0,1470,22,0.00004,3,0.555556,0.633333,168.329736,0.257576,0.002602
103198,103198,,18,11,29,18,11,29,0.000872,0.000098,0,15546,1,0.000039,17,0.176234,0.192521,63654.645733,0.123153,0.004677
103199,103199,,7,21,28,7,21,28,0.000642,0.002532,0,15895,30,0.000013,14,0.198415,0.218468,127973.832217,0.19709,0.003977
103200,103200,,0,9,9,0,9,9,0,0.002914,0,17666,25,0.00001,12,0.18938,0.208702,0,0.208333,0
103201,103201,,0,2,2,0,2,2,0,0,0,17667,1,0.00001,15,0.12866,0.13787,0,0.5,0
103202,103202,,0,3,3,0,3,3,0,0.000008,0,17668,0,0.00001,13,0.169418,0.183187,0,0.5,0
103203,103203,,2,34,36,2,34,36,0.000139,0.003029,0,17669,30,0.00001,13,0.213052,0.238584,42574.461417,0.094444,0.000687
103204,103204,,3,18,21,3,18,21,0.000041,0.001706,0,15771,4,0.000011,17,0.191173,0.220571,87479.377604,0.152381,0.000972
103205,103205,,5,23,28,5,23,28,0.00013,0.002621,0,15581,25,0.000013,14,0.194551,0.216398,7732.734245,0.108466,0.001201
103206,103206,,2,16,18,2,16,18,0.000001,0.000167,0,17672,30,0.000012,15,0.184175,0.202117,1965.622155,0.169935,0.000445
9405180,9405180,,1,2,3,1,2,3,0.000002,0.000005,0,17671,30,0.000011,1,1,1,5,0.166667,0.000232
9608188,9608188,,2,5,7,2,5,7,0.000002,0.000011,0,17670,30,0.000012,2,0.857143,0.916667,15.083333,0.071429,0.000451
9208005,9208005,,4,0,4,4,0,4,0,0,0,5435,15,0.000018,0,0,0,0,0,0.000904
103207,103207,,0,10,10,0,10,10,0,0.001235,0,17673,25,0.00001,14,0.19434,0.213944,0,0.288889,0
103208,103208,,11,19,30,11,19,30,0.001742,0.017927,0,17674,1,0.000015,17,0.191808,0.215571,19872.486365,0.132184,0.003052
103209,103209,,16,25,41,16,25,41,0.001023,0.005015,0,15925,30,0.000017,13,0.214469,0.240671,81200.652145,0.1,0.00619
103212,103212,,0,5,5,0,5,5,0,0.002261,0,17675,22,0.00001,16,0.162415,0.182524,0,0.05,0
103213,103213,,1,5,6,1,5,6,0.000012,0.00036,0,16274,3,0.000011,15,0.171555,0.186543,9.583333,0.466667,0.000309
103214,103214,,3,4,7,3,4,7,0.000227,0,0,17676,6,0.000012,14,0.147178,0.156973,2404.608689,0.238095,0.000684
103215,103215,,5,12,17,5,12,17,0.000012,0.000002,0,17678,22,0.000014,18,0.129564,0.138377,696.752124,0.279412,0.001129
9809012,9809012,,2,0,2,2,0,2,0,0,0,17677,5,0.000015,0,0,0,0,0,0.000478
103216,103216,,0,1,1,0,1,1,0,0,18,17680,39,0.00001,1,1,1,0,0,0
103039,103039,,1,0,1,1,0,1,0,0,18,17679,39,0.000019,0,0,0,0,0,0.000219
103217,103217,,15,6,21,15,6,21,0.00055,0.001691,0,15768,30,0.000017,14,0.186716,0.204562,273.357199,0.283333,0.006102
103218,103218,,0,6,6,0,6,6,0,0.000003,0,17681,8,0.00001,14,0.139187,0.147876,0,0.233333,0
103219,103219,,7,41,48,7,41,48,0.00167,0.005286,0,15613,1,0.000013,14,0.210987,0.238637,48892.285564,0.124113,0.002041
103220,103220,,16,47,63,16,47,63,0.001399,0.020567,0,15995,1,0.000023,15,0.214418,0.243231,110045.026489,0.08935,0.005999
103221,103221,,3,13,16,3,13,16,0.000004,0.000007,0,17683,23,0.000012,13,0.156085,0.172525,1044.609027,0.333333,0.00071
9904032,9904032,,3,13,16,3,13,16,0,0.000013,0,17682,23,0.000012,13,0.156702,0.174193,2014.146833,0.295833,0.000711
9306092,9306092,,5,0,5,5,0,5,0.000001,0,0,12621,23,0.000017,0,0,0,0,0.15,0.001143
103222,103222,,7,31,38,7,31,38,0.000473,0.020918,0,17684,4,0.000014,12,0.207487,0.234646,14224.570117,0.136558,0.001688
103223,103223,,33,25,58,33,25,58,0.001293,0.002452,0,16176,10,0.000028,14,0.200074,0.227645,11561.120505,0.145796,0.013588
103224,103224,,5,14,19,5,14,19,0.000519,0.00226,0,17685,2,0.000014,13,0.202109,0.225197,7138.536818,0.163743,0.001175
103225,103225,,1,5,6,1,5,6,0.000045,0.000062,0,16005,28,0.000011,14,0.189736,0.210407,25335.650947,0.266667,0.000394
103226,103226,,1,12,13,1,12,13,0.000025,0.002213,0,17686,30,0.00001,14,0.194633,0.213438,309.196298,0.339744,0.000226
103227,103227,,3,2,5,3,2,5,0.000051,0.00001,0,17687,15,0.000013,12,0.167927,0.182779,543.863374,0.1,0.000847
103228,103228,,0,5,5,0,5,5,0,0.000003,0,17688,28,0.00001,3,0.578947,0.69697,0,0.15,0
103229,103229,,9,29,38,9,29,38,0.000635,0.004287,0,17693,30,0.000013,14,0.208535,0.232364,23239.112026,0.117354,0.002195
9801181,9801181,,3,30,33,3,30,33,0.000184,0.010101,0,17691,2,0.000011,15,0.205804,0.24741,3551.669533,0.141098,0.000733
9903105,9903105,,2,25,27,2,25,27,0.000072,0.009597,0,17692,2,0.000011,11,0.234977,0.270847,3406.435625,0.183761,0.0005
9201052,9201052,,2,0,2,2,0,2,0.000119,0,0,17689,3,0.000012,0,0,0,0,0.5,0.000466
9308156,9308156,,1,6,7,1,6,7,0.000119,0.000059,0,17690,3,0.00001,3,0.535714,0.588889,74.074783,0.095238,0.00024
103230,103230,,30,32,62,30,32,62,0.004946,0.018213,0,16199,1,0.000022,17,0.195921,0.221709,11548.898369,0.191169,0.008583
103231,103231,,9,22,31,9,22,31,0.001397,0.008894,0,17694,1,0.000016,14,0.19198,0.215803,12077.45972,0.110753,0.002104
103232,103232,,6,7,13,6,7,13,0.000012,0.000045,0,17695,52,0.000016,14,0.155556,0.169621,11774.733741,0.179487,0.001381
103235,103235,,16,25,41,16,25,41,0.000511,0.015364,0,15976,23,0.000023,13,0.2045,0.229311,199630.103643,0.067073,0.003921
10064,10064,,5,0,5,5,0,5,0.000184,0,0,15975,23,0.000014,0,0,0,0,0.15,0.001257
103236,103236,,0,2,2,0,2,2,0,0,0,17696,23,0.00001,2,0.666667,0.75,0,0.5,0
9507030,9507030,,4,1,5,4,1,5,0,0,0,10207,23,0.000023,2,0.6,0.666667,0,0.3,0.000923
103237,103237,,5,19,24,5,19,24,0.00061,0.001792,0,17697,1,0.000014,16,0.186505,0.208884,32332.593301,0.152174,0.00141
103238,103238,,2,3,5,2,3,5,0,0,0,17701,22,0.000016,3,0.5,0.642857,2,0.2,0.000438
9401120,9401120,,3,1,4,3,1,4,0,0.000001,0,17700,22,0.000021,2,0.571429,0.625,12,0.166667,0.00067
9409042,9409042,,2,0,2,2,0,2,0,0,0,17699,22,0.000017,0,0,0,0,0.5,0.000451
9409109,9409109,,2,0,2,2,0,2,0,0,0,17698,22,0.000017,0,0,0,0,0.5,0.000451
103239,103239,,109,62,171,109,62,171,0.00484,0.005013,0,15698,0,0.000104,15,0.217396,0.25165,457121.724918,0.048332,0.032997
104073,104073,,46,30,76,46,30,76,0.002258,0.00322,0,16715,0,0.000044,15,0.205055,0.233302,54191.216013,0.091579,0.013405
105032,105032,,48,14,62,48,14,62,0.002314,0.000927,0,17702,3,0.000039,11,0.216272,0.240082,111128.382093,0.095452,0.017116
108187,108187,,78,24,102,78,24,102,0.003249,0.003094,0,17712,0,0.000073,13,0.199582,0.22296,136097.516198,0.078626,0.025748
106241,106241,,27,41,68,27,41,68,0.000964,0.00372,0,17711,0,0.000029,12,0.213157,0.240386,95982.626843,0.107989,0.008843
108075,108075,,73,30,103,73,30,103,0.004132,0.004046,0,16152,3,0.000051,15,0.215099,0.243657,292805.369496,0.057586,0.024271
109050,109050,,32,4,36,32,4,36,0.000613,0.00039,0,17715,0,0.000036,14,0.182063,0.199806,5231.432168,0.163492,0.008813
109004,109004,,28,23,51,28,23,51,0.000765,0.001592,0,17714,0,0.000039,14,0.202923,0.228022,46118.437031,0.136471,0.00809
103240,103240,,8,17,25,8,17,25,0.000843,0.002826,0,15695,25,0.000014,15,0.190553,0.213337,31603.194931,0.24,0.002312
103241,103241,,28,25,53,28,25,53,0.004988,0.002232,0,15656,8,0.000021,13,0.198873,0.219972,27166.297642,0.235849,0.010305
204218,204218,,14,33,47,14,33,47,0.002467,0.019613,0,17858,8,0.000014,14,0.199206,0.225561,17818.305785,0.170675,0.003608
104262,104262,,13,23,36,13,23,36,0.00159,0.004791,0,17738,25,0.000015,16,0.190567,0.217755,8553.824311,0.13254,0.003832
105070,105070,,35,29,64,35,29,64,0.006086,0.004928,0,15660,8,0.000023,13,0.194741,0.218677,18466.189164,0.210813,0.011867
105249,105249,,21,29,50,21,29,50,0.002355,0.012737,0,16035,8,0.000017,13,0.196661,0.219687,3697.749176,0.216327,0.006379
106086,106086,,24,33,57,24,33,57,0.003752,0.020298,0,15707,8,0.000022,13,0.195222,0.21985,9357.743852,0.183897,0.007937
107108,107108,,10,57,67,10,57,67,0.0012,0.007255,0,17739,25,0.000015,14,0.208037,0.237563,48991.652787,0.100407,0.002985
108052,108052,,6,37,43,6,37,43,0.001176,0.021937,0,17857,1,0.000012,14,0.214967,0.245161,10517.788152,0.183278,0.001567
111085,111085,,39,26,65,39,26,65,0.006395,0.018669,0,17740,8,0.000022,14,0.204132,0.230733,98863.989883,0.148317,0.01192
111247,111247,,23,18,41,23,18,41,0.004604,0.018287,0,17742,8,0.000018,15,0.193231,0.218901,15110.427709,0.180488,0.006699
112009,112009,,10,22,32,10,22,32,0.002053,0.018115,0,17760,8,0.000013,13,0.197381,0.218469,28168.974561,0.25,0.003131
204190,204190,,8,22,30,8,22,30,0.001585,0.002985,0,17852,25,0.000012,13,0.191026,0.212169,27050.986147,0.186207,0.002055
103242,103242,,4,21,25,4,21,25,0.000145,0.001004,0,17859,2,0.000012,14,0.167453,0.191763,7502.266665,0.193333,0.000951
103243,103243,,1,29,30,1,29,30,0.000053,0.007598,0,17861,0,0.00001,12,0.206124,0.249774,71.951657,0.143678,0.000219
9307145,9307145,,8,5,13,8,5,13,0.00018,0.000029,0,780,0,0.000021,2,0.727273,0.8125,3390.741954,0.230769,0.002095
9412033,9412033,,5,12,17,5,12,17,0.000141,0.000059,0,1626,0,0.000014,3,0.647059,0.757576,38375.566845,0.147059,0.001345
9505120,9505120,,1,10,11,1,10,11,0.000089,0.000133,0,17860,0,0.00001,3,0.541667,0.653846,3.394444,0.245455,0.000226
9305103,9305103,,2,0,2,2,0,2,0.000001,0,0,1621,0,0.000015,0,0,0,0,0.5,0.000488
9404176,9404176,,2,3,5,2,3,5,0.000001,0.000016,0,1623,0,0.000014,1,1,1,487.344615,0.05,0.000489
103244,103244,,0,19,19,0,19,19,0,0.001821,0,17862,1,0.00001,15,0.19914,0.226541,0,0.143275,0
103245,103245,,0,7,7,0,7,7,0,0.000003,0,17864,23,0.00001,15,0.170751,0.193108,0,0.095238,0
9503193,9503193,,1,3,4,1,3,4,0,0.000005,0,17863,23,0.000011,5,0.346457,0.401894,36.146368,0.166667,0.000219
103246,103246,,4,28,32,4,28,32,0.000211,0.003029,0,17866,4,0.000012,17,0.187699,0.21558,4424.122014,0.196573,0.001005
9502089,9502089,,2,8,10,2,8,10,0.000065,0.000127,0,17865,4,0.000011,6,0.298013,0.358148,65.126919,0.177778,0.000473
103254,103254,,1,2,3,1,2,3,0.000001,0,0,17867,4,0.000011,10,0.173837,0.195775,9.533333,0,0.000219
103247,103247,,29,16,45,29,16,45,0.003284,0.018529,0,17765,1,0.000028,15,0.227751,0.257798,68972.489058,0.126263,0.008532
103248,103248,,4,22,26,4,22,26,0.000677,0.004831,0,15692,25,0.000012,17,0.200232,0.225442,3217.456011,0.141538,0.001438
103249,103249,,1,11,12,1,11,12,0.000004,0.000355,0,17868,1,0.000011,17,0.162312,0.178833,30.170266,0.25,0.000226
103250,103250,,1,5,6,1,5,6,0.000003,0.000007,0,17869,6,0.00001,16,0.134782,0.148384,44.261993,0.433333,0.000266
103251,103251,,1,1,2,1,1,2,0,0,0,17871,28,0.000014,1,1,1,0,0.5,0.000232
103053,103053,,2,0,2,2,0,2,0,0,0,17870,28,0.000027,0,0,0,0,0.5,0.000458
103252,103252,,4,9,13,4,9,13,0.000008,0.000004,0,17872,6,0.000012,15,0.155134,0.169571,12675.907399,0.160256,0.000897
103253,103253,,0,1,1,0,1,1,0,0,0,17873,26,0.00001,1,1,1,0,0,0
103255,103255,,13,4,17,13,4,17,0.000678,0.000023,0,15547,1,0.000028,18,0.150202,0.159973,1058.548933,0.194853,0.003381
103256,103256,,37,30,67,37,30,67,0.001356,0.001777,0,15788,30,0.000026,13,0.208914,0.231459,186095.869916,0.146088,0.011576
103257,103257,,3,22,25,3,22,25,0.000037,0.001224,0,17805,25,0.000011,15,0.191764,0.212998,36107.779226,0.205,0.000675
103258,103258,,3,12,15,3,12,15,0.000058,0.000733,0,17874,22,0.000012,15,0.168919,0.183078,258.562597,0.12381,0.000684
9403103,9403103,,2,0,2,2,0,2,0,0,0,10303,22,0.000022,0,0,0,0,0.5,0.00052
9405157,9405157,,1,2,3,1,2,3,0,0,0,10305,22,0.000015,1,1,1,1880,0.166667,0.000293
103259,103259,,2,10,12,2,10,12,0.000314,0.012752,0,15691,25,0.000011,16,0.190892,0.213312,12666.933643,0.189394,0.000567
103260,103260,,5,10,15,5,10,15,0.000019,0.000671,0,17875,13,0.000013,15,0.153271,0.177441,1487.625825,0.242857,0.001135
103261,103261,,3,10,13,3,10,13,0.000012,0.003076,0,17876,2,0.000013,13,0.19914,0.219452,4417.817479,0.166667,0.00067
103262,103262,,2,24,26,2,24,26,0.000194,0.006433,0,17877,2,0.000011,13,0.221248,0.245868,1576.1896,0.192308,0.000445
103263,103263,,4,14,18,4,14,18,0,0.000001,0,17878,6,0.000013,20,0.12718,0.157804,723.008506,0.215686,0.00091
103264,103264,,0,7,7,0,7,7,0,0.000987,0,17879,25,0.00001,15,0.187277,0.208723,0,0.190476,0
9401113,9401113,,3,1,4,3,1,4,0.000018,0,0,14405,13,0.000015,1,1,1,46,0.083333,0.000684
9204101,9204101,,4,0,4,4,0,4,0.000008,0,0,14404,13,0.000027,0,0,0,0,0.166667,0.000916
103265,103265,,6,15,21,6,15,21,0.000266,0.001491,0,17850,25,0.000011,16,0.181653,0.203355,410.551829,0.271429,0.001549
104002,104002,,7,17,24,7,17,24,0,0.000004,0,17880,6,0.000015,14,0.15323,0.168421,27406.813622,0.137681,0.001573
9412142,9412142,,3,1,4,3,1,4,0,0,0,7522,6,0.000014,1,1,1,3127.665882,0.416667,0.000764
9412237,9412237,,5,7,12,5,7,12,0.000002,0.000001,0,7524,6,0.000015,3,0.583333,0.714286,28032.543382,0.075758,0.001189
104003,104003,,3,8,11,3,8,11,0.000004,0.000191,0,17885,28,0.000014,13,0.180239,0.197559,4887.167005,0.154545,0.000678
9912179,9912179,,4,8,12,4,8,12,0.000054,0.000003,0,17884,23,0.000015,14,0.138319,0.155502,2805.004314,0.05303,0.000982
9412244,9412244,,1,2,3,1,2,3,0,0,0,17883,23,0.000012,1,1,1,123,0.166667,0.000247
9909039,9909039,,4,4,8,4,4,8,0,0.000001,0,17881,23,0.000021,8,0.253989,0.280772,756.282175,0.160714,0.00093
104004,104004,,1,6,7,1,6,7,0.000021,0.003063,0,17886,30,0.000011,13,0.18833,0.206244,184.203009,0.214286,0.000226
104005,104005,,67,3,70,67,3,70,0.003974,0.001023,0,15679,0,0.000106,15,0.172965,0.187859,99968.724657,0.045963,0.018379
104006,104006,,0,1,1,0,1,1,0,0,0,17887,23,0.00001,14,0.158242,0.1719,0,0,0
104007,104007,,3,1,4,3,1,4,0,0,0,17888,23,0.000014,1,1,1,9,0.166667,0.000724
104008,104008,,3,2,5,3,2,5,0,0,0,17893,6,0.000019,13,0.153449,0.170713,1149.255936,0.2,0.000671
9901142,9901142,,3,9,12,3,9,12,0,0.000009,0,17892,26,0.000023,12,0.180794,0.211507,3340.323876,0.121212,0.000684
9204047,9204047,,3,0,3,3,0,3,0,0,0,17889,26,0.00002,0,0,0,0,0.5,0.000697
9606167,9606167,,5,6,11,5,6,11,0.000023,0.000015,0,7312,26,0.000023,8,0.22865,0.261216,129299.961121,0.181818,0.001185
9809006,9809006,,3,2,5,3,2,5,0,0,0,17890,26,0.000015,9,0.186828,0.204707,1,0.4,0.000691
9809066,9809066,,2,5,7,2,5,7,0,0,0,17891,26,0.000013,12,0.179353,0.20658,197.080257,0.309524,0.000458
104009,104009,,1,20,21,1,20,21,0.000038,0.002042,0,17895,25,0.00001,16,0.185136,0.209215,1584.772395,0.121429,0.000316
9412065,9412065,,1,8,9,1,8,9,0.000024,0.000099,0,17894,13,0.00001,5,0.342466,0.397048,225.928914,0.125,0.000227
9801194,9801194,,2,23,25,2,23,25,0.000128,0.004679,0,5729,13,0.000011,15,0.195826,0.239428,101404.524814,0.096667,0.000485
9411129,9411129,,7,1,8,7,1,8,0.000006,0,0,5719,13,0.000025,1,1,1,14.312552,0.196429,0.001607
9411061,9411061,,7,4,11,7,4,11,0.000076,0.000281,0,5725,13,0.000021,4,0.455882,0.513441,34099.146629,0.109091,0.0016
9504060,9504060,,4,6,10,4,6,10,0.000059,0.000009,0,5727,13,0.000015,5,0.281525,0.334375,27617.520926,0.2,0.00091
9512209,9512209,,3,6,9,3,6,9,0.000073,0.000181,0,5728,13,0.000012,9,0.220224,0.25086,8422.21394,0.222222,0.000671
104011,104011,,3,24,27,3,24,27,0.000535,0.002337,0,17896,8,0.000011,13,0.220287,0.245673,6108.662806,0.138177,0.000752
104012,104012,,1,7,8,1,7,8,0.000001,0.000023,0,17898,26,0.000011,17,0.136574,0.149045,6.569048,0.214286,0.000219
9711129,9711129,,1,5,6,1,5,6,0,0.000473,0,17897,26,0.000011,15,0.158251,0.174293,1747.308312,0.133333,0.000226
104013,104013,,0,1,1,0,1,1,0,0,0,17900,26,0.00001,5,0.266667,0.327083,0,0,0
9903188,9903188,,1,2,3,1,2,3,0,0.000009,0,17899,26,0.000019,4,0.340909,0.427778,15,0.166667,0.000219
104014,104014,,0,4,4,0,4,4,0,0,0,17901,23,0.00001,18,0.108452,0.114668,0,0.166667,0
104015,104015,,4,6,10,4,6,10,0.000042,0.000268,0,17903,3,0.000013,14,0.183309,0.199393,1912.291684,0.188889,0.001102
8021,8021,,1,0,1,1,0,1,0.000003,0,0,17902,3,0.000012,0,0,0,0,0,0.000248
104016,104016,,29,50,79,29,50,79,0.004726,0.021321,0,16202,1,0.000021,15,0.209404,0.244206,58908.437415,0.169263,0.008326
104017,104017,,19,22,41,19,22,41,0.000416,0.000675,0,17808,30,0.000018,13,0.206834,0.22681,8696.126395,0.177439,0.0054
104018,104018,,1,5,6,1,5,6,0,0,0,17904,6,0.000011,14,0.12426,0.139223,642.729933,0.266667,0.000219
104020,104020,,1,7,8,1,7,8,0.000039,0.00056,0,17905,25,0.00001,18,0.18532,0.204242,18.563896,0.25,0.000219
104021,104021,,7,55,62,7,55,62,0.000505,0.005859,0,17831,30,0.000012,12,0.218513,0.244867,6158.816156,0.151772,0.001739
104022,104022,,3,9,12,3,9,12,0.000012,0.000002,0,17908,22,0.000012,17,0.145627,0.15732,3605.39039,0.136364,0.000697
9612025,9612025,,2,7,9,2,7,9,0,0.000015,0,17907,26,0.000015,8,0.228261,0.275781,704.198029,0.013889,0.000471
9306051,9306051,,1,0,1,1,0,1,0,0,0,17906,26,0.000012,0,0,0,0,0,0.000233
104023,104023,,16,22,38,16,22,38,0.001497,0.002039,0,15672,25,0.000016,13,0.198397,0.219864,32676.482974,0.159317,0.004408
104025,104025,,2,2,4,2,2,4,0.000019,0,0,17909,5,0.000014,11,0.145171,0.167036,331.258383,0,0.000452
104026,104026,,22,43,65,22,43,65,0.002947,0.009493,0,16197,1,0.000018,12,0.222364,0.251282,41660.094767,0.124519,0.006488
104027,104027,,2,5,7,2,5,7,0.000005,0.000044,0,17910,5,0.000012,13,0.162141,0.173924,12.61878,0.214286,0.000445
9501026,9501026,,5,1,6,5,1,6,0.000009,0,0,1913,5,0.000043,2,0.666667,0.75,12890.392757,0.133333,0.001259
104028,104028,,2,30,32,2,30,32,0.000019,0.000009,0,17911,17,0.000011,14,0.142972,0.178337,98122.105188,0.27621,0.000592
104029,104029,,13,8,21,13,8,21,0.000007,0.000071,0,17912,23,0.000034,14,0.171964,0.187225,59606.678392,0.190476,0.003088
104047,104047,,6,6,12,6,6,12,0.000004,0.000008,0,17913,23,0.000016,15,0.151263,0.163348,2125.812585,0.234848,0.001433
104030,104030,,0,1,1,0,1,1,0,0,0,17914,4,0.00001,1,1,1,0,0,0
104031,104031,,1,122,123,1,122,123,0.000057,0.006324,0,17915,0,0.00001,15,0.233262,0.268187,7233.620793,0.043916,0.000248
104032,104032,,8,18,26,8,18,26,0.000373,0.003508,0,17917,1,0.000015,14,0.20336,0.229459,11881.375761,0.129231,0.00217
103135,103135,,16,0,16,16,0,16,0.000159,0,0,17916,0,0.000041,0,0,0,0,0.225,0.004069
104033,104033,,0,7,7,0,7,7,0,0.00042,0,17918,4,0.00001,15,0.170385,0.184961,0,0.238095,0
104034,104034,,1,5,6,1,5,6,0.000052,0.002874,0,17919,2,0.00001,18,0.191695,0.213975,12.370866,0.266667,0.000219
104035,104035,,43,6,49,43,6,49,0.001641,0.000321,0,15680,0,0.000079,16,0.179192,0.197999,51768.648472,0.065051,0.011041
104036,104036,,45,28,73,45,28,73,0.00211,0.005558,0,15855,30,0.000033,13,0.218213,0.243501,85072.951804,0.099315,0.014058
104045,104045,,32,22,54,32,22,54,0.001384,0.002063,0,15808,30,0.000023,13,0.221416,0.247334,38357.543245,0.118099,0.009004
104139,104139,,31,37,68,31,37,68,0.001646,0.005524,0,15866,30,0.000022,14,0.217142,0.243964,97864.104826,0.123354,0.010125
104037,104037,,48,48,96,48,48,96,0.003344,0.005785,0,16167,4,0.000034,14,0.210624,0.243425,100695.842124,0.102522,0.020356
9806170,9806170,,3,22,25,3,22,25,0.000142,0.002839,0,8024,4,0.000011,11,0.210249,0.242063,2448.654752,0.31,0.001135
9806224,9806224,,2,32,34,2,32,34,0.000081,0.003409,0,7998,4,0.000011,12,0.215864,0.251314,1486.237657,0.110517,0.000574
9808125,9808125,,4,13,17,4,13,17,0.000144,0.003465,0,7997,4,0.000011,12,0.209038,0.239857,1792.834516,0.246324,0.001012
104038,104038,,4,7,11,4,7,11,0.000033,0.000047,0,17920,30,0.000012,19,0.123218,0.138539,91.849048,0.227273,0.00089
104039,104039,,1,20,21,1,20,21,0.00026,0.004813,0,17921,1,0.00001,15,0.216128,0.247632,0,0.145238,0.000219
9204103,9204103,,4,0,4,4,0,4,0.000317,0,0,5721,1,0.00002,0,0,0,0,0.083333,0.00091
104040,104040,,0,1,1,0,1,1,0,0.000019,0,17922,8,0.00001,13,0.157439,0.166875,0,0,0
104042,104042,,4,22,26,4,22,26,0.000242,0.001224,0,15946,3,0.000012,12,0.197798,0.217719,1898.487629,0.290769,0.001376
104044,104044,,3,35,38,3,35,38,0.000624,0.018772,0,15735,1,0.000011,15,0.222653,0.259264,2088.973107,0.139403,0.000775
104046,104046,,0,31,31,0,31,31,0,0.013151,0,17923,2,0.00001,13,0.208851,0.241785,0,0.156989,0
104048,104048,,4,33,37,4,33,37,0.000089,0.000635,0,17924,2,0.000014,14,0.181424,0.205759,42406.319695,0.125375,0.001
104049,104049,,12,22,34,12,22,34,0.000548,0.002426,0,15640,25,0.000014,16,0.180764,0.203543,1381.66124,0.209447,0.003232
104050,104050,,12,30,42,12,30,42,0.000719,0.003931,0,17927,41,0.000017,15,0.200363,0.225668,24891.15416,0.121371,0.002782
9403028,9403028,,3,2,5,3,2,5,0.000053,0.000008,0,17926,10,0.000018,4,0.409091,0.509259,63.069247,0.05,0.000737
9807044,9807044,,3,2,5,3,2,5,0.000057,0.000001,0,17925,10,0.000019,4,0.37931,0.477273,123.783762,0.1,0.000744
104052,104052,,1,1,2,1,1,2,0,0,0,17929,9,0.000011,1,1,1,1,0,0.000219
9810085,9810085,,2,0,2,2,0,2,0.000005,0,0,17928,9,0.000022,0,0,0,0,0,0.000451
104055,104055,,1,8,9,1,8,9,0,0.000013,0,17932,23,0.00001,16,0.132837,0.158874,497.447959,0.236111,0.000226
9808003,9808003,,3,11,14,3,11,14,0.000001,0.000022,0,17931,23,0.000013,15,0.145975,0.176437,3872.959709,0.131868,0.000677
9907135,9907135,,1,6,7,1,6,7,0,0.000015,0,17930,23,0.000011,16,0.136084,0.165912,584.789724,0.142857,0.000226
104057,104057,,3,29,32,3,29,32,0.000077,0.004848,0,15937,25,0.000012,15,0.204676,0.232837,8362.455429,0.133065,0.00099
104058,104058,,0,7,7,0,7,7,0,0.000012,0,17933,23,0.00001,15,0.145558,0.159969,0,0.190476,0
104059,104059,,0,42,42,0,42,42,0,0.008803,0,17937,30,0.00001,15,0.214045,0.246288,0,0.093496,0
9504017,9504017,,3,6,9,3,6,9,0.000104,0.000099,0,17935,17,0.000044,4,0.475,0.592105,148.5,0.111111,0.000697
9512015,9512015,,5,1,6,5,1,6,0.000104,0.000001,0,17936,17,0.000033,5,0.333333,0.385,100,0.133333,0.001128
9807178,9807178,,3,0,3,3,0,3,0.000103,0,0,17934,17,0.000021,0,0,0,0,0,0.000658
104061,104061,,6,9,15,6,9,15,0.000228,0.001606,0,15945,3,0.000013,15,0.185924,0.208699,2453.160939,0.195238,0.001699
104062,104062,,1,5,6,1,5,6,0.000046,0.000166,0,17938,4,0.000011,10,0.198572,0.227608,1,0.266667,0.000226
104063,104063,,0,3,3,0,3,3,0,0.00134,0,17939,4,0.00001,7,0.246575,0.282876,0,0.333333,0
104064,104064,,8,23,31,8,23,31,0.000307,0.00376,0,17940,4,0.000013,15,0.170285,0.190494,11808.784216,0.217204,0.001935
104065,104065,,6,16,22,6,16,22,0.00115,0.004131,0,15979,1,0.000014,11,0.228073,0.259037,4881.559487,0.166667,0.001591
104066,104066,,7,14,21,7,14,21,0.001275,0.020902,0,17941,1,0.000015,11,0.22741,0.2586,6423.510616,0.25,0.001781
9606031,9606031,,4,20,24,4,20,24,0.000276,0.002812,0,3573,13,0.000012,11,0.209083,0.253078,466.517304,0.172101,0.001244
104067,104067,,5,14,19,5,14,19,0.000136,0.001488,0,17942,25,0.000013,15,0.188351,0.208313,2136.784332,0.222222,0.001155
104068,104068,,6,38,44,6,38,44,0.000532,0.005228,0,15978,2,0.000011,12,0.220222,0.249967,13472.656414,0.134778,0.001459
3209,3209,,4,0,4,4,0,4,0.000198,0,0,15977,2,0.000011,0,0,0,0,0.333333,0.000943
9706104,9706104,,1,0,1,1,0,1,0.000061,0,0,15969,2,0.00001,0,0,0,0,0,0.00026
104169,104169,,14,54,68,14,54,68,0.001456,0.011137,0,15919,30,0.000014,12,0.218927,0.247753,120552.733407,0.090869,0.00499
104133,104133,,20,37,57,20,37,57,0.000951,0.004239,0,15893,30,0.000019,11,0.21105,0.233671,140986.851979,0.133459,0.007032
9210005,9210005,,1,0,1,1,0,1,0.000063,0,0,5105,2,0.000012,0,0,0,0,0,0.000498
9502117,9502117,,3,4,7,3,4,7,0.000124,0.000055,0,3911,26,0.000013,7,0.25724,0.313576,0,0.428571,0.000834
9503203,9503203,,2,6,8,2,6,8,0.000089,0.000057,0,5123,26,0.000011,7,0.260575,0.323701,11872.664799,0.267857,0.000562
104069,104069,,5,17,22,5,17,22,0.000727,0.01797,0,16211,1,0.000012,13,0.203323,0.226527,887.876905,0.272727,0.001261
105199,105199,,13,25,38,13,25,38,0.000469,0.003531,0,17709,0,0.000016,16,0.198456,0.22654,5758.40674,0.170697,0.003749
105212,105212,,18,10,28,18,10,28,0.000575,0.001774,0,17708,0,0.000022,16,0.181929,0.202124,462.406192,0.195767,0.005214
106179,106179,,16,8,24,16,8,24,0.000357,0.000575,0,17706,3,0.000028,12,0.196505,0.215375,47184.263126,0.130435,0.006019
105203,105203,,39,3,42,39,3,42,0.001498,0.001376,0,17705,3,0.000031,15,0.195829,0.226989,14919.760297,0.142276,0.013705
105204,105204,,61,25,86,61,25,86,0.00264,0.003396,0,17704,3,0.000046,12,0.211348,0.236461,82573.177622,0.086867,0.020162
105061,105061,,3,19,22,3,19,22,0.000099,0.004752,0,17710,0,0.000011,16,0.195747,0.224293,1479.648988,0.162338,0.000893
106051,106051,,12,15,27,12,15,27,0.000442,0.00298,0,17707,25,0.000016,13,0.192962,0.213913,21226.784847,0.172365,0.003175
106190,106190,,6,27,33,6,27,33,0.000249,0.003108,0,17703,25,0.000013,16,0.196725,0.224,8224.814155,0.173295,0.001646
104075,104075,,3,11,14,3,11,14,0.000102,0.00002,0,17950,22,0.000013,14,0.157158,0.168257,1413.094087,0.192308,0.000751
9807214,9807214,,8,3,11,8,3,11,0.000178,0,0,17947,25,0.00002,6,0.322581,0.495,605.458333,0.172727,0.001914
9810229,9810229,,2,5,7,2,5,7,0.000064,0.000003,0,17949,25,0.000011,6,0.363636,0.579167,16.333333,0.190476,0.000466
9607194,9607194,,5,1,6,5,1,6,0,0,0,17946,25,0.000027,5,0.333333,0.421429,38.75,0.1,0.00119
9607195,9607195,,5,0,5,5,0,5,0,0,0,17944,25,0.000027,0,0,0,0,0.1,0.00119
9607196,9607196,,5,0,5,5,0,5,0,0,0,17943,25,0.000027,0,0,0,0,0.1,0.00119
9611034,9611034,,4,4,8,4,4,8,0.000102,0,0,17948,25,0.000015,5,0.416667,0.595,1383.682689,0.107143,0.00097
104076,104076,,6,25,31,6,25,31,0.00019,0.003872,0,17816,30,0.000017,13,0.207334,0.230211,16597.247757,0.169892,0.00161
9711041,9711041,,1,0,1,1,0,1,0.000054,0,0,14660,2,0.000012,0,0,0,0,0,0.000266
104077,104077,,1,6,7,1,6,7,0.000018,0.00066,0,17951,4,0.00001,14,0.148959,0.167984,1.023519,0.380952,0.000219
104078,104078,,7,6,13,7,6,13,0.00013,0.000138,0,17953,10,0.000013,13,0.172243,0.189035,1185.8738,0.192308,0.002003
9810005,9810005,,3,3,6,3,3,6,0.000297,0.000048,0,17952,10,0.000013,14,0.149697,0.163309,25.71543,0.3,0.000766
104079,104079,,4,13,17,4,13,17,0.000001,0.000009,0,17961,6,0.000015,14,0.135859,0.154365,1525.499614,0.150735,0.00093
9811188,9811188,,4,3,7,4,3,7,0.000001,0.000002,0,17954,6,0.000016,9,0.206167,0.241721,4.666667,0.404762,0.000943
9905105,9905105,,4,8,12,4,8,12,0,0.000003,0,17960,6,0.000027,12,0.177109,0.201608,5759.663289,0.106061,0.000956
9612070,9612070,,4,6,10,4,6,10,0,0.000011,0,17956,9,0.000017,11,0.195828,0.221946,8935.486037,0.133333,0.000964
9803242,9803242,,3,8,11,3,8,11,0,0.000006,0,17959,9,0.000017,12,0.168111,0.190727,674.615615,0.127273,0.000705
9803243,9803243,,5,13,18,5,13,18,0.000001,0.000006,0,17958,9,0.000018,12,0.174405,0.202328,2777.730461,0.098039,0.001196
104080,104080,,7,2,9,7,2,9,0.000391,0.000009,0,17962,8,0.000027,14,0.156856,0.171187,5690.455514,0.236111,0.001868
104081,104081,,23,9,32,23,9,32,0.000422,0.001154,0,17964,13,0.00003,14,0.182804,0.204414,30838.368898,0.095766,0.005532
9906106,9906106,,1,10,11,1,10,11,0.000014,0.004312,0,17963,2,0.000013,14,0.193253,0.226086,1322.091092,0.190909,0.000375
104082,104082,,8,46,54,8,46,54,0.000778,0.00578,0,17966,52,0.000013,15,0.224361,0.25618,13758.381861,0.09399,0.001902
9912177,9912177,,3,39,42,3,39,42,0.000133,0.006261,0,17965,2,0.000011,11,0.240257,0.27716,6005.798987,0.098142,0.000725
104084,104084,,1,7,8,1,7,8,0.000001,0.000042,0,17968,23,0.00001,15,0.164403,0.176585,942.187325,0.089286,0.000252
9801041,9801041,,2,2,4,2,2,4,0,0.000031,0,17967,23,0.000016,8,0.182569,0.207328,229.287434,0.083333,0.000452
104085,104085,,1,8,9,1,8,9,0.000006,0.00052,0,17969,2,0.000011,21,0.168846,0.191264,0,0.277778,0.000219
104086,104086,,0,20,20,0,20,20,0,0.003564,0,17970,30,0.00001,13,0.202041,0.222138,0,0.186842,0
104087,104087,,5,7,12,5,7,12,0.000045,0.000163,0,17971,23,0.000013,12,0.193918,0.212605,17376.52344,0.098485,0.001135
104089,104089,,2,22,24,2,22,24,0.000063,0.002126,0,17975,2,0.000012,14,0.189444,0.219466,640.513596,0.21558,0.000438
10019,10019,,2,0,2,2,0,2,0.000082,0,0,17974,30,0.000011,0,0,0,0,0.5,0.000451
9506086,9506086,,1,13,14,1,13,14,0.000025,0.00272,0,17973,13,0.00001,9,0.234599,0.283605,100.717971,0.214286,0.000232
9910043,9910043,,3,11,14,3,11,14,0.000144,0.002659,0,17972,2,0.000011,15,0.173875,0.198799,118.022554,0.225275,0.000683
104090,104090,,18,30,48,18,30,48,0.000775,0.002075,0,15789,30,0.000017,12,0.205926,0.228269,58303.714594,0.142287,0.005673
104091,104091,,4,21,25,4,21,25,0.000104,0.000268,0,17976,30,0.000011,14,0.19156,0.210179,2662.674983,0.133333,0.000938
104092,104092,,4,2,6,4,2,6,0.000044,0,0,17978,4,0.000018,12,0.158707,0.172529,4225.200729,0.066667,0.000983
9904028,9904028,,2,2,4,2,2,4,0.000028,0.000071,0,17977,4,0.000018,11,0.18562,0.206382,5142.864356,0,0.000505
104093,104093,,13,13,26,13,13,26,0.000347,0.002481,0,15924,30,0.000042,14,0.209096,0.231034,186671.40425,0.050769,0.005163
104094,104094,,7,9,16,7,9,16,0.000024,0.00019,0,17979,4,0.000014,15,0.172401,0.188889,2135.305414,0.175,0.001654
104095,104095,,5,41,46,5,41,46,0.000126,0.002034,0,17814,30,0.000011,14,0.211683,0.235794,8102.626692,0.171981,0.001679
104153,104153,,41,10,51,41,10,51,0.001257,0.000972,0,15920,30,0.000043,13,0.192082,0.210124,106021.501175,0.075686,0.011581
104098,104098,,5,11,16,5,11,16,0.000116,0.000668,0,17980,23,0.000014,13,0.170279,0.186399,4872.899505,0.125,0.001155
104152,104152,,10,8,18,10,8,18,0.000169,0.000026,0,17981,23,0.00002,15,0.156127,0.166619,29177.576753,0.111111,0.00229
104099,104099,,21,25,46,21,25,46,0.001149,0.001014,0,15762,3,0.000017,12,0.196588,0.2158,6720.582976,0.243961,0.007282
105115,105115,,14,55,69,14,55,69,0.000315,0.003672,0,17791,3,0.000016,12,0.210126,0.236027,29838.379068,0.135124,0.003715
104143,104143,,20,42,62,20,42,62,0.000788,0.004906,0,15872,30,0.00002,11,0.216468,0.242754,52893.087347,0.122686,0.005615
104164,104164,,19,21,40,19,21,40,0.001337,0.001195,0,15767,3,0.000016,12,0.19642,0.215275,6568.978502,0.273077,0.006298
105098,105098,,20,28,48,20,28,48,0.001075,0.001506,0,15947,3,0.000016,13,0.187058,0.206274,4501.756573,0.200355,0.006094
105247,105247,,9,23,32,9,23,32,0.000121,0.000672,0,17792,3,0.000013,13,0.189421,0.210006,11364.693118,0.155242,0.002181
9507053,9507053,,2,7,9,2,7,9,0.000008,0.000006,0,17790,6,0.000011,5,0.325069,0.375282,489.187602,0.166667,0.000499
105264,105264,,6,18,24,6,18,24,0.000088,0.001355,0,17982,3,0.000012,13,0.19728,0.218456,1884.71894,0.208333,0.001447
106033,106033,,8,26,34,8,26,34,0.000376,0.000804,0,17983,3,0.000012,16,0.19615,0.217073,2801.18109,0.234403,0.001844
105227,105227,,25,39,64,25,39,64,0.00164,0.016866,0,15952,3,0.00002,13,0.204915,0.230273,50824.522284,0.155258,0.007755
105228,105228,,13,31,44,13,31,44,0.001168,0.005204,0,17786,3,0.000015,15,0.212048,0.237859,25490.871548,0.142178,0.003158
105238,105238,,17,34,51,17,34,51,0.000833,0.001387,0,15948,3,0.000015,12,0.200517,0.222005,9161.792238,0.175294,0.005013
105245,105245,,14,33,47,14,33,47,0.000368,0.022862,0,17788,3,0.000016,16,0.203907,0.23084,33069.399944,0.110546,0.003866
104100,104100,,10,15,25,10,15,25,0.000409,0.00098,0,17984,52,0.000014,12,0.192695,0.213835,914.765524,0.196667,0.002772
104101,104101,,2,6,8,2,6,8,0.000023,0.000039,0,17985,0,0.000013,15,0.18962,0.214642,2121.789122,0.214286,0.000452
104102,104102,,36,10,46,36,10,46,0.001234,0.001372,0,17986,8,0.000054,12,0.199819,0.221618,53304.393251,0.131401,0.010548
104103,104103,,1,20,21,1,20,21,0.000032,0.00204,0,17987,13,0.00001,17,0.199815,0.228285,6642.655949,0.159524,0.000239
104104,104104,,2,6,8,2,6,8,0,0.00001,0,17988,23,0.000014,17,0.134334,0.147859,5509.560956,0.160714,0.000445
104105,104105,,16,20,36,16,20,36,0.000442,0.002633,0,16180,10,0.000021,14,0.190017,0.215961,10727.260288,0.096825,0.00582
104106,104106,,8,37,45,8,37,45,0.000303,0.002636,0,15899,30,0.000013,18,0.201735,0.224826,5050.981485,0.178283,0.002314
104107,104107,,2,7,9,2,7,9,0.000008,0.000002,0,17989,23,0.000012,15,0.14067,0.156706,243.870295,0.138889,0.000451
9507052,9507052,,4,3,7,4,3,7,0,0.000003,0,8382,23,0.000017,2,0.636364,0.714286,13.2,0.285714,0.000998
9511095,9511095,,1,4,5,1,4,5,0,0.000001,0,8380,23,0.000012,2,0.642857,0.722222,8449.010908,0.15,0.000319
104108,104108,,3,11,14,3,11,14,0.000021,0.000037,0,17991,30,0.000012,14,0.161824,0.174513,1503.93805,0.115385,0.00071
9712183,9712183,,1,6,7,1,6,7,0,0.000026,0,17990,30,0.000011,11,0.176727,0.197249,60.902907,0.095238,0.000239
9607096,9607096,,5,5,10,5,5,10,0.000002,0.000013,0,8662,30,0.000017,3,0.55,0.606061,45.018993,0.244444,0.001149
9809051,9809051,,3,2,5,3,2,5,0.000001,0.000028,0,14563,26,0.000018,16,0.14545,0.157914,2372.56659,0.3,0.000684
9901141,9901141,,2,4,6,2,4,6,0,0.000028,0,14564,26,0.000015,16,0.145847,0.159158,2830.891527,0.2,0.000452
104109,104109,,0,1,1,0,1,1,0,0.000006,0,17992,2,0.00001,15,0.157657,0.171513,0,0,0
104110,104110,,0,14,14,0,14,14,0,0.000062,0,17994,23,0.00001,17,0.160801,0.189138,0,0.28022,0
9711171,9711171,,1,7,8,1,7,8,0.000001,0.000025,0,17993,23,0.00001,10,0.208413,0.240347,52.483141,0.303571,0.000219
104111,104111,,1,17,18,1,17,18,0.000367,0.010783,0,17995,8,0.00001,12,0.226689,0.257288,268.968674,0.215686,0.000447
104112,104112,,6,41,47,6,41,47,0.000381,0.00737,0,17996,2,0.000012,14,0.219367,0.247731,12241.346206,0.157724,0.001382
104113,104113,,7,18,25,7,18,25,0.000439,0.001697,0,15728,25,0.000014,15,0.20108,0.224948,21711.414329,0.17,0.001804
104130,104130,,7,13,20,7,13,20,0.000476,0.006979,0,15729,25,0.000014,16,0.193677,0.217386,2529.618969,0.226316,0.001769
104114,104114,,1,6,7,1,6,7,0.000041,0.000161,0,17997,28,0.00001,11,0.188824,0.205944,102.96726,0.142857,0.000219
104115,104115,,9,17,26,9,17,26,0.00013,0.000018,0,17999,23,0.00002,14,0.169009,0.193929,5112.065623,0.086154,0.002051
9707210,9707210,,1,6,7,1,6,7,0,0.000007,0,17998,23,0.000011,9,0.199054,0.221458,15.233333,0.261905,0.000278
104116,104116,,3,6,9,3,6,9,0,0.000001,0,18000,28,0.000014,2,0.8,0.875,5.333333,0.236111,0.000677
104117,104117,,1,1,2,1,1,2,0.000057,0.000003,0,18001,41,0.00001,13,0.152315,0.163001,78.874143,0,0.000248
104118,104118,,12,16,28,12,16,28,0.000478,0.000572,0,16092,25,0.000015,18,0.173566,0.193056,6669.22936,0.207672,0.002968
104120,104120,,0,5,5,0,5,5,0,0.000002,0,18002,6,0.00001,9,0.200369,0.244995,0,0.2,0
9204003,9204003,,9,0,9,9,0,9,0,0,0,2034,9,0.000056,0,0,0,0,0.111111,0.002117
9303095,9303095,,4,0,4,4,0,4,0,0,0,2371,6,0.000062,0,0,0,0,0,0.001046
104121,104121,,0,3,3,0,3,3,0,0,0,18003,22,0.00001,9,0.183036,0.241967,0,0.166667,0
104122,104122,,8,20,28,8,20,28,0.000582,0.001905,0,17779,25,0.000012,15,0.188148,0.209829,6886.10783,0.185185,0.002064
9407071,9407071,,2,2,4,2,2,4,0.000048,0,0,17778,25,0.000011,1,1,1,2760,0.083333,0.000494
9211029,9211029,,3,0,3,3,0,3,0,0,0,13205,22,0.000033,0,0,0,0,0,0.000684
9305122,9305122,,2,0,2,2,0,2,0,0,0,17777,22,0.000018,0,0,0,0,0,0.000465
104123,104123,,3,2,5,3,2,5,0.000214,0.000007,0,16338,23,0.000012,17,0.157292,0.17497,11866.362565,0.2,0.000802
104124,104124,,26,16,42,26,16,42,0.001238,0.001371,0,16181,10,0.000024,14,0.205513,0.231968,30136.777999,0.217189,0.010624
104125,104125,,7,21,28,7,21,28,0.000777,0.001754,0,18004,1,0.000014,14,0.198878,0.224806,7473.151298,0.205026,0.001894
104126,104126,,14,39,53,14,39,53,0.00055,0.0016,0,18005,52,0.000015,12,0.208339,0.233014,14347.623524,0.185776,0.003983
104127,104127,,0,1,1,0,1,1,0,0.000001,0,18006,5,0.00001,16,0.174875,0.190557,0,0,0
104128,104128,,1,13,14,1,13,14,0,0.000018,0,18007,5,0.000011,16,0.137927,0.153074,13.406567,0.274725,0.000219
104129,104129,,0,1,1,0,1,1,0,0.000002,0,18008,4,0.00001,13,0.152829,0.166189,0,0,0
104131,104131,,3,16,19,3,16,19,0.000787,0.00247,0,18009,25,0.000013,13,0.201981,0.226413,10275.651356,0.122807,0.000971
104132,104132,,4,25,29,4,25,29,0.000207,0.0189,0,18010,0,0.000017,14,0.212434,0.241742,19731.238643,0.121921,0.000904
104134,104134,,0,16,16,0,16,16,0,0.001325,0,18011,25,0.00001,13,0.188982,0.208738,0,0.316667,0
104136,104136,,66,16,82,66,16,82,0.003674,0.006832,0,15996,3,0.000054,16,0.197382,0.221135,55115.057046,0.119392,0.02322
104137,104137,,0,1,1,0,1,1,0,0,0,18013,23,0.00001,13,0.14716,0.16932,0,0,0
9702060,9702060,,1,8,9,1,8,9,0,0.000072,0,18012,23,0.000019,12,0.172264,0.213045,595,0.180556,0.000219
104138,104138,,6,21,27,6,21,27,0.000363,0.00037,0,16337,13,0.000013,15,0.175809,0.1972,13674.249746,0.065527,0.001532
104140,104140,,2,1,3,2,1,3,0,0,0,18015,25,0.000022,1,1,1,4,0.166667,0.000464
104060,104060,,1,0,1,1,0,1,0,0,0,18014,25,0.000029,0,0,0,0,0,0.000232
104141,104141,,32,31,63,32,31,63,0.005423,0.004267,0,15657,8,0.000023,13,0.197489,0.223159,15583.324775,0.15873,0.01129
104142,104142,,1,3,4,1,3,4,0.000162,0.000299,0,18016,1,0.00001,13,0.174102,0.191799,0,0.333333,0.000226
104144,104144,,1,1,2,1,1,2,0,0,0,18018,9,0.000019,2,0.666667,0.75,2,0,0.000219
9502068,9502068,,1,1,2,1,1,2,0,0,0,18017,9,0.000027,1,1,1,2,0,0.000226
104145,104145,,0,1,1,0,1,1,0,0,19,18020,40,0.00001,1,1,1,0,0,0
9909162,9909162,,1,0,1,1,0,1,0,0,19,18019,40,0.000019,0,0,0,0,0,0.000219
9511223,9511223,,5,3,8,5,3,8,0.000028,0.000003,0,4427,0,0.000025,3,0.47619,0.583333,3161.019934,0.25,0.001298
104147,104147,,31,32,63,31,32,63,0.001083,0.003054,0,18021,52,0.000025,12,0.206378,0.230649,40687.044708,0.103175,0.007952
104149,104149,,0,3,3,0,3,3,0,0.000032,0,18022,13,0.00001,15,0.175774,0.193555,0,0.333333,0
104150,104150,,7,34,41,7,34,41,0.000392,0.002108,0,16088,25,0.000013,12,0.208857,0.230939,61832.606108,0.14878,0.001914
104154,104154,,4,13,17,4,13,17,0.00007,0.002572,0,18023,30,0.000013,15,0.185126,0.205028,7069.783121,0.261029,0.000896
104155,104155,,5,12,17,5,12,17,0.000659,0.001145,0,16173,0,0.000013,14,0.194242,0.218176,13705.05631,0.136029,0.00149
104156,104156,,9,18,27,9,18,27,0.00114,0.003298,0,15733,25,0.000014,15,0.202703,0.228143,3813.521266,0.226496,0.002289
105108,105108,,21,12,33,21,12,33,0.002678,0.002439,0,15686,25,0.00002,16,0.193898,0.21709,31315.49676,0.072917,0.006257
104157,104157,,0,1,1,0,1,1,0,0.00007,0,18024,13,0.00001,1,1,1,0,0,0
104158,104158,,25,19,44,25,19,44,0.001024,0.00057,0,16097,52,0.000033,14,0.187414,0.209243,74016.395629,0.055497,0.00666
9204053,9204053,,1,1,2,1,1,2,0,0,0,1958,52,0.000017,1,1,1,70.046036,0,0.000322
104159,104159,,17,27,44,17,27,44,0.003275,0.003265,0,15659,8,0.000016,13,0.191442,0.212891,2597.443738,0.2537,0.006604
104160,104160,,3,5,8,3,5,8,0,0.000001,0,18026,5,0.000013,18,0.090021,0.098783,13.297024,0.232143,0.000683
2179,2179,,5,0,5,5,0,5,0.000022,0,0,18025,5,0.000016,0,0,0,0,0.3,0.001175
104161,104161,,2,2,4,2,2,4,0.000005,0.000002,0,18027,2,0.000011,17,0.136009,0.148253,0,0.416667,0.000458
104162,104162,,2,9,11,2,9,11,0.000013,0.000017,0,18047,15,0.000012,13,0.166453,0.18633,515.342902,0.054545,0.000445
9706190,9706190,,6,17,23,6,17,23,0.000313,0.000015,0,18041,15,0.000016,9,0.253991,0.349179,15242.432806,0.088933,0.001443
9707153,9707153,,3,8,11,3,8,11,0,0.000008,0,18045,15,0.000014,8,0.245085,0.308435,260.163324,0.2,0.000677
9707201,9707201,,1,5,6,1,5,6,0,0.000007,0,18046,15,0.000011,9,0.220657,0.27107,9.186447,0.366667,0.000232
9801031,9801031,,3,2,5,3,2,5,0,0,0,18029,8,0.000015,1,1,1,12,0.15,0.000671
9311103,9311103,,8,3,11,8,3,11,0.000087,0.000472,0,8395,22,0.000027,1,1,1,8059.047619,0.063636,0.001927
9406129,9406129,,3,3,6,3,3,6,0,0.000004,0,18036,15,0.000013,1,1,1,850,0.233333,0.000718
9512047,9512047,,2,11,13,2,11,13,0,0.000543,0,18040,5,0.000012,5,0.348837,0.436889,545.698196,0.108974,0.000485
9704118,9704118,,3,21,24,3,21,24,0,0.000016,0,18039,15,0.000013,8,0.277078,0.423063,10666.103474,0.081522,0.000718
9602149,9602149,,3,2,5,3,2,5,0,0,0,18030,15,0.000013,2,0.625,0.7,1713.037738,0.2,0.000704
9612145,9612145,,1,10,11,1,10,11,0,0.000003,0,18044,15,0.000011,7,0.285256,0.38138,236.94043,0.072727,0.000239
9612137,9612137,,2,0,2,2,0,2,0,0,0,18028,8,0.000019,0,0,0,0,0.5,0.000458
104163,104163,,3,24,27,3,24,27,0.00009,0.002731,0,18048,13,0.000011,18,0.174442,0.200834,64.215161,0.196581,0.000671
104166,104166,,1,4,5,1,4,5,0.000023,0.000003,0,18049,0,0.000011,15,0.174126,0.190731,32.622921,0.25,0.000226
104167,104167,,4,17,21,4,17,21,0.000147,0.002684,0,18050,30,0.000012,15,0.188389,0.209262,5383.703793,0.269048,0.001085
104168,104168,,10,27,37,10,27,37,0.000556,0.003019,0,18051,30,0.000013,13,0.209857,0.233418,3448.920713,0.186186,0.00243
9506117,9506117,,6,2,8,6,2,8,0.000012,0,0,15123,5,0.000024,2,0.75,0.833333,1299.717201,0.089286,0.001445
104171,104171,,8,12,20,8,12,20,0.000467,0.001781,0,18052,4,0.000015,13,0.183481,0.203722,3145.979647,0.310526,0.001965
104173,104173,,10,42,52,10,42,52,0.000412,0.002672,0,16250,3,0.000013,13,0.217542,0.246425,38477.390335,0.092006,0.00339
104174,104174,,7,7,14,7,7,14,0.000641,0.001119,0,17776,25,0.000012,16,0.187399,0.208358,2727.119835,0.159341,0.001806
104175,104175,,1,5,6,1,5,6,0.000162,0.000223,0,18053,1,0.00001,15,0.161274,0.177524,5.689394,0.2,0.000226
9403113,9403113,,4,1,5,4,1,5,0.00021,0.000004,0,8218,1,0.000017,2,0.6,0.666667,5.959834,0.1,0.000937
104176,104176,,9,21,30,9,21,30,0.000306,0.001017,0,16278,3,0.000013,12,0.201387,0.222727,6718.553061,0.171264,0.002782
104177,104177,,11,34,45,11,34,45,0.000509,0.000864,0,17720,25,0.000016,13,0.207105,0.230017,28935.139597,0.092424,0.002768
104178,104178,,3,23,26,3,23,26,0.00022,0.001493,0,18054,2,0.000011,13,0.200899,0.228319,3040.469573,0.136923,0.000703
104179,104179,,15,2,17,15,2,17,0.000291,0.000066,0,18055,0,0.00003,16,0.160306,0.171254,3557.60459,0.191176,0.003758
104180,104180,,69,12,81,69,12,81,0.005476,0.001282,0,15421,8,0.000067,17,0.197702,0.220926,44083.339681,0.048457,0.022121
104181,104181,,64,6,70,64,6,70,0.00505,0.000687,0,15419,8,0.000061,13,0.173932,0.18975,5538.750585,0.057764,0.020478
104182,104182,,1,1,2,1,1,2,0,0.000001,0,18056,26,0.000011,5,0.266234,0.321138,41,0,0.000219
104183,104183,,0,1,1,0,1,1,0,0.000003,0,18057,3,0.00001,1,1,1,0,0,0
104184,104184,,6,2,8,6,2,8,0.00003,0.000066,0,18058,10,0.000015,15,0.179071,0.198689,1793.199933,0.357143,0.001495
104185,104185,,12,25,37,12,25,37,0.000492,0.002357,0,17772,25,0.000015,16,0.184898,0.207557,6084.436736,0.251502,0.003238
104188,104188,,1,20,21,1,20,21,0.000035,0.002053,0,18061,4,0.00001,14,0.175112,0.206493,120.665959,0.159524,0.000219
9710095,9710095,,3,9,12,3,9,12,0.000025,0.000073,0,18060,23,0.000013,12,0.188031,0.210039,5353.13307,0.090909,0.000684
9609090,9609090,,1,15,16,1,15,16,0.000001,0.000059,0,18059,28,0.000011,8,0.215633,0.272396,541.893953,0.070833,0.000239
9309084,9309084,,1,3,4,1,3,4,0.000001,0.000001,0,2582,23,0.000012,2,0.666667,0.75,0.711111,0.333333,0.000316
104191,104191,,2,8,10,2,8,10,0.000036,0.000793,0,18062,15,0.000011,18,0.172552,0.192423,1833.096213,0.2,0.000451
104192,104192,,1,10,11,1,10,11,0.000001,0.000092,0,18063,23,0.000011,21,0.152347,0.173289,1419.680917,0.154545,0.000226
104193,104193,,0,13,13,0,13,13,0,0.000009,0,18064,23,0.00001,20,0.134149,0.153738,0,0.262821,0
104194,104194,,0,14,14,0,14,14,0,0.003426,0,18065,1,0.00001,13,0.212469,0.244312,0,0.142857,0
104195,104195,,2,17,19,2,17,19,0.000049,0.000719,0,18066,25,0.00001,14,0.18714,0.209684,152.844883,0.30117,0.000472
104196,104196,,2,8,10,2,8,10,0.000022,0.000189,0,18067,2,0.000011,16,0.177387,0.194437,26.400415,0.377778,0.000519
104197,104197,,1,3,4,1,3,4,0,0.000001,0,18068,6,0.000019,2,0.8,0.875,4,0.083333,0.000219
104198,104198,,3,27,30,3,27,30,0.000568,0.023104,0,15593,1,0.000011,13,0.214629,0.240546,18134.788682,0.129885,0.000944
104199,104199,,0,2,2,0,2,2,0,0.000019,0,18069,3,0.00001,16,0.143062,0.156603,0,0,0
104200,104200,,21,63,84,21,63,84,0.000671,0.001946,0,18070,52,0.000021,14,0.214021,0.242599,79061.014577,0.103987,0.005481
104201,104201,,6,16,22,6,16,22,0.000135,0.001162,0,15582,25,0.000017,15,0.19042,0.210953,32304.620646,0.175325,0.001723
104202,104202,,25,25,50,25,25,50,0.000913,0.00084,0,16225,1,0.000023,14,0.197469,0.221824,76472.276821,0.075918,0.007382
9409072,9409072,,1,8,9,1,8,9,0.00001,0.001376,0,16223,13,0.000011,4,0.370968,0.427536,630.86298,0.111111,0.000407
104203,104203,,0,19,19,0,19,19,0,0.000786,0,18072,52,0.00001,18,0.155839,0.17925,0,0.114035,0
9408160,9408160,,2,5,7,2,5,7,0.000009,0.000003,0,18071,9,0.000013,3,0.6,0.694444,20.757576,0.047619,0.000438
9806130,9806130,,1,14,15,1,14,15,0.00014,0.00895,0,17136,4,0.00001,13,0.206935,0.237715,2.184653,0.17619,0.000232
9806147,9806147,,5,17,22,5,17,22,0.000437,0.0002,0,10404,4,0.000014,15,0.185769,0.211837,13470.936754,0.145022,0.001135
104205,104205,,4,2,6,4,2,6,0,0,0,18075,26,0.000018,12,0.139847,0.149806,8350.670811,0.1,0.000896
9908055,9908055,,1,8,9,1,8,9,0,0.000001,0,18074,26,0.000018,11,0.162496,0.179431,10442.252018,0.083333,0.000245
9705158,9705158,,2,1,3,2,1,3,0.000069,0,0,4975,26,0.000013,2,0.666667,0.75,18046.095832,0,0.000507
9806221,9806221,,2,9,11,2,9,11,0,0.001551,0,18073,26,0.000012,11,0.183578,0.205023,12206.015911,0.172727,0.000445
104206,104206,,6,27,33,6,27,33,0.000888,0.003351,0,15968,13,0.000013,12,0.210041,0.235877,28170.461228,0.125,0.001872
104207,104207,,1,4,5,1,4,5,0,0,0,18076,6,0.000011,14,0.146117,0.156255,12292.322572,0.15,0.000226
9301123,9301123,,4,0,4,4,0,4,0,0,0,10077,41,0.000042,0,0,0,0,0,0.000959
104208,104208,,15,12,27,15,12,27,0.000353,0.000493,0,16189,10,0.00002,15,0.191445,0.214101,5748.387019,0.183761,0.005815
104209,104209,,5,12,17,5,12,17,0.000086,0.001729,0,18077,2,0.000014,14,0.183133,0.208846,2312.623207,0.183824,0.001209
104210,104210,,1,13,14,1,13,14,0.000119,0.006392,0,18078,2,0.00001,14,0.211938,0.236434,0.532258,0.302198,0.000219
104211,104211,,3,11,14,3,11,14,0.000087,0.003038,0,18079,3,0.000011,13,0.187715,0.209384,356.140911,0.241758,0.00071
104212,104212,,7,30,37,7,30,37,0,0.000293,0,18083,6,0.000019,15,0.18451,0.208604,70827.120366,0.061562,0.00164
9412031,9412031,,1,0,1,1,0,1,0.000003,0,0,18082,6,0.00001,0,0,0,0,0,0.000266
9509153,9509153,,5,9,14,5,9,14,0.000004,0.00003,0,11459,6,0.000014,5,0.444444,0.545417,453.711528,0.17033,0.001228
9612150,9612150,,3,13,16,3,13,16,0.000004,0.000006,0,13217,6,0.000015,7,0.25,0.309506,913.692583,0.154167,0.000745
9806222,9806222,,3,5,8,3,5,8,0.000004,0.000002,0,18081,6,0.000012,14,0.132377,0.149329,2446.927918,0.089286,0.000717
9911178,9911178,,4,7,11,4,7,11,0.000042,0.000004,0,18080,6,0.000013,13,0.140295,0.158081,36827.977462,0.172727,0.001151
9511102,9511102,,3,2,5,3,2,5,0,0.001307,0,13215,6,0.000036,6,0.274678,0.319271,837.647873,0.1,0.000691
9512011,9512011,,4,16,20,4,16,20,0.000013,0.000008,0,11462,6,0.000014,6,0.316159,0.409259,10022.110599,0.136842,0.000965
9212125,9212125,,3,1,4,3,1,4,0.000001,0.000001,0,12097,6,0.000022,1,1,1,18.13785,0,0.000771
104213,104213,,10,21,31,10,21,31,0.000557,0.002498,0,18084,25,0.000016,15,0.190352,0.213024,17791.11881,0.176344,0.002599
104215,104215,,10,13,23,10,13,23,0.000294,0.000482,0,15726,0,0.000015,15,0.197272,0.220707,7850.986265,0.152174,0.002663
104216,104216,,0,3,3,0,3,3,0,0.000003,0,18087,2,0.00001,9,0.182306,0.20097,0,0,0
9510065,9510065,,1,0,1,1,0,1,0,0,0,18086,2,0.000013,0,0,0,0,0,0.000219
9610194,9610194,,1,0,1,1,0,1,0,0,0,18085,2,0.000013,0,0,0,0,0,0.000219
104218,104218,,6,56,62,6,56,62,0.000454,0.006269,0,15964,3,0.000011,12,0.211399,0.239664,7523.914523,0.129561,0.001772
104219,104219,,6,2,8,6,2,8,0.000767,0.000013,0,18088,8,0.000018,14,0.155702,0.169591,2178.753188,0.214286,0.001606
104220,104220,,2,13,15,2,13,15,0.000023,0.000031,0,18089,6,0.000011,15,0.11135,0.135619,13.038648,0.266667,0.000451
104222,104222,,1,10,11,1,10,11,0,0.000008,0,18090,23,0.000011,18,0.110089,0.133242,17.274904,0.127273,0.000226
104223,104223,,3,10,13,3,10,13,0.000021,0.000296,0,18091,2,0.000012,15,0.195911,0.215978,8917.110875,0.224359,0.000704
104224,104224,,18,19,37,18,19,37,0.000306,0.002024,0,18092,30,0.000026,16,0.190073,0.211026,14498.177797,0.119369,0.004531
104225,104225,,0,1,1,0,1,1,0,0,0,18093,23,0.00001,3,0.454545,0.533333,0,0,0
104226,104226,,10,21,31,10,21,31,0.001037,0.00168,0,16045,25,0.000013,15,0.196637,0.220166,3069.298572,0.129032,0.002974
104227,104227,,20,51,71,20,51,71,0.002095,0.004211,0,15666,25,0.00002,14,0.204989,0.232703,56363.429445,0.102616,0.005805
106100,106100,,11,37,48,11,37,48,0.001057,0.003801,0,16089,25,0.000014,13,0.206837,0.231951,52712.808138,0.139628,0.003069
106019,106019,,8,18,26,8,18,26,0.000538,0.002624,0,15592,25,0.000014,15,0.192338,0.217221,11657.159785,0.121538,0.002119
104228,104228,,0,3,3,0,3,3,0,0,0,18095,26,0.00001,4,0.362069,0.448413,0,0,0
9308103,9308103,,2,0,2,2,0,2,0,0,0,18094,26,0.000014,0,0,0,0,0,0.000438
104229,104229,,5,24,29,5,24,29,0.000191,0.001633,0,18096,3,0.000014,13,0.190973,0.21022,14799.472372,0.242611,0.001597
104230,104230,,9,39,48,9,39,48,0.000262,0.001895,0,17794,3,0.000013,12,0.199865,0.221418,4715.988491,0.22695,0.003046
104231,104231,,3,3,6,3,3,6,0.000004,0.00001,0,18097,23,0.000014,14,0.157881,0.170889,876.697983,0.233333,0.000718
104232,104232,,3,36,39,3,36,39,0.000381,0.016476,0,18098,30,0.000011,14,0.224963,0.258605,5870.101719,0.139001,0.000705
104233,104233,,0,1,1,0,1,1,0,0.000001,0,18099,20,0.00001,2,0.666667,0.75,0,0,0
104234,104234,,2,18,20,2,18,20,0.000002,0.011298,0,18100,28,0.000011,14,0.18978,0.212631,7016.120884,0.221053,0.000451
104235,104235,,1,14,15,1,14,15,0.000024,0.000327,0,18101,2,0.00001,13,0.193831,0.218248,0,0.2,0.000219
104237,104237,,0,5,5,0,5,5,0,0.001275,0,18103,25,0.00001,16,0.187774,0.208838,0,0.15,0
9409049,9409049,,1,0,1,1,0,1,0.000015,0,0,18102,25,0.000012,0,0,0,0,0,0.000219
104238,104238,,41,28,69,41,28,69,0.001725,0.004025,0,15998,3,0.000036,17,0.193849,0.221631,72119.689892,0.127025,0.014863
9908132,9908132,,12,4,16,12,4,16,0.00058,0.000092,0,15988,3,0.000016,13,0.180868,0.201769,11104.261432,0.266667,0.004016
9601160,9601160,,2,6,8,2,6,8,0.000001,0.000001,0,15987,17,0.000018,5,0.425532,0.564167,7779.686651,0.125,0.000535
104239,104239,,9,19,28,9,19,28,0.001094,0.019325,0,15407,25,0.000017,16,0.198845,0.225298,36051.627742,0.153439,0.003403
104240,104240,,5,3,8,5,3,8,0.000001,0,0,18105,9,0.000016,14,0.159693,0.172677,68.73731,0.321429,0.001155
9212084,9212084,,1,0,1,1,0,1,0,0,0,18104,9,0.000015,0,0,0,0,0,0.000252
104241,104241,,7,6,13,7,6,13,0.000539,0.000855,0,18107,0,0.000018,16,0.15249,0.163432,8397.287387,0.128205,0.001708
9506073,9506073,,1,0,1,1,0,1,0.00001,0,0,18106,0,0.000013,0,0,0,0,0,0.000267
104242,104242,,1,1,2,1,1,2,0,0,0,18109,26,0.000014,1,1,1,1,0,0.000219
8158,8158,,1,0,1,1,0,1,0,0,0,18108,26,0.000023,0,0,0,0,0,0.000226
104243,104243,,2,23,25,2,23,25,0.000048,0.003532,0,17799,30,0.000011,13,0.201842,0.223811,785.826023,0.195,0.000581
104244,104244,,9,21,30,9,21,30,0.000419,0.002494,0,15884,30,0.000019,12,0.201068,0.221549,12214.484597,0.164368,0.003642
104245,104245,,0,1,1,0,1,1,0,0.000027,0,18110,4,0.00001,1,1,1,0,0,0
104246,104246,,20,9,29,20,9,29,0.001104,0.002713,0,18111,1,0.000042,13,0.194774,0.213011,43584.638508,0.076355,0.005242
104247,104247,,21,9,30,21,9,30,0.000426,0.00021,0,18112,2,0.000025,15,0.151273,0.165529,4601.114878,0.183908,0.005266
104248,104248,,0,2,2,0,2,2,0,0.000018,0,18113,1,0.00001,14,0.157111,0.169802,0,0.5,0
104249,104249,,5,3,8,5,3,8,0.000232,0.000014,0,18116,1,0.000018,1,1,1,36.907143,0.089286,0.001181
9704203,9704203,,4,0,4,4,0,4,0,0,0,18114,1,0.000043,0,0,0,0,0.166667,0.000931
9902143,9902143,,1,1,2,1,1,2,0,0,0,18115,1,0.000015,1,1,1,0,0.5,0.000253
104250,104250,,0,2,2,0,2,2,0,0.000018,0,18117,30,0.00001,14,0.178017,0.191044,0,0.5,0
104251,104251,,2,15,17,2,15,17,0.000554,0.019986,0,18118,1,0.000011,11,0.227111,0.257369,3074.083101,0.242647,0.000713
104252,104252,,0,2,2,0,2,2,0,0.000003,0,18119,23,0.00001,12,0.194648,0.217393,0,0,0
104253,104253,,2,11,13,2,11,13,0.000061,0.002087,0,18120,4,0.00001,17,0.177653,0.204261,5.453368,0.352564,0.000461
104254,104254,,8,28,36,8,28,36,0.000277,0.001153,0,18121,52,0.000013,15,0.192728,0.216356,7574.754712,0.180159,0.002182
104255,104255,,1,7,8,1,7,8,0,0.000007,0,18122,20,0.00001,14,0.144403,0.153201,1.101699,0.303571,0.000219
104256,104256,,0,2,2,0,2,2,0,0,0,18124,26,0.00001,17,0.101578,0.109799,0,0,0
9701136,9701136,,3,0,3,3,0,3,0.000002,0,0,18123,26,0.000018,0,0,0,0,0,0.000658
104257,104257,,1,16,17,1,16,17,0,0.000012,0,18125,5,0.000011,15,0.134608,0.147239,5822.659997,0.132353,0.000219
104258,104258,,0,3,3,0,3,3,0,0.000002,0,18133,5,0.00001,15,0.141049,0.153913,0,0.166667,0
9710140,9710140,,3,2,5,3,2,5,0,0.000001,0,18131,5,0.000019,9,0.180541,0.197179,105.801269,0.1,0.00067
9810139,9810139,,2,3,5,2,3,5,0,0.000003,0,18132,5,0.000014,14,0.164001,0.184702,10057.453299,0.1,0.000438
9511184,9511184,,3,4,7,3,4,7,0.000012,0.000013,0,18130,5,0.000022,8,0.218956,0.246896,1376.193278,0.047619,0.00069
104259,104259,,19,20,39,19,20,39,0.001316,0.0043,0,16169,52,0.000019,11,0.205643,0.231141,8069.916783,0.18691,0.006608
104260,104260,,13,22,35,13,22,35,0.000296,0.003206,0,18134,30,0.000019,14,0.188718,0.21244,16546.867224,0.19916,0.003257
104261,104261,,1,11,12,1,11,12,0,0.000026,0,18135,5,0.000011,15,0.153573,0.168151,204.856208,0.060606,0.000219
104263,104263,,8,6,14,8,6,14,0.000377,0.001044,0,17817,3,0.000016,14,0.188641,0.206104,5711.478311,0.181319,0.003627
104264,104264,,13,29,42,13,29,42,0.000239,0.002823,0,18136,30,0.000022,14,0.212852,0.238952,42049.413806,0.109756,0.003165
104265,104265,,0,6,6,0,6,6,0,0.00013,0,18137,26,0.00001,12,0.194969,0.213849,0,0.333333,0
104266,104266,,0,7,7,0,7,7,0,0.00049,0,18141,25,0.00001,14,0.176273,0.196518,0,0.166667,0
9907197,9907197,,1,2,3,1,2,3,0.000006,0,0,18140,23,0.000011,2,0.583333,0.642857,7,0.166667,0.000219
9709187,9709187,,2,3,5,2,3,5,0,0,0,18139,23,0.000016,2,0.666667,0.75,19,0.1,0.000451
104267,104267,,0,7,7,0,7,7,0,0.00002,0,18142,22,0.00001,8,0.217009,0.314511,0,0.261905,0
105001,105001,,28,17,45,28,17,45,0.003653,0.006757,0,17766,1,0.000029,12,0.200878,0.222811,26307.638727,0.126768,0.008405
105002,105002,,2,5,7,2,5,7,0.00005,0.002677,0,18143,30,0.000012,14,0.175654,0.192613,33.286714,0.238095,0.000458
105003,105003,,0,2,2,0,2,2,0,0,0,18147,22,0.00001,2,0.6,0.666667,0,0,0
9604008,9604008,,1,2,3,1,2,3,0,0,0,18146,22,0.000014,1,1,1,2,0,0.000219
9605204,9605204,,4,2,6,4,2,6,0,0,0,18144,22,0.000025,1,1,1,8,0,0.000877
9303132,9303132,,3,0,3,3,0,3,0,0,0,18145,22,0.000019,0,0,0,0,0,0.000664
9304120,9304120,,5,0,5,5,0,5,0.000001,0,0,10314,22,0.000033,0,0,0,0,0.05,0.001155
9311057,9311057,,5,0,5,5,0,5,0.000001,0,0,10316,22,0.000037,0,0,0,0,0,0.001135
105004,105004,,0,1,1,0,1,1,0,0,0,18148,22,0.00001,2,0.6,0.666667,0,0,0
105005,105005,,8,36,44,8,36,44,0.001755,0.008255,0,16206,1,0.000012,16,0.207255,0.234677,146099.790133,0.103594,0.002441
105006,105006,,15,38,53,15,38,53,0.000739,0.004068,0,18149,2,0.000019,12,0.22713,0.255172,111209.0276,0.08672,0.003997
105007,105007,,7,23,30,7,23,30,0.000927,0.002277,0,16714,25,0.000014,13,0.194941,0.217667,14609.934818,0.195402,0.00205
105008,105008,,9,6,15,9,6,15,0.000311,0.000075,0,15548,25,0.00002,17,0.164584,0.176749,6635.235955,0.228571,0.002576
105009,105009,,2,4,6,2,4,6,0.000001,0.000001,0,18150,5,0.000012,14,0.12447,0.150081,9.2,0.333333,0.000513
105010,105010,,7,10,17,7,10,17,0.000091,0.000811,0,17826,23,0.000074,13,0.193041,0.211472,82765.398953,0.091912,0.001746
105011,105011,,1,2,3,1,2,3,0,0.000718,0,18151,30,0.000013,16,0.166501,0.179981,2460.082607,0,0.000219
105012,105012,,13,17,30,13,17,30,0.00027,0.001599,0,17809,30,0.000015,14,0.198103,0.218286,794.359942,0.227586,0.003537
105013,105013,,3,13,16,3,13,16,0.000038,0.000023,0,17801,22,0.000013,15,0.13531,0.153981,85646.354129,0.129167,0.000995
105014,105014,,10,30,40,10,30,40,0.000473,0.003574,0,18152,52,0.000012,15,0.206108,0.23433,12191.978762,0.146154,0.002496
105015,105015,,0,10,10,0,10,10,0,0.000015,0,18153,6,0.00001,17,0.172979,0.189855,0,0.1,0
9303045,9303045,,2,4,6,2,4,6,0,0,0,2366,9,0.000013,2,0.75,0.833333,680.794623,0.033333,0.000475
105016,105016,,7,21,28,7,21,28,0.00029,0.004689,0,18154,13,0.000012,18,0.184483,0.211543,659.917761,0.179894,0.00204
9508132,9508132,,2,26,28,2,26,28,0.000227,0.005044,0,1256,13,0.000013,9,0.233652,0.290047,7930.834949,0.124339,0.00092
105017,105017,,6,11,17,6,11,17,0.000254,0.000432,0,15983,8,0.000013,14,0.195817,0.215026,57699.663454,0.154412,0.001987
105019,105019,,25,27,52,25,27,52,0.00286,0.01744,0,16174,10,0.000019,13,0.205755,0.23261,30278.126972,0.197587,0.008614
105020,105020,,3,7,10,3,7,10,0.000189,0.001206,0,18155,4,0.00001,13,0.169168,0.194545,49.319192,0.333333,0.001036
105021,105021,,0,1,1,0,1,1,0,0.000027,0,18156,13,0.00001,9,0.219937,0.253098,0,0,0
105022,105022,,1,4,5,1,4,5,0,0,0,18158,23,0.000015,3,0.535714,0.611111,18,0.2,0.000226
9904195,9904195,,2,5,7,2,5,7,0,0,0,18157,23,0.000014,3,0.666667,0.791667,6.245238,0.119048,0.000445
105023,105023,,52,34,86,52,34,86,0.002642,0.021946,0,16000,3,0.000043,17,0.210605,0.241432,156604.049941,0.091929,0.017978
106206,106206,,21,29,50,21,29,50,0.000905,0.002855,0,16233,3,0.000018,17,0.204947,0.232899,13986.486176,0.14,0.005938
105062,105062,,36,29,65,36,29,65,0.001317,0.008662,0,16231,3,0.000033,17,0.210918,0.239236,82200.925588,0.104808,0.010561
105220,105220,,11,13,24,11,13,24,0.000357,0.000786,0,16232,3,0.000015,17,0.194634,0.217709,4155.18871,0.26087,0.003277
105024,105024,,43,44,87,43,44,87,0.001582,0.001808,0,15756,3,0.000035,13,0.191855,0.213557,16191.06465,0.187918,0.018235
105025,105025,,0,2,2,0,2,2,0,0.000005,0,18159,10,0.00001,14,0.157279,0.171047,0,0,0
105026,105026,,0,2,2,0,2,2,0,0.000003,0,18160,23,0.00001,3,0.529412,0.592593,0,0,0
105027,105027,,5,13,18,5,13,18,0.000092,0.000062,0,18161,15,0.000013,14,0.176245,0.19066,5037.959858,0.130719,0.001241
105028,105028,,6,4,10,6,4,10,0.00003,0.000001,0,18163,23,0.00002,14,0.129979,0.143311,5986.829363,0.166667,0.001434
9907120,9907120,,6,0,6,6,0,6,0.000018,0,0,18162,23,0.000023,0,0,0,0,0.233333,0.001448
105029,105029,,1,8,9,1,8,9,0.000004,0.000325,0,18164,2,0.000011,16,0.13921,0.159678,1200.974697,0.486111,0.000219
106197,106197,,0,11,11,0,11,11,0,0.000328,0,18165,2,0.00001,17,0.145142,0.170895,0,0.318182,0
105031,105031,,1,5,6,1,5,6,0.000005,0.000111,0,18166,13,0.000011,13,0.172355,0.188678,810.447435,0.166667,0.000272
106097,106097,,7,8,15,7,8,15,0.000308,0.001534,0,17771,25,0.000014,16,0.183995,0.205085,3329.094096,0.119048,0.00171
4016,4016,,2,0,2,2,0,2,0.000018,0,0,17770,25,0.00002,0,0,0,0,0,0.000486
105033,105033,,3,6,9,3,6,9,0.000001,0,0,18167,6,0.000012,17,0.118398,0.128089,275.070095,0.180556,0.000684
9306049,9306049,,8,1,9,8,1,9,0.000001,0,0,12096,6,0.000036,1,1,1,44.112549,0.138889,0.001859
9810034,9810034,,1,2,3,1,2,3,0,0.000001,0,13277,6,0.000011,1,1,1,1.4,0.333333,0.000246
105034,105034,,0,1,1,0,1,1,0,0.000909,0,18168,0,0.00001,11,0.185509,0.206342,0,0,0
105035,105035,,7,34,41,7,34,41,0.001229,0.010684,0,17764,2,0.000011,14,0.223933,0.260913,5961.883628,0.139634,0.001778
105036,105036,,21,12,33,21,12,33,0.003359,0.002087,0,15658,8,0.000018,13,0.189772,0.211114,10999.123085,0.316288,0.007863
105037,105037,,6,11,17,6,11,17,0.000001,0.000002,0,18169,22,0.000016,17,0.143459,0.153671,7057.776673,0.242647,0.001367
105039,105039,,0,23,23,0,23,23,0,0.012867,0,18170,1,0.00001,15,0.21729,0.254088,0,0.162055,0
105040,105040,,1,8,9,1,8,9,0,0,0,18173,9,0.000011,17,0.127809,0.137166,1.333333,0.222222,0.000219
9408071,9408071,,7,0,7,7,0,7,0.00001,0,0,18172,15,0.000045,0,0,0,0,0.095238,0.001627
9904192,9904192,,3,5,8,3,5,8,0,0.000089,0,18171,9,0.000014,16,0.145767,0.15778,14046.132654,0.214286,0.00067
105041,105041,,1,20,21,1,20,21,0.000059,0.002491,0,18174,4,0.00001,18,0.172346,0.199075,42.23635,0.278571,0.000268
105043,105043,,5,11,16,5,11,16,0.000005,0.000115,0,18175,22,0.000016,14,0.163025,0.181148,6331.997515,0.183333,0.001149
9510239,9510239,,3,12,15,3,12,15,0.000002,0.00005,0,16418,22,0.000016,4,0.488636,0.593023,129.401762,0.080952,0.000711
9611167,9611167,,5,5,10,5,5,10,0.000034,0.000011,0,14860,22,0.000014,4,0.486486,0.587963,156.748206,0.166667,0.001185
9412194,9412194,,1,2,3,1,2,3,0.000001,0.000005,0,3766,22,0.000011,1,1,1,23.726997,0.166667,0.000277
105044,105044,,2,17,19,2,17,19,0.000173,0.004163,0,18176,1,0.000011,13,0.228276,0.260388,1560.703899,0.163743,0.000503
105045,105045,,43,34,77,43,34,77,0.001731,0.002033,0,16178,4,0.000033,14,0.213431,0.241317,89401.639327,0.135338,0.014318
105046,105046,,11,36,47,11,36,47,0.000254,0.00683,0,16117,9,0.000012,14,0.182842,0.20924,12633.157197,0.154024,0.002843
9508105,9508105,,3,5,8,3,5,8,0.00012,0.000115,0,3837,13,0.000013,5,0.305389,0.348693,47111.5691,0.071429,0.000842
9312065,9312065,,1,0,1,1,0,1,0,0,0,6300,9,0.000012,0,0,0,0,0,0.000287
105047,105047,,14,11,25,14,11,25,0.002155,0.018185,0,18177,1,0.00002,16,0.207499,0.238015,22766.363168,0.135,0.003767
105049,105049,,30,35,65,30,35,65,0.003763,0.005832,0,16175,10,0.000021,14,0.21139,0.240863,38251.348277,0.10601,0.009734
105050,105050,,17,4,21,17,4,21,0.000338,0.000135,0,18178,2,0.000025,15,0.147296,0.158947,10083.107514,0.209524,0.004362
105051,105051,,0,27,27,0,27,27,0,0.005921,0,18179,30,0.00001,14,0.196522,0.219869,0,0.219373,0
111090,111090,,11,12,23,11,12,23,0.001531,0.001187,0,18183,4,0.000019,16,0.17484,0.196384,26385.45674,0.171937,0.002543
106175,106175,,8,23,31,8,23,31,0.00051,0.003751,0,18182,4,0.000014,13,0.174831,0.195319,8383.373389,0.194624,0.001899
106185,106185,,10,3,13,10,3,13,0.001347,0.000512,0,18180,4,0.00002,15,0.187021,0.20837,1493.890123,0.25,0.002471
111078,111078,,10,27,37,10,27,37,0.001662,0.018498,0,18181,1,0.000014,15,0.203206,0.233948,67182.065818,0.123874,0.002549
105053,105053,,2,4,6,2,4,6,0.000012,0.000001,0,18186,25,0.000012,13,0.166337,0.179022,12,0.3,0.000445
9504164,9504164,,2,2,4,2,2,4,0,0,0,11238,23,0.000017,3,0.5,0.633333,176.25,0.083333,0.000458
9905100,9905100,,6,12,18,6,12,18,0.000024,0.000698,0,18185,0,0.000019,12,0.199003,0.221237,23168.363535,0.137255,0.001429
9406026,9406026,,2,0,2,2,0,2,0,0,0,11236,23,0.000027,0,0,0,0,0.5,0.000465
9409198,9409198,,2,2,4,2,2,4,0,0,0,11237,23,0.000021,2,0.666667,0.75,113.25,0.083333,0.000458
9809214,9809214,,3,5,8,3,5,8,0.000008,0.000001,0,18184,5,0.000015,10,0.152451,0.177715,3824.478978,0.071429,0.000698
105054,105054,,7,25,32,7,25,32,0.000121,0.001619,0,18187,3,0.000012,13,0.189819,0.210152,7606.291775,0.160282,0.001645
105055,105055,,0,17,17,0,17,17,0,0.01647,0,18188,1,0.00001,13,0.201314,0.223475,0,0.143382,0
105056,105056,,1,15,16,1,15,16,0.000042,0.003542,0,18189,30,0.00001,12,0.194666,0.215359,13.580718,0.370833,0.000226
105057,105057,,10,2,12,10,2,12,0,0,0,18193,23,0.000061,2,0.75,0.833333,633,0.19697,0.002377
9805166,9805166,,3,0,3,3,0,3,0,0,0,18192,23,0.000052,0,0,0,0,0.166667,0.000731
9910221,9910221,,2,1,3,2,1,3,0,0,0,18191,23,0.000042,1,1,1,212,0.166667,0.000506
9403169,9403169,,2,0,2,2,0,2,0,0,0,18190,23,0.000052,0,0,0,0,0.5,0.000452
105058,105058,,82,12,94,82,12,94,0.002422,0.000599,0,15798,3,0.000063,13,0.19395,0.211765,22646.887709,0.149051,0.031606
105059,105059,,80,80,160,80,80,160,0.003021,0.002424,0,15797,3,0.000063,12,0.20646,0.23152,219318.961241,0.116274,0.031337
105060,105060,,7,9,16,7,9,16,0,0.00001,0,18194,23,0.000016,15,0.162296,0.182423,14743.998434,0.2125,0.001791
105063,105063,,9,19,28,9,19,28,0.000569,0.00053,0,18195,52,0.000013,15,0.195391,0.216903,3156.868502,0.171958,0.002213
105064,105064,,0,8,8,0,8,8,0,0.000003,0,18196,23,0.00001,17,0.156952,0.174664,0,0.232143,0
105065,105065,,0,5,5,0,5,5,0,0.000011,0,18197,2,0.00001,16,0.143031,0.157215,0,0.5,0
105066,105066,,40,44,84,40,44,84,0.002977,0.006293,0,16182,4,0.00003,12,0.220084,0.250962,54913.294195,0.132817,0.017521
105067,105067,,2,2,4,2,2,4,0.000002,0.000149,0,18198,13,0.000014,11,0.181588,0.203146,733.586305,0.25,0.000451
105068,105068,,4,46,50,4,46,50,0.000197,0.019514,0,16039,25,0.000011,15,0.209657,0.239142,43789.026206,0.130204,0.000955
105069,105069,,0,14,14,0,14,14,0,0.000228,0,18199,5,0.00001,15,0.158646,0.172841,0,0.225275,0
105072,105072,,0,4,4,0,4,4,0,0.000017,0,18200,3,0.00001,18,0.16633,0.178326,0,0.083333,0
105074,105074,,0,4,4,0,4,4,0,0,0,18202,23,0.00001,2,0.75,0.833333,0,0.25,0
9802137,9802137,,1,0,1,1,0,1,0,0,0,18201,23,0.000012,0,0,0,0,0,0.000219
9502048,9502048,,2,0,2,2,0,2,0,0,0,12587,23,0.000039,0,0,0,0,0.5,0.000478
105075,105075,,7,25,32,7,25,32,0.000371,0.001801,0,18203,4,0.000012,14,0.18275,0.208004,4182.963928,0.142137,0.001908
105076,105076,,14,20,34,14,20,34,0.001273,0.00337,0,17787,3,0.000015,14,0.189955,0.211551,9855.190012,0.127451,0.004547
105077,105077,,23,19,42,23,19,42,0.002451,0.001403,0,15939,1,0.000018,15,0.208392,0.234509,38910.522702,0.102207,0.005819
105159,105159,,17,31,48,17,31,48,0.001698,0.013709,0,15941,13,0.000015,16,0.229662,0.267286,51732.831349,0.108599,0.004468
105078,105078,,3,9,12,3,9,12,0.000064,0.000015,0,18204,6,0.000011,12,0.173714,0.2021,126.329526,0.204545,0.000677
105079,105079,,10,33,43,10,33,43,0.00032,0.003203,0,17813,30,0.000014,15,0.214066,0.239443,9897.377858,0.167774,0.002779
105080,105080,,0,3,3,0,3,3,0,0.000014,0,18205,25,0.00001,18,0.16792,0.183275,0,0.5,0
105081,105081,,4,8,12,4,8,12,0.000001,0.000002,0,18206,22,0.000014,6,0.263761,0.327971,31.5,0.340909,0.000903
105082,105082,,36,12,48,36,12,48,0.000913,0.001777,0,15903,30,0.000048,13,0.200437,0.221132,132780.771318,0.073138,0.010535
105083,105083,,7,47,54,7,47,54,0.000935,0.004138,0,18207,30,0.000011,13,0.227162,0.259646,8394.182366,0.17051,0.001708
105084,105084,,0,5,5,0,5,5,0,0.000017,0,18208,4,0.00001,16,0.159078,0.175602,0,0.2,0
105086,105086,,6,3,9,6,3,9,0.000409,0.000017,0,18210,2,0.000014,17,0.16053,0.175331,1338.132763,0.138889,0.001527
9508138,9508138,,2,1,3,2,1,3,0,0,0,18209,2,0.000017,1,1,1,98.428382,0.166667,0.000487
106269,106269,,3,28,31,3,28,31,0.000039,0.001176,0,18211,52,0.000011,15,0.207349,0.230934,3687.417706,0.133333,0.000691
105242,105242,,29,32,61,29,32,61,0.001594,0.002234,0,15867,30,0.000026,15,0.207545,0.231667,104355.524782,0.098634,0.010764
106194,106194,,13,19,32,13,19,32,0.000337,0.001038,0,16275,3,0.000017,15,0.197575,0.218212,51272.059347,0.190524,0.00328
105088,105088,,1,6,7,1,6,7,0.000299,0.001326,0,15690,25,0.00001,16,0.180724,0.199693,20.543045,0.238095,0.000348
105089,105089,,9,38,47,9,38,47,0.000831,0.00502,0,15900,30,0.000014,12,0.205589,0.228632,12188.139354,0.186864,0.004971
105090,105090,,10,43,53,10,43,53,0.000451,0.007905,0,18212,2,0.000013,15,0.208274,0.23942,18951.028427,0.084906,0.00245
105091,105091,,12,26,38,12,26,38,0.000768,0.005012,0,15689,25,0.000015,15,0.199455,0.225776,13388.373273,0.135135,0.003297
105092,105092,,0,2,2,0,2,2,0,0.000001,0,18213,6,0.00001,14,0.147808,0.157837,0,0.5,0
105093,105093,,22,19,41,22,19,41,0.003074,0.011842,0,15662,8,0.000018,13,0.191282,0.212768,2691.88643,0.289634,0.007699
105094,105094,,5,46,51,5,46,51,0.000365,0.006601,0,17827,30,0.000012,13,0.211105,0.235584,20205.551962,0.147059,0.002012
107115,107115,,8,62,70,8,62,70,0.000497,0.00678,0,17828,30,0.000013,13,0.226439,0.253532,15880.441814,0.109524,0.002678
106030,106030,,3,8,11,3,8,11,0.000154,0.000236,0,17825,30,0.000011,16,0.20814,0.233731,5114.688763,0.045455,0.000723
107037,107037,,16,18,34,16,18,34,0.000416,0.001404,0,17824,30,0.000018,14,0.196894,0.217381,5722.574225,0.163993,0.004027
9310053,9310053,,3,0,3,3,0,3,0.000102,0,0,17823,30,0.000013,0,0,0,0,0.166667,0.000791
105095,105095,,21,12,33,21,12,33,0.000515,0.001449,0,18214,2,0.000026,18,0.19915,0.223198,16927.641332,0.158144,0.005818
105136,105136,,21,30,51,21,30,51,0.00197,0.019647,0,16132,13,0.000024,13,0.220635,0.25249,62052.619141,0.118431,0.00585
106012,106012,,28,14,42,28,14,42,0.001023,0.001018,0,18215,2,0.00003,18,0.20235,0.228315,28787.68837,0.116144,0.007511
105096,105096,,13,36,49,13,36,49,0.000729,0.018509,0,16191,10,0.000019,14,0.207728,0.236646,13654.1322,0.119898,0.005906
105097,105097,,93,42,135,93,42,135,0.007393,0.013302,0,15418,0,0.000067,16,0.215497,0.247485,305793.115817,0.064677,0.0307
106014,106014,,33,57,90,33,57,90,0.004217,0.026269,0,17853,1,0.000024,17,0.220462,0.255895,50717.426268,0.104494,0.010163
105100,105100,,10,16,26,10,16,26,0.000388,0.003125,0,16713,25,0.000015,16,0.18621,0.211804,5261.379094,0.227692,0.002571
105101,105101,,6,32,38,6,32,38,0.000476,0.005367,0,18216,0,0.000012,13,0.201889,0.227544,9160.847324,0.133713,0.00164
106267,106267,,7,24,31,7,24,31,0.000524,0.001288,0,18217,0,0.000013,15,0.197863,0.22257,22269.549562,0.148387,0.001852
105102,105102,,4,32,36,4,32,36,0.000284,0.00114,0,18218,2,0.000011,14,0.200054,0.225918,12515.352627,0.176984,0.000958
105103,105103,,0,6,6,0,6,6,0,0.000861,0,18221,3,0.00001,15,0.193468,0.212215,0,0.133333,0
5200,5200,,1,0,1,1,0,1,0.00001,0,0,18220,3,0.000011,0,0,0,0,0,0.000219
105030,105030,,1,0,1,1,0,1,0.00001,0,0,18219,3,0.000011,0,0,0,0,0,0.000219
105104,105104,,1,11,12,1,11,12,0.000231,0.002332,0,18222,8,0.00001,15,0.195487,0.217518,25.480767,0.204545,0.000236
105105,105105,,7,5,12,7,5,12,0.000812,0.00083,0,18223,8,0.000016,14,0.15696,0.171694,5712.6463,0.151515,0.001848
105106,105106,,1,21,22,1,21,22,0.000005,0.002224,0,18226,52,0.00001,15,0.207515,0.23188,1038.360088,0.181818,0.00028
9903081,9903081,,3,21,24,3,21,24,0.00029,0.001943,0,18225,2,0.000011,12,0.198637,0.228002,534.233068,0.161232,0.000671
9805107,9805107,,1,25,26,1,25,26,0.000023,0.007397,0,18224,4,0.00001,13,0.208875,0.241374,1184.452818,0.227692,0.000239
105107,105107,,2,3,5,2,3,5,0,0.000005,0,18227,22,0.000016,14,0.158022,0.171193,1,0.35,0.000445
105109,105109,,2,7,9,2,7,9,0,0,0,18233,23,0.000011,17,0.137478,0.152573,2209.459002,0.041667,0.000465
9512099,9512099,,3,0,3,3,0,3,0,0,0,18231,23,0.000031,0,0,0,0,0.333333,0.000711
9704088,9704088,,4,1,5,4,1,5,0,0,0,18232,23,0.00002,1,1,1,5.5,0.15,0.000923
9901082,9901082,,1,0,1,1,0,1,0,0,0,18230,23,0.000011,0,0,0,0,0,0.000232
9901083,9901083,,1,0,1,1,0,1,0,0,0,18229,23,0.000011,0,0,0,0,0,0.000232
9901097,9901097,,2,0,2,2,0,2,0,0,0,18228,23,0.000012,0,0,0,0,0,0.000465
105110,105110,,5,4,9,5,4,9,0.000429,0.000272,0,15955,2,0.000012,15,0.15249,0.163867,146.139238,0.236111,0.001245
105244,105244,,3,12,15,3,12,15,0.000354,0.002449,0,15956,2,0.000011,14,0.182638,0.200326,2874.550165,0.128571,0.000785
110086,110086,,4,20,24,4,20,24,0.000703,0.003486,0,18234,2,0.000011,13,0.195966,0.219399,1571.523454,0.115942,0.000897
105112,105112,,4,8,12,4,8,12,0.000615,0.000615,0,18235,1,0.000014,12,0.188847,0.207546,3350.988897,0.106061,0.000986
105113,105113,,4,29,33,4,29,33,0.000254,0.017475,0,16295,1,0.000011,12,0.227748,0.261116,15030.635074,0.160038,0.000939
9411153,9411153,,2,17,19,2,17,19,0.000206,0.000133,0,16293,5,0.000011,6,0.348624,0.447222,1105.996417,0.04386,0.000472
105114,105114,,2,9,11,2,9,11,0,0.000001,0,18236,23,0.000011,17,0.139132,0.155861,2186.479959,0.118182,0.000478
105129,105129,,44,18,62,44,18,62,0.001156,0.000939,0,15799,3,0.00004,13,0.19199,0.212652,13040.779545,0.187467,0.017145
105168,105168,,74,63,137,74,63,137,0.001793,0.002513,0,15869,3,0.000056,13,0.19735,0.223112,36794.986848,0.132299,0.026818
105116,105116,,0,8,8,0,8,8,0,0.002861,0,18237,25,0.00001,15,0.188952,0.210133,0,0.160714,0
105118,105118,,2,4,6,2,4,6,0.000004,0.000302,0,18238,4,0.000014,13,0.166345,0.190616,49.533164,0.266667,0.000445
105119,105119,,1,4,5,1,4,5,0,0.000032,0,18240,30,0.000013,15,0.138028,0.144823,8553,0.1,0.000219
12123,12123,,5,0,5,5,0,5,0.000058,0,0,18239,30,0.000018,0,0,0,0,0.15,0.001128
105120,105120,,6,11,17,6,11,17,0.000039,0.001021,0,18241,30,0.000021,17,0.18952,0.208166,22575.425006,0.165441,0.001715
105121,105121,,8,22,30,8,22,30,0.000394,0.002256,0,16721,4,0.000012,12,0.184314,0.203748,8813.897936,0.249425,0.00193
105122,105122,,2,3,5,2,3,5,0.000011,0.001017,0,18242,23,0.000018,12,0.195501,0.220129,3845.801606,0.1,0.000451
105123,105123,,11,17,28,11,17,28,0.000371,0.002323,0,16107,9,0.000013,14,0.217844,0.250754,19212.123926,0.287037,0.002803
105124,105124,,2,2,4,2,2,4,0,0,0,18243,23,0.000014,17,0.118359,0.127049,2,0.25,0.000445
105125,105125,,0,19,19,0,19,19,0,0.002758,0,18244,2,0.00001,15,0.175231,0.196528,0,0.178363,0
105126,105126,,1,7,8,1,7,8,0.000017,0.000153,0,18245,30,0.00001,15,0.182222,0.201489,692.527803,0.25,0.000247
105127,105127,,5,17,22,5,17,22,0.000055,0.001352,0,18247,30,0.000016,13,0.196252,0.214823,7436.28457,0.134199,0.001253
12207,12207,,1,0,1,1,0,1,0.000016,0,0,18246,30,0.000011,0,0,0,0,0,0.000254
105128,105128,,11,1,12,11,1,12,0.000028,0,0,18249,25,0.00004,1,1,1,17.5,0.113636,0.002551
102047,102047,,7,0,7,7,0,7,0.000015,0,0,18248,25,0.000065,0,0,0,0,0.238095,0.001661
105130,105130,,0,2,2,0,2,2,0,0,0,18250,22,0.00001,7,0.234483,0.290476,0,0,0
105131,105131,,0,4,4,0,4,4,0,0.000358,0,18251,8,0.00001,15,0.187199,0.203771,0,0.416667,0
105133,105133,,0,2,2,0,2,2,0,0,0,18252,25,0.00001,12,0.160575,0.170296,0,0.5,0
105134,105134,,7,21,28,7,21,28,0.000259,0.019195,0,18253,1,0.000021,13,0.193829,0.219518,16016.310049,0.132275,0.00179
105135,105135,,16,21,37,16,21,37,0.00006,0.000191,0,18254,22,0.00003,14,0.186113,0.203699,81616.266781,0.121622,0.003792
9509057,9509057,,4,1,5,4,1,5,0.000004,0,0,11551,22,0.000014,1,1,1,30.863095,0.15,0.001018
9606159,9606159,,5,4,9,5,4,9,0.00002,0.000002,0,11338,22,0.000026,1,1,1,41.314286,0.166667,0.00131
105137,105137,,3,30,33,3,30,33,0.000246,0.019512,0,15681,25,0.000011,13,0.21626,0.248334,17834.923104,0.122159,0.000746
105138,105138,,2,20,22,2,20,22,0.000097,0.017454,0,18255,25,0.000011,15,0.199557,0.226815,9393.643629,0.179654,0.000568
105139,105139,,4,40,44,4,40,44,0.000254,0.007354,0,17840,30,0.000011,15,0.21987,0.251661,3926.648814,0.16649,0.001029
105141,105141,,7,7,14,7,7,14,0.000001,0.000005,0,18257,23,0.000015,18,0.140073,0.155426,2661.06983,0.241758,0.00158
9811176,9811176,,3,7,10,3,7,10,0,0.000006,0,18256,23,0.000013,14,0.133298,0.145062,37.976557,0.288889,0.000723
105142,105142,,3,4,7,3,4,7,0.00016,0.000446,0,18259,1,0.000012,14,0.180182,0.196239,8195.268202,0.095238,0.000678
9712089,9712089,,4,0,4,4,0,4,0.000008,0,0,18258,1,0.000019,0,0,0,0,0.083333,0.00091
105143,105143,,0,7,7,0,7,7,0,0.001013,0,18260,10,0.00001,13,0.192512,0.210293,0,0.142857,0
105144,105144,,1,3,4,1,3,4,0,0,0,18261,6,0.000013,13,0.153611,0.171745,383.209904,0.25,0.000226
105145,105145,,0,13,13,0,13,13,0,0.002041,0,18262,30,0.00001,13,0.183095,0.201878,0,0.185897,0
105146,105146,,1,5,6,1,5,6,0.000041,0.000001,0,18263,23,0.00001,14,0.142476,0.160205,24.268663,0.1,0.000219
105148,105148,,2,10,12,2,10,12,0.000002,0.000007,0,18265,6,0.000011,14,0.156322,0.167132,10260.260076,0.083333,0.000512
9309117,9309117,,1,1,2,1,1,2,0,0.000003,0,18264,6,0.000011,1,1,1,15.805495,0,0.000233
105149,105149,,17,2,19,17,2,19,0.000608,0.000046,0,18266,2,0.000021,15,0.143638,0.154313,0.111111,0.236842,0.004244
105153,105153,,8,8,16,8,8,16,0.000441,0.001017,0,18267,0,0.000016,16,0.181578,0.199952,8402.615592,0.141667,0.002038
105154,105154,,1,30,31,1,30,31,0.000034,0.001909,0,17815,30,0.00001,15,0.202166,0.22597,1082.470586,0.216129,0.000376
105155,105155,,76,51,127,76,51,127,0.004117,0.003925,0,16262,0,0.000041,13,0.221506,0.251827,187530.626864,0.113798,0.025528
9411022,9411022,,2,11,13,2,11,13,0.000016,0.000611,0,1709,0,0.000012,5,0.336986,0.415854,3755.764233,0.102564,0.000649
105156,105156,,10,19,29,10,19,29,0.000409,0.000833,0,15870,3,0.000016,13,0.187909,0.204623,3253.635299,0.279557,0.003295
105157,105157,,0,2,2,0,2,2,0,0.000004,0,18268,23,0.00001,6,0.245161,0.274708,0,0.5,0
105158,105158,,7,34,41,7,34,41,0.000705,0.002916,0,15732,25,0.000014,12,0.20866,0.234199,44326.410568,0.12439,0.001845
106038,106038,,5,40,45,5,40,45,0.000436,0.009371,0,15944,13,0.000012,13,0.229098,0.263071,17184.07312,0.156061,0.001238
105161,105161,,4,7,11,4,7,11,0.000146,0.000025,0,18269,1,0.000014,13,0.160144,0.175065,4936.627858,0.2,0.000896
105163,105163,,8,15,23,8,15,23,0.000163,0.00001,0,18270,23,0.000015,19,0.146931,0.163194,27163.667913,0.199605,0.001846
105164,105164,,5,12,17,5,12,17,0.000042,0.000073,0,18271,4,0.000014,15,0.169539,0.192649,6395.38627,0.238971,0.001118
105165,105165,,0,2,2,0,2,2,0,0.001017,0,18272,2,0.00001,12,0.19124,0.209906,0,0,0
105166,105166,,4,58,62,4,58,62,0.000568,0.007828,0,17839,30,0.000011,15,0.22464,0.253808,6211.003294,0.158382,0.00099
105167,105167,,0,7,7,0,7,7,0,0.002086,0,18273,0,0.00001,12,0.209384,0.23325,0,0.142857,0
9305166,9305166,,8,0,8,8,0,8,0.000434,0,0,15743,3,0.000046,0,0,0,0,0.267857,0.004073
105169,105169,,2,5,7,2,5,7,0.000039,0.000049,0,18274,4,0.00001,13,0.146226,0.174229,13.522894,0.261905,0.000445
105170,105170,,1,7,8,1,7,8,0.000213,0.017741,0,18275,1,0.00001,16,0.225798,0.257913,21.527462,0.357143,0.000219
105171,105171,,11,30,41,11,30,41,0.001166,0.012787,0,15959,2,0.000014,13,0.220333,0.256706,62886.343935,0.110976,0.002881
108006,108006,,3,25,28,3,25,28,0.000157,0.004522,0,18277,2,0.000011,13,0.219458,0.255711,8097.726589,0.134921,0.000797
105284,105284,,9,28,37,9,28,37,0.000461,0.000967,0,18276,30,0.000014,14,0.192707,0.21797,3773.100262,0.203453,0.002308
105172,105172,,0,1,1,0,1,1,0,0,20,18279,42,0.00001,1,1,1,0,0,0
9069,9069,,1,0,1,1,0,1,0,0,20,18278,42,0.000019,0,0,0,0,0,0.000219
105173,105173,,3,3,6,3,3,6,0,0.000005,0,18280,30,0.000026,15,0.150134,0.164146,3370.097784,0.166667,0.000684
105174,105174,,1,35,36,1,35,36,0.000022,0.00162,0,18281,52,0.00001,13,0.203832,0.230339,290.936774,0.192063,0.000233
105175,105175,,25,19,44,25,19,44,0.000688,0.00245,0,15875,3,0.000024,12,0.199777,0.222118,22464.729596,0.219873,0.009737
105176,105176,,4,36,40,4,36,40,0.000085,0.006991,0,18282,2,0.000012,16,0.202493,0.234211,10399.97189,0.119872,0.001004
105177,105177,,5,24,29,5,24,29,0,0.000012,0,18283,6,0.000013,14,0.137647,0.166433,6954.915528,0.083744,0.001141
9307007,9307007,,2,4,6,2,4,6,0,0,0,2373,6,0.000037,1,1,1,17136.77453,0.033333,0.00051
9509119,9509119,,8,32,40,8,32,40,0.000009,0.00012,0,4455,9,0.00002,7,0.339833,0.503396,36073.176668,0.064744,0.001801
9305135,9305135,,2,1,3,2,1,3,0,0,0,2370,6,0.00002,1,1,1,0,0.333333,0.000452
9312060,9312060,,4,1,5,4,1,5,0,0,0,5884,6,0.000031,1,1,1,0.802632,0.35,0.001051
9405201,9405201,,2,2,4,2,2,4,0,0,0,5887,6,0.000018,3,0.478261,0.545455,35.6,0.333333,0.000558
9203044,9203044,,2,0,2,2,0,2,0.000002,0,0,3168,9,0.000012,0,0,0,0,0.5,0.000533
9303164,9303164,,6,3,9,6,3,9,0.000003,0.000031,0,1059,9,0.000015,1,1,1,15.867533,0.25,0.001437
9309041,9309041,,8,8,16,8,8,16,0.000003,0.000023,0,450,9,0.000044,2,0.7,0.785714,8813.791982,0.158333,0.002137
9411221,9411221,,2,9,11,2,9,11,0.000002,0.000019,0,4453,9,0.000011,3,0.578947,0.681818,376.946222,0.063636,0.000491
9508125,9508125,,1,5,6,1,5,6,0.000001,0.000028,0,4452,9,0.00001,2,0.647059,0.727273,0,0.233333,0.000272
105178,105178,,7,11,18,7,11,18,0.000189,0.000037,0,18284,6,0.000018,15,0.179212,0.202237,6895.913396,0.143791,0.001672
105179,105179,,4,3,7,4,3,7,0.000001,0.000001,0,18285,23,0.000023,14,0.133597,0.144801,4597.458179,0.166667,0.000896
105180,105180,,2,18,20,2,18,20,0.000262,0.001433,0,17806,25,0.000012,16,0.18748,0.208407,41284.545505,0.165789,0.000732
105181,105181,,10,6,16,10,6,16,0.000428,0.007519,0,15740,1,0.000021,18,0.203002,0.238583,45348.377242,0.1375,0.002498
105182,105182,,13,39,52,13,39,52,0.000511,0.003854,0,16717,25,0.000015,14,0.203986,0.233392,26437.081633,0.112745,0.003494
105183,105183,,2,13,15,2,13,15,0.000014,0.000609,0,18286,1,0.000012,8,0.205895,0.243887,191.826443,0.242857,0.000451
9601166,9601166,,6,12,18,6,12,18,0.000444,0.000056,0,5541,5,0.000023,6,0.289809,0.328526,24875.663979,0.071895,0.001545
9511189,9511189,,2,5,7,2,5,7,0.00005,0.000608,0,4947,13,0.000012,4,0.386076,0.430328,12.736145,0.380952,0.000505
9611179,9611179,,2,2,4,2,2,4,0.000015,0.000473,0,17403,1,0.000012,7,0.225587,0.24364,187.532468,0.25,0.000465
105184,105184,,28,32,60,28,32,60,0.000775,0.001169,0,15871,3,0.000024,13,0.190606,0.211432,2984.826383,0.246045,0.010766
105185,105185,,7,18,25,7,18,25,0.000219,0.002325,0,17819,30,0.000012,12,0.201778,0.221998,1080.965038,0.22,0.001887
105186,105186,,7,14,21,7,14,21,0.001081,0.003236,0,15685,25,0.000015,17,0.188315,0.213654,4339.493288,0.147619,0.00205
105187,105187,,9,22,31,9,22,31,0.000243,0.003483,0,18287,30,0.000014,14,0.199814,0.222589,2611.01876,0.178495,0.002346
105188,105188,,4,15,19,4,15,19,0.000231,0.000904,0,18288,30,0.000011,12,0.202671,0.223125,5755.103896,0.216374,0.000956
105189,105189,,0,4,4,0,4,4,0,0.003139,0,18290,23,0.00001,10,0.186047,0.214294,0,0.083333,0
9407020,9407020,,6,4,10,6,4,10,0.000041,0.000002,0,11539,23,0.000015,2,0.7,0.785714,205.318847,0.044444,0.001341
9612002,9612002,,1,0,1,1,0,1,0.000037,0,0,18289,23,0.000012,0,0,0,0,0,0.000219
9301120,9301120,,7,1,8,7,1,8,0.000008,0,0,1657,23,0.000027,1,1,1,510.000495,0.125,0.001682
105190,105190,,3,5,8,3,5,8,0.000001,0.000063,0,18291,5,0.000012,17,0.150899,0.161122,9.709524,0.196429,0.000697
105191,105191,,6,20,26,6,20,26,0.0002,0.002047,0,18292,30,0.000013,13,0.199793,0.220724,10502.501486,0.141538,0.001396
105192,105192,,18,9,27,18,9,27,0.000366,0.001637,0,17812,30,0.000024,13,0.191548,0.208758,4526.159772,0.179487,0.00447
105193,105193,,1,6,7,1,6,7,0,0,0,18294,20,0.000011,4,0.461538,0.659722,1,0.309524,0.000219
9603145,9603145,,1,0,1,1,0,1,0,0,0,18293,20,0.000011,0,0,0,0,0,0.000226
105194,105194,,3,19,22,3,19,22,0.000291,0.002835,0,18295,4,0.000011,14,0.177066,0.204262,3075.210739,0.095238,0.000836
105195,105195,,0,20,20,0,20,20,0,0.000356,0,18296,1,0.00001,15,0.179104,0.199812,0,0.084211,0
105196,105196,,3,7,10,3,7,10,0.000023,0.000005,0,18297,25,0.000012,13,0.160444,0.171391,22.8,0.288889,0.000677
105197,105197,,1,8,9,1,8,9,0.000001,0.000051,0,18298,4,0.00001,16,0.16616,0.189322,0,0.333333,0.000226
105198,105198,,9,14,23,9,14,23,0.000163,0.000013,0,18299,23,0.000016,15,0.145591,0.160666,18383.808211,0.189723,0.002065
105200,105200,,10,26,36,10,26,36,0.000525,0.000996,0,16103,1,0.000014,15,0.197106,0.221218,26318.582808,0.180159,0.002822
105201,105201,,0,5,5,0,5,5,0,0.00001,0,18300,22,0.00001,8,0.19697,0.289309,0,0.4,0
105202,105202,,0,5,5,0,5,5,0,0.000935,0,18301,25,0.00001,17,0.183051,0.201225,0,0.1,0
105205,105205,,3,18,21,3,18,21,0.000677,0.001419,0,16245,3,0.000011,15,0.205142,0.231412,2091.4274,0.190476,0.000823
105206,105206,,9,11,20,9,11,20,0.00027,0.000263,0,16196,9,0.000013,15,0.178268,0.195265,5167.07988,0.226316,0.002212
105207,105207,,10,30,40,10,30,40,0.001017,0.017899,0,15736,25,0.000014,13,0.218906,0.252901,19425.544965,0.142949,0.002499
105208,105208,,34,39,73,34,39,73,0.002248,0.004241,0,18302,0,0.000021,13,0.205524,0.232049,29484.157,0.175609,0.012737
105209,105209,,1,11,12,1,11,12,0.000007,0.002298,0,18303,3,0.00001,17,0.188781,0.208433,201.614598,0.166667,0.00029
105210,105210,,8,29,37,8,29,37,0.000633,0.00077,0,18304,2,0.000013,14,0.204169,0.229976,14864.748654,0.202703,0.001889
105211,105211,,3,8,11,3,8,11,0.000106,0.000107,0,18305,4,0.000014,15,0.135791,0.151838,2465.546491,0.290909,0.000699
108029,108029,,1,3,4,1,3,4,0.00002,0.00001,0,18306,4,0.000011,16,0.131005,0.146302,779.083729,0.333333,0.000219
105213,105213,,1,3,4,1,3,4,0,0,0,18307,23,0.000011,1,1,1,1,0.333333,0.000226
105214,105214,,21,43,64,21,43,64,0.003195,0.021211,0,15669,8,0.000017,12,0.208594,0.235368,34092.842272,0.194692,0.007504
105215,105215,,3,22,25,3,22,25,0.000001,0.000013,0,18308,23,0.000012,14,0.162159,0.175622,8287.290521,0.17,0.000658
105216,105216,,4,27,31,4,27,31,0.000412,0.003927,0,18309,52,0.00001,13,0.196555,0.220787,500.511901,0.209677,0.00097
105217,105217,,7,20,27,7,20,27,0.000398,0.001092,0,18310,1,0.000013,13,0.200506,0.223869,21328.69913,0.188034,0.001799
105218,105218,,11,43,54,11,43,54,0.001907,0.020131,0,18311,1,0.000013,16,0.186873,0.214402,10297.782552,0.189378,0.003309
105219,105219,,5,9,14,5,9,14,0.000678,0.008547,0,17753,8,0.000012,18,0.208418,0.242059,926.998102,0.153846,0.001616
105221,105221,,4,20,24,4,20,24,0.000087,0.000739,0,18312,30,0.000012,13,0.201602,0.22239,4349.44935,0.219203,0.000938
105222,105222,,1,9,10,1,9,10,0,0.000007,0,18313,23,0.000011,18,0.125942,0.139207,3487.648587,0.288889,0.000219
105223,105223,,2,2,4,2,2,4,0,0.000001,0,18314,22,0.000012,1,1,1,4,0.083333,0.000438
105224,105224,,1,8,9,1,8,9,0.000082,0.011407,0,18315,1,0.000011,14,0.188823,0.208773,2401.195764,0.305556,0.000219
105225,105225,,43,28,71,43,28,71,0.002316,0.002681,0,16183,10,0.000029,13,0.208566,0.235464,27145.77877,0.143863,0.016007
105226,105226,,4,7,11,4,7,11,0.000044,0.000975,0,18316,30,0.000014,15,0.18627,0.204152,673.196232,0.190909,0.001057
105229,105229,,12,55,67,12,55,67,0.000739,0.019243,0,18317,52,0.000014,14,0.224377,0.254908,38562.136981,0.092944,0.00333
105230,105230,,22,19,41,22,19,41,0.000727,0.000819,0,17795,3,0.000019,13,0.182515,0.200709,11435.971115,0.146951,0.005968
105232,105232,,0,8,8,0,8,8,0,0.000005,0,18318,23,0.00001,12,0.17214,0.192127,0,0.089286,0
105233,105233,,0,10,10,0,10,10,0,0.000224,0,18319,52,0.00001,13,0.172307,0.189332,0,0.133333,0
105234,105234,,1,4,5,1,4,5,0,0.000006,0,18320,23,0.000012,7,0.332136,0.372033,0,0.35,0.000219
105235,105235,,8,34,42,8,34,42,0.001606,0.021638,0,17730,1,0.000013,16,0.220763,0.252359,25666.263133,0.219512,0.001973
105236,105236,,4,12,16,4,12,16,0.000001,0.000004,0,18321,5,0.000013,17,0.110554,0.11947,5701.789373,0.208333,0.000877
105237,105237,,1,47,48,1,47,48,0.000012,0.013768,0,18322,1,0.00001,18,0.203619,0.248204,3684.324593,0.098404,0.000226
105239,105239,,2,5,7,2,5,7,0.000001,0.000016,0,18323,52,0.000011,14,0.157841,0.174521,415.874819,0.214286,0.000445
105240,105240,,3,11,14,3,11,14,0.000766,0.001683,0,18324,25,0.000011,16,0.187692,0.208536,855.448718,0.313187,0.000705
105243,105243,,17,15,32,17,15,32,0.000501,0.001522,0,12472,25,0.000022,19,0.179044,0.204823,22491.124293,0.122984,0.004407
105246,105246,,3,41,44,3,41,44,0.000177,0.001771,0,18325,3,0.00001,13,0.201701,0.224929,2210.691223,0.205603,0.001176
105250,105250,,26,28,54,26,28,54,0.003252,0.009575,0,16213,10,0.00002,14,0.20558,0.234293,8711.235791,0.191824,0.008514
105251,105251,,11,9,20,11,9,20,0.000291,0.000154,0,16033,30,0.00002,14,0.183823,0.203157,137513.195748,0.028947,0.002737
105252,105252,,19,16,35,19,16,35,0.001192,0.0009,0,16269,52,0.000022,18,0.199682,0.225051,8548.358782,0.17395,0.005353
105253,105253,,3,11,14,3,11,14,0.000213,0.000961,0,18326,2,0.000011,15,0.202581,0.226184,8044.331513,0.197802,0.000718
105254,105254,,21,63,84,21,63,84,0.003665,0.016079,0,18327,1,0.000016,17,0.192965,0.220484,24472.43679,0.16595,0.005951
105255,105255,,13,35,48,13,35,48,0.00052,0.004688,0,15569,25,0.000021,16,0.192417,0.218737,39402.869253,0.124557,0.003633
105257,105257,,17,34,51,17,34,51,0.000949,0.003587,0,15894,30,0.000017,12,0.200875,0.223479,13212.73827,0.196471,0.0065
105258,105258,,22,49,71,22,49,71,0.002545,0.014554,0,17855,1,0.000018,17,0.221454,0.253341,21713.181698,0.153924,0.006264
105259,105259,,5,7,12,5,7,12,0.000035,0.000022,0,18329,22,0.000013,16,0.162246,0.174134,33697.120507,0.242424,0.00117
9310100,9310100,,1,0,1,1,0,1,0,0,0,18328,22,0.000012,0,0,0,0,0,0.000253
105260,105260,,12,14,26,12,14,26,0.000246,0.000183,0,18330,4,0.000017,15,0.15395,0.174707,15656.864318,0.143077,0.003132
9505140,9505140,,2,12,14,2,12,14,0.000002,0.00002,0,1301,4,0.000012,7,0.268293,0.327543,23825.950426,0.214286,0.000539
105261,105261,,3,13,16,3,13,16,0.000136,0.003057,0,18331,0,0.000012,18,0.193969,0.219614,2197.187403,0.0625,0.000704
105262,105262,,4,4,8,4,4,8,0.000001,0.00001,0,18332,23,0.000016,16,0.13176,0.142889,0.214286,0.482143,0.001242
105263,105263,,4,24,28,4,24,28,0.0003,0.003641,0,18333,2,0.000012,14,0.207875,0.237632,13663.208188,0.078042,0.001552
105265,105265,,7,21,28,7,21,28,0.000212,0.002872,0,18334,30,0.000013,17,0.204946,0.22918,489.40577,0.187831,0.001613
105266,105266,,3,2,5,3,2,5,0.00034,0.000015,0,18335,52,0.000012,16,0.15315,0.165152,81.441325,0.2,0.000892
105268,105268,,8,8,16,8,8,16,0.000002,0.000012,0,18336,23,0.000017,16,0.133505,0.146869,540.066034,0.2875,0.002149
105269,105269,,6,16,22,6,16,22,0.000953,0.003,0,18337,25,0.000011,12,0.201408,0.223533,4557.350295,0.155844,0.001532
105270,105270,,10,30,40,10,30,40,0.002209,0.019398,0,18338,1,0.000014,14,0.201096,0.225223,10337.033857,0.204487,0.002852
105271,105271,,3,11,14,3,11,14,0.000121,0.001546,0,18340,30,0.000012,16,0.196712,0.216914,470.460953,0.159341,0.000708
1160,1160,,4,0,4,4,0,4,0.000139,0,0,18339,30,0.000013,0,0,0,0,0.5,0.000947
105272,105272,,8,17,25,8,17,25,0.000399,0.000694,0,17793,3,0.000013,14,0.175904,0.194533,8307.438943,0.088333,0.002287
105274,105274,,19,14,33,19,14,33,0.000563,0.002403,0,18341,2,0.000022,15,0.191365,0.213811,7453.731781,0.197917,0.004808
105275,105275,,4,5,9,4,5,9,0.000021,0.000004,0,18342,23,0.000015,17,0.12405,0.133276,3850.270482,0.222222,0.00089
105276,105276,,23,43,66,23,43,66,0.005429,0.011357,0,18343,1,0.000018,16,0.198907,0.227882,23339.665715,0.117249,0.006731
105277,105277,,14,14,28,14,14,28,0.000293,0.000649,0,18344,2,0.000021,15,0.195923,0.217156,21134.565482,0.198413,0.003592
105278,105278,,0,1,1,0,1,1,0,0.000001,0,18345,22,0.00001,5,0.304348,0.402381,0,0,0
105279,105279,,2,11,13,2,11,13,0.000109,0.001033,0,18346,8,0.000011,14,0.183333,0.211463,1710.301561,0.089744,0.000445
105281,105281,,0,9,9,0,9,9,0,0.000014,0,18347,23,0.00001,15,0.161218,0.178114,0,0.361111,0
105282,105282,,1,7,8,1,7,8,0,0.000003,0,18349,5,0.000012,13,0.110729,0.139887,1.916667,0.267857,0.000219
9803032,9803032,,1,0,1,1,0,1,0,0,0,18348,5,0.000011,0,0,0,0,0,0.000226
105283,105283,,5,38,43,5,38,43,0.000298,0.016882,0,18350,1,0.000012,14,0.194233,0.221754,3195.779767,0.190476,0.001539
105286,105286,,7,25,32,7,25,32,0.000213,0.001012,0,18351,5,0.000013,15,0.200111,0.222358,27371.274323,0.114919,0.001594
105288,105288,,7,47,54,7,47,54,0.000594,0.012376,0,17767,2,0.000012,13,0.230291,0.261994,35098.565293,0.107617,0.001698
105289,105289,,7,16,23,7,16,23,0.000287,0.002802,0,18352,4,0.000013,15,0.180019,0.201557,22700.139878,0.22332,0.002008
9608097,9608097,,1,3,4,1,3,4,0.000034,0.000008,0,6067,26,0.00001,2,0.714286,0.8,7894.669105,0.25,0.00024
105291,105291,,1,31,32,1,31,32,0.000608,0.003258,0,18353,0,0.00001,16,0.18828,0.2139,102.343189,0.164315,0.000245
105292,105292,,1,22,23,1,22,23,0.000085,0.006974,0,18354,2,0.00001,13,0.207471,0.237958,49.253978,0.197628,0.000226
105293,105293,,2,7,9,2,7,9,0.00006,0.001164,0,18355,25,0.000011,15,0.186178,0.206566,104.156985,0.236111,0.000526
105294,105294,,5,8,13,5,8,13,0.000001,0.000012,0,18356,9,0.000016,13,0.185865,0.207914,3997.282409,0.25641,0.001128
105295,105295,,0,2,2,0,2,2,0,0.001681,0,18357,25,0.00001,12,0.179933,0.195169,0,0,0
105296,105296,,4,25,29,4,25,29,0.000165,0.016526,0,18358,25,0.000011,16,0.200634,0.231427,9990.628673,0.156404,0.000903
105297,105297,,0,1,1,0,1,1,0,0,0,18359,10,0.00001,13,0.163493,0.178914,0,0,0
105298,105298,,2,22,24,2,22,24,0.00016,0.010569,0,18360,2,0.000011,14,0.21194,0.244836,2988.093405,0.139493,0.000499
105299,105299,,26,15,41,26,15,41,0.000011,0.000021,0,18362,23,0.000039,15,0.152776,0.169113,43297.992701,0.163415,0.006434
105018,105018,,18,0,18,18,0,18,0.00001,0,0,18361,23,0.000027,0,0,0,0,0.245098,0.004642
105301,105301,,2,4,6,2,4,6,0,0.000002,0,18364,23,0.000012,16,0.132726,0.142943,105.70906,0.1,0.000445
9403063,9403063,,5,0,5,5,0,5,0,0,0,18363,23,0.000033,0,0,0,0,0.15,0.001135
105302,105302,,2,44,46,2,44,46,0.000091,0.005014,0,18366,4,0.00001,13,0.18858,0.222081,799.869264,0.236232,0.000482
9507042,9507042,,1,1,2,1,1,2,0.000059,0,0,18365,20,0.00001,2,0.6,0.666667,4.303571,0,0.000233
105303,105303,,7,9,16,7,9,16,0.000027,0.000846,0,18367,30,0.000028,14,0.185431,0.202361,21327.111,0.108333,0.001724
105304,105304,,6,8,14,6,8,14,0.000419,0.002588,0,18368,25,0.000015,15,0.202919,0.232223,6574.806412,0.137363,0.001394
105305,105305,,6,12,18,6,12,18,0.000047,0.000227,0,18369,52,0.000015,16,0.16932,0.187868,15517.592656,0.238562,0.001381
105306,105306,,4,3,7,4,3,7,0.000001,0,0,18370,6,0.000017,9,0.210373,0.245811,582.603821,0.190476,0.00089
9412176,9412176,,5,12,17,5,12,17,0.000001,0.000032,0,6986,52,0.000023,5,0.313472,0.385813,11137.425659,0.099265,0.001208
9307097,9307097,,1,1,2,1,1,2,0,0,0,6985,52,0.000012,1,1,1,36.256904,0,0.000253
105307,105307,,2,46,48,2,46,48,0.000034,0.002334,0,18371,30,0.000011,13,0.212792,0.238536,5817.212109,0.166223,0.000463
105308,105308,,77,17,94,77,17,94,0.006102,0.001006,0,16001,41,0.000092,17,0.190592,0.213886,77268.059641,0.077213,0.032435
105309,105309,,26,23,49,26,23,49,0.004998,0.01905,0,18374,1,0.000023,16,0.209358,0.241778,41935.331754,0.097789,0.007534
9710107,9710107,,1,15,16,1,15,16,0.000224,0.000163,0,18373,17,0.000011,14,0.177285,0.201413,2570.912336,0.083333,0.000413
9310136,9310136,,6,6,12,6,6,12,0.000004,0.000094,0,2998,17,0.000016,4,0.353846,0.423913,2786.106653,0.166667,0.001542
9401143,9401143,,3,7,10,3,7,10,0.000001,0.000002,0,4253,17,0.000013,3,0.551724,0.677083,1692.302111,0.177778,0.000756
9411013,9411013,,4,6,10,4,6,10,0.000002,0.00003,0,4252,17,0.000014,4,0.333333,0.403226,81.566667,0.244444,0.000982
9609008,9609008,,4,16,20,4,16,20,0.000034,0.000064,0,4250,17,0.000014,8,0.295726,0.384056,51186.255396,0.094737,0.000989
9201077,9201077,,1,0,1,1,0,1,0.000002,0,0,18372,17,0.00001,0,0,0,0,0,0.000228
105310,105310,,4,1,5,4,1,5,0.000024,0,0,18375,22,0.000017,3,0.5,0.583333,89.883333,0.25,0.000997
105311,105311,,21,64,85,21,64,85,0.000819,0.0029,0,17818,30,0.000016,14,0.214309,0.239714,61055.887998,0.107563,0.006075
105312,105312,,9,55,64,9,55,64,0.00039,0.002513,0,17785,3,0.000013,13,0.195845,0.219049,1128.120891,0.254464,0.002994
105313,105313,,3,4,7,3,4,7,0.000006,0.000011,0,18376,2,0.000012,10,0.195489,0.221267,1425.870602,0.119048,0.00073
9703224,9703224,,6,13,19,6,13,19,0.000018,0.001215,0,8913,9,0.000019,10,0.231849,0.282588,29116.937089,0.128655,0.001382
9204023,9204023,,12,0,12,12,0,12,0.000015,0,0,1057,9,0.000085,0,0,0,0,0.090909,0.003148
9508005,9508005,,7,19,26,7,19,26,0.000034,0.000021,0,3221,9,0.000023,6,0.346895,0.423868,78560.149969,0.050769,0.001693
9611108,9611108,,4,8,12,4,8,12,0.000014,0.000001,0,8910,9,0.000015,6,0.27027,0.322302,6855.935979,0.212121,0.000936
105314,105314,,4,9,13,4,9,13,0.000255,0.000857,0,16244,3,0.000012,13,0.212975,0.235752,5935.044005,0.147436,0.001116
105315,105315,,0,17,17,0,17,17,0,0.001879,0,18377,22,0.00001,15,0.182258,0.202753,0,0.125,0
105316,105316,,5,5,10,5,5,10,0.000171,0.000009,0,18378,25,0.000014,14,0.157956,0.169101,1378.0291,0.2,0.001156
105317,105317,,0,2,2,0,2,2,0,0.000002,0,18379,6,0.00001,10,0.177861,0.196717,0,0,0
105318,105318,,0,9,9,0,9,9,0,0.000512,0,18380,25,0.00001,15,0.195377,0.219504,0,0.208333,0
105319,105319,,9,26,35,9,26,35,0.000132,0.000968,0,17796,3,0.000013,13,0.190255,0.21324,1882.970127,0.212605,0.002539
105320,105320,,7,62,69,7,62,69,0.000897,0.005561,0,17851,25,0.000013,13,0.206262,0.235338,56910.367286,0.096547,0.001919
9704193,9704193,,1,26,27,1,26,27,0.000065,0.0055,0,17849,0,0.00001,12,0.223415,0.261626,3997.506588,0.091168,0.00027
9609190,9609190,,2,8,10,2,8,10,0.000275,0.001233,0,17848,0,0.00001,12,0.19253,0.22299,63.342678,0.211111,0.000446
105321,105321,,1,16,17,1,16,17,0.000017,0.000042,0,18383,9,0.00001,14,0.184941,0.21189,13220.087299,0.058824,0.000237
9704065,9704065,,6,18,24,6,18,24,0.000002,0.000055,0,18382,9,0.000016,10,0.228286,0.269998,3161.378295,0.092391,0.001407
9909067,9909067,,1,6,7,1,6,7,0,0.000002,0,18381,9,0.00001,12,0.153686,0.17226,1191.449447,0.190476,0.000226
9206054,9206054,,2,0,2,2,0,2,0,0,0,7505,9,0.000014,0,0,0,0,0.5,0.00058
9402083,9402083,,8,2,10,8,2,10,0.000064,0.000001,0,954,4,0.000021,1,1,1,6674.06913,0.188889,0.001972
106001,106001,,28,11,39,28,11,39,0.000355,0.000381,0,15583,25,0.000057,14,0.173882,0.18989,70172.807389,0.116734,0.007114
106002,106002,,4,28,32,4,28,32,0.000368,0.001422,0,15954,3,0.00001,14,0.198798,0.220875,1176.046526,0.233871,0.001003
106201,106201,,13,121,134,13,121,134,0.001019,0.02372,0,15980,3,0.000014,15,0.237653,0.275195,289881.834328,0.071092,0.003665
106112,106112,,39,25,64,39,25,64,0.005226,0.020732,0,15536,1,0.000036,18,0.197994,0.237822,80097.140724,0.070933,0.011415
9806225,9806225,,4,29,33,4,29,33,0.000499,0.006268,0,15935,2,0.000011,13,0.201621,0.235382,989.283414,0.16572,0.000991
106003,106003,,0,5,5,0,5,5,0,0.000001,0,18384,15,0.00001,14,0.147523,0.15645,0,0.2,0
106004,106004,,12,33,45,12,33,45,0.001425,0.003185,0,18385,1,0.000016,14,0.210006,0.236869,46881.124508,0.128788,0.003638
106005,106005,,23,29,52,23,29,52,0.001947,0.002752,0,16268,52,0.000021,17,0.213093,0.240852,72307.921823,0.10822,0.006645
106006,106006,,4,8,12,4,8,12,0.000115,0.001229,0,18386,30,0.000011,14,0.189361,0.207262,56.93975,0.204545,0.000903
106007,106007,,0,2,2,0,2,2,0,0.00002,0,18387,0,0.00001,3,0.5,0.551282,0,0,0
106008,106008,,1,22,23,1,22,23,0.000022,0.020646,0,18388,1,0.00001,13,0.20971,0.242522,1854.621784,0.201581,0.000226
106009,106009,,0,9,9,0,9,9,0,0.000007,0,18389,23,0.00001,19,0.132349,0.147201,0,0.291667,0
106010,106010,,58,80,138,58,80,138,0.001941,0.003052,0,17789,3,0.000048,16,0.204676,0.23293,95281.946052,0.114831,0.019849
106011,106011,,18,29,47,18,29,47,0.000292,0.002323,0,15879,30,0.000021,16,0.192075,0.212242,19241.14963,0.078631,0.004514
106072,106072,,12,15,27,12,15,27,0.000205,0.000132,0,15882,30,0.000017,17,0.185071,0.202878,14503.96609,0.135328,0.002979
106016,106016,,17,6,23,17,6,23,0.000323,0.00007,0,15878,30,0.000023,14,0.175612,0.188031,231.585343,0.15415,0.004227
106013,106013,,6,31,37,6,31,37,0.000528,0.002459,0,18390,0,0.000012,13,0.201489,0.223046,23941.299405,0.134384,0.001704
106015,106015,,11,30,41,11,30,41,0.001628,0.020482,0,18391,1,0.000014,17,0.206705,0.241872,8854.587202,0.207927,0.003016
106018,106018,,3,15,18,3,15,18,0.000033,0.001072,0,18392,30,0.000012,19,0.183327,0.203002,1430.078433,0.107843,0.00073
106020,106020,,10,37,47,10,37,47,0.002333,0.023351,0,15423,1,0.000013,17,0.220108,0.255875,20767.124417,0.129047,0.00322
106021,106021,,6,33,39,6,33,39,0.000506,0.002829,0,18393,0,0.000012,13,0.204473,0.227098,16485.37044,0.137652,0.001559
106022,106022,,5,23,28,5,23,28,0.000673,0.001529,0,15684,25,0.000013,13,0.198304,0.221207,24281.891218,0.100529,0.001645
106023,106023,,5,11,16,5,11,16,0.000032,0.000241,0,18394,2,0.000019,16,0.183876,0.202483,11212.018151,0.179167,0.001148
106024,106024,,12,32,44,12,32,44,0.000515,0.003451,0,17837,30,0.000016,15,0.207351,0.232032,16483.327827,0.179704,0.002876
106025,106025,,0,10,10,0,10,10,0,0.000721,0,18396,23,0.00001,16,0.162114,0.177502,0,0.166667,0
9711182,9711182,,1,11,12,1,11,12,0.000008,0.000013,0,18395,23,0.000011,12,0.183527,0.237288,54.154435,0.19697,0.000219
9308013,9308013,,2,1,3,2,1,3,0,0.000001,0,4114,23,0.000014,1,1,1,2.333333,0,0.00046
106026,106026,,37,13,50,37,13,50,0.001449,0.000662,0,16192,10,0.000031,12,0.200045,0.222643,9941.592423,0.148163,0.012727
106027,106027,,20,25,45,20,25,45,0.000406,0.002769,0,17798,3,0.000019,12,0.202499,0.226448,11122.534508,0.179293,0.00689
106028,106028,,7,22,29,7,22,29,0.000482,0.006207,0,18398,15,0.000013,13,0.203945,0.231976,50324.757921,0.094828,0.001588
9506063,9506063,,1,11,12,1,11,12,0.000073,0.002088,0,18397,4,0.00001,6,0.278751,0.324135,767.643066,0.121212,0.000265
106029,106029,,1,7,8,1,7,8,0,0.000002,0,18402,15,0.000012,12,0.139759,0.160876,22.666667,0.035714,0.000219
9311155,9311155,,3,1,4,3,1,4,0.000015,0,0,18401,15,0.000013,1,1,1,344,0.083333,0.000724
9604117,9604117,,1,5,6,1,5,6,0,0.000003,0,18399,15,0.000011,2,0.6,0.666667,25.333333,0.166667,0.000226
9310164,9310164,,2,0,2,2,0,2,0,0,0,18400,15,0.000023,0,0,0,0,0.5,0.000465
9309136,9309136,,2,3,5,2,3,5,0,0,0,9362,15,0.000024,1,1,1,776.612755,0.05,0.000473
9311082,9311082,,1,2,3,1,2,3,0,0,0,9361,15,0.00002,2,0.75,0.833333,686.757408,0,0.000254
9405126,9405126,,3,2,5,3,2,5,0.000003,0.000004,0,6448,15,0.000016,2,0.75,0.833333,86.524296,0.15,0.000704
106031,106031,,4,26,30,4,26,30,0.000313,0.002888,0,16210,8,0.000012,12,0.217523,0.240624,307459.210344,0.071264,0.001026
106032,106032,,9,12,21,9,12,21,0.001414,0.007649,0,17728,1,0.000015,13,0.20458,0.226931,8324.968369,0.221429,0.002939
106034,106034,,71,29,100,71,29,100,0.00292,0.001304,0,16190,10,0.000047,12,0.211001,0.237258,77202.098985,0.112121,0.023957
106035,106035,,2,11,13,2,11,13,0,0.000004,0,18403,22,0.000011,18,0.139833,0.153873,4175.219999,0.365385,0.000458
106036,106036,,58,29,87,58,29,87,0.001391,0.016186,0,15876,3,0.000047,16,0.196945,0.220646,42940.124804,0.163994,0.020084
106037,106037,,1,3,4,1,3,4,0,0.000061,0,18404,25,0.00001,16,0.173096,0.192224,2164.600371,0,0.000232
106039,106039,,0,2,2,0,2,2,0,0,0,18405,23,0.00001,8,0.209765,0.232769,0,0,0
106040,106040,,36,52,88,36,52,88,0.0028,0.005134,0,16193,4,0.000027,12,0.212416,0.242524,57912.535109,0.118861,0.016023
106041,106041,,10,21,31,10,21,31,0.000344,0.002026,0,16093,25,0.000014,17,0.19119,0.216127,6000.630282,0.178495,0.002561
106042,106042,,4,7,11,4,7,11,0.000343,0.000833,0,15885,30,0.000015,12,0.190495,0.207891,14186.964572,0.127273,0.00245
106043,106043,,1,31,32,1,31,32,0.000024,0.001127,0,18406,4,0.00001,13,0.214219,0.239551,1650.401057,0.099798,0.000246
106044,106044,,33,11,44,33,11,44,0.000524,0.000908,0,18407,30,0.00004,14,0.188808,0.206794,52370.814729,0.066596,0.008231
106045,106045,,0,53,53,0,53,53,0,0.005848,0,18408,4,0.00001,17,0.187439,0.220087,0,0.236575,0
106046,106046,,8,26,34,8,26,34,0.000601,0.002682,0,18409,30,0.000013,14,0.207135,0.229587,4502.488955,0.177362,0.001896
106047,106047,,8,19,27,8,19,27,0.000174,0.001475,0,18410,30,0.000016,14,0.199448,0.221025,16194.891488,0.094017,0.001991
106049,106049,,0,3,3,0,3,3,0,0,0,18411,28,0.00001,13,0.163415,0.175394,0,0,0
106052,106052,,1,12,13,1,12,13,0,0.000005,0,18414,9,0.000011,14,0.157625,0.18602,8.166667,0.198718,0.000219
9303064,9303064,,4,1,5,4,1,5,0,0,0,12608,9,0.000015,1,1,1,28.193056,0.15,0.000936
9310061,9310061,,4,5,9,4,5,9,0,0.00001,0,18413,9,0.000015,5,0.373737,0.456757,63.054762,0.138889,0.000903
9403036,9403036,,4,4,8,4,4,8,0,0.000011,0,18412,9,0.000013,2,0.75,0.833333,17.9,0.107143,0.00089
9206009,9206009,,3,0,3,3,0,3,0.000001,0,0,4209,9,0.000031,0,0,0,0,0,0.000719
106053,106053,,6,12,18,6,12,18,0.000009,0.000002,0,18415,17,0.000014,13,0.160517,0.196495,919.359303,0.218954,0.001441
106054,106054,,8,46,54,8,46,54,0.000848,0.02117,0,15675,25,0.000012,13,0.219484,0.247061,26308.677057,0.131726,0.002494
106055,106055,,36,31,67,36,31,67,0.003215,0.00189,0,16214,10,0.000022,12,0.213585,0.240294,31821.995612,0.195161,0.012217
106056,106056,,0,7,7,0,7,7,0,0.000009,0,18417,30,0.00001,15,0.166972,0.179953,0,0.142857,0
9402069,9402069,,1,0,1,1,0,1,0,0,0,18416,30,0.000011,0,0,0,0,0,0.000219
9401019,9401019,,1,1,2,1,1,2,0,0.000003,0,18035,15,0.000014,1,1,1,0,0.5,0.000239
106057,106057,,1,3,4,1,3,4,0,0,0,18420,23,0.000012,3,0.538462,0.666667,6,0.083333,0.000219
9602092,9602092,,1,0,1,1,0,1,0,0,0,18419,23,0.000013,0,0,0,0,0,0.000226
9808121,9808121,,2,0,2,2,0,2,0,0,0,18418,23,0.000016,0,0,0,0,0.5,0.000445
106058,106058,,15,25,40,15,25,40,0.000784,0.001295,0,15584,25,0.000021,13,0.185289,0.208646,44204.320409,0.104487,0.00425
9910229,9910229,,1,12,13,1,12,13,0.000015,0.001931,0,15538,25,0.000011,13,0.184182,0.205773,2941.28048,0.217949,0.00033
9902191,9902191,,1,17,18,1,17,18,0.000023,0.01956,0,15537,1,0.000011,13,0.210694,0.245173,1649.439568,0.215686,0.000227
106059,106059,,5,7,12,5,7,12,0.000541,0.000403,0,18421,2,0.000012,17,0.182821,0.200702,6452.790175,0.128788,0.001311
106060,106060,,1,3,4,1,3,4,0,0,0,18422,6,0.000011,9,0.196953,0.22688,109.928571,0.333333,0.000219
106061,106061,,10,56,66,10,56,66,0.001565,0.015812,0,18424,1,0.000013,14,0.222275,0.253885,60191.332361,0.099068,0.002816
9809107,9809107,,1,13,14,1,13,14,0.000186,0.002324,0,18423,4,0.00001,13,0.18801,0.215974,1635.034655,0.274725,0.000293
106062,106062,,17,10,27,17,10,27,0.000431,0.000825,0,18425,2,0.000022,16,0.188681,0.210111,6088.787973,0.2151,0.004233
106063,106063,,0,8,8,0,8,8,0,0.009979,0,18426,1,0.00001,11,0.224452,0.254228,0,0.428571,0
106064,106064,,8,12,20,8,12,20,0.000659,0.011105,0,18427,1,0.000019,15,0.180385,0.201732,28429.038426,0.110526,0.001819
106065,106065,,2,14,16,2,14,16,0.000004,0.000076,0,18428,23,0.000012,12,0.197342,0.217545,16230.749449,0.229167,0.00046
106066,106066,,3,5,8,3,5,8,0.000012,0.000016,0,18429,6,0.000013,19,0.13602,0.154504,166.621882,0.142857,0.000683
106068,106068,,5,48,53,5,48,53,0.000207,0.001382,0,18430,3,0.000011,17,0.190846,0.213753,1941.226069,0.28447,0.001927
106069,106069,,7,14,21,7,14,21,0.000002,0.000067,0,18431,6,0.000014,17,0.166263,0.188623,73190.875837,0.142857,0.001685
106070,106070,,7,7,14,7,7,14,0.000003,0.000004,0,18432,6,0.000013,14,0.130279,0.145415,24.374462,0.318681,0.001645
106071,106071,,0,12,12,0,12,12,0,0.000001,0,18433,26,0.00001,9,0.206063,0.240066,0,0.136364,0
9406195,9406195,,3,4,7,3,4,7,0.000001,0.000003,0,7300,26,0.000018,2,0.833333,0.9,11707.477843,0.071429,0.000889
9302072,9302072,,3,1,4,3,1,4,0.000001,0.000002,0,7306,26,0.000013,1,1,1,15.965046,0.25,0.000791
9501001,9501001,,1,0,1,1,0,1,0,0,0,7305,26,0.000011,0,0,0,0,0,0.000293
9401107,9401107,,2,3,5,2,3,5,0.000003,0.000165,0,2806,26,0.000012,1,1,1,29.550076,0.15,0.000496
106073,106073,,5,12,17,5,12,17,0.000892,0.016908,0,18434,1,0.000013,18,0.204786,0.23971,84719.38057,0.154412,0.001158
106074,106074,,6,10,16,6,10,16,0.000061,0.001772,0,18435,30,0.000019,13,0.195534,0.21463,10743.401132,0.170833,0.001394
106075,106075,,3,12,15,3,12,15,0.000063,0.001632,0,18436,30,0.000013,13,0.192238,0.211131,7715.855569,0.119048,0.000724
106076,106076,,14,23,37,14,23,37,0.001086,0.001296,0,16123,25,0.000018,16,0.195356,0.219595,40365.734638,0.106607,0.003706
106077,106077,,0,3,3,0,3,3,0,0,0,18438,5,0.00001,15,0.130582,0.146215,0,0.166667,0
9907223,9907223,,1,4,5,1,4,5,0,0.000002,0,18437,5,0.000013,15,0.130656,0.147038,17.666667,0.15,0.000219
106078,106078,,2,39,41,2,39,41,0.000239,0.02095,0,18439,3,0.000011,14,0.216247,0.244223,117591.429395,0.082317,0.00068
106103,106103,,7,24,31,7,24,31,0.000207,0.009778,0,18440,3,0.000013,15,0.196278,0.219601,29780.88489,0.106452,0.001772
106079,106079,,18,21,39,18,21,39,0.000537,0.001165,0,16227,3,0.000019,16,0.197969,0.221409,10131.623841,0.166667,0.005657
106080,106080,,0,15,15,0,15,15,0,0.016844,0,18441,1,0.00001,15,0.18834,0.211748,0,0.138095,0
106081,106081,,3,53,56,3,53,56,0.000099,0.008912,0,16718,25,0.000011,14,0.217553,0.250742,38000.520518,0.075649,0.000801
9908133,9908133,,4,7,11,4,7,11,0.000147,0.000177,0,16712,13,0.000012,14,0.178564,0.200731,3496.502856,0.181818,0.000988
9412227,9412227,,2,7,9,2,7,9,0.000002,0.000065,0,4246,17,0.000013,5,0.324074,0.394762,0,0.416667,0.000522
106083,106083,,2,15,17,2,15,17,0.000045,0.000546,0,18442,25,0.000012,13,0.196733,0.217669,3129.857666,0.095588,0.000466
106087,106087,,4,3,7,4,3,7,0.000002,0,0,18444,23,0.000017,9,0.1793,0.202705,336.966005,0.142857,0.000916
105099,105099,,4,0,4,4,0,4,0.000004,0,0,18443,23,0.000021,0,0,0,0,0.166667,0.000936
106088,106088,,4,16,20,4,16,20,0.00002,0.001752,0,18445,30,0.000017,13,0.196091,0.215925,10785.017865,0.136842,0.000929
106089,106089,,25,13,38,25,13,38,0.00028,0.000212,0,18446,30,0.000031,15,0.17645,0.191974,12285.110611,0.101707,0.006225
106138,106138,,27,9,36,27,9,36,0.000456,0.000849,0,18447,30,0.00003,14,0.187708,0.205422,8919.432503,0.123016,0.006636
106092,106092,,7,24,31,7,24,31,0.000565,0.013894,0,15737,1,0.000013,14,0.209903,0.243225,9615.785468,0.170968,0.001766
106093,106093,,4,14,18,4,14,18,0.000819,0.002638,0,18448,4,0.000011,13,0.212922,0.239945,519.092861,0.176471,0.001007
106094,106094,,0,21,21,0,21,21,0,0.001007,0,18451,4,0.00001,15,0.205869,0.22835,0,0.066667,0
9607217,9607217,,1,7,8,1,7,8,0.000012,0.000002,0,18450,5,0.00001,4,0.446429,0.566667,9.474359,0.089286,0.000219
9406193,9406193,,4,5,9,4,5,9,0.000013,0.000076,0,3653,5,0.000016,2,0.857143,0.916667,47.576819,0.125,0.000916
9511025,9511025,,2,0,2,2,0,2,0,0,0,18449,5,0.00002,0,0,0,0,0,0.000445
106095,106095,,0,2,2,0,2,2,0,0,0,18452,23,0.00001,3,0.5,0.583333,0,0,0
106096,106096,,0,22,22,0,22,22,0,0.001804,0,18453,3,0.00001,14,0.197399,0.22092,0,0.101732,0
106098,106098,,1,2,3,1,2,3,0,0.000177,0,18454,23,0.000019,14,0.17021,0.195297,1481,0,0.000219
106106,106106,,0,1,1,0,1,1,0,0,0,18455,23,0.00001,15,0.145537,0.16039,0,0,0
106099,106099,,2,12,14,2,12,14,0.000084,0.006153,0,18456,1,0.000011,12,0.194028,0.214069,2903.051663,0.175824,0.000509
106203,106203,,11,18,29,11,18,29,0.000414,0.001401,0,16090,25,0.000015,12,0.203164,0.224209,16343.992058,0.224138,0.003074
106127,106127,,16,95,111,16,95,111,0.001555,0.025415,0,15706,25,0.000018,11,0.236286,0.273102,187980.666263,0.076658,0.005329
107233,107233,,10,26,36,10,26,36,0.00064,0.002948,0,16094,25,0.000014,13,0.19722,0.220499,13893.805452,0.161905,0.002866
106131,106131,,8,16,24,8,16,24,0.000201,0.001882,0,16091,25,0.000014,16,0.1872,0.209749,2034.272632,0.182971,0.001995
112045,112045,,38,59,97,38,59,97,0.004249,0.021322,0,17807,8,0.00003,12,0.228117,0.259606,178734.792546,0.126074,0.010311
106109,106109,,153,10,163,153,10,163,0.018012,0.002565,0,15422,8,0.000112,17,0.191698,0.215018,136585.447368,0.058737,0.051339
106113,106113,,193,21,214,193,21,214,0.024252,0.013959,0,15404,8,0.000135,11,0.205579,0.228859,89421.303251,0.057589,0.063053
106151,106151,,37,31,68,37,31,68,0.005912,0.013946,0,15535,8,0.000029,11,0.201806,0.22601,43007.001009,0.093284,0.014326
106184,106184,,35,26,61,35,26,61,0.005592,0.003646,0,15529,8,0.000026,14,0.203889,0.226436,121067.691032,0.145628,0.01427
106191,106191,,64,32,96,64,32,96,0.009364,0.019755,0,15450,8,0.000041,12,0.220067,0.250607,144329.220505,0.145614,0.024212
106247,106247,,76,25,101,76,25,101,0.010753,0.004114,0,15533,8,0.000048,13,0.215868,0.246323,81658.393002,0.140891,0.027927
107134,107134,,55,53,108,55,53,108,0.007562,0.021995,0,15709,8,0.000034,12,0.226221,0.259026,256581.464631,0.13162,0.018936
107169,107169,,32,20,52,32,20,52,0.004998,0.002805,0,15984,8,0.000023,13,0.205912,0.227586,165045.939794,0.148944,0.011347
108150,108150,,51,22,73,51,22,73,0.001024,0.000951,0,17804,3,0.000041,15,0.190419,0.210633,41294.693324,0.226218,0.017509
108172,108172,,36,149,185,36,149,185,0.00569,0.027924,0,16124,8,0.000025,12,0.246712,0.284866,586098.283421,0.065687,0.012289
109057,109057,,41,22,63,41,22,63,0.005578,0.01032,0,16015,8,0.000029,11,0.221132,0.249033,56467.160914,0.190476,0.014687
109122,109122,,11,20,31,11,20,31,0.001552,0.018632,0,17781,8,0.000015,12,0.222829,0.250966,21715.688073,0.170968,0.003138
109133,109133,,20,15,35,20,15,35,0.002361,0.016881,0,17782,1,0.000018,12,0.203319,0.22517,23256.322958,0.132773,0.005371
109213,109213,,67,30,97,67,30,97,0.00885,0.013571,0,15710,8,0.000057,12,0.206534,0.232465,228506.544188,0.101697,0.024932
110007,110007,,94,35,129,94,35,129,0.01302,0.009752,0,16019,8,0.000057,11,0.214986,0.238537,406472.788327,0.083031,0.028741
110031,110031,,38,36,74,38,36,74,0.005342,0.009294,0,16125,8,0.000024,12,0.216078,0.241,99527.845594,0.180304,0.01357
110062,110062,,31,26,57,31,26,57,0.005661,0.008861,0,17734,8,0.000021,12,0.220071,0.249616,48851.018697,0.203321,0.011016
110064,110064,,22,35,57,22,35,57,0.003795,0.004608,0,17750,8,0.000016,12,0.217011,0.243527,40296.251804,0.14787,0.006976
110108,110108,,104,58,162,104,58,162,0.013891,0.024866,0,17736,8,0.000068,13,0.209709,0.238051,296737.551734,0.085039,0.032093
110123,110123,,33,18,51,33,18,51,0.004377,0.016573,0,17748,8,0.000023,13,0.194291,0.214679,2160.684592,0.206667,0.011022
110143,110143,,16,42,58,16,42,58,0.001181,0.004309,0,17780,25,0.000017,13,0.211144,0.23526,62328.964502,0.11585,0.004459
110169,110169,,22,19,41,22,19,41,0.003234,0.002048,0,17754,8,0.000017,13,0.194096,0.21495,6441.679295,0.208537,0.007313
110234,110234,,47,26,73,47,26,73,0.007052,0.018148,0,17749,8,0.000026,12,0.205567,0.228639,22284.111428,0.164003,0.015019
110238,110238,,4,32,36,4,32,36,0.000972,0.004199,0,17769,8,0.000011,12,0.209717,0.235168,17254.982082,0.105556,0.001358
110265,110265,,42,22,64,42,22,64,0.005983,0.01996,0,17752,8,0.000023,13,0.195676,0.217384,35637.477917,0.177331,0.013156
111008,111008,,36,50,86,36,50,86,0.004966,0.021584,0,17751,8,0.000022,12,0.225044,0.255903,41558.370617,0.179891,0.011541
111093,111093,,54,58,112,54,58,112,0.007366,0.006082,0,17755,8,0.000028,12,0.216906,0.242338,86215.986071,0.148649,0.015942
111182,111182,,18,82,100,18,82,100,0.002491,0.02325,0,17756,8,0.000016,12,0.220523,0.2481,32161.449521,0.150606,0.005614
111201,111201,,7,20,27,7,20,27,0.001209,0.00229,0,17763,8,0.000012,13,0.203899,0.225303,5034.315723,0.196581,0.002383
111217,111217,,40,24,64,40,24,64,0.005375,0.002892,0,17761,8,0.000023,13,0.191184,0.212118,4976.928439,0.134425,0.011741
111238,111238,,19,85,104,19,85,104,0.002834,0.023304,0,17758,8,0.000016,12,0.221443,0.249128,20865.041352,0.150765,0.005791
111276,111276,,17,25,42,17,25,42,0.00323,0.003108,0,17759,8,0.000015,13,0.199538,0.221343,2937.590053,0.25029,0.005283
112227,112227,,4,44,48,4,44,48,0.000546,0.020887,0,17845,8,0.000011,12,0.216202,0.241364,23227.180847,0.121454,0.001059
108194,108194,,4,20,24,4,20,24,0.000689,0.000345,0,17844,25,0.000011,13,0.189676,0.208881,1611.385681,0.121377,0.001053
111007,111007,,2,16,18,2,16,18,0.000271,0.001688,0,17843,30,0.00001,13,0.198404,0.217846,17295.962733,0.166667,0.00052
202198,202198,,12,46,58,12,46,58,0.001276,0.020735,0,18479,25,0.000014,12,0.223394,0.255261,28005.035046,0.119782,0.002971
108013,108013,,12,20,32,12,20,32,0.00088,0.00311,0,16038,25,0.000016,12,0.21738,0.249126,34896.176194,0.117944,0.003249
111153,111153,,37,10,47,37,10,47,0.000921,0.000287,0,18478,3,0.000028,14,0.184527,0.199752,21837.020431,0.244218,0.011983
201268,201268,,10,30,40,10,30,40,0.000933,0.003004,0,18468,8,0.000014,13,0.197511,0.219399,5472.182479,0.269872,0.002513
202060,202060,,13,28,41,13,28,41,0.000898,0.003363,0,17846,25,0.000016,12,0.20477,0.226932,34586.10704,0.156098,0.003412
202107,202107,,13,20,33,13,20,33,0.001209,0.002494,0,17847,25,0.000015,13,0.193146,0.213539,4393.707746,0.176136,0.0033
202140,202140,,8,50,58,8,50,58,0.001248,0.019486,0,18457,8,0.000012,12,0.221841,0.253948,12200.388766,0.121597,0.002056
106101,106101,,4,2,6,4,2,6,0.000269,0.000022,0,17719,25,0.000012,14,0.161973,0.173444,26.491007,0.333333,0.001121
106102,106102,,0,8,8,0,8,8,0,0.000005,0,18481,23,0.00001,19,0.13057,0.144263,0,0.357143,0
9908178,9908178,,1,9,10,1,9,10,0,0.000007,0,18480,23,0.000011,18,0.139488,0.155266,807.22475,0.3,0.000219
106104,106104,,2,18,20,2,18,20,0.000043,0.001118,0,18482,0,0.000011,14,0.194741,0.221527,4715.675517,0.105263,0.000438
106105,106105,,12,13,25,12,13,25,0.000427,0.000232,0,18484,52,0.000016,16,0.173114,0.19728,11128.989661,0.123333,0.00322
9511040,9511040,,3,3,6,3,3,6,0.000004,0.000009,0,18483,52,0.000014,3,0.518519,0.583333,36.902673,0.166667,0.000792
106107,106107,,12,32,44,12,32,44,0.000252,0.001185,0,17797,3,0.000014,17,0.197429,0.222021,32737.362411,0.183404,0.003865
9902178,9902178,,8,2,10,8,2,10,0.000084,0.000019,0,17784,3,0.000015,7,0.24812,0.286003,292.386021,0.122222,0.002095
106108,106108,,5,12,17,5,12,17,0.00122,0.019945,0,18485,1,0.000013,17,0.196076,0.231969,861.042699,0.319853,0.001228
106110,106110,,9,8,17,9,8,17,0.000217,0.001662,0,18486,30,0.000015,16,0.186419,0.204231,1389.831833,0.158088,0.002092
106111,106111,,6,3,9,6,3,9,0.000244,0.000007,0,18487,8,0.000014,13,0.148183,0.160554,54.889469,0.055556,0.001348
9601132,9601132,,1,0,1,1,0,1,0.000218,0,0,8402,1,0.00001,0,0,0,0,0,0.000378
106114,106114,,3,23,26,3,23,26,0.000205,0.017678,0,18488,41,0.000011,13,0.185793,0.210146,1051.966295,0.209231,0.000718
106116,106116,,2,13,15,2,13,15,0.000185,0.017042,0,18489,41,0.000012,14,0.180212,0.2037,257.024673,0.214286,0.000445
106117,106117,,47,33,80,47,33,80,0.006529,0.010892,0,17854,1,0.000028,13,0.214951,0.242268,37757.990132,0.146994,0.014155
106118,106118,,0,5,5,0,5,5,0,0.000006,0,18490,23,0.00001,7,0.333333,0.37541,0,0.35,0
106120,106120,,32,64,96,32,64,96,0.002409,0.007286,0,17774,25,0.000029,12,0.228737,0.261862,338857.449979,0.061294,0.010312
106121,106121,,16,20,36,16,20,36,0.001008,0.001427,0,17835,30,0.000015,14,0.202591,0.223335,3188.157238,0.225397,0.004105
106122,106122,,1,6,7,1,6,7,0,0.000005,0,18491,15,0.000011,15,0.139875,0.147948,3606.019804,0.071429,0.000226
106123,106123,,1,2,3,1,2,3,0.000002,0,0,18493,52,0.000011,5,0.291667,0.357937,819.947622,0.166667,0.000268
9808158,9808158,,1,3,4,1,3,4,0,0.000008,0,18492,52,0.000015,4,0.384615,0.4625,23.145681,0.25,0.000226
106125,106125,,13,22,35,13,22,35,0.000238,0.001983,0,18494,30,0.000018,15,0.194236,0.216611,14849.673089,0.12521,0.003324
106126,106126,,11,13,24,11,13,24,0.000661,0.00876,0,18495,0,0.000018,16,0.17928,0.201073,9143.671934,0.13587,0.002844
106128,106128,,4,35,39,4,35,39,0.000425,0.023876,0,16016,25,0.000013,16,0.201363,0.230964,10418.448001,0.117409,0.00134
106129,106129,,20,24,44,20,24,44,0.001667,0.0014,0,16270,52,0.000019,11,0.216167,0.238588,53982.381619,0.149577,0.005407
106133,106133,,7,15,22,7,15,22,0.000001,0.000028,0,16329,20,0.000014,16,0.15852,0.18016,5160.526779,0.248918,0.001824
108040,108040,,17,22,39,17,22,39,0.000017,0.000017,0,16331,20,0.00002,13,0.166579,0.183082,11440.580773,0.141026,0.004072
9808070,9808070,,2,6,8,2,6,8,0.000164,0.000023,0,15534,5,0.000012,11,0.194045,0.237468,847.397639,0.214286,0.000878
106134,106134,,4,7,11,4,7,11,0.000103,0.001116,0,17722,25,0.000013,15,0.175433,0.194674,3957.935786,0.281818,0.001068
106135,106135,,3,3,6,3,3,6,0.000004,0.000008,0,18496,22,0.000012,15,0.1402,0.151088,0.309524,0.366667,0.000684
106136,106136,,3,19,22,3,19,22,0.000031,0.001442,0,18497,30,0.000012,13,0.210481,0.231465,7158.889686,0.114719,0.00075
9304033,9304033,,4,2,6,4,2,6,0.000017,0.000007,0,2767,22,0.000022,1,1,1,2.5,0.133333,0.000911
106137,106137,,1,2,3,1,2,3,0,0.000003,0,18498,26,0.000011,1,1,1,1,0.166667,0.000219
106139,106139,,3,2,5,3,2,5,0,0,0,18499,6,0.000019,7,0.241071,0.331041,19.333333,0.25,0.000658
106140,106140,,14,37,51,14,37,51,0.000703,0.004337,0,17721,25,0.000017,13,0.220593,0.250691,65912.204063,0.080392,0.003525
106141,106141,,5,8,13,5,8,13,0.000057,0.000034,0,18500,30,0.000016,19,0.173927,0.188678,1050.973707,0.185897,0.001261
106142,106142,,5,31,36,5,31,36,0.000394,0.002452,0,18501,52,0.000011,14,0.207187,0.231104,928.150834,0.153175,0.001135
106143,106143,,7,8,15,7,8,15,0.000209,0.001342,0,18502,25,0.000017,16,0.187994,0.209333,13013.030175,0.171429,0.001735
106144,106144,,8,3,11,8,3,11,0.000081,0.000003,0,18503,8,0.000023,7,0.271698,0.334524,271.609199,0.281818,0.001892
106145,106145,,9,12,21,9,12,21,0.000543,0.001359,0,17743,25,0.000015,17,0.185304,0.206012,4320.555928,0.180952,0.002133
106148,106148,,2,22,24,2,22,24,0.000086,0.002901,0,18504,1,0.00001,15,0.207974,0.233283,3453.705821,0.086957,0.000532
106149,106149,,28,41,69,28,41,69,0.002813,0.017047,0,18506,1,0.000029,18,0.207839,0.235236,87811.004709,0.078005,0.007541
9806243,9806243,,5,5,10,5,5,10,0.000449,0.000004,0,18505,28,0.000014,16,0.141978,0.1578,6803.903467,0.144444,0.00143
106200,106200,,20,30,50,20,30,50,0.002395,0.020026,0,18507,1,0.000024,13,0.218336,0.250065,77377.495409,0.114694,0.005537
107040,107040,,4,5,9,4,5,9,0.00033,0.000188,0,18508,1,0.000015,14,0.183882,0.201845,2901.201634,0.319444,0.001052
111119,111119,,10,28,38,10,28,38,0.000647,0.018801,0,18510,2,0.000015,18,0.218177,0.252639,24308.230375,0.11522,0.002349
107149,107149,,15,8,23,15,8,23,0.000357,0.000573,0,18509,23,0.000026,14,0.185351,0.204762,58918.688601,0.102767,0.004236
201226,201226,,8,25,33,8,25,33,0.001492,0.016008,0,18527,1,0.000014,14,0.183703,0.207509,34112.734446,0.150568,0.002559
107186,107186,,14,13,27,14,13,27,0.001288,0.006477,0,18518,1,0.00002,14,0.192739,0.215908,4821.967849,0.18661,0.003867
108192,108192,,6,7,13,6,7,13,0.000373,0.000045,0,18525,1,0.000014,17,0.178881,0.196027,3448.717764,0.198718,0.001487
109067,109067,,10,27,37,10,27,37,0.000407,0.015233,0,18526,1,0.000018,14,0.18394,0.203836,14740.965834,0.102853,0.002562
201112,201112,,15,33,48,15,33,48,0.00177,0.017101,0,18524,1,0.000021,13,0.196061,0.219555,106005.936996,0.114362,0.005921
203115,203115,,6,8,14,6,8,14,0.000395,0.005791,0,18528,1,0.000015,15,0.172207,0.193621,6792.151511,0.153846,0.001421
206068,206068,,5,17,22,5,17,22,0.000393,0.015565,0,18591,1,0.000012,14,0.192938,0.214896,592.180371,0.246753,0.001149
205131,205131,,27,66,93,27,66,93,0.00246,0.023646,0,18590,1,0.000024,13,0.224604,0.258114,199681.70724,0.073165,0.006771
106150,106150,,0,8,8,0,8,8,0,0.000053,0,18592,2,0.00001,14,0.167011,0.183364,0,0.232143,0
106152,106152,,2,5,7,2,5,7,0.000015,0.000005,0,18594,15,0.000011,14,0.162264,0.174047,335.319395,0.166667,0.000445
106085,106085,,3,0,3,3,0,3,0,0,0,18593,15,0.000018,0,0,0,0,0.166667,0.000717
106153,106153,,9,11,20,9,11,20,0.00205,0.001444,0,18595,1,0.000012,16,0.182528,0.209638,2303.012428,0.171053,0.002224
106155,106155,,26,44,70,26,44,70,0.000993,0.004209,0,18567,0,0.000019,13,0.219582,0.251844,65219.676054,0.105383,0.008608
9511048,9511048,,1,22,23,1,22,23,0.000049,0.003852,0,18566,0,0.00001,13,0.216235,0.269727,49.47145,0.272727,0.000428
106156,106156,,0,1,1,0,1,1,0,0,0,18596,30,0.00001,17,0.137656,0.146472,0,0,0
106157,106157,,39,11,50,39,11,50,0.000748,0.000353,0,17802,3,0.000031,13,0.211396,0.231628,155188.065914,0.158776,0.011601
106158,106158,,0,7,7,0,7,7,0,0.00009,0,18598,41,0.00001,8,0.193706,0.219451,0,0.166667,0
9907185,9907185,,3,5,8,3,5,8,0.000002,0.000096,0,18597,41,0.000013,7,0.233887,0.258847,432.370491,0.160714,0.000658
106159,106159,,3,14,17,3,14,17,0.000046,0.002926,0,18599,30,0.000012,14,0.194886,0.214471,2123.485257,0.25,0.000718
106160,106160,,40,26,66,40,26,66,0.005182,0.003318,0,17856,1,0.000025,14,0.209118,0.23431,15513.542896,0.141492,0.011675
106161,106161,,5,32,37,5,32,37,0.000571,0.022952,0,18515,1,0.000012,13,0.218501,0.253814,3639.184215,0.160661,0.001291
106162,106162,,20,25,45,20,25,45,0.001325,0.001823,0,16215,10,0.00002,12,0.204729,0.229072,14627.654866,0.187374,0.007532
106163,106163,,0,10,10,0,10,10,0,0.000811,0,18600,25,0.00001,14,0.184798,0.205155,0,0.166667,0
106164,106164,,1,15,16,1,15,16,0.000001,0.001143,0,18601,13,0.00001,12,0.201545,0.227049,4647.933463,0.116667,0.000219
106165,106165,,2,20,22,2,20,22,0.000172,0.00442,0,18602,2,0.00001,14,0.189285,0.212082,1129.743604,0.140693,0.000557
106166,106166,,1,3,4,1,3,4,0,0,0,18603,23,0.000011,16,0.134879,0.146997,0,0.333333,0.000219
106167,106167,,2,17,19,2,17,19,0.000002,0.003169,0,18604,2,0.000014,14,0.21004,0.23415,16025.918394,0.222222,0.000438
106168,106168,,0,7,7,0,7,7,0,0.000153,0,18605,5,0.00001,18,0.163483,0.175943,0,0.071429,0
106170,106170,,2,7,9,2,7,9,0.000001,0.001523,0,18606,30,0.000013,14,0.189328,0.207337,2119.373771,0.263889,0.000452
106171,106171,,13,42,55,13,42,55,0.001892,0.014942,0,16151,1,0.000017,13,0.223167,0.256355,145915.897962,0.087205,0.004281
106172,106172,,0,20,20,0,20,20,0,0.000158,0,18607,13,0.00001,15,0.158848,0.178268,0,0.263158,0
106173,106173,,3,7,10,3,7,10,0.000019,0.000013,0,18608,23,0.000017,21,0.151679,0.170414,28842.65958,0.077778,0.000898
106177,106177,,12,37,49,12,37,49,0.00051,0.018112,0,16212,10,0.000016,13,0.215191,0.240782,333574.660919,0.133078,0.005589
106178,106178,,4,77,81,4,77,81,0.000217,0.016203,0,18609,2,0.000011,14,0.242913,0.286299,14457.662181,0.08858,0.00098
106180,106180,,8,45,53,8,45,53,0.000097,0.003198,0,17821,30,0.00002,13,0.223188,0.248333,54273.996335,0.137881,0.002107
106181,106181,,6,23,29,6,23,29,0.000067,0.002699,0,18610,30,0.000017,13,0.213708,0.235001,39324.087943,0.149015,0.001614
110057,110057,,23,5,28,23,5,28,0.000451,0.000816,0,18611,30,0.000029,14,0.18194,0.198846,22516.73984,0.051587,0.005719
111122,111122,,7,6,13,7,6,13,0.000127,0.000803,0,18614,30,0.000015,12,0.188469,0.205199,2932.377698,0.128205,0.001719
108045,108045,,17,11,28,17,11,28,0.000301,0.00115,0,18612,30,0.000027,13,0.188662,0.206687,9364.901109,0.124339,0.004203
111049,111049,,3,8,11,3,8,11,0.000031,0.000843,0,18613,30,0.000014,14,0.185747,0.204268,3217.22034,0.163636,0.000745
106182,106182,,6,10,16,6,10,16,0.000002,0.000052,0,18615,52,0.000016,14,0.155754,0.170294,4922.794879,0.229167,0.001354
106183,106183,,1,5,6,1,5,6,0.000111,0.002172,0,18616,4,0.000011,18,0.143979,0.160033,258.81955,0.1,0.000219
106186,106186,,14,41,55,14,41,55,0.001278,0.010601,0,18573,1,0.000017,14,0.216898,0.246026,43418.035874,0.155219,0.003857
106187,106187,,2,22,24,2,22,24,0.000021,0.001248,0,18617,3,0.000011,12,0.203299,0.223867,896.703583,0.195652,0.000466
106188,106188,,7,21,28,7,21,28,0.000055,0.001055,0,18618,23,0.000015,13,0.212854,0.23531,27266.678814,0.124339,0.001693
106189,106189,,2,29,31,2,29,31,0.000088,0.003168,0,18619,30,0.000011,12,0.205412,0.228673,2568.529714,0.136559,0.000569
211074,211074,,1,27,28,1,27,28,0.000039,0.020135,0,18645,1,0.00001,14,0.214041,0.249377,894.669212,0.166667,0.000226
110173,110173,,12,56,68,12,56,68,0.000877,0.023291,0,18644,2,0.000015,13,0.217091,0.249857,78098.590341,0.104039,0.002903
201253,201253,,39,226,265,39,226,265,0.00753,0.045228,0,18558,1,0.000026,12,0.245843,0.290217,435206.106086,0.048671,0.010125
205061,205061,,3,28,31,3,28,31,0.000809,0.019154,0,18640,1,0.000011,13,0.204786,0.23044,1694.401633,0.226882,0.000723
106192,106192,,14,23,37,14,23,37,0.001004,0.018692,0,18646,4,0.000021,13,0.204438,0.228948,14293.039794,0.137387,0.004151
106193,106193,,13,21,34,13,21,34,0.00022,0.007144,0,18647,26,0.00002,12,0.197159,0.219164,14947.578727,0.146168,0.002941
9301006,9301006,,4,1,5,4,1,5,0.00007,0,0,5403,26,0.000019,1,1,1,227.555669,0.05,0.001033
106195,106195,,3,38,41,3,38,41,0.000391,0.003005,0,18648,3,0.000011,14,0.195531,0.219116,4644.440919,0.146341,0.000701
106196,106196,,0,12,12,0,12,12,0,0.00089,0,18650,30,0.00001,14,0.194886,0.214473,0,0.113636,0
9710086,9710086,,1,8,9,1,8,9,0.00001,0.000142,0,18649,28,0.000011,13,0.186085,0.211333,38.729558,0.208333,0.000219
106198,106198,,0,1,1,0,1,1,0,0.000152,0,18651,30,0.00001,14,0.153741,0.163861,0,0,0
106199,106199,,4,10,14,4,10,14,0.000074,0.000021,0,18652,23,0.000015,16,0.160273,0.174604,14489.821161,0.208791,0.000909
106202,106202,,4,16,20,4,16,20,0.000634,0.016605,0,18653,41,0.000011,13,0.179049,0.200686,266.563419,0.336842,0.000938
106204,106204,,0,2,2,0,2,2,0,0.000002,0,18654,10,0.00001,6,0.241935,0.297222,0,0.5,0
106205,106205,,18,19,37,18,19,37,0.000228,0.003441,0,18655,30,0.000019,12,0.219649,0.242927,34295.571983,0.127628,0.004487
106207,106207,,5,8,13,5,8,13,0.000003,0.000132,0,18656,6,0.000013,12,0.179486,0.196915,85585.663125,0.160256,0.001188
106208,106208,,0,1,1,0,1,1,0,0.000001,0,18657,2,0.00001,19,0.10908,0.117892,0,0,0
106209,106209,,32,27,59,32,27,59,0.00346,0.003641,0,16018,8,0.000025,13,0.207748,0.23477,54002.21972,0.078317,0.011692
106210,106210,,0,13,13,0,13,13,0,0.000525,0,18658,2,0.00001,16,0.171483,0.19047,0,0.160256,0
106211,106211,,2,43,45,2,43,45,0.000003,0.00062,0,18659,13,0.000011,13,0.189615,0.214542,22556.377219,0.154545,0.000451
106212,106212,,7,28,35,7,28,35,0.000286,0.002574,0,18660,2,0.000013,16,0.205943,0.233583,10867.942165,0.143697,0.001676
106213,106213,,19,47,66,19,47,66,0.000445,0.001864,0,17820,30,0.000017,13,0.221252,0.246289,43974.49632,0.135431,0.00505
106214,106214,,2,6,8,2,6,8,0.000001,0.000035,0,18661,30,0.000013,14,0.168383,0.181629,167.747473,0.214286,0.000458
106215,106215,,5,11,16,5,11,16,0.000012,0.000021,0,18662,23,0.000013,14,0.162184,0.174363,180.637475,0.283333,0.001168
106216,106216,,0,3,3,0,3,3,0,0.000023,0,18663,8,0.00001,15,0.135689,0.144987,0,0.5,0
106217,106217,,7,30,37,7,30,37,0.00077,0.002313,0,17832,30,0.000012,12,0.218088,0.243368,9673.875606,0.160661,0.002369
106218,106218,,3,23,26,3,23,26,0.000249,0.004338,0,18664,2,0.000011,12,0.213473,0.243414,9601.719209,0.236923,0.000697
106220,106220,,11,7,18,11,7,18,0.000523,0.000393,0,18665,25,0.000017,15,0.182394,0.201243,8833.137596,0.238562,0.002821
106221,106221,,0,2,2,0,2,2,0,0,0,18668,41,0.00001,17,0.122884,0.13119,0,0.5,0
9904015,9904015,,5,4,9,5,4,9,0.000001,0.000016,0,18666,41,0.000037,16,0.140045,0.152693,14981.979073,0.152778,0.001122
9906009,9906009,,4,1,5,4,1,5,0.000001,0,0,18667,41,0.000019,17,0.122863,0.131017,0,0.2,0.000877
106222,106222,,0,10,10,0,10,10,0,0.001033,0,18669,13,0.00001,14,0.184485,0.208463,0,0.311111,0
106223,106223,,4,14,18,4,14,18,0.000003,0.000021,0,18670,6,0.000012,13,0.154729,0.168108,40670.187092,0.199346,0.000936
106225,106225,,0,4,4,0,4,4,0,0.000975,0,18671,25,0.00001,16,0.18117,0.200257,0,0.416667,0
106226,106226,,2,3,5,2,3,5,0,0.000025,0,18673,5,0.000014,13,0.135114,0.158816,2,0.2,0.000438
104165,104165,,2,0,2,2,0,2,0,0,0,18672,5,0.000016,0,0,0,0,0.5,0.000451
106227,106227,,7,8,15,7,8,15,0.000066,0.000063,0,18675,23,0.000022,14,0.141235,0.154484,4395.469558,0.119048,0.001632
9508114,9508114,,6,1,7,6,1,7,0.000001,0,0,18674,23,0.000032,1,1,1,7.97619,0.190476,0.001428
108129,108129,,8,13,21,8,13,21,0.000016,0.000024,0,18676,23,0.000018,18,0.136405,0.154383,15726.040689,0.116667,0.001835
106228,106228,,2,8,10,2,8,10,0.000193,0.000274,0,18677,25,0.000011,16,0.185647,0.205232,560.422748,0.2,0.000478
106231,106231,,3,32,35,3,32,35,0.000117,0.002019,0,18678,3,0.000011,12,0.202113,0.223283,430.75353,0.194958,0.001073
106232,106232,,0,15,15,0,15,15,0,0.001654,0,18679,30,0.00001,15,0.198814,0.222637,0,0.138095,0
106233,106233,,1,12,13,1,12,13,0,0.001648,0,18682,25,0.000019,13,0.189525,0.208852,10176,0.134615,0.000219
9405154,9405154,,1,0,1,1,0,1,0.000019,0,0,18681,25,0.000011,0,0,0,0,0,0.000226
9408058,9408058,,1,0,1,1,0,1,0.000019,0,0,18680,25,0.000011,0,0,0,0,0,0.000226
106234,106234,,7,48,55,7,48,55,0.000625,0.013757,0,16271,52,0.000013,12,0.238692,0.272878,50271.444985,0.087879,0.002041
106235,106235,,9,9,18,9,9,18,0.000655,0.001713,0,16243,0,0.000046,15,0.180997,0.20356,44814.31617,0.160131,0.00234
106236,106236,,1,2,3,1,2,3,0.000011,0.000001,0,18683,23,0.000012,2,0.666667,0.75,0.333333,0.333333,0.000219
106237,106237,,4,10,14,4,10,14,0.000173,0.001577,0,17775,25,0.000012,13,0.199161,0.218751,7054.276205,0.230769,0.001095
106238,106238,,18,27,45,18,27,45,0.003246,0.018234,0,18514,1,0.000015,15,0.21095,0.242868,13568.117412,0.242424,0.005195
106239,106239,,3,3,6,3,3,6,0.000012,0.000001,0,18684,23,0.000014,19,0.124275,0.135581,202.368531,0.2,0.000732
106240,106240,,1,13,14,1,13,14,0.000014,0.001106,0,18685,25,0.00001,18,0.188076,0.211692,28.033019,0.21978,0.000219
9310016,9310016,,1,6,7,1,6,7,0.000008,0.000313,0,1080,13,0.000012,2,0.75,0.833333,68.82183,0.071429,0.000345
106242,106242,,12,9,21,12,9,21,0.000524,0.000302,0,15877,3,0.000015,17,0.178585,0.196023,12595.074651,0.211905,0.00346
106243,106243,,1,24,25,1,24,25,0.000039,0.000823,0,18686,25,0.00001,13,0.208618,0.231584,455.250992,0.26,0.000246
106244,106244,,2,8,10,2,8,10,0.000053,0.00104,0,18687,2,0.000011,13,0.205045,0.226305,3149.229001,0.188889,0.000471
106245,106245,,14,19,33,14,19,33,0.000466,0.0023,0,18688,25,0.000015,13,0.199486,0.220771,12441.03098,0.199811,0.003514
106246,106246,,0,21,21,0,21,21,0,0.003412,0,18689,4,0.00001,12,0.177724,0.203362,0,0.17381,0
106248,106248,,0,3,3,0,3,3,0,0.000126,0,18690,2,0.00001,15,0.176094,0.18982,0,0.5,0
106249,106249,,15,31,46,15,31,46,0.002483,0.002433,0,18513,1,0.000014,16,0.184336,0.209683,1616.95037,0.192271,0.004351
106250,106250,,1,5,6,1,5,6,0,0.000001,0,18691,23,0.000012,17,0.137374,0.152186,1,0.2,0.000226
9404119,9404119,,5,1,6,5,1,6,0,0,0,13113,23,0.000028,1,1,1,68.844322,0.033333,0.001123
106252,106252,,0,6,6,0,6,6,0,0.00001,0,18692,23,0.00001,18,0.129873,0.143436,0,0.233333,0
106253,106253,,2,26,28,2,26,28,0.000232,0.005479,0,18693,2,0.000011,16,0.222212,0.256945,6351.605045,0.153439,0.00048
106254,106254,,1,3,4,1,3,4,0,0.000002,0,18695,4,0.000015,2,0.8,0.875,8,0.083333,0.000226
9904177,9904177,,2,1,3,2,1,3,0,0.000002,0,18694,4,0.000017,1,1,1,0,0.333333,0.000445
106255,106255,,8,26,34,8,26,34,0.001471,0.019904,0,18570,25,0.000014,19,0.211365,0.248666,26183.533476,0.127451,0.001916
106256,106256,,15,27,42,15,27,42,0.000147,0.006773,0,18696,25,0.000024,12,0.204912,0.228706,139622.21529,0.085947,0.003733
106257,106257,,1,4,5,1,4,5,0,0.000037,0,18697,1,0.000012,13,0.188474,0.203933,558.914894,0.3,0.000219
106258,106258,,5,11,16,5,11,16,0.000036,0.000028,0,18698,20,0.000013,13,0.169561,0.183647,344.853802,0.170833,0.001122
106260,106260,,3,46,49,3,46,49,0.000304,0.008978,0,18700,15,0.000012,12,0.22353,0.250686,119542.752577,0.034864,0.000751
9202080,9202080,,2,0,2,2,0,2,0.000177,0,0,18699,15,0.000011,0,0,0,0,0,0.000466
9206040,9206040,,3,0,3,3,0,3,0.000009,0,0,9355,9,0.000019,0,0,0,0,0.166667,0.000684
106261,106261,,9,14,23,9,14,23,0.000757,0.001599,0,17718,25,0.000018,15,0.188415,0.207621,10599.991116,0.166008,0.002718
106262,106262,,2,23,25,2,23,25,0.000048,0.001697,0,18701,52,0.000011,14,0.201213,0.226559,2373.648494,0.125,0.000516
106263,106263,,2,17,19,2,17,19,0.000069,0.00284,0,18702,25,0.000011,15,0.189872,0.212617,0,0.336257,0.000445
106264,106264,,2,9,11,2,9,11,0,0.000003,0,18703,23,0.000012,18,0.122173,0.135642,2370.770662,0.218182,0.000451
106265,106265,,4,10,14,4,10,14,0.000337,0.009183,0,18704,1,0.000012,17,0.206294,0.238279,4039.247931,0.153846,0.001054
106266,106266,,6,23,29,6,23,29,0.000415,0.002975,0,18705,10,0.000012,13,0.203844,0.230597,1888.978552,0.1367,0.002028
106268,106268,,0,17,17,0,17,17,0,0.00001,0,18706,6,0.00001,13,0.147073,0.168702,0,0.242647,0
106271,106271,,5,9,14,5,9,14,0.000217,0.001766,0,18707,25,0.000011,15,0.188824,0.211019,1271.480968,0.214286,0.001311
106272,106272,,0,6,6,0,6,6,0,0.000032,0,18709,52,0.00001,15,0.108919,0.128126,0,0.1,0
9503176,9503176,,3,3,6,3,3,6,0.000008,0.000016,0,18708,13,0.000014,6,0.27619,0.359195,131.315864,0.033333,0.000718
106273,106273,,3,4,7,3,4,7,0,0.000004,0,18710,6,0.000017,15,0.156175,0.167642,26192.056181,0.261905,0.000677
106274,106274,,21,13,34,21,13,34,0.001379,0.001596,0,18711,3,0.000022,12,0.195836,0.218004,19957.184293,0.108734,0.00671
106275,106275,,3,15,18,3,15,18,0.000002,0.000008,0,18712,6,0.000011,16,0.121986,0.135997,269.636141,0.150327,0.000677
106276,106276,,5,19,24,5,19,24,0.000571,0.001202,0,17762,8,0.000012,17,0.189329,0.212085,5907.159171,0.11413,0.001451
106277,106277,,0,4,4,0,4,4,0,0.000008,0,18713,30,0.00001,12,0.178365,0.205646,0,0.083333,0
106278,106278,,1,10,11,1,10,11,0.000011,0.000348,0,18716,30,0.00001,14,0.175,0.192775,141.479186,0.127273,0.000219
9803073,9803073,,2,1,3,2,1,3,0.000004,0,0,18715,3,0.000013,13,0.15959,0.173312,0,0.333333,0.000445
9812191,9812191,,1,5,6,1,5,6,0.000004,0.000434,0,18714,4,0.000011,15,0.159036,0.177547,118.019444,0.2,0.000226
106279,106279,,3,4,7,3,4,7,0.000023,0.000034,0,18717,30,0.000012,14,0.168368,0.181498,607.249118,0.238095,0.000671
106280,106280,,11,16,27,11,16,27,0.000143,0.000118,0,18718,30,0.000016,14,0.188664,0.205003,14636.69597,0.084046,0.002522
106281,106281,,4,45,49,4,45,49,0.000066,0.004009,0,18719,30,0.000012,14,0.209154,0.234789,11384.911402,0.108418,0.001015
106282,106282,,7,21,28,7,21,28,0.000137,0.003911,0,17713,0,0.000015,13,0.199371,0.222476,10133.845882,0.189153,0.002009
106283,106283,,3,2,5,3,2,5,0,0,4,18721,16,0.000033,2,0.625,0.7,11,0.15,0.00067
10089,10089,,1,0,1,1,0,1,0,0,4,18720,16,0.000025,0,0,0,0,0,0.000239
106284,106284,,0,16,16,0,16,16,0,0.015918,0,18722,1,0.00001,18,0.185664,0.207478,0,0.079167,0
106285,106285,,8,36,44,8,36,44,0.000152,0.004568,0,18723,0,0.000014,13,0.214239,0.242635,22623.5349,0.140592,0.002022
106286,106286,,1,13,14,1,13,14,0.000053,0.017446,0,18724,1,0.00001,15,0.2056,0.239533,1295.877102,0.274725,0.000287
106287,106287,,3,7,10,3,7,10,0,0.000017,0,18725,9,0.000013,14,0.16007,0.174602,77.93731,0.277778,0.000664
107001,107001,,6,4,10,6,4,10,0.000017,0.000011,0,18726,52,0.000016,14,0.151769,0.164085,2305.176075,0.233333,0.001408
107002,107002,,19,21,40,19,21,40,0.001015,0.010447,0,16230,3,0.000018,17,0.197775,0.222827,30144.10952,0.141026,0.006068
107003,107003,,0,1,1,0,1,1,0,0,21,18728,43,0.00001,1,1,1,0,0,0
9911009,9911009,,1,0,1,1,0,1,0,0,21,18727,43,0.000019,0,0,0,0,0,0.000219
107005,107005,,0,9,9,0,9,9,0,0.000005,0,18729,5,0.00001,17,0.119968,0.137132,0,0.180556,0
107006,107006,,2,3,5,2,3,5,0,0,0,18730,23,0.00002,22,0.138895,0.156712,6296.895854,0,0.000438
107007,107007,,16,31,47,16,31,47,0.00036,0.002156,0,17800,3,0.000018,17,0.197814,0.222766,12207.529972,0.219704,0.005705
107008,107008,,0,2,2,0,2,2,0,0,0,18731,52,0.00001,1,1,1,0,0.5,0
107009,107009,,1,6,7,1,6,7,0.000005,0.000162,0,18732,13,0.000011,17,0.171854,0.192258,748.224067,0.119048,0.000272
107010,107010,,1,15,16,1,15,16,0.000001,0.001765,0,18733,30,0.000011,13,0.193852,0.212751,1418.505643,0.145833,0.000226
107011,107011,,13,10,23,13,10,23,0.001171,0.001524,0,18734,25,0.000018,16,0.183681,0.205703,5115.859731,0.187747,0.003333
107012,107012,,3,8,11,3,8,11,0.00006,0.001091,0,18735,28,0.000013,12,0.167251,0.18265,7098.564997,0.090909,0.000697
9812249,9812249,,1,7,8,1,7,8,0.000022,0.000287,0,10969,28,0.00001,15,0.177751,0.203962,1279.45416,0.142857,0.000243
107013,107013,,1,2,3,1,2,3,0,0,0,18736,23,0.000012,15,0.120013,0.130704,8.5,0.166667,0.000219
9703112,9703112,,3,1,4,3,1,4,0.000004,0.000001,0,15153,15,0.00002,3,0.428571,0.5,22.833333,0,0.000677
107014,107014,,1,15,16,1,15,16,0.000039,0.004446,0,18737,30,0.00001,14,0.184239,0.203299,28.116494,0.166667,0.000219
107015,107015,,6,15,21,6,15,21,0.000001,0.00001,0,18738,6,0.000014,13,0.172466,0.193118,17835.106657,0.1,0.001407
9602053,9602053,,1,0,1,1,0,1,0.000005,0,0,9055,6,0.000011,0,0,0,0,0,0.000255
9704212,9704212,,1,1,2,1,1,2,0.000005,0.000005,0,9054,6,0.000011,1,1,1,85.643491,0,0.000255
107016,107016,,2,29,31,2,29,31,0.000081,0.00446,0,18739,4,0.000011,14,0.168743,0.197517,714.2189,0.190323,0.000465
107017,107017,,2,4,6,2,4,6,0,0,0,18740,20,0.000012,4,0.423077,0.583333,0,0.5,0.000445
107018,107018,,0,25,25,0,25,25,0,0.001163,0,18741,25,0.00001,16,0.191915,0.215431,0,0.178333,0
107019,107019,,2,4,6,2,4,6,0,0.000001,0,18742,5,0.000015,17,0.122429,0.136746,1704.05,0.2,0.000438
107021,107021,,2,3,5,2,3,5,0,0.000001,0,18743,5,0.000015,18,0.10931,0.12025,9.916667,0.2,0.000438
107023,107023,,0,13,13,0,13,13,0,0.000004,0,18744,5,0.00001,16,0.107006,0.117917,0,0.262821,0
107024,107024,,2,12,14,2,12,14,0,0.000005,0,18745,5,0.000014,16,0.15078,0.163042,29866.574392,0.126374,0.000445
107025,107025,,9,28,37,9,28,37,0.000297,0.005363,0,17773,25,0.000014,17,0.206494,0.243848,13659.163111,0.143393,0.002222
107027,107027,,1,3,4,1,3,4,0,0,0,18746,20,0.000012,3,0.482759,0.559524,0.5,0.25,0.000219
107028,107028,,6,14,20,6,14,20,0.00105,0.00302,0,18559,1,0.000012,12,0.202477,0.22486,1840.639358,0.221053,0.00173
9909040,9909040,,3,12,15,3,12,15,0.000244,0.019527,0,18545,1,0.000011,11,0.225632,0.255106,2049.866426,0.32381,0.00093
107029,107029,,1,11,12,1,11,12,0.000192,0.000081,0,18748,23,0.00001,15,0.15103,0.163625,609.723855,0.136364,0.000226
9205050,9205050,,1,0,1,1,0,1,0.000001,0,0,18747,23,0.000011,0,0,0,0,0,0.000226
9304071,9304071,,5,1,6,5,1,6,0.000138,0.000007,0,7340,23,0.000018,1,1,1,1,0.166667,0.001178
107030,107030,,0,3,3,0,3,3,0,0,0,18749,26,0.00001,17,0.111857,0.128319,0,0,0
107031,107031,,20,25,45,20,25,45,0.002794,0.003808,0,16006,8,0.000019,13,0.211503,0.239009,124664.656656,0.113636,0.007716
107067,107067,,21,39,60,21,39,60,0.00281,0.011909,0,16014,8,0.000019,13,0.220075,0.24552,131087.644508,0.119492,0.008365
107183,107183,,2,12,14,2,12,14,0.000308,0.000818,0,18750,8,0.000011,13,0.202662,0.222497,13332.307151,0.197802,0.000763
107032,107032,,0,76,76,0,76,76,0,0.022105,0,18751,1,0.00001,15,0.217829,0.25674,0,0.075965,0
107033,107033,,3,14,17,3,14,17,0.000142,0.002385,0,18752,30,0.000011,13,0.215603,0.238143,4390.767904,0.150735,0.000789
107034,107034,,5,6,11,5,6,11,0.000553,0.00112,0,17724,25,0.000012,14,0.188321,0.207191,616.54526,0.290909,0.001271
107035,107035,,4,17,21,4,17,21,0.000113,0.008858,0,18626,52,0.000012,12,0.204845,0.227423,8821.548204,0.169048,0.001005
9701173,9701173,,7,11,18,7,11,18,0.001099,0.000528,0,18625,41,0.000014,9,0.208946,0.257252,7421.521383,0.133987,0.002261
9606166,9606166,,1,1,2,1,1,2,0.000006,0.000001,0,18624,41,0.000011,1,1,1,0,0.5,0.000275
107036,107036,,20,40,60,20,40,60,0.001733,0.001802,0,18565,0,0.000017,13,0.220562,0.248892,45978.420688,0.139266,0.008155
107038,107038,,0,31,31,0,31,31,0,0.000499,0,18756,4,0.00001,13,0.208521,0.2348,0,0.073118,0
9211020,9211020,,1,0,1,1,0,1,0.000006,0,0,18755,4,0.00001,0,0,0,0,0,0.000219
9503148,9503148,,1,4,5,1,4,5,0.000006,0.000011,0,18754,5,0.00001,2,0.833333,0.9,1.666667,0.15,0.000219
9910049,9910049,,4,16,20,4,16,20,0.000012,0.004755,0,18753,4,0.000013,12,0.191344,0.217397,2131.229221,0.155263,0.000896
9508081,9508081,,1,0,1,1,0,1,0.000013,0,0,5390,4,0.000012,0,0,0,0,0,0.000295
107039,107039,,29,7,36,29,7,36,0.000503,0.000109,0,18757,15,0.000043,15,0.174092,0.186835,33468.698555,0.130952,0.007271
107041,107041,,2,1,3,2,1,3,0.000025,0.000033,0,18758,2,0.000011,15,0.159771,0.17575,0,0.333333,0.000465
107042,107042,,2,1,3,2,1,3,0,0.000018,0,18759,25,0.000019,15,0.16514,0.176931,0,0.5,0.000451
107043,107043,,4,6,10,4,6,10,0.000002,0.000114,0,18761,3,0.00002,14,0.166192,0.178716,30481.156243,0.166667,0.00093
9903009,9903009,,1,0,1,1,0,1,0.000001,0,0,18760,3,0.000013,0,0,0,0,0,0.000246
107044,107044,,21,21,42,21,21,42,0.000906,0.00154,0,18762,0,0.000019,13,0.205725,0.230294,56416.308609,0.117886,0.00671
107045,107045,,5,3,8,5,3,8,0.00003,0.00001,0,18764,5,0.000016,15,0.149091,0.161719,57.093973,0.214286,0.001142
9703042,9703042,,2,0,2,2,0,2,0.00018,0,0,18763,5,0.000016,0,0,0,0,0,0.000471
107046,107046,,18,18,36,18,18,36,0.000201,0.000934,0,18475,3,0.000017,17,0.180361,0.200706,1523.725788,0.211111,0.005533
107047,107047,,0,2,2,0,2,2,0,0,0,18766,22,0.00001,1,1,1,0,0,0
105140,105140,,1,0,1,1,0,1,0,0,0,18765,22,0.000014,0,0,0,0,0,0.000219
107048,107048,,10,10,20,10,10,20,0.000029,0.000004,0,18768,22,0.000017,15,0.162999,0.175474,1733.994042,0.226316,0.002383
9404120,9404120,,10,2,12,10,2,12,0.000027,0.000001,0,18767,22,0.00002,2,0.75,0.833333,0.392857,0.272727,0.00237
9412093,9412093,,2,0,2,2,0,2,0,0,0,11335,22,0.00002,0,0,0,0,0,0.000529
9204059,9204059,,3,0,3,3,0,3,0,0,0,11333,22,0.000039,0,0,0,0,0.333333,0.000727
9403106,9403106,,1,1,2,1,1,2,0,0,0,11336,22,0.000014,1,1,1,0,0.5,0.000274
9507103,9507103,,1,1,2,1,1,2,0,0,0,11334,22,0.000014,1,1,1,0,0.5,0.000274
107049,107049,,2,11,13,2,11,13,0.000231,0.000033,0,16336,5,0.00001,12,0.1649,0.178523,1982.514694,0.076923,0.000563
107050,107050,,4,12,16,4,12,16,0,0.000003,0,18769,6,0.000013,14,0.137869,0.151415,1817.569328,0.220833,0.00089
107052,107052,,0,4,4,0,4,4,0,0.000077,0,18770,0,0.00001,16,0.164677,0.177869,0,0.5,0
107053,107053,,0,9,9,0,9,9,0,0.000117,0,18771,22,0.00001,16,0.15717,0.176117,0,0.125,0
107054,107054,,9,9,18,9,9,18,0.000014,0.000139,0,18772,15,0.00002,14,0.184279,0.198794,23883.769854,0.189542,0.002189
107055,107055,,19,33,52,19,33,52,0.000489,0.001879,0,18773,30,0.00002,14,0.193104,0.214086,15579.303702,0.152715,0.004914
107056,107056,,2,6,8,2,6,8,0,0.000009,0,18774,4,0.000016,13,0.149171,0.166273,1204.584857,0.107143,0.000469
107057,107057,,27,49,76,27,49,76,0.004211,0.010567,0,18588,1,0.00002,14,0.227836,0.259172,147720.787134,0.118421,0.007231
107058,107058,,0,2,2,0,2,2,0,0,0,18776,22,0.00001,2,0.75,0.833333,0,0,0
11150,11150,,1,0,1,1,0,1,0,0,0,18775,22,0.000014,0,0,0,0,0,0.000219
107059,107059,,0,5,5,0,5,5,0,0.000214,0,18777,0,0.00001,15,0.177847,0.192895,0,0.25,0
107060,107060,,3,11,14,3,11,14,0.000278,0.00217,0,18778,1,0.000011,16,0.194703,0.218633,74.576063,0.247253,0.000671
107061,107061,,13,18,31,13,18,31,0.000363,0.001345,0,18779,2,0.000017,13,0.182137,0.204206,17167.642208,0.144086,0.003046
107062,107062,,1,9,10,1,9,10,0.000001,0.000119,0,18780,30,0.000011,13,0.178089,0.192919,268.075683,0.188889,0.000219
107063,107063,,6,25,31,6,25,31,0.000085,0.0004,0,18783,52,0.000012,15,0.191076,0.21153,8340.761976,0.130108,0.001514
9406120,9406120,,3,1,4,3,1,4,0.000206,0.000003,0,18782,52,0.000011,1,1,1,9.921679,0.25,0.000746
9607132,9607132,,4,0,4,4,0,4,0.000005,0,0,18781,26,0.00002,0,0,0,0,0.083333,0.000925
107064,107064,,1,6,7,1,6,7,0,0.000001,0,18784,23,0.000012,17,0.137406,0.152417,4,0.238095,0.000226
107065,107065,,4,20,24,4,20,24,0.000149,0.001352,0,16034,25,0.000011,14,0.199623,0.219427,5932.21376,0.137681,0.001048
107066,107066,,2,15,17,2,15,17,0.000216,0.002835,0,18785,2,0.000011,13,0.189076,0.21131,33.889932,0.352941,0.000465
9804148,9804148,,1,3,4,1,3,4,0.000255,0.000003,0,8411,22,0.00001,2,0.714286,0.8,12102.627139,0,0.000361
107068,107068,,2,14,16,2,14,16,0.000044,0.001975,0,17811,30,0.00001,12,0.206566,0.227676,9498.766899,0.125,0.00074
107069,107069,,0,1,1,0,1,1,0,0,0,18786,23,0.00001,1,1,1,0,0,0
107070,107070,,1,22,23,1,22,23,0.000025,0.000556,0,18787,3,0.00001,14,0.190581,0.207909,1063.169392,0.258893,0.000395
107071,107071,,12,28,40,12,28,40,0.002433,0.017347,0,18541,1,0.000014,16,0.193356,0.216772,15371.91441,0.249359,0.003984
107072,107072,,1,24,25,1,24,25,0.000042,0.004945,0,18788,4,0.00001,13,0.188155,0.214549,12409.325468,0.193333,0.000246
107073,107073,,2,6,8,2,6,8,0,0.000004,0,18789,20,0.000016,2,0.875,0.928571,2.5,0.339286,0.000465
9507155,9507155,,10,3,13,10,3,13,0.000242,0,0,3108,20,0.000034,1,1,1,1692.516638,0.192308,0.002419
9507156,9507156,,3,1,4,3,1,4,0,0,0,3107,20,0.000019,2,0.6,0.666667,2.5,0.333333,0.000772
107074,107074,,4,5,9,4,5,9,0,0.000008,0,18790,23,0.000021,18,0.184321,0.19965,86403.187166,0.208333,0.000956
107075,107075,,0,20,20,0,20,20,0,0.001314,0,18791,3,0.00001,13,0.190516,0.209384,0,0.294737,0
107078,107078,,8,11,19,8,11,19,0.000105,0.000042,0,18792,30,0.00002,14,0.182694,0.196734,16269.886751,0.172515,0.002077
107079,107079,,1,24,25,1,24,25,0.000043,0.003602,0,18793,4,0.00001,14,0.210979,0.244192,139.589867,0.145,0.000232
107080,107080,,3,3,6,3,3,6,0.000002,0.00007,0,18794,17,0.00002,6,0.289855,0.400833,4,0.3,0.000677
107081,107081,,5,113,118,5,113,118,0.000549,0.017056,0,16264,0,0.000012,14,0.233477,0.271035,29724.528119,0.082863,0.001573
107090,107090,,6,57,63,6,57,63,0.000861,0.002818,0,18795,0,0.000011,13,0.21287,0.242058,4761.945497,0.144649,0.001718
107082,107082,,1,11,12,1,11,12,0,0.000005,0,18796,6,0.00001,16,0.136976,0.149941,1624.866674,0.106061,0.000265
107083,107083,,1,19,20,1,19,20,0.000001,0.000998,0,18797,5,0.000011,15,0.190596,0.214292,1688.984504,0.115789,0.000226
107084,107084,,8,35,43,8,35,43,0.001767,0.004174,0,18516,1,0.000012,15,0.213857,0.246487,7770.381867,0.157807,0.002326
107085,107085,,0,7,7,0,7,7,0,0.002163,0,18798,25,0.00001,16,0.168522,0.191328,0,0.142857,0
107086,107086,,15,45,60,15,45,60,0.00055,0.002745,0,17723,25,0.00002,12,0.211611,0.235257,48166.103034,0.10904,0.003534
107087,107087,,4,34,38,4,34,38,0.000138,0.004248,0,17838,30,0.000012,15,0.216915,0.244064,1490.726939,0.181366,0.00095
107088,107088,,8,1,9,8,1,9,0.000438,0.000037,0,16122,8,0.00002,13,0.169734,0.182673,7526.103048,0.013889,0.002155
107089,107089,,1,24,25,1,24,25,0.000001,0.000373,0,18799,5,0.000012,12,0.194315,0.215609,1902.160548,0.103333,0.000219
209034,209034,,19,71,90,19,71,90,0.000407,0.002534,0,19388,3,0.000015,14,0.210851,0.238197,34778.221153,0.156804,0.005222
203211,203211,,109,63,172,109,63,172,0.004014,0.003514,0,18843,3,0.000076,14,0.200766,0.225262,272498.564235,0.090677,0.038289
203265,203265,,96,18,114,96,18,114,0.003185,0.00138,0,18846,3,0.000066,14,0.195418,0.217457,45410.277517,0.130337,0.033186
204008,204008,,67,12,79,67,12,79,0.002088,0.000594,0,18848,3,0.00006,15,0.19808,0.220261,118078.745989,0.184031,0.02517
204070,204070,,54,6,60,54,6,60,0.001386,0.000249,0,18849,3,0.00004,15,0.186603,0.204258,4250.865517,0.263277,0.020163
204084,204084,,49,26,75,49,26,75,0.001335,0.003031,0,18863,3,0.000037,14,0.202652,0.227298,37186.272095,0.193153,0.018115
204140,204140,,43,13,56,43,13,56,0.001155,0.001464,0,18902,3,0.000034,15,0.194363,0.218368,26234.873676,0.249026,0.015721
204143,204143,,80,43,123,80,43,123,0.002133,0.002405,0,18901,3,0.000048,15,0.19809,0.221825,39064.17513,0.134679,0.026409
204150,204150,,44,10,54,44,10,54,0.001469,0.000178,0,18905,3,0.000028,15,0.184195,0.202519,2242.555909,0.25891,0.01507
204187,204187,,44,10,54,44,10,54,0.00123,0.000262,0,18903,3,0.000029,16,0.182033,0.199819,1033.465633,0.273585,0.015586
204198,204198,,3,25,28,3,25,28,0.000116,0.019633,0,19387,1,0.000011,14,0.198501,0.229936,9647.039378,0.166667,0.000921
204203,204203,,24,72,96,24,72,96,0.001173,0.003638,0,19005,3,0.000017,13,0.221458,0.250716,98237.216371,0.083882,0.007965
204204,204204,,41,25,66,41,25,66,0.001102,0.001426,0,18906,3,0.000027,16,0.192657,0.215654,9478.849889,0.224009,0.014176
204252,204252,,25,8,33,25,8,33,0.000713,0.000272,0,18908,3,0.000018,16,0.182,0.199605,70.497516,0.354167,0.008719
205003,205003,,47,20,67,47,20,67,0.0013,0.000697,0,18904,3,0.000028,14,0.200088,0.222535,45191.473072,0.197196,0.015988
205055,205055,,19,14,33,19,14,33,0.000552,0.000283,0,18907,3,0.000017,15,0.188246,0.206718,421.288042,0.354167,0.007174
205085,205085,,41,29,70,41,29,70,0.000993,0.000955,0,19006,3,0.000023,14,0.205368,0.227359,33144.059802,0.219462,0.013372
205098,205098,,39,30,69,39,30,69,0.00096,0.001034,0,18920,3,0.000022,15,0.200875,0.223488,8801.750209,0.217391,0.012692
205121,205121,,41,32,73,41,32,73,0.001473,0.00075,0,19008,3,0.000023,15,0.200147,0.223265,22318.964718,0.190259,0.01303
205140,205140,,20,14,34,20,14,34,0.000559,0.000219,0,19054,3,0.000016,15,0.188906,0.206711,15101.803811,0.335116,0.00688
205146,205146,,29,17,46,29,17,46,0.000724,0.00148,0,19010,3,0.000018,15,0.194159,0.215631,3383.686589,0.28599,0.009514
205179,205179,,34,31,65,34,31,65,0.001092,0.001773,0,19141,3,0.00002,13,0.209651,0.231948,40360.327731,0.231731,0.010772
206102,206102,,19,25,44,19,25,44,0.000334,0.000676,0,19323,3,0.000015,13,0.192103,0.210338,1572.971842,0.287526,0.006148
206212,206212,,22,37,59,22,37,59,0.000697,0.001022,0,19325,3,0.000015,13,0.206203,0.227745,9163.635612,0.25716,0.007096
207105,207105,,45,103,148,45,103,148,0.002144,0.00346,0,19329,3,0.000022,13,0.225982,0.258728,258017.389152,0.070279,0.012659
207119,207119,,32,27,59,32,27,59,0.001408,0.001317,0,19007,3,0.000018,14,0.203448,0.225448,13628.980442,0.193746,0.009384
207146,207146,,18,14,32,18,14,32,0.000596,0.000903,0,19375,3,0.000013,16,0.190509,0.211432,911.496164,0.237903,0.005038
207156,207156,,34,55,89,34,55,89,0.001207,0.001991,0,19330,3,0.00002,14,0.205256,0.230356,31506.702729,0.177222,0.009602
208019,208019,,28,21,49,28,21,49,0.000676,0.000602,0,19009,3,0.00002,15,0.192974,0.213551,7773.851571,0.230442,0.008136
208023,208023,,14,28,42,14,28,42,0.000494,0.002473,0,19334,3,0.000013,15,0.200265,0.223856,9531.799755,0.252613,0.004314
208094,208094,,26,38,64,26,38,64,0.000742,0.001633,0,19342,3,0.000017,15,0.198545,0.221374,9037.854921,0.237351,0.00734
208124,208124,,18,19,37,18,19,37,0.000852,0.00064,0,19331,3,0.000013,15,0.187762,0.207036,519.438199,0.313063,0.005127
208142,208142,,27,124,151,27,124,151,0.001306,0.008791,0,19381,3,0.000016,14,0.21785,0.249149,47363.892626,0.1,0.00748
208217,208217,,13,44,57,13,44,57,0.000358,0.002147,0,19383,3,0.000013,15,0.20158,0.227021,5056.685225,0.179198,0.003744
107091,107091,,18,3,21,18,3,21,0.002593,0.006187,0,15932,8,0.000019,17,0.172341,0.190004,41.414153,0.311905,0.007569
107092,107092,,0,10,10,0,10,10,0,0.00129,0,19389,13,0.00001,15,0.17277,0.199835,0,0.111111,0
107093,107093,,5,12,17,5,12,17,0.000009,0.000108,0,19391,23,0.000012,15,0.164697,0.195425,622.332533,0.165441,0.001197
9906061,9906061,,11,13,24,11,13,24,0.000019,0.000095,0,19390,20,0.000018,15,0.167697,0.200226,5244.736981,0.126812,0.002666
9705073,9705073,,1,9,10,1,9,10,0.000001,0.000017,0,12676,23,0.000011,13,0.151116,0.170437,947.758921,0.133333,0.000275
107095,107095,,0,5,5,0,5,5,0,0.000003,0,19392,17,0.00001,14,0.138002,0.150918,0,0.15,0
107096,107096,,8,20,28,8,20,28,0.000598,0.018667,0,19394,4,0.000016,13,0.2043,0.227656,3772.940874,0.18254,0.002648
9812029,9812029,,3,2,5,3,2,5,0.00044,0.000008,0,19393,4,0.000012,6,0.234375,0.272444,5.781143,0.35,0.000784
9505131,9505131,,1,2,3,1,2,3,0,0.000001,0,4369,17,0.000017,2,0.583333,0.642857,795.50171,0.166667,0.000282
107097,107097,,5,10,15,5,10,15,0.00035,0.001944,0,19215,2,0.000013,15,0.188364,0.212272,3974.33954,0.157143,0.001216
107098,107098,,2,42,44,2,42,44,0.000153,0.001478,0,18828,3,0.00001,14,0.205113,0.228588,33086.583178,0.203488,0.000805
107099,107099,,16,29,45,16,29,45,0.000107,0.000736,0,19259,30,0.000023,13,0.213622,0.237815,47314.441779,0.131313,0.003924
107100,107100,,6,9,15,6,9,15,0.000171,0.000212,0,18582,10,0.000014,16,0.185643,0.206779,2119.788993,0.27619,0.001461
107101,107101,,28,16,44,28,16,44,0.000522,0.000289,0,17803,3,0.000029,14,0.189368,0.205732,32190.564669,0.329281,0.010905
9306029,9306029,,8,1,9,8,1,9,0.000168,0.000005,0,17783,3,0.000034,1,1,1,14.046544,0.166667,0.002786
107102,107102,,5,16,21,5,16,21,0.000856,0.001463,0,18969,1,0.000011,14,0.196135,0.217918,2167.33906,0.192857,0.001285
107103,107103,,5,8,13,5,8,13,0.000278,0.005148,0,16240,2,0.000012,15,0.174313,0.19305,9588.624624,0.147436,0.001264
107104,107104,,4,15,19,4,15,19,0.000008,0.000034,0,19395,23,0.000015,14,0.171821,0.193085,2973.860824,0.093567,0.000916
107105,107105,,1,20,21,1,20,21,0.00022,0.002539,0,17830,30,0.00001,13,0.19754,0.217045,1837.620816,0.133333,0.000933
107106,107106,,15,33,48,15,33,48,0.001045,0.002102,0,17836,30,0.000015,15,0.20339,0.227327,28375.594816,0.175532,0.003788
107107,107107,,0,4,4,0,4,4,0,0.000002,0,19400,28,0.00001,13,0.158145,0.172735,0,0.083333,0
9607152,9607152,,1,2,3,1,2,3,0,0.000002,0,19399,28,0.000012,7,0.218654,0.248085,77.442782,0.333333,0.000219
9701040,9701040,,2,0,2,2,0,2,0,0,0,19396,28,0.000015,0,0,0,0,0,0.000438
9410099,9410099,,2,8,10,2,8,10,0.000024,0.002053,0,19398,4,0.000017,6,0.277344,0.33439,229.942782,0.077778,0.000445
107109,107109,,2,7,9,2,7,9,0,0.000003,0,19402,23,0.000016,23,0.125053,0.140729,12030.850574,0.055556,0.000438
9609231,9609231,,4,8,12,4,8,12,0.000041,0.000027,0,19401,23,0.00002,8,0.235883,0.273424,1046.509517,0.045455,0.00089
107110,107110,,11,33,44,11,33,44,0.00046,0.004425,0,17829,30,0.000015,13,0.212753,0.236031,10476.811386,0.147463,0.003483
9604146,9604146,,3,4,7,3,4,7,0.000005,0.000009,0,6829,30,0.000015,14,0.148402,0.167409,9580.693137,0,0.000737
9607086,9607086,,4,6,10,4,6,10,0.000001,0.000014,0,6827,30,0.000019,3,0.564103,0.628788,242.562707,0.233333,0.00101
9704184,9704184,,3,5,8,3,5,8,0.000001,0.000013,0,6858,30,0.000016,12,0.142405,0.156093,1176.145563,0.178571,0.00071
107111,107111,,2,29,31,2,29,31,0.000093,0.01264,0,19403,1,0.000011,15,0.197373,0.225702,2451.362241,0.129032,0.000644
9601082,9601082,,3,2,5,3,2,5,0.000003,0.000002,0,4424,0,0.000017,4,0.369565,0.436275,12192.639571,0.05,0.000768
107112,107112,,1,7,8,1,7,8,0.000007,0.009901,0,19404,1,0.000012,12,0.224832,0.255156,4748.077016,0.125,0.000219
107113,107113,,3,23,26,3,23,26,0.000608,0.009921,0,19318,13,0.000012,13,0.202354,0.226461,1181.294955,0.212308,0.000832
107114,107114,,3,34,37,3,34,37,0.000202,0.002613,0,19405,4,0.00001,17,0.190363,0.219959,1154.69414,0.196697,0.000859
107116,107116,,17,35,52,17,35,52,0.000341,0.003822,0,16234,3,0.000019,17,0.200648,0.226815,23472.930737,0.121418,0.005126
107117,107117,,2,4,6,2,4,6,0,0,0,19406,6,0.000013,14,0.146486,0.156148,13121.751161,0.166667,0.000458
107118,107118,,4,9,13,4,9,13,0.000008,0.000116,0,19407,52,0.000012,18,0.16429,0.187721,6013.642968,0.166667,0.000974
107119,107119,,20,46,66,20,46,66,0.003565,0.016005,0,18538,1,0.000028,13,0.220161,0.249517,112509.857005,0.086014,0.010278
107120,107120,,5,16,21,5,16,21,0.000004,0.000013,0,19408,23,0.000013,14,0.155309,0.172864,1291.575663,0.295238,0.001148
107121,107121,,7,20,27,7,20,27,0.000121,0.001985,0,17810,30,0.000013,14,0.199745,0.218952,1481.769552,0.254986,0.001842
107122,107122,,0,1,1,0,1,1,0,0,0,19410,9,0.00001,1,1,1,0,0,0
103194,103194,,4,0,4,4,0,4,0,0,0,19409,9,0.000032,0,0,0,0,0.083333,0.000883
107123,107123,,4,14,18,4,14,18,0.000003,0.000835,0,19411,2,0.000016,14,0.177852,0.207298,5164.404635,0.104575,0.000896
107124,107124,,9,24,33,9,24,33,0.000533,0.001038,0,19412,9,0.000013,13,0.200211,0.224414,13614.769723,0.145833,0.002116
107125,107125,,2,2,4,2,2,4,0,0,0,19413,5,0.000015,1,1,1,0,0.5,0.000445
107126,107126,,14,30,44,14,30,44,0.000615,0.003121,0,18858,25,0.000016,13,0.206724,0.230395,33715.213063,0.102537,0.003529
107127,107127,,1,21,22,1,21,22,0.000122,0.002715,0,19414,30,0.00001,14,0.201693,0.225193,6.922746,0.220779,0.000239
107128,107128,,19,13,32,19,13,32,0.000232,0.000493,0,18876,0,0.000028,14,0.180982,0.203962,46497.70868,0.127016,0.004802
107004,107004,,22,0,22,22,0,22,0.000371,0,0,18875,0,0.000053,0,0,0,0,0.106061,0.005662
107129,107129,,0,12,12,0,12,12,0,0.000075,0,19415,30,0.00001,15,0.182073,0.197703,0,0.106061,0
107130,107130,,8,4,12,8,4,12,0.000552,0.000999,0,18885,0,0.000017,16,0.17799,0.195502,10256.34375,0.227273,0.001979
107131,107131,,8,12,20,8,12,20,0.000798,0.003872,0,18622,1,0.000014,14,0.202311,0.233099,6871.701617,0.178947,0.002258
107132,107132,,0,10,10,0,10,10,0,0.002859,0,19416,1,0.00001,12,0.22585,0.255909,0,0.266667,0
107133,107133,,0,6,6,0,6,6,0,0.000012,0,19417,5,0.00001,16,0.119341,0.130165,0,0.133333,0
107136,107136,,8,1,9,8,1,9,0.000044,0.000004,0,19418,0,0.000019,1,1,1,0.75,0.208333,0.001826
107137,107137,,3,16,19,3,16,19,0.000022,0.000113,0,16311,5,0.000012,15,0.157243,0.177173,462.696043,0.122807,0.000679
107138,107138,,64,38,102,64,38,102,0.003113,0.002604,0,18568,0,0.000031,13,0.215172,0.242603,37008.224243,0.151718,0.020927
107140,107140,,10,33,43,10,33,43,0.000735,0.002579,0,16333,5,0.000013,11,0.216468,0.245015,54427.64318,0.059801,0.002506
107141,107141,,3,10,13,3,10,13,0.000109,0.012422,0,16042,25,0.000011,16,0.190776,0.214553,548.782208,0.205128,0.000784
107142,107142,,7,32,39,7,32,39,0.000681,0.006206,0,19419,2,0.000012,13,0.216244,0.242471,4359.641036,0.131579,0.001672
107143,107143,,73,39,112,73,39,112,0.003966,0.00273,0,18564,0,0.000037,14,0.209275,0.238484,55537.943345,0.103604,0.023788
9604183,9604183,,4,11,15,4,11,15,0.000083,0.000483,0,8081,0,0.000012,10,0.212295,0.244373,444.429456,0.247619,0.001025
9704113,9704113,,4,10,14,4,10,14,0.000467,0.000083,0,8083,0,0.000011,12,0.173629,0.197264,1224.039198,0.203297,0.001093
9707249,9707249,,2,21,23,2,21,23,0.000074,0.000619,0,8084,0,0.000011,12,0.189866,0.22276,6.17486,0.197628,0.000564
9708023,9708023,,1,13,14,1,13,14,0.000027,0.000101,0,8082,0,0.00001,11,0.204528,0.237667,59908.476907,0.186813,0.000326
107145,107145,,4,27,31,4,27,31,0.000069,0.004713,0,19420,2,0.000013,16,0.194173,0.224796,12545.98829,0.108602,0.00091
9609043,9609043,,3,7,10,3,7,10,0.000051,0.001541,0,2822,0,0.000016,10,0.200082,0.223649,38080.253952,0.077778,0.000854
107146,107146,,4,6,10,4,6,10,0.000025,0.000025,0,19423,13,0.000015,13,0.160452,0.17495,892.615095,0.111111,0.000943
9612210,9612210,,4,3,7,4,3,7,0.000015,0.000229,0,19422,13,0.000017,10,0.206271,0.234473,2059.274931,0.166667,0.000951
9610182,9610182,,3,4,7,3,4,7,0.000014,0.00001,0,19421,13,0.000017,16,0.157651,0.184275,28.270963,0.238095,0.000704
107147,107147,,10,28,38,10,28,38,0.000392,0.003236,0,19424,30,0.000013,13,0.198064,0.220643,4117.056575,0.179943,0.002465
107148,107148,,9,8,17,9,8,17,0.000266,0.001468,0,19425,25,0.000017,16,0.189319,0.211148,3121.933486,0.180147,0.002215
107151,107151,,0,57,57,0,57,57,0,0.001556,0,19429,4,0.00001,13,0.189912,0.221445,0,0.167607,0
9801187,9801187,,1,19,20,1,19,20,0.000018,0.00065,0,19428,4,0.00001,16,0.168015,0.189753,5.808519,0.278947,0.000219
9812015,9812015,,1,1,2,1,1,2,0.000018,0.000158,0,19427,4,0.00001,10,0.175521,0.20851,0.04,0,0.000219
9904210,9904210,,1,22,23,1,22,23,0.000018,0.001093,0,19426,4,0.00001,14,0.155209,0.174181,8.393942,0.355731,0.000219
107152,107152,,6,69,75,6,69,75,0.000273,0.003919,0,18887,52,0.000011,12,0.22981,0.260852,51769.857898,0.103964,0.001758
107153,107153,,3,35,38,3,35,38,0.000115,0.003314,0,19430,0,0.000011,16,0.201827,0.231836,5255.699704,0.081081,0.000681
107154,107154,,1,3,4,1,3,4,0.000001,0.000018,0,19431,30,0.000011,14,0.185367,0.200581,17.583147,0.416667,0.000233
107155,107155,,3,18,21,3,18,21,0.00011,0.003237,0,19261,30,0.000012,13,0.206105,0.23023,3192.599918,0.114286,0.000726
107216,107216,,6,12,18,6,12,18,0.000253,0.002114,0,19262,30,0.000013,14,0.193317,0.213049,1742.255348,0.267974,0.001509
107156,107156,,3,15,18,3,15,18,0.000149,0.009732,0,19432,25,0.000012,13,0.210467,0.241142,7801.814719,0.245098,0.000717
107157,107157,,1,9,10,1,9,10,0,0.000003,0,19434,26,0.000011,13,0.168373,0.182166,1374.547354,0.122222,0.000219
9209027,9209027,,7,0,7,7,0,7,0.000001,0,0,752,26,0.000048,0,0,0,0,0.166667,0.001788
9705103,9705103,,6,8,14,6,8,14,0.000004,0.000004,0,19433,26,0.000018,6,0.262097,0.329487,610.833637,0.098901,0.001361
107158,107158,,3,7,10,3,7,10,0.000023,0.000017,0,19435,2,0.000013,16,0.136688,0.148437,13813.745749,0.155556,0.000752
107159,107159,,10,15,25,10,15,25,0.000487,0.000401,0,18985,0,0.000015,15,0.182388,0.204765,5193.253139,0.145,0.002713
107161,107161,,1,5,6,1,5,6,0.000001,0.000192,0,19436,28,0.000011,14,0.164567,0.179864,157.553182,0.166667,0.000226
107162,107162,,9,21,30,9,21,30,0.000118,0.000421,0,19437,52,0.000015,15,0.197835,0.220539,17884.769782,0.185057,0.002227
107163,107163,,9,35,44,9,35,44,0.000498,0.012087,0,19061,8,0.000016,13,0.209141,0.234332,32986.905003,0.056025,0.003309
9412232,9412232,,3,5,8,3,5,8,0.000292,0.000481,0,19060,5,0.000011,2,0.857143,0.916667,650.657378,0.142857,0.000741
9612197,9612197,,5,0,5,5,0,5,0.00033,0,0,7393,5,0.000019,0,0,0,0,0.1,0.00122
9912224,9912224,,1,11,12,1,11,12,0.000142,0.002545,0,19059,13,0.00001,14,0.175049,0.204676,189.774421,0.272727,0.000296
9307057,9307057,,3,0,3,3,0,3,0.000013,0,0,1006,5,0.000014,0,0,0,0,0.166667,0.000718
107164,107164,,1,16,17,1,16,17,0.000005,0.000306,0,19439,4,0.00001,14,0.18647,0.205972,1762.400639,0.165441,0.000226
9605038,9605038,,2,0,2,2,0,2,0.000004,0,0,19438,41,0.000022,0,0,0,0,0,0.000458
107165,107165,,2,16,18,2,16,18,0.000272,0.001014,0,19114,3,0.000011,17,0.188159,0.210553,5607.295642,0.088235,0.000461
9908030,9908030,,1,5,6,1,5,6,0.000012,0.000801,0,19113,2,0.00001,13,0.17925,0.200374,122.082824,0.2,0.000232
107166,107166,,89,82,171,89,82,171,0.005088,0.005312,0,18569,0,0.000046,14,0.221305,0.253818,353027.327886,0.078466,0.027606
9409184,9409184,,1,1,2,1,1,2,0,0.000004,0,1717,0,0.000025,2,0.538462,0.571429,919.24676,0,0.000389
9609137,9609137,,1,22,23,1,22,23,0.000003,0.000173,0,4400,22,0.000011,11,0.177371,0.202254,308845.04709,0.065217,0.000293
107167,107167,,3,60,63,3,60,63,0.000359,0.02394,0,17716,0,0.000012,14,0.207299,0.237256,10106.876178,0.204301,0.000788
107168,107168,,8,8,16,8,8,16,0.00011,0.00012,0,19440,30,0.000015,17,0.179423,0.196274,2549.458163,0.195833,0.001833
107170,107170,,1,1,2,1,1,2,0,0,6,19441,24,0.000014,2,0.666667,0.75,0,0.5,0.000219
107171,107171,,1,1,2,1,1,2,0.000001,0,0,19442,5,0.000012,15,0.144429,0.15211,1984.671011,0,0.000219
107172,107172,,6,59,65,6,59,65,0.000127,0.007138,0,17841,30,0.000013,13,0.229414,0.257795,31611.908358,0.137981,0.00141
107173,107173,,12,15,27,12,15,27,0.001544,0.017494,0,15934,8,0.000018,17,0.184272,0.207777,10888.224664,0.115385,0.004839
107174,107174,,2,9,11,2,9,11,0.000104,0.001542,0,19443,25,0.00001,13,0.199672,0.219719,443.778109,0.345455,0.000526
107175,107175,,9,11,20,9,11,20,0.000386,0.001587,0,16037,25,0.000018,16,0.184444,0.206676,5135.501636,0.152632,0.002385
107176,107176,,3,37,40,3,37,40,0.000025,0.003359,0,19444,0,0.000012,13,0.212346,0.238708,15161.056244,0.140385,0.000693
107177,107177,,109,57,166,109,57,166,0.005655,0.005331,0,16221,10,0.000072,14,0.211959,0.24244,385450.762131,0.058379,0.033722
107178,107178,,11,33,44,11,33,44,0.000226,0.006198,0,19445,30,0.000016,13,0.227154,0.255562,43317.117979,0.128436,0.002772
107200,107200,,15,15,30,15,15,30,0.000331,0.003972,0,19446,30,0.000019,14,0.207594,0.231043,23789.037379,0.166667,0.003656
107179,107179,,5,21,26,5,21,26,0.000104,0.000353,0,19447,30,0.000012,17,0.200656,0.223031,3629.213352,0.112308,0.001203
107180,107180,,5,36,41,5,36,41,0.000627,0.023289,0,19285,30,0.000012,12,0.228457,0.259742,21645.063052,0.119512,0.001169
107181,107181,,9,6,15,9,6,15,0.00021,0.001422,0,19448,13,0.000018,15,0.165751,0.185344,2582.072837,0.204762,0.002138
107182,107182,,0,5,5,0,5,5,0,0.000008,0,19449,23,0.00001,13,0.153922,0.180568,0,0.35,0
107184,107184,,3,27,30,3,27,30,0.000139,0.004178,0,19450,30,0.000011,18,0.194699,0.21869,1431.266635,0.226437,0.000658
107185,107185,,11,45,56,11,45,56,0.000444,0.007135,0,19451,2,0.000015,18,0.214481,0.243604,49147.72356,0.095779,0.00256
107187,107187,,1,18,19,1,18,19,0,0.000012,0,19452,23,0.000011,19,0.145274,0.159489,1992.254264,0.22807,0.000219
107188,107188,,2,5,7,2,5,7,0.000001,0.000009,0,19453,26,0.000012,15,0.136298,0.145537,58.597665,0.190476,0.000438
107189,107189,,12,33,45,12,33,45,0.000964,0.003383,0,18627,52,0.000015,12,0.222671,0.253764,25820.522444,0.157576,0.003355
107190,107190,,0,9,9,0,9,9,0,0.000013,0,19454,23,0.00001,15,0.143638,0.159452,0,0.236111,0
107191,107191,,0,11,11,0,11,11,0,0.009455,0,19455,22,0.00001,14,0.17645,0.204481,0,0.127273,0
9406109,9406109,,3,3,6,3,3,6,0,0.000003,0,7335,22,0.000023,4,0.40678,0.46875,361.026081,0.266667,0.000738
9508112,9508112,,2,2,4,2,2,4,0,0.000001,0,7339,22,0.000014,5,0.305882,0.360256,0.333333,0.333333,0.000485
107192,107192,,0,1,1,0,1,1,0,0.000002,0,19456,23,0.00001,2,0.6,0.666667,0,0,0
107193,107193,,6,10,16,6,10,16,0.0005,0.000053,0,19461,4,0.000013,13,0.147923,0.166105,837.393509,0.175,0.001402
9508025,9508025,,14,1,15,14,1,15,0.000796,0.000004,0,14852,4,0.000033,1,1,1,10.44915,0.180952,0.003412
9610208,9610208,,5,5,10,5,5,10,0.000028,0.000031,0,19458,4,0.000016,12,0.167976,0.188622,1880.238203,0.277778,0.00117
9802100,9802100,,8,5,13,8,5,13,0.000499,0.000025,0,19460,4,0.000018,13,0.147834,0.162909,6074.040621,0.205128,0.001895
9908179,9908179,,2,4,6,2,4,6,0.000001,0.000009,0,19457,6,0.00002,8,0.232791,0.269822,558.364206,0.166667,0.000478
9507056,9507056,,6,2,8,6,2,8,0.000049,0.000028,0,14853,4,0.000024,3,0.555556,0.666667,3.5,0.321429,0.001525
9511210,9511210,,5,4,9,5,4,9,0.000047,0.000054,0,14854,4,0.000021,10,0.18226,0.205597,2486.22821,0.277778,0.001251
9609123,9609123,,8,29,37,8,29,37,0.000499,0.003848,0,14857,4,0.000021,11,0.200817,0.239127,30774.619255,0.171171,0.001908
9611025,9611025,,1,4,5,1,4,5,0,0.000021,0,19459,4,0.000013,12,0.168018,0.188526,5716.453544,0.4,0.000273
107194,107194,,4,7,11,4,7,11,0.000021,0.000341,0,19462,1,0.000014,17,0.162187,0.178193,13118.199079,0.363636,0.000929
107195,107195,,5,12,17,5,12,17,0.000133,0.000411,0,19463,52,0.000011,16,0.18969,0.210776,1286.448331,0.209559,0.001296
107196,107196,,6,15,21,6,15,21,0.00001,0.000029,0,19464,20,0.000013,16,0.139734,0.159917,1564.583196,0.116667,0.001416
107197,107197,,7,40,47,7,40,47,0.000355,0.001444,0,18829,3,0.000013,15,0.196289,0.218562,35226.265484,0.212766,0.003149
107198,107198,,7,18,25,7,18,25,0.000239,0.00234,0,19465,25,0.000014,13,0.207592,0.229423,9746.874043,0.155,0.001634
107199,107199,,8,27,35,8,27,35,0.000124,0.003121,0,17842,30,0.000014,13,0.218939,0.24266,20820.926475,0.15042,0.001991
107201,107201,,1,5,6,1,5,6,0.000021,0.001178,0,19466,25,0.00001,18,0.182259,0.201138,19.249854,0.366667,0.000268
107203,107203,,1,7,8,1,7,8,0.000016,0.00031,0,19352,3,0.00001,15,0.1785,0.194203,6.041984,0.196429,0.000233
107204,107204,,13,21,34,13,21,34,0.000271,0.001472,0,19467,25,0.000018,16,0.201278,0.224018,9705.339748,0.171123,0.003155
107205,107205,,1,9,10,1,9,10,0,0.000001,0,19468,22,0.000011,15,0.125062,0.134149,2429.457374,0.333333,0.000219
107206,107206,,1,4,5,1,4,5,0,0.000149,0,19469,13,0.000012,13,0.168629,0.183958,733.586305,0.2,0.000226
107207,107207,,2,7,9,2,7,9,0.000008,0.000059,0,19470,26,0.000012,16,0.180191,0.195806,2042.165737,0.097222,0.000465
107208,107208,,0,12,12,0,12,12,0,0.000025,0,19474,5,0.00001,16,0.144241,0.163066,0,0.25,0
9811039,9811039,,2,5,7,2,5,7,0.000001,0.000001,0,19472,5,0.000011,12,0.142279,0.155143,50.8343,0.261905,0.000465
9910038,9910038,,4,16,20,4,16,20,0.000015,0.000036,0,19473,5,0.000014,16,0.149426,0.170654,6533.625324,0.076316,0.000903
9908037,9908037,,2,5,7,2,5,7,0.000014,0.000024,0,19471,5,0.000011,14,0.147472,0.161896,4765.49734,0.190476,0.000465
107209,107209,,4,8,12,4,8,12,0.00013,0.000343,0,19475,13,0.000012,13,0.175506,0.192493,4150.817877,0.128788,0.000916
107210,107210,,0,6,6,0,6,6,0,0.000007,0,19476,22,0.00001,16,0.128816,0.137495,0,0.133333,0
9402059,9402059,,1,1,2,1,1,2,0,0,0,10007,22,0.000016,2,0.666667,0.75,0,0.5,0.000268
107211,107211,,0,2,2,0,2,2,0,0.000006,0,19477,15,0.00001,4,0.384615,0.491667,0,0.5,0
107212,107212,,11,56,67,11,56,67,0.002142,0.021566,0,18542,1,0.000012,15,0.211894,0.245313,9926.84655,0.211669,0.003094
107213,107213,,0,27,27,0,27,27,0,0.019824,0,19478,1,0.00001,14,0.205748,0.232629,0,0.249288,0
107214,107214,,4,19,23,4,19,23,0.000085,0.002639,0,19479,2,0.000013,15,0.187669,0.211661,7341.673913,0.096838,0.000977
107215,107215,,5,24,29,5,24,29,0.000297,0.003767,0,19003,30,0.000012,13,0.205697,0.228333,6654.837335,0.1367,0.001152
107217,107217,,2,18,20,2,18,20,0.000028,0.001494,0,19480,52,0.000011,16,0.186998,0.208424,1537.887904,0.234211,0.000534
107218,107218,,1,6,7,1,6,7,0.000031,0.001285,0,19481,8,0.00001,14,0.212256,0.238859,875.183741,0.047619,0.000232
107220,107220,,7,29,36,7,29,36,0.0008,0.010638,0,17729,1,0.000016,13,0.22139,0.250373,30548.108129,0.130159,0.00191
107221,107221,,3,6,9,3,6,9,0.000001,0.00001,0,19488,20,0.000011,14,0.147158,0.157026,229.79547,0.180556,0.000716
9906034,9906034,,3,8,11,3,8,11,0,0.000001,0,19485,20,0.000022,11,0.152359,0.182496,708.28634,0.090909,0.000691
9906062,9906062,,1,0,1,1,0,1,0,0,0,19487,20,0.000012,0,0,0,0,0,0.000239
9908158,9908158,,2,6,8,2,6,8,0,0.000001,0,19486,20,0.000012,11,0.152254,0.179983,71.666707,0.142857,0.000459
9312007,9312007,,2,0,2,2,0,2,0,0,0,19484,20,0.000014,0,0,0,0,0.5,0.000471
9712123,9712123,,4,1,5,4,1,5,0,0,0,10083,20,0.000023,11,0.149557,0.168549,523,0.3,0.000936
9712244,9712244,,4,0,4,4,0,4,0,0,0,16897,20,0.00003,0,0,0,0,0.083333,0.000923
9802136,9802136,,3,4,7,3,4,7,0,0,0,10087,20,0.000016,11,0.150685,0.174529,450.880195,0.119048,0.000684
9805035,9805035,,1,2,3,1,2,3,0,0,0,19483,20,0.000012,12,0.130532,0.144658,19,0.166667,0.000239
107222,107222,,3,14,17,3,14,17,0.000064,0.000659,0,19489,0,0.000013,15,0.192578,0.219308,10557.989463,0.202206,0.000724
107223,107223,,5,7,12,5,7,12,0.000107,0.001301,0,19490,25,0.000013,20,0.171223,0.195133,539.782582,0.265152,0.001197
107224,107224,,5,5,10,5,5,10,0.000369,0.010459,0,19201,1,0.000017,18,0.167213,0.187381,6088.1237,0.155556,0.001177
107225,107225,,8,13,21,8,13,21,0.000202,0.001682,0,19491,30,0.000014,15,0.194081,0.212392,5346.391758,0.204762,0.001956
107226,107226,,0,31,31,0,31,31,0,0.001798,0,19492,30,0.00001,15,0.202065,0.225386,0,0.141935,0
107227,107227,,3,24,27,3,24,27,0.000082,0.003471,0,19493,25,0.000012,13,0.198636,0.221255,7603.415955,0.112536,0.000671
107228,107228,,2,9,11,2,9,11,0.000014,0.000796,0,19494,13,0.000012,15,0.183027,0.205584,3467.32038,0.072727,0.000481
107229,107229,,4,21,25,4,21,25,0.000061,0.000425,0,19139,13,0.000012,14,0.17819,0.199999,5225.395314,0.148333,0.000906
9506192,9506192,,2,11,13,2,11,13,0.000006,0.002138,0,19138,13,0.000013,9,0.242448,0.292971,338.068005,0.185897,0.000471
9505147,9505147,,3,6,9,3,6,9,0.00012,0.000838,0,2151,13,0.000012,6,0.307416,0.358755,3902.080547,0.180556,0.000825
107230,107230,,2,1,3,2,1,3,0,0,0,19495,23,0.000016,10,0.172535,0.186344,0,0.333333,0.000458
107231,107231,,1,4,5,1,4,5,0.000007,0.001162,0,19496,3,0.000011,13,0.21115,0.235089,1711.276391,0.05,0.000219
107232,107232,,0,19,19,0,19,19,0,0.001517,0,19497,25,0.00001,14,0.192801,0.216045,0,0.149123,0
107234,107234,,5,27,32,5,27,32,0.000404,0.00165,0,16305,8,0.000011,13,0.194188,0.218288,34242.80024,0.159274,0.001676
9907052,9907052,,1,9,10,1,9,10,0.000019,0.000036,0,16304,5,0.00001,14,0.157713,0.183769,5412.622863,0.244444,0.00026
9811058,9811058,,1,5,6,1,5,6,0,0.000027,0,16303,5,0.000011,7,0.237683,0.258703,204.129301,0.366667,0.000226
107235,107235,,2,1,3,2,1,3,0,0,0,19499,26,0.000012,1,1,1,7,0,0.000452
102068,102068,,1,0,1,1,0,1,0,0,0,19498,26,0.000021,0,0,0,0,0,0.000232
107236,107236,,1,5,6,1,5,6,0,0.00001,0,19500,6,0.000012,20,0.102186,0.109932,4,0.066667,0.000219
204149,204149,,8,16,24,8,16,24,0.000083,0.000404,0,19512,30,0.000015,13,0.208883,0.229873,16061.427137,0.119565,0.001839
107251,107251,,36,62,98,36,62,98,0.001536,0.001659,0,17822,30,0.000025,13,0.22421,0.250168,122897.506473,0.102146,0.009921
108216,108216,,2,15,17,2,15,17,0.000039,0.002164,0,19511,30,0.000011,13,0.213414,0.235762,735.333973,0.113971,0.000498
112127,112127,,6,37,43,6,37,43,0.000095,0.001928,0,19510,30,0.000013,13,0.212695,0.234826,4807.765463,0.151717,0.001388
203260,203260,,11,31,42,11,31,42,0.00008,0.001951,0,19509,30,0.000019,14,0.195686,0.215799,9600.805084,0.0964,0.002529
107238,107238,,9,19,28,9,19,28,0.001835,0.003778,0,16044,8,0.000013,13,0.19244,0.215014,2748.722821,0.284392,0.003542
107239,107239,,10,7,17,10,7,17,0.000017,0.000065,0,19513,23,0.000024,15,0.122615,0.141011,2689.774533,0.084559,0.002291
107240,107240,,0,1,1,0,1,1,0,0,0,19514,22,0.00001,17,0.138815,0.146279,0,0,0
107241,107241,,1,15,16,1,15,16,0.000708,0.001458,0,18563,25,0.00001,14,0.188053,0.208316,7686.502004,0.116667,0.000253
9411031,9411031,,2,1,3,2,1,3,0.000001,0,0,7081,22,0.000012,1,1,1,1669.304405,0.333333,0.000525
9412053,9412053,,1,10,11,1,10,11,0.000001,0.00001,0,7082,22,0.000011,3,0.653846,0.77451,10658.105395,0.136364,0.000298
107243,107243,,9,8,17,9,8,17,0.00075,0.00015,0,19179,1,0.000019,12,0.188864,0.206986,2783.1081,0.220588,0.002308
107244,107244,,4,23,27,4,23,27,0.000106,0.015099,0,19515,25,0.000013,13,0.200444,0.224873,5821.057365,0.119658,0.000972
107245,107245,,12,6,18,12,6,18,0.000104,0.000054,0,19081,0,0.000027,13,0.177783,0.195435,50817.201178,0.091503,0.00285
107246,107246,,4,4,8,4,4,8,0.00002,0.000001,0,19516,26,0.000014,17,0.123225,0.132318,10.264835,0.214286,0.000896
107247,107247,,4,21,25,4,21,25,0.000009,0.000522,0,19521,4,0.000013,15,0.180532,0.201633,3049.020035,0.11,0.000969
9407096,9407096,,5,2,7,5,2,7,0.00001,0.000003,0,1258,4,0.000014,4,0.478261,0.55303,14.317157,0.261905,0.001229
9506089,9506089,,2,26,28,2,26,28,0.000009,0.00008,0,19520,4,0.000011,7,0.287066,0.367617,2070.110132,0.101852,0.000531
9210106,9210106,,2,0,2,2,0,2,0.000003,0,0,3147,4,0.000011,0,0,0,0,0.5,0.000487
9403080,9403080,,4,1,5,4,1,5,0.000002,0.000002,0,15366,22,0.00002,1,1,1,5.742995,0.15,0.000911
9406056,9406056,,5,13,18,5,13,18,0.000004,0.000166,0,3148,4,0.000018,5,0.322222,0.398391,30456.129699,0.156863,0.001257
9410157,9410157,,2,9,11,2,9,11,0.000001,0.000014,0,19517,4,0.000011,6,0.2836,0.326377,46.06318,0.318182,0.000459
9411069,9411069,,1,2,3,1,2,3,0.000001,0.000002,0,19519,22,0.00001,1,1,1,4.742995,0.333333,0.000233
9502058,9502058,,1,8,9,1,8,9,0.000001,0.000029,0,19518,4,0.00001,6,0.279661,0.319697,36.129847,0.291667,0.000233
107248,107248,,1,19,20,1,19,20,0,0.00276,0,19522,6,0.00001,14,0.177153,0.203911,1476.916202,0.107895,0.000219
107250,107250,,2,19,21,2,19,21,0.000053,0.003646,0,19523,30,0.000011,13,0.212782,0.234319,5273.94302,0.138095,0.000465
107252,107252,,1,11,12,1,11,12,0.000007,0.000256,0,19524,1,0.000011,12,0.190287,0.208737,245.400738,0.325758,0.000249
107253,107253,,0,5,5,0,5,5,0,0.00013,0,19525,0,0.00001,15,0.172498,0.189122,0,0.05,0
107255,107255,,4,14,18,4,14,18,0.000015,0.000068,0,19526,15,0.000012,15,0.178285,0.194777,3637.139296,0.124183,0.000938
9505167,9505167,,3,9,12,3,9,12,0.000035,0.000057,0,4530,13,0.000016,7,0.257143,0.293012,24138.354668,0.128788,0.000802
9411076,9411076,,3,7,10,3,7,10,0.000005,0.000123,0,4524,13,0.000017,3,0.413793,0.49537,56.729655,0.155556,0.000723
9505151,9505151,,2,8,10,2,8,10,0.000004,0.000061,0,4525,13,0.000015,7,0.261832,0.296474,180.141485,0.166667,0.00049
107256,107256,,1,4,5,1,4,5,0,0.000003,0,19527,6,0.000011,16,0.157591,0.172203,1761.657428,0.15,0.000219
107257,107257,,7,8,15,7,8,15,0.000091,0.001368,0,19528,25,0.000015,15,0.191623,0.214448,3673.805933,0.238095,0.001626
107258,107258,,0,8,8,0,8,8,0,0.000023,0,19530,4,0.00001,15,0.159927,0.173028,0,0.017857,0
9707101,9707101,,7,1,8,7,1,8,0.000003,0,0,10806,1,0.000032,3,0.5,0.611111,20.5,0.107143,0.001568
9812173,9812173,,1,1,2,1,1,2,0,0.000001,0,19529,30,0.000011,3,0.5,0.566667,5,0,0.000219
9706166,9706166,,5,1,6,5,1,6,0,0,0,8458,1,0.000067,2,0.666667,0.75,16128,0.166667,0.001182
107259,107259,,1,21,22,1,21,22,0.00004,0.005726,0,19531,8,0.000011,18,0.187164,0.213989,2810.27718,0.062771,0.000219
107260,107260,,3,5,8,3,5,8,0.000226,0.000807,0,19533,30,0.000011,13,0.184867,0.20101,1030.034325,0.232143,0.000664
9703202,9703202,,3,5,8,3,5,8,0.000365,0.000053,0,19532,13,0.000014,13,0.170172,0.203149,63.238761,0.267857,0.000684
107261,107261,,12,26,38,12,26,38,0.002433,0.018594,0,17731,1,0.000017,16,0.211061,0.241408,34618.480969,0.188478,0.00379
107262,107262,,1,13,14,1,13,14,0.000328,0.000984,0,16041,25,0.00001,13,0.195033,0.216906,4120.237791,0.153846,0.000513
107263,107263,,1,22,23,1,22,23,0.000034,0.006716,0,19535,0,0.00001,13,0.216999,0.254202,1613.830993,0.094862,0.000226
9308149,9308149,,1,0,1,1,0,1,0.000079,0,0,19534,0,0.00001,0,0,0,0,0,0.000226
107264,107264,,24,13,37,24,13,37,0.000721,0.000582,0,18878,0,0.000019,17,0.173537,0.193905,4773.702321,0.158408,0.00764
107265,107265,,2,22,24,2,22,24,0.000049,0.003749,0,19102,52,0.000011,18,0.215054,0.241488,6577.587801,0.152174,0.000529
107266,107266,,1,2,3,1,2,3,0,0,0,19536,15,0.000014,18,0.138462,0.146321,0.5,0.333333,0.000219
107267,107267,,2,20,22,2,20,22,0.000017,0.002617,0,15931,30,0.000013,13,0.217184,0.239841,163094.233013,0.099567,0.000717
108001,108001,,14,27,41,14,27,41,0.000686,0.00269,0,18628,52,0.000016,12,0.213104,0.236643,6702.692309,0.17622,0.003793
108002,108002,,2,26,28,2,26,28,0.000043,0.002945,0,19100,30,0.000011,14,0.217152,0.241418,13151.507864,0.149471,0.000492
108003,108003,,15,31,46,15,31,46,0.000694,0.002909,0,18857,25,0.000016,16,0.184654,0.208216,4860.885989,0.237198,0.003775
108017,108017,,4,22,26,4,22,26,0.000199,0.002156,0,19120,25,0.000011,17,0.18407,0.20769,13010.987931,0.266154,0.001052
108004,108004,,1,12,13,1,12,13,0,0.00004,0,19537,5,0.00001,17,0.162173,0.177901,4486.886076,0.185897,0.000219
108005,108005,,5,7,12,5,7,12,0.000011,0.000289,0,19079,0,0.000017,13,0.180519,0.198169,4825.655476,0.128788,0.001209
108007,108007,,21,28,49,21,28,49,0.001116,0.003187,0,19538,30,0.000018,13,0.217124,0.241252,14683.475354,0.152636,0.005615
109121,109121,,13,20,33,13,20,33,0.000876,0.001311,0,19540,30,0.000015,13,0.200876,0.221664,2933.844424,0.242424,0.003419
109070,109070,,20,53,73,20,53,73,0.001078,0.006851,0,19539,30,0.000018,12,0.217105,0.243465,37352.525306,0.124239,0.005216
108008,108008,,1,53,54,1,53,54,0.000009,0.007105,0,19541,9,0.00001,12,0.221559,0.250554,1673.097876,0.075472,0.000226
108009,108009,,0,6,6,0,6,6,0,0.008446,0,19542,6,0.00001,12,0.225514,0.255071,0,0.133333,0
108010,108010,,21,17,38,21,17,38,0.000453,0.001556,0,18877,0,0.000024,13,0.183178,0.201539,38325.21836,0.133001,0.005187
108011,108011,,1,17,18,1,17,18,0.000033,0.008243,0,19543,1,0.00001,12,0.205285,0.228543,686.861578,0.20915,0.000239
108014,108014,,0,8,8,0,8,8,0,0.000877,0,19544,30,0.00001,12,0.18828,0.20555,0,0.196429,0
108015,108015,,0,4,4,0,4,4,0,0,0,19546,6,0.00001,15,0.127879,0.134457,0,0,0
106270,106270,,1,0,1,1,0,1,0,0,0,19545,6,0.000012,0,0,0,0,0,0.000219
108016,108016,,8,40,48,8,40,48,0.000788,0.004865,0,19043,1,0.000012,15,0.214002,0.242424,4073.813294,0.162234,0.002089
108018,108018,,1,17,18,1,17,18,0,0.000072,0,19547,20,0.00001,17,0.145456,0.166823,172.03616,0.156863,0.000258
108020,108020,,6,20,26,6,20,26,0.00054,0.020728,0,16168,1,0.000014,13,0.215709,0.24757,14206.08698,0.192308,0.00227
108021,108021,,1,8,9,1,8,9,0,0.000078,0,19548,22,0.000012,14,0.153834,0.173973,5467.879271,0.222222,0.000219
108022,108022,,0,4,4,0,4,4,0,0.000001,0,19549,26,0.00001,17,0.127677,0.136996,0,0.083333,0
9811225,9811225,,5,9,14,5,9,14,0.000002,0.000009,0,14562,26,0.000018,8,0.189189,0.250996,494.037953,0.148352,0.001116
108023,108023,,2,13,15,2,13,15,0.000054,0.002498,0,19550,4,0.00001,16,0.154879,0.171418,1.754212,0.266667,0.000526
108024,108024,,0,4,4,0,4,4,0,0.000022,0,19551,26,0.00001,13,0.15818,0.179024,0,0.25,0
108025,108025,,4,20,24,4,20,24,0.00031,0.019213,0,19552,25,0.000012,12,0.218621,0.249468,14322.754136,0.182971,0.000987
108026,108026,,1,8,9,1,8,9,0,0.000458,0,19553,2,0.000019,15,0.175799,0.192137,9240,0.138889,0.000219
108027,108027,,0,2,2,0,2,2,0,0.000001,0,19554,22,0.00001,12,0.137526,0.155687,0,0,0
108028,108028,,1,9,10,1,9,10,0.000001,0.000036,0,19557,0,0.00001,18,0.160295,0.181313,0,0.211111,0.000219
9606076,9606076,,2,4,6,2,4,6,0.000001,0.001031,0,19556,0,0.000012,9,0.184906,0.21451,29.56227,0.033333,0.000445
9509054,9509054,,4,2,6,4,2,6,0.000055,0.000011,0,4423,0,0.000024,3,0.48,0.541667,169.970186,0.033333,0.000924
9510073,9510073,,1,0,1,1,0,1,0.000012,0,0,19555,0,0.000012,0,0,0,0,0,0.000232
108030,108030,,0,1,1,0,1,1,0,0,0,19559,25,0.00001,1,1,1,0,0,0
101009,101009,,4,0,4,4,0,4,0.000014,0,0,19558,25,0.000027,0,0,0,0,0.083333,0.00089
108031,108031,,1,14,15,1,14,15,0,0.000008,0,19560,20,0.00001,4,0.588235,0.708333,5.148799,0.147619,0.000258
108032,108032,,0,12,12,0,12,12,0,0.001114,0,19561,5,0.00001,15,0.139679,0.159318,0,0.166667,0
108034,108034,,12,11,23,12,11,23,0.000002,0.000001,0,19562,23,0.000019,15,0.144562,0.158652,6323.482884,0.171937,0.002967
108035,108035,,3,18,21,3,18,21,0.000359,0.000549,0,19133,52,0.000011,16,0.164825,0.188566,801.813117,0.221429,0.000939
108036,108036,,3,18,21,3,18,21,0.000335,0.000624,0,16308,5,0.000011,15,0.164838,0.187408,1110.454075,0.202381,0.000823
108037,108037,,0,13,13,0,13,13,0,0.000037,0,19563,52,0.00001,14,0.156513,0.172528,0,0.153846,0
108038,108038,,0,14,14,0,14,14,0,0.000928,0,19564,30,0.00001,14,0.183856,0.203165,0,0.126374,0
108039,108039,,2,9,11,2,9,11,0,0.000003,0,19565,6,0.000012,16,0.157408,0.172512,696.492492,0.209091,0.000484
9704070,9704070,,2,8,10,2,8,10,0.000001,0.00001,0,13270,6,0.000012,12,0.173092,0.196824,15846.910776,0.1,0.000486
108041,108041,,4,11,15,4,11,15,0.000227,0.000511,0,19566,30,0.000012,14,0.177942,0.196582,170.253526,0.395238,0.001132
111102,111102,,16,22,38,16,22,38,0.001424,0.002385,0,19568,30,0.000016,14,0.191597,0.216311,5551.098642,0.158606,0.003765
108070,108070,,8,16,24,8,16,24,0.000987,0.002064,0,19567,30,0.000013,14,0.180824,0.200742,1734.373654,0.266304,0.001981
204240,204240,,11,18,29,11,18,29,0.001057,0.01117,0,19569,30,0.000013,13,0.211877,0.2457,18690.671323,0.173645,0.002556
108042,108042,,3,10,13,3,10,13,0.000008,0.007059,0,19570,4,0.000014,12,0.206289,0.231124,24721.398137,0.198718,0.000703
108043,108043,,8,82,90,8,82,90,0.000612,0.006081,0,18896,3,0.000016,15,0.22917,0.261295,29916.85416,0.093633,0.001952
108044,108044,,27,11,38,27,11,38,0.000432,0.000141,0,16321,52,0.000024,13,0.191323,0.207978,27943.923134,0.115932,0.006968
108046,108046,,2,10,12,2,10,12,0.000011,0.002812,0,19571,2,0.000011,14,0.181048,0.201266,3685.976605,0.075758,0.000438
108047,108047,,0,13,13,0,13,13,0,0.000006,0,19572,23,0.00001,20,0.138079,0.151913,0,0.237179,0
108050,108050,,2,25,27,2,25,27,0.000244,0.000733,0,16302,5,0.00001,16,0.202903,0.233145,11897.308824,0.094017,0.000589
9810050,9810050,,3,17,20,3,17,20,0.000063,0.003703,0,16292,2,0.000012,15,0.186084,0.213414,5823.01118,0.155263,0.000686
108051,108051,,0,25,25,0,25,25,0,0.000046,0,19573,20,0.00001,13,0.171183,0.187408,0,0.17,0
108053,108053,,0,12,12,0,12,12,0,0.000002,0,19574,5,0.00001,16,0.116871,0.130275,0,0.166667,0
108054,108054,,0,6,6,0,6,6,0,0.000425,0,19575,1,0.00001,12,0.190562,0.209132,0,0.366667,0
108055,108055,,11,57,68,11,57,68,0.00052,0.008203,0,17717,0,0.000019,14,0.206151,0.234693,25267.97601,0.170544,0.002786
108056,108056,,2,20,22,2,20,22,0.000056,0.002246,0,19173,25,0.000011,15,0.185741,0.207821,2587.944802,0.192641,0.000539
108057,108057,,3,1,4,3,1,4,0,0,0,19576,6,0.000016,15,0.136461,0.144443,0,0.333333,0.000671
108058,108058,,4,5,9,4,5,9,0.000043,0.00016,0,19577,4,0.000013,13,0.173291,0.187722,7526.455606,0.097222,0.000896
108059,108059,,0,11,11,0,11,11,0,0.000022,0,19578,4,0.00001,16,0.134667,0.151278,0,0.209091,0
9304039,9304039,,6,1,7,6,1,7,0.000004,0.000001,0,1280,4,0.000016,1,1,1,11.4125,0.047619,0.001397
108060,108060,,0,1,1,0,1,1,0,0,0,19579,5,0.00001,1,1,1,0,0,0
108061,108061,,9,8,17,9,8,17,0.000398,0.000013,0,19582,15,0.000026,13,0.172185,0.183527,9679.061796,0.077206,0.002097
9210033,9210033,,2,4,6,2,4,6,0,0.000016,0,19581,15,0.000014,1,1,1,72.27619,0.133333,0.000505
111176,111176,,6,3,9,6,3,9,0.000059,0.000019,0,19583,15,0.000018,14,0.166482,0.177898,2221.912038,0.166667,0.00136
9202022,9202022,,1,0,1,1,0,1,0,0,0,19580,15,0.000013,0,0,0,0,0,0.000233
108062,108062,,2,15,17,2,15,17,0.000016,0.000036,0,19584,23,0.000011,15,0.174026,0.194144,161.669849,0.194853,0.000438
108063,108063,,2,14,16,2,14,16,0,0.000004,0,19585,6,0.000013,14,0.121633,0.1432,1109.392998,0.191667,0.000451
108064,108064,,14,10,24,14,10,24,0.000565,0.000312,0,18633,4,0.000016,15,0.187401,0.206795,7287.403934,0.353261,0.004384
108065,108065,,8,13,21,8,13,21,0.000286,0.002298,0,19586,25,0.000013,17,0.167035,0.187143,2788.99032,0.161905,0.00199
108066,108066,,0,4,4,0,4,4,0,0.000927,0,19591,23,0.00001,12,0.187737,0.203569,0,0.083333,0
9512003,9512003,,1,1,2,1,1,2,0.000011,0,0,19590,4,0.000012,2,0.571429,0.625,4,0,0.000219
9609226,9609226,,1,8,9,1,8,9,0.000011,0.000008,0,19587,23,0.000012,9,0.202985,0.265398,47.620624,0.111111,0.000219
9407177,9407177,,2,3,5,2,3,5,0.000003,0.000052,0,19589,4,0.000021,1,1,1,8,0.05,0.000445
108067,108067,,0,3,3,0,3,3,0,0.000008,0,19593,15,0.00001,9,0.210996,0.242351,0,0,0
104051,104051,,1,0,1,1,0,1,0,0,0,19592,15,0.000013,0,0,0,0,0,0.000219
9807148,9807148,,5,2,7,5,2,7,0.000683,0.000051,0,9063,8,0.000015,8,0.26177,0.30394,264.069305,0.095238,0.001333
108068,108068,,4,22,26,4,22,26,0.000228,0.002615,0,19599,25,0.000013,13,0.193575,0.214733,4964.825901,0.147692,0.000917
9302055,9302055,,4,1,5,4,1,5,0.000119,0,0,19597,25,0.000025,1,1,1,36.166667,0.15,0.000936
9402110,9402110,,2,2,4,2,2,4,0.000119,0.000001,0,19598,25,0.000011,2,0.75,0.833333,17,0.25,0.000484
9405020,9405020,,3,1,4,3,1,4,0.00014,0,0,19596,25,0.000011,2,0.666667,0.75,18.333333,0.25,0.000704
9208052,9208052,,3,0,3,3,0,3,0,0,0,19594,25,0.000068,0,0,0,0,0.166667,0.000718
9303128,9303128,,5,1,6,5,1,6,0,0,0,19595,25,0.000035,1,1,1,10.833333,0.066667,0.001176
108069,108069,,0,12,12,0,12,12,0,0.003381,0,19600,2,0.00001,11,0.217816,0.246837,0,0.19697,0
108071,108071,,0,3,3,0,3,3,0,0.000001,0,19601,6,0.00001,17,0.118036,0.126848,0,0.5,0
108072,108072,,3,9,12,3,9,12,0.000052,0.001028,0,19602,30,0.000011,16,0.193067,0.215273,265.986813,0.242424,0.000684
108073,108073,,3,9,12,3,9,12,0.000032,0.001441,0,19603,25,0.000013,14,0.193071,0.213354,327.120337,0.325758,0.000684
108074,108074,,0,4,4,0,4,4,0,0.000019,0,19604,28,0.00001,1,1,1,0,0,0
108076,108076,,6,10,16,6,10,16,0.000114,0.001744,0,19502,30,0.000013,15,0.191222,0.212554,5844.794845,0.2,0.001522
108077,108077,,1,20,21,1,20,21,0,0.000007,0,19605,6,0.000011,13,0.142506,0.161484,590.630025,0.342857,0.000226
108078,108078,,9,11,20,9,11,20,0.000364,0.001696,0,19025,0,0.000013,15,0.182836,0.203688,14159.861367,0.213158,0.002586
108079,108079,,0,10,10,0,10,10,0,0.000102,0,19606,30,0.00001,15,0.146958,0.168131,0,0.344444,0
108080,108080,,23,24,47,23,24,47,0.002197,0.002106,0,18574,10,0.000018,15,0.19962,0.224791,22060.568412,0.251156,0.007456
108081,108081,,0,12,12,0,12,12,0,0.001518,0,19607,25,0.00001,14,0.184251,0.205632,0,0.272727,0
108082,108082,,1,11,12,1,11,12,0,0.000007,0,19610,23,0.000011,14,0.137494,0.151669,107.875863,0.166667,0.000219
9905009,9905009,,3,4,7,3,4,7,0,0.000006,0,19609,23,0.000013,18,0.105277,0.122228,55.471448,0.285714,0.000677
9901075,9901075,,2,6,8,2,6,8,0,0.000004,0,19608,23,0.000014,17,0.114899,0.130978,550.691667,0.321429,0.000465
108083,108083,,0,24,24,0,24,24,0,0.000204,0,19611,23,0.00001,16,0.138781,0.15738,0,0.195652,0
108084,108084,,6,17,23,6,17,23,0.000059,0.000366,0,18583,10,0.000014,15,0.193795,0.215919,76659.748991,0.173913,0.00176
108085,108085,,10,46,56,10,46,56,0.001026,0.004758,0,18897,3,0.000012,16,0.215612,0.244569,54797.419476,0.078247,0.002672
108087,108087,,1,7,8,1,7,8,0.000191,0.000511,0,19612,41,0.00001,14,0.196734,0.215172,4986.72815,0.107143,0.000242
108089,108089,,14,2,16,14,2,16,0.000925,0.000066,0,18884,0,0.000021,16,0.160306,0.171254,9073.070821,0.1875,0.003697
108090,108090,,6,1,7,6,1,7,0.000191,0,0,19245,28,0.000036,4,0.428571,0.513889,2498.021954,0.047619,0.001865
108091,108091,,20,23,43,20,23,43,0.000623,0.000965,0,18579,10,0.000021,15,0.198567,0.225112,120412.527919,0.184385,0.005715
108092,108092,,4,37,41,4,37,41,0.000484,0.003641,0,16036,8,0.000011,14,0.204893,0.2266,14430.235158,0.185976,0.001427
108012,108012,,1,0,1,1,0,1,0.000043,0,0,16021,8,0.00001,0,0,0,0,0,0.000253
108093,108093,,8,8,16,8,8,16,0.000181,0.000085,0,18935,52,0.000015,14,0.172746,0.187542,536.513236,0.341667,0.002082
108094,108094,,5,35,40,5,35,40,0.000243,0.004961,0,18550,0,0.000012,15,0.197098,0.224868,8538.371026,0.101923,0.001169
108095,108095,,4,18,22,4,18,22,0.000045,0.002245,0,19123,52,0.000011,12,0.208567,0.231017,2902.073845,0.175325,0.001022
108096,108096,,5,14,19,5,14,19,0.000074,0.000882,0,19501,30,0.000013,14,0.203654,0.22409,4499.773735,0.248538,0.001205
108097,108097,,2,10,12,2,10,12,0.000003,0.000046,0,19613,26,0.000013,12,0.18908,0.204799,406.379021,0.166667,0.000438
108098,108098,,2,13,15,2,13,15,0.000439,0.000916,0,18960,8,0.00001,16,0.176295,0.194151,162.769688,0.385714,0.00068
108099,108099,,0,9,9,0,9,9,0,0.000277,0,19614,15,0.00001,13,0.182059,0.201081,0,0.097222,0
107094,107094,,9,0,9,9,0,9,0.000353,0,0,19309,1,0.000016,0,0,0,0,0.027778,0.002853
108100,108100,,35,32,67,35,32,67,0.00204,0.002747,0,16276,52,0.000025,16,0.204784,0.231682,69300.116572,0.118272,0.009506
108101,108101,,27,41,68,27,41,68,0.004191,0.026336,0,18587,1,0.000024,13,0.216612,0.24475,106351.033432,0.14223,0.008357
108102,108102,,15,12,27,15,12,27,0.000309,0.000375,0,18844,52,0.000017,13,0.194446,0.213716,12190.731056,0.165242,0.004004
108103,108103,,0,15,15,0,15,15,0,0.002276,0,19616,30,0.00001,15,0.196082,0.218154,0,0.17619,0
9911203,9911203,,1,20,21,1,20,21,0.000027,0.004071,0,19615,30,0.00001,13,0.200215,0.223077,313.814286,0.171429,0.000219
108104,108104,,3,14,17,3,14,17,0.000052,0.001333,0,19617,30,0.000011,15,0.200034,0.22107,651.965863,0.330882,0.000704
108105,108105,,5,6,11,5,6,11,0.000012,0.000002,0,19618,23,0.000013,14,0.1428,0.171143,2.196825,0.390909,0.001168
108106,108106,,12,19,31,12,19,31,0.001919,0.01782,0,19037,1,0.000014,13,0.196789,0.220639,9495.956041,0.148387,0.003133
108107,108107,,0,18,18,0,18,18,0,0.000019,0,19619,23,0.00001,16,0.156775,0.175618,0,0.124183,0
9602171,9602171,,3,3,6,3,3,6,0,0,0,11740,22,0.000018,3,0.6,0.722222,263.299687,0.133333,0.000671
9306094,9306094,,3,0,3,3,0,3,0,0,0,3751,22,0.000025,0,0,0,0,0.333333,0.00073
9310106,9310106,,2,0,2,2,0,2,0,0,0,3750,22,0.000022,0,0,0,0,0.5,0.000504
9412119,9412119,,7,4,11,7,4,11,0,0,0,3752,22,0.000031,2,0.833333,0.9,41215.71406,0.081818,0.001608
108108,108108,,0,2,2,0,2,2,0,0.00001,0,19620,3,0.00001,16,0.187226,0.203359,0,0,0
108109,108109,,3,8,11,3,8,11,0.000075,0.001399,0,19621,25,0.000012,13,0.188846,0.206696,7675.573357,0.181818,0.000704
108110,108110,,6,4,10,6,4,10,0.000089,0.000081,0,19622,4,0.000017,13,0.179585,0.197656,21411.540851,0.155556,0.001348
108111,108111,,4,5,9,4,5,9,0,0.000004,0,19623,15,0.000016,15,0.138668,0.145367,0,0.430556,0.000903
108113,108113,,3,36,39,3,36,39,0.000261,0.00302,0,19284,30,0.00001,14,0.208867,0.23431,1470.980619,0.182861,0.000694
108114,108114,,12,17,29,12,17,29,0.001391,0.016098,0,19624,25,0.000019,14,0.199309,0.223669,10444.144247,0.141626,0.002842
108115,108115,,13,11,24,13,11,24,0.001167,0.015885,0,19625,25,0.00002,14,0.19283,0.216248,7117.895412,0.150362,0.003062
108116,108116,,1,8,9,1,8,9,0,0.004951,0,19627,5,0.000011,15,0.165156,0.185274,2430.761905,0.152778,0.000219
9902130,9902130,,2,7,9,2,7,9,0.000058,0.00493,0,19626,5,0.000013,15,0.164781,0.184333,2474.190476,0.152778,0.000445
108117,108117,,5,8,13,5,8,13,0.000014,0.00012,0,19080,0,0.000015,15,0.177827,0.198456,15514.852223,0.134615,0.001157
9410101,9410101,,1,4,5,1,4,5,0.000001,0.000085,0,19078,0,0.000012,1,1,1,63.458095,0.05,0.000252
9310093,9310093,,3,0,3,3,0,3,0.000022,0,0,5466,0,0.000015,0,0,0,0,0,0.000692
108118,108118,,19,22,41,19,22,41,0.000517,0.000262,0,19628,30,0.000018,13,0.216523,0.239883,23408.640102,0.142073,0.004785
108119,108119,,32,10,42,32,10,42,0.004246,0.001368,0,15933,8,0.000024,13,0.20565,0.22556,162832.861963,0.205575,0.011266
109096,109096,,8,15,23,8,15,23,0.000544,0.012411,0,15741,1,0.00002,17,0.202009,0.23533,80874.396607,0.096838,0.003316
109168,109168,,23,11,34,23,11,34,0.001876,0.001563,0,15739,8,0.000029,14,0.194074,0.21577,64033.751344,0.100713,0.009875
110048,110048,,10,15,25,10,15,25,0.001175,0.001915,0,17735,1,0.000018,12,0.190395,0.211595,13439.665818,0.121667,0.003799
109010,109010,,11,11,22,11,11,22,0.000552,0.016017,0,17732,1,0.000023,17,0.18557,0.208927,28573.887302,0.108225,0.002972
110087,110087,,72,18,90,72,18,90,0.010678,0.018422,0,17737,8,0.000043,11,0.204306,0.228086,21451.32211,0.08814,0.022404
110089,110089,,25,8,33,25,8,33,0.002004,0.000742,0,17733,8,0.000027,12,0.195433,0.214301,108214.253312,0.086174,0.00781
111072,111072,,18,13,31,18,13,31,0.001296,0.001655,0,18806,1,0.000026,12,0.192525,0.214153,14009.656728,0.07957,0.005738
112218,112218,,66,48,114,66,48,114,0.008602,0.019286,0,18637,8,0.000062,12,0.220355,0.245373,369852.623037,0.110697,0.018657
112223,112223,,44,66,110,44,66,110,0.006178,0.020842,0,18807,8,0.000027,13,0.215714,0.242609,226193.460515,0.10367,0.01247
110189,110189,,11,41,52,11,41,52,0.002545,0.02107,0,18557,1,0.000017,17,0.187955,0.218665,24843.417884,0.141026,0.003404
112002,112002,,17,28,45,17,28,45,0.002035,0.00953,0,18461,8,0.000014,12,0.216997,0.246694,9594.678214,0.229293,0.004981
112066,112066,,10,33,43,10,33,43,0.001926,0.00964,0,18460,8,0.000013,13,0.215595,0.245194,6625.898102,0.184385,0.003053
112079,112079,,18,22,40,18,22,40,0.001797,0.002706,0,18805,25,0.000018,13,0.211392,0.235707,30822.610413,0.069872,0.005502
112140,112140,,18,45,63,18,45,63,0.002747,0.018206,0,18464,8,0.000014,13,0.203525,0.227151,16788.090072,0.185612,0.005223
112152,112152,,14,51,65,14,51,65,0.002019,0.017212,0,18462,8,0.000014,12,0.227673,0.258852,23550.477846,0.192548,0.004021
112226,112226,,23,56,79,23,56,79,0.003188,0.021303,0,18465,8,0.000017,12,0.218386,0.244641,23175.039153,0.183869,0.00612
112093,112093,,19,30,49,19,30,49,0.002732,0.003887,0,18459,8,0.000016,13,0.200329,0.221401,12021.911907,0.188776,0.005318
202127,202127,,13,34,47,13,34,47,0.002162,0.010576,0,19198,8,0.000013,13,0.218687,0.249253,25851.805892,0.125809,0.003472
110196,110196,,35,8,43,35,8,43,0.00644,0.012382,0,18520,41,0.000036,13,0.222532,0.253258,40140.483604,0.094684,0.014416
110271,110271,,38,22,60,38,22,60,0.001383,0.008039,0,18847,3,0.000037,12,0.206097,0.23204,90899.45795,0.094915,0.013175
201158,201158,,27,32,59,27,32,59,0.002014,0.003684,0,18954,8,0.000028,16,0.191832,0.216387,71406.749387,0.088545,0.007665
202028,202028,,3,23,26,3,23,26,0.000144,0.000395,0,19197,0,0.000011,14,0.195346,0.219569,6946.95308,0.147692,0.000861
202094,202094,,22,40,62,22,40,62,0.00325,0.008877,0,19158,8,0.000016,12,0.211827,0.24192,19634.569258,0.120571,0.005737
203191,203191,,8,52,60,8,52,60,0.001016,0.023855,0,19211,8,0.000012,13,0.212756,0.239718,13801.059792,0.162147,0.001982
110072,110072,,24,10,34,24,10,34,0.002169,0.001957,0,17727,8,0.000035,13,0.186763,0.207867,14354.870506,0.074866,0.00749
112253,112253,,24,33,57,24,33,57,0.002462,0.009399,0,18466,8,0.000017,12,0.207675,0.231953,23248.95783,0.151942,0.006416
201174,201174,,12,34,46,12,34,46,0.002178,0.003575,0,19185,8,0.000012,13,0.201252,0.222599,2763.522371,0.229469,0.003161
201176,201176,,11,43,54,11,43,54,0.002032,0.003833,0,19191,8,0.000012,13,0.205167,0.22862,3226.943099,0.160028,0.002673
201210,201210,,8,80,88,8,80,88,0.001495,0.023941,0,19208,8,0.000012,12,0.231377,0.264556,57318.805986,0.139368,0.001956
202008,202008,,11,52,63,11,52,63,0.002054,0.022653,0,19184,8,0.000012,13,0.214066,0.24174,11436.820264,0.145417,0.002902
202073,202073,,7,18,25,7,18,25,0.001491,0.012153,0,16126,1,0.000012,13,0.189345,0.209953,32024.750973,0.146667,0.001838
202096,202096,,8,15,23,8,15,23,0.00143,0.006881,0,19189,8,0.000012,13,0.193873,0.213474,2531.557603,0.175889,0.002015
202098,202098,,6,13,19,6,13,19,0.001248,0.002269,0,17726,25,0.000012,14,0.199565,0.219422,11159.764608,0.169591,0.001615
202161,202161,,3,7,10,3,7,10,0.000411,0.005447,0,19210,8,0.000011,17,0.178594,0.198356,27.076477,0.211111,0.000796
202163,202163,,37,3,40,37,3,40,0.004999,0.000311,0,18949,8,0.000026,13,0.187673,0.203518,12144.427052,0.087179,0.010192
202193,202193,,5,59,64,5,59,64,0.000811,0.023471,0,19209,8,0.000011,13,0.209667,0.236807,8351.590745,0.142857,0.001298
203003,203003,,9,15,24,9,15,24,0.001031,0.001133,0,19203,8,0.000015,13,0.19489,0.213448,36302.318029,0.141304,0.002168
203083,203083,,9,42,51,9,42,51,0.001157,0.015336,0,19186,8,0.000013,13,0.222562,0.255722,31021.659501,0.161961,0.002399
203101,203101,,32,107,139,32,107,139,0.003008,0.031262,0,18961,8,0.000032,13,0.222151,0.25924,352614.951195,0.053175,0.008557
203235,203235,,6,38,44,6,38,44,0.00115,0.002316,0,19214,8,0.000011,13,0.215656,0.240885,20618.35857,0.183932,0.001588
112147,112147,,37,31,68,37,31,68,0.001393,0.001469,0,18883,0,0.000024,13,0.207458,0.234127,63503.146191,0.129939,0.012276
201004,201004,,20,57,77,20,57,77,0.002683,0.012928,0,19170,8,0.000015,13,0.223031,0.254436,17411.535069,0.143199,0.005246
203019,203019,,33,39,72,33,39,72,0.001512,0.006858,0,18894,3,0.000022,13,0.208841,0.238051,59221.846264,0.081768,0.010518
203268,203268,,14,49,63,14,49,63,0.001776,0.005772,0,19199,8,0.000016,13,0.223913,0.254372,42552.67171,0.141065,0.00329
203208,203208,,6,38,44,6,38,44,0.000739,0.017748,0,19192,8,0.000011,12,0.209507,0.233314,4913.896371,0.238901,0.001576
203219,203219,,7,15,22,7,15,22,0.000534,0.001088,0,19187,8,0.000012,13,0.192049,0.211501,6599.898476,0.168831,0.001746
205119,205119,,13,17,30,13,17,30,0.00103,0.00069,0,19166,0,0.000018,13,0.19572,0.218996,21386.944037,0.104598,0.003403
112177,112177,,10,25,35,10,25,35,0.000308,0.004795,0,19164,13,0.000017,13,0.20551,0.238265,46420.78811,0.092437,0.00241
203074,203074,,3,8,11,3,8,11,0.000161,0.000308,0,19165,13,0.000012,14,0.183763,0.204691,3694.425586,0.136364,0.000798
203206,203206,,19,9,28,19,9,28,0.000846,0.000396,0,19163,0,0.000018,17,0.186234,0.209686,12832.866358,0.186508,0.00487
204156,204156,,14,7,21,14,7,21,0.000882,0.00127,0,19160,0,0.000017,13,0.177254,0.194455,5666.29254,0.104762,0.003481
205315,205315,,5,27,32,5,27,32,0.000296,0.002925,0,19636,0,0.000014,15,0.206375,0.23361,27771.914907,0.094758,0.001221
111025,111025,,28,31,59,28,31,59,0.001052,0.001558,0,18892,3,0.000021,13,0.209303,0.238314,53716.84253,0.099357,0.009438
202112,202112,,2,8,10,2,8,10,0.00023,0.000138,0,19635,8,0.000011,14,0.188428,0.205628,9144.159472,0.077778,0.000479
202124,202124,,36,31,67,36,31,67,0.001648,0.001505,0,18893,0,0.000022,13,0.204388,0.229505,52939.285414,0.168476,0.011759
203163,203163,,27,35,62,27,35,62,0.000917,0.005345,0,18899,3,0.000021,13,0.21396,0.241602,45859.208463,0.137229,0.008587
205316,205316,,14,21,35,14,21,35,0.001882,0.001268,0,19169,8,0.000014,17,0.198315,0.223027,33841.716309,0.07563,0.003765
112197,112197,,12,28,40,12,28,40,0.000997,0.004607,0,18872,0,0.000014,16,0.22094,0.258693,46241.680201,0.116026,0.003713
201028,201028,,47,29,76,47,29,76,0.001939,0.002113,0,18882,0,0.000027,16,0.211454,0.243915,83835.484152,0.120526,0.013859
201029,201029,,31,27,58,31,27,58,0.001036,0.00648,0,18987,0,0.000022,17,0.193723,0.223251,12146.145414,0.117665,0.008561
204027,204027,,13,18,31,13,18,31,0.001755,0.010273,0,19167,8,0.000019,13,0.195236,0.216079,23375.58756,0.096774,0.003561
205080,205080,,8,29,37,8,29,37,0.000973,0.00587,0,19155,8,0.000018,14,0.204104,0.227976,22130.315054,0.118619,0.002036
205101,205101,,34,33,67,34,33,67,0.002868,0.00778,0,19168,3,0.000021,16,0.208629,0.234329,47364.535059,0.133198,0.010357
205177,205177,,10,37,47,10,37,47,0.001364,0.020957,0,19159,8,0.000014,13,0.20734,0.231007,15137.29715,0.12766,0.002405
108120,108120,,37,30,67,37,30,67,0.002309,0.004842,0,16194,4,0.000026,13,0.204327,0.231114,13644.490788,0.126866,0.014175
108121,108121,,8,8,16,8,8,16,0.000674,0.000441,0,18620,1,0.000014,15,0.177413,0.193868,3751.446993,0.225,0.002283
108122,108122,,3,24,27,3,24,27,0.000847,0.019542,0,18945,1,0.000011,15,0.211142,0.243676,6000.63541,0.173789,0.000787
108123,108123,,2,19,21,2,19,21,0.000082,0.002321,0,19638,2,0.000011,13,0.200985,0.22351,13708.373673,0.090476,0.000498
9702123,9702123,,1,12,13,1,12,13,0.000027,0.001207,0,19637,0,0.00001,11,0.203375,0.231613,315.512616,0.237179,0.000233
108124,108124,,4,11,15,4,11,15,0.000001,0.000005,0,19639,22,0.000013,15,0.163287,0.176441,599.474051,0.252381,0.000903
108125,108125,,0,12,12,0,12,12,0,0.001762,0,19640,30,0.00001,14,0.190329,0.208563,0,0.204545,0
108126,108126,,7,38,45,7,38,45,0.000517,0.002356,0,19097,52,0.000012,15,0.205642,0.230924,18153.896122,0.157071,0.00216
108127,108127,,3,15,18,3,15,18,0.000119,0.004347,0,18989,0,0.000011,19,0.182967,0.211189,8726.206919,0.107843,0.001071
108128,108128,,3,34,37,3,34,37,0.000057,0.003096,0,19641,30,0.000011,13,0.20663,0.235413,6364.378461,0.246246,0.000664
9410178,9410178,,2,1,3,2,1,3,0,0,0,7254,23,0.000017,1,1,1,0,0.333333,0.000497
108130,108130,,0,21,21,0,21,21,0,0.000007,0,19642,17,0.00001,12,0.15598,0.19606,0,0.209524,0
108131,108131,,32,13,45,32,13,45,0.00105,0.000757,0,18868,0,0.00002,14,0.197127,0.222394,7177.807072,0.206566,0.010392
108132,108132,,1,5,6,1,5,6,0.000021,0.001346,0,19643,25,0.00001,13,0.186063,0.204891,59.358242,0.3,0.000268
108133,108133,,10,25,35,10,25,35,0.000231,0.000698,0,19644,25,0.000015,16,0.195231,0.217721,4245.62334,0.189076,0.002437
108134,108134,,0,14,14,0,14,14,0,0.000055,0,19645,5,0.00001,16,0.193212,0.217545,0,0.076923,0
108135,108135,,11,35,46,11,35,46,0.000475,0.0054,0,18984,0,0.000016,14,0.197988,0.229256,16498.145042,0.087923,0.00283
108136,108136,,0,3,3,0,3,3,0,0.000003,0,19647,22,0.00001,17,0.141001,0.153055,0,0.166667,0
9804169,9804169,,2,2,4,2,2,4,0,0.000032,0,19646,30,0.000022,11,0.161552,0.172849,1879.389241,0.083333,0.000438
108137,108137,,15,29,44,15,29,44,0.000823,0.001293,0,16171,52,0.000015,15,0.19863,0.228816,25745.828826,0.115222,0.004488
108138,108138,,2,8,10,2,8,10,0,0.000028,0,19648,23,0.000012,15,0.13151,0.145375,9.745238,0.233333,0.000438
108140,108140,,16,22,38,16,22,38,0.000538,0.001417,0,16229,3,0.000017,15,0.202414,0.227316,14229.743131,0.174964,0.005543
108141,108141,,2,16,18,2,16,18,0,0.000006,0,19649,17,0.00002,12,0.150241,0.185816,1226.230672,0.25817,0.000438
108142,108142,,20,15,35,20,15,35,0.000349,0.000511,0,18630,52,0.000018,17,0.193626,0.215981,11666.951516,0.226891,0.00532
108143,108143,,7,18,25,7,18,25,0.000305,0.002151,0,19650,30,0.000013,13,0.204712,0.229218,6068.72064,0.186667,0.001606
108144,108144,,0,9,9,0,9,9,0,0.001989,0,19651,13,0.00001,15,0.1557,0.178033,0,0.375,0
108145,108145,,4,10,14,4,10,14,0.00018,0.000819,0,19652,30,0.000012,15,0.184035,0.200781,795.493277,0.17033,0.000944
108146,108146,,0,1,1,0,1,1,0,0,0,19653,28,0.00001,4,0.4,0.479167,0,0,0
108147,108147,,5,16,21,5,16,21,0.000277,0.009893,0,19654,1,0.000013,15,0.221908,0.253951,11559.544921,0.133333,0.001155
108148,108148,,0,4,4,0,4,4,0,0.000008,0,19655,9,0.00001,16,0.137942,0.145919,0,0.333333,0
108149,108149,,0,9,9,0,9,9,0,0.000079,0,19657,17,0.00001,16,0.163072,0.183711,0,0.111111,0
9806002,9806002,,6,12,18,6,12,18,0.000134,0.002062,0,19656,26,0.000017,15,0.187845,0.218243,13673.017185,0.166667,0.001387
9503104,9503104,,5,27,32,5,27,32,0.000121,0.000015,0,6771,9,0.000017,5,0.400585,0.498905,115627.153725,0.079637,0.00123
9507007,9507007,,5,5,10,5,5,10,0.000189,0.000062,0,6177,26,0.000018,5,0.310345,0.417901,2211.756049,0.133333,0.001266
9508103,9508103,,6,4,10,6,4,10,0.000103,0.000004,0,6848,26,0.000021,7,0.210896,0.258016,31548.84281,0.166667,0.001496
108151,108151,,2,10,12,2,10,12,0.000005,0.00009,0,19658,1,0.000011,13,0.184159,0.202147,2411.250693,0.083333,0.000471
108152,108152,,14,44,58,14,44,58,0.001367,0.018532,0,18634,1,0.000016,14,0.215444,0.252735,59375.593255,0.066848,0.003468
108153,108153,,7,12,19,7,12,19,0.000053,0.000124,0,19659,13,0.000015,13,0.178018,0.19296,20463.457259,0.064327,0.001634
108154,108154,,1,18,19,1,18,19,0.000115,0.003177,0,19660,30,0.00001,13,0.214824,0.236728,994.447168,0.222222,0.000219
108155,108155,,0,5,5,0,5,5,0,0.000027,0,19661,4,0.00001,18,0.160556,0.18096,0,0.2,0
108156,108156,,4,31,35,4,31,35,0.000163,0.002584,0,19662,25,0.000011,13,0.200682,0.223441,5165.28725,0.188235,0.00097
108157,108157,,7,22,29,7,22,29,0.000003,0.000021,0,19663,6,0.000014,17,0.158584,0.1769,22269.194401,0.149015,0.001567
108158,108158,,7,27,34,7,27,34,0.000112,0.001711,0,18821,30,0.000014,13,0.215498,0.237836,7651.472833,0.173797,0.001676
108159,108159,,0,7,7,0,7,7,0,0.000001,0,19667,8,0.00001,5,0.378947,0.485648,0,0.309524,0
9609045,9609045,,7,2,9,7,2,9,0,0.000001,0,13353,8,0.000025,1,1,1,15.783333,0.25,0.001626
9801196,9801196,,3,11,14,3,11,14,0,0.000002,0,19665,8,0.000013,4,0.5,0.623656,45.083333,0.120879,0.000664
9903073,9903073,,2,3,5,2,3,5,0,0.000001,0,19664,8,0.000012,2,0.8,0.875,2.25,0.25,0.000445
9905088,9905088,,1,9,10,1,9,10,0,0.000002,0,19666,8,0.000011,4,0.454545,0.564286,5.583333,0.266667,0.000219
9612097,9612097,,3,5,8,3,5,8,0,0.000001,0,13356,8,0.000025,2,0.777778,0.857143,44.029304,0.178571,0.000703
9701104,9701104,,4,10,14,4,10,14,0,0.000003,0,13355,8,0.000016,4,0.510638,0.65625,196.961905,0.093407,0.000922
108160,108160,,0,5,5,0,5,5,0,0.000002,0,19668,22,0.00001,15,0.133997,0.147907,0,0.3,0
108161,108161,,2,48,50,2,48,50,0.000155,0.008877,0,19671,2,0.00001,12,0.225673,0.254172,964.806505,0.117143,0.000445
9901059,9901059,,1,27,28,1,27,28,0.000104,0.004586,0,19670,2,0.00001,14,0.187635,0.216019,111.989703,0.148148,0.000232
9205033,9205033,,2,0,2,2,0,2,0.000063,0,0,19669,2,0.000011,0,0,0,0,0,0.000445
108162,108162,,1,5,6,1,5,6,0.000039,0.000046,0,19672,41,0.00001,14,0.188195,0.213316,0,0.366667,0.000226
108163,108163,,3,2,5,3,2,5,0,0,0,19673,23,0.000015,4,0.421053,0.53125,18.5,0.25,0.000671
108164,108164,,3,7,10,3,7,10,0.000243,0.000959,0,19674,25,0.000011,16,0.184879,0.202988,3324.916681,0.233333,0.00067
108165,108165,,50,18,68,50,18,68,0.001954,0.001921,0,18581,10,0.000036,15,0.199467,0.225535,40031.328331,0.09921,0.016114
108166,108166,,1,8,9,1,8,9,0,0.000002,0,19675,17,0.000011,13,0.148396,0.180577,4.72022,0.291667,0.000219
108167,108167,,6,26,32,6,26,32,0.000694,0.005346,0,18458,13,0.000012,13,0.198502,0.220213,7069.12845,0.168347,0.001601
9602066,9602066,,4,0,4,4,0,4,0,0,0,4989,13,0.000052,0,0,0,0,0.5,0.000989
9702177,9702177,,3,1,4,3,1,4,0,0,0,4990,13,0.000027,1,1,1,0,0.5,0.000749
9703001,9703001,,2,2,4,2,2,4,0,0,0,4991,13,0.000019,1,1,1,0,0.5,0.000516
108168,108168,,0,20,20,0,20,20,0,0.003367,0,19676,1,0.00001,16,0.199797,0.232549,0,0.315789,0
108169,108169,,17,22,39,17,22,39,0.000568,0.004709,0,19677,2,0.000021,15,0.193847,0.216949,10683.871632,0.195007,0.004197
108170,108170,,6,6,12,6,6,12,0.000821,0.011137,0,19386,1,0.000013,12,0.196354,0.21645,581.935047,0.234848,0.001405
108171,108171,,0,1,1,0,1,1,0,0,0,19678,23,0.00001,1,1,1,0,0,0
108173,108173,,0,3,3,0,3,3,0,0.000001,0,19679,22,0.00001,12,0.162277,0.178448,0,0.5,0
108174,108174,,2,24,26,2,24,26,0.000075,0.004959,0,19680,13,0.000011,15,0.202129,0.229921,5864.441388,0.118462,0.000445
108175,108175,,0,1,1,0,1,1,0,0,0,19682,20,0.00001,2,0.666667,0.75,0,0,0
9510063,9510063,,1,1,2,1,1,2,0,0.000001,0,19681,20,0.000019,1,1,1,1,0,0.000219
108176,108176,,14,22,36,14,22,36,0.000655,0.003466,0,16241,2,0.000018,18,0.190085,0.215213,48451.48915,0.088095,0.003769
108177,108177,,0,6,6,0,6,6,0,0,0,19686,26,0.00001,11,0.141914,0.170863,0,0.066667,0
9809080,9809080,,1,2,3,1,2,3,0,0,0,19685,26,0.000011,10,0.158305,0.180433,325,0,0.000219
9902139,9902139,,2,0,2,2,0,2,0,0,0,19683,26,0.000022,0,0,0,0,0.5,0.000445
9910187,9910187,,1,1,2,1,1,2,0,0,0,19684,26,0.000011,1,1,1,0,0.5,0.000219
9403146,9403146,,6,2,8,6,2,8,0.000036,0.000004,0,7776,26,0.00005,1,1,1,725.777791,0.142857,0.001394
108178,108178,,2,22,24,2,22,24,0.000043,0.001399,0,19328,3,0.000012,15,0.20676,0.234611,8223.029884,0.177536,0.000769
108179,108179,,11,30,41,11,30,41,0.000297,0.003548,0,19687,25,0.000015,16,0.204491,0.228573,12286.817541,0.164024,0.00261
108180,108180,,1,5,6,1,5,6,0,0.000001,0,19688,5,0.000011,14,0.125673,0.153463,0.25,0.4,0.000219
108181,108181,,1,15,16,1,15,16,0.000025,0.00079,0,19689,30,0.000011,14,0.184887,0.203737,74.549278,0.216667,0.000219
108182,108182,,8,14,22,8,14,22,0.001267,0.008911,0,18560,1,0.000017,17,0.202002,0.235094,5506.290948,0.316017,0.003564
108183,108183,,11,25,36,11,25,36,0.000077,0.000529,0,18983,0,0.000019,13,0.194803,0.223679,21642.244242,0.057937,0.002624
108184,108184,,16,3,19,16,3,19,0.000138,0.000134,0,19066,0,0.00003,12,0.176056,0.19102,11984.635725,0.169591,0.004012
108185,108185,,11,4,15,11,4,15,0.000339,0.000965,0,19076,0,0.000024,12,0.191971,0.208927,17531.328439,0.061905,0.00268
9911075,9911075,,2,3,5,2,3,5,0.000012,0.000748,0,19075,0,0.000016,15,0.17555,0.193533,1397.375031,0.2,0.00052
108186,108186,,4,12,16,4,12,16,0.000194,0.001247,0,18832,30,0.000012,14,0.189413,0.207718,3910.604674,0.191667,0.001247
108188,108188,,0,2,2,0,2,2,0,0.000011,0,19691,4,0.00001,15,0.143934,0.15618,0,0,0
9907153,9907153,,1,0,1,1,0,1,0,0,0,19690,4,0.000014,0,0,0,0,0,0.000219
108189,108189,,1,15,16,1,15,16,0.000035,0.001143,0,19692,2,0.000011,14,0.191239,0.210818,1370.453674,0.195833,0.000219
108190,108190,,5,7,12,5,7,12,0.000025,0.001644,0,19693,8,0.000015,15,0.185472,0.202232,653.339038,0.219697,0.001436
108191,108191,,9,30,39,9,30,39,0.000305,0.006575,0,19027,13,0.000015,13,0.205005,0.230061,36120.347342,0.065452,0.002277
108193,108193,,0,19,19,0,19,19,0,0.001235,0,19694,25,0.00001,17,0.190354,0.211113,0,0.181287,0
108196,108196,,22,26,48,22,26,48,0.001083,0.006926,0,16236,3,0.000019,13,0.215158,0.241426,33591.342802,0.178191,0.006335
108197,108197,,1,5,6,1,5,6,0.000032,0.000161,0,19695,30,0.00001,16,0.157963,0.170572,0,0.333333,0.000219
108198,108198,,0,38,38,0,38,38,0,0.010086,0,19697,2,0.00001,16,0.218108,0.250162,0,0.168563,0
9806201,9806201,,1,13,14,1,13,14,0.000119,0.004614,0,19696,2,0.00001,14,0.187445,0.214084,10.6862,0.285714,0.000219
108199,108199,,0,15,15,0,15,15,0,0.001242,0,19698,5,0.00001,12,0.204364,0.224976,0,0.1,0
108201,108201,,14,8,22,14,8,22,0.000724,0.000302,0,19104,52,0.000015,17,0.190265,0.211914,2449.522162,0.212121,0.00371
108202,108202,,2,29,31,2,29,31,0.000079,0.002937,0,18890,3,0.00001,14,0.199142,0.225105,1621.997629,0.16129,0.000516
108203,108203,,6,15,21,6,15,21,0.000412,0.015934,0,19699,1,0.000016,15,0.177706,0.20049,13460.931776,0.138095,0.001348
108204,108204,,3,20,23,3,20,23,0.000015,0.002355,0,19700,23,0.000013,11,0.231097,0.262667,18118.278415,0.067194,0.000697
108205,108205,,17,46,63,17,46,63,0.00273,0.024492,0,18970,1,0.000015,15,0.224127,0.260335,43973.077252,0.135433,0.004429
108206,108206,,4,9,13,4,9,13,0.000206,0.000042,0,16322,52,0.000011,14,0.173768,0.188704,9297.574542,0.089744,0.000963
9304042,9304042,,6,0,6,6,0,6,0.000028,0,0,10681,6,0.000018,0,0,0,0,0.1,0.001376
108207,108207,,12,18,30,12,18,30,0.000486,0.002531,0,18994,2,0.000017,19,0.204663,0.23085,9354.840284,0.164368,0.003631
108208,108208,,2,10,12,2,10,12,0.000021,0.000218,0,19701,25,0.000011,13,0.160684,0.171981,39.001832,0.19697,0.000445
108209,108209,,1,8,9,1,8,9,0.000064,0.006455,0,19702,8,0.00001,13,0.20383,0.225155,66.746934,0.333333,0.000338
108210,108210,,1,2,3,1,2,3,0.000001,0.000021,0,19703,25,0.000011,13,0.174423,0.189899,80.370202,0,0.000246
108211,108211,,0,19,19,0,19,19,0,0.000015,0,19704,6,0.00001,18,0.146481,0.163877,0,0.187135,0
108212,108212,,0,7,7,0,7,7,0,0.015429,0,19705,1,0.00001,16,0.167812,0.191951,0,0.261905,0
108213,108213,,3,2,5,3,2,5,0,0.000004,0,19707,9,0.000013,1,1,1,1.866667,0.2,0.000664
9811113,9811113,,2,1,3,2,1,3,0,0.000004,0,19706,9,0.000016,1,1,1,0.166667,0.333333,0.000464
108214,108214,,2,3,5,2,3,5,0,0.000001,0,19708,9,0.000014,18,0.136346,0.146644,5572.758605,0.05,0.000445
9205105,9205105,,3,0,3,3,0,3,0.000001,0,0,4210,9,0.000021,0,0,0,0,0,0.000705
108215,108215,,14,36,50,14,36,50,0.000526,0.002844,0,18859,25,0.000015,14,0.197809,0.2215,28527.826443,0.15551,0.00339
108217,108217,,0,2,2,0,2,2,0,0,0,19710,26,0.00001,2,0.75,0.833333,0,0,0
9601176,9601176,,2,0,2,2,0,2,0.000003,0,0,19709,26,0.000015,0,0,0,0,0,0.000445
108218,108218,,6,7,13,6,7,13,0.000005,0.000023,0,19712,0,0.000016,18,0.154811,0.168509,12050.576018,0.224359,0.001388
9206083,9206083,,8,1,9,8,1,9,0.000016,0.000062,0,1708,0,0.000018,1,1,1,5.666667,0.166667,0.002074
9210030,9210030,,1,0,1,1,0,1,0,0,0,19711,0,0.000012,0,0,0,0,0,0.000259
108219,108219,,15,11,26,15,11,26,0.0005,0.000422,0,18580,10,0.000016,15,0.189256,0.210782,4514.402508,0.286154,0.004607
108220,108220,,8,27,35,8,27,35,0.000303,0.002594,0,19194,0,0.000012,15,0.204992,0.231603,6726.736623,0.152941,0.002
9911197,9911197,,2,13,15,2,13,15,0.000081,0.018056,0,19193,41,0.00001,11,0.228496,0.259051,3225.375187,0.22381,0.000507
108221,108221,,14,24,38,14,24,38,0.000588,0.006954,0,19713,4,0.000021,12,0.221825,0.256077,25400.203126,0.153627,0.004983
108222,108222,,1,9,10,1,9,10,0.000003,0.000022,0,19714,30,0.00001,12,0.147371,0.165594,23.777255,0.2,0.000219
108223,108223,,0,6,6,0,6,6,0,0.000001,0,19717,5,0.00001,17,0.144611,0.162659,0,0.133333,0
9704166,9704166,,1,6,7,1,6,7,0,0.000001,0,19716,5,0.000011,4,0.588235,0.758333,9.5,0.190476,0.000219
9509079,9509079,,4,0,4,4,0,4,0,0,0,9747,5,0.00002,0,0,0,0,0.25,0.000924
9602169,9602169,,2,6,8,2,6,8,0,0.000001,0,19715,5,0.000013,4,0.6,0.787037,4,0.303571,0.000445
108225,108225,,1,13,14,1,13,14,0,0.000008,0,19719,28,0.000011,14,0.145163,0.169737,746.349393,0.17033,0.000219
9809141,9809141,,4,2,6,4,2,6,0,0,0,19718,28,0.000016,4,0.472222,0.52451,49,0.1,0.000883
108226,108226,,19,14,33,19,14,33,0.000534,0.000548,0,18578,10,0.000022,15,0.191341,0.213656,11039.535116,0.224432,0.005825
108228,108228,,4,4,8,4,4,8,0.000185,0.001724,0,19720,30,0.000011,13,0.188307,0.204517,13.120569,0.392857,0.001033
108229,108229,,22,46,68,22,46,68,0.000851,0.010387,0,18873,4,0.000017,13,0.218455,0.248212,39253.822551,0.13367,0.006886
108230,108230,,2,25,27,2,25,27,0.000053,0.004133,0,18866,10,0.000011,14,0.206146,0.231465,21018.09562,0.095442,0.000814
108231,108231,,0,34,34,0,34,34,0,0.001725,0,19721,4,0.00001,12,0.204455,0.231026,0,0.178253,0
108232,108232,,1,10,11,1,10,11,0,0.001145,0,19722,2,0.000012,15,0.202783,0.231018,16427.884418,0.054545,0.000226
108233,108233,,0,24,24,0,24,24,0,0.008887,0,19723,2,0.00001,14,0.212322,0.239306,0,0.181159,0
108234,108234,,15,30,45,15,30,45,0.000366,0.001145,0,19013,52,0.000015,14,0.205168,0.230166,16499.844294,0.205556,0.004567
108235,108235,,5,18,23,5,18,23,0.000945,0.006806,0,18547,1,0.000011,16,0.184156,0.206458,1719.017455,0.215415,0.001296
108236,108236,,6,7,13,6,7,13,0.00002,0.00013,0,19090,52,0.000015,13,0.170135,0.185296,2588.894037,0.141026,0.001529
108237,108237,,3,8,11,3,8,11,0.000018,0.00121,0,19724,25,0.000013,14,0.192855,0.212853,6339.432745,0.318182,0.000664
108238,108238,,20,15,35,20,15,35,0.000788,0.000727,0,18845,52,0.000021,13,0.197054,0.217648,26698.0063,0.127731,0.00659
108239,108239,,3,15,18,3,15,18,0.000577,0.019329,0,18926,1,0.000016,14,0.202806,0.235356,5827.381122,0.202614,0.002363
108240,108240,,2,13,15,2,13,15,0.000036,0.000095,0,19728,30,0.000013,13,0.20918,0.228756,22463.116793,0.061905,0.000503
9411065,9411065,,2,0,2,2,0,2,0.000001,0,0,19727,30,0.000014,0,0,0,0,0,0.000452
9411109,9411109,,6,0,6,6,0,6,0.000001,0,0,11749,5,0.000067,0,0,0,0,0.1,0.001395
9910068,9910068,,4,4,8,4,4,8,0.000001,0,0,19726,5,0.000023,10,0.175285,0.200117,1649.494446,0.125,0.00091
9807043,9807043,,4,1,5,4,1,5,0,0,0,19725,5,0.00002,1,1,1,9.71621,0.2,0.000916
108242,108242,,0,10,10,0,10,10,0,0.000007,0,19729,23,0.00001,21,0.140638,0.15884,0,0.088889,0
108243,108243,,0,4,4,0,4,4,0,0.000024,0,19730,22,0.00001,15,0.145442,0.158666,0,0.083333,0
108244,108244,,6,25,31,6,25,31,0.000075,0.000543,0,19731,0,0.000016,15,0.17234,0.200888,5964.567278,0.094624,0.0014
9806157,9806157,,3,11,14,3,11,14,0.000008,0.00009,0,14314,0,0.000014,12,0.195336,0.222929,3470.641492,0.137363,0.000711
108245,108245,,38,35,73,38,35,73,0.001664,0.001231,0,18584,10,0.00003,14,0.211834,0.238257,171209.775255,0.128425,0.01171
109025,109025,,28,44,72,28,44,72,0.001676,0.002923,0,18585,10,0.000022,15,0.202892,0.231543,57695.512723,0.084703,0.008319
109001,109001,,0,1,1,0,1,1,0,0.000014,0,19732,15,0.00001,2,0.571429,0.625,0,0,0
109002,109002,,2,5,7,2,5,7,0.000001,0.000063,0,19733,1,0.000015,11,0.180126,0.193815,9351.658815,0.166667,0.000465
109003,109003,,5,3,8,5,3,8,0.00008,0.000003,0,19734,8,0.000014,8,0.221239,0.271778,9,0.321429,0.001149
109005,109005,,2,7,9,2,7,9,0.000002,0.000272,0,19735,13,0.000013,17,0.169852,0.190249,2141.193964,0.083333,0.000458
9210153,9210153,,1,0,1,1,0,1,0.000001,0,0,6143,10,0.000011,0,0,0,0,0,0.000249
109006,109006,,0,3,3,0,3,3,0,0.000003,0,19736,1,0.00001,3,0.625,0.766667,0,0.333333,0
9711004,9711004,,3,1,4,3,1,4,0.000279,0,0,8459,1,0.000016,3,0.5,0.611111,23946.504545,0.166667,0.000759
9509156,9509156,,1,1,2,1,1,2,0,0,0,8457,1,0.000071,1,1,1,8065,0,0.000253
109007,109007,,0,3,3,0,3,3,0,0.000003,0,19737,1,0.00001,3,0.625,0.766667,0,0.333333,0
109008,109008,,6,16,22,6,16,22,0.000002,0.000057,0,19738,4,0.000014,15,0.174887,0.193593,13630.426468,0.108225,0.001381
9510066,9510066,,2,1,3,2,1,3,0,0,0,17340,22,0.000025,1,1,1,88,0,0.000459
109009,109009,,4,3,7,4,3,7,0.000002,0.00001,0,19739,9,0.000014,13,0.154757,0.167945,7497.17778,0.119048,0.000883
109011,109011,,0,3,3,0,3,3,0,0.000002,0,19740,23,0.00001,15,0.118672,0.128104,0,0.333333,0
109013,109013,,2,44,46,2,44,46,0.000054,0.003458,0,19741,52,0.000011,13,0.208765,0.235646,5248.344159,0.175362,0.000586
9210142,9210142,,2,0,2,2,0,2,0.000061,0,0,793,0,0.000012,0,0,0,0,0.5,0.000732
109014,109014,,1,6,7,1,6,7,0,0,0,19744,20,0.000011,4,0.457143,0.609375,0,0.380952,0.000219
9502019,9502019,,2,2,4,2,2,4,0,0,0,19743,20,0.000012,2,0.75,0.833333,6,0.083333,0.000445
9408107,9408107,,1,0,1,1,0,1,0,0,0,19742,20,0.000015,0,0,0,0,0,0.000232
109015,109015,,1,9,10,1,9,10,0.00003,0.000344,0,19745,30,0.00001,13,0.206754,0.225944,16.042493,0.311111,0.000239
109016,109016,,0,1,1,0,1,1,0,0,0,19746,20,0.00001,12,0.132429,0.149495,0,0,0
109017,109017,,15,29,44,15,29,44,0.001563,0.018869,0,17741,25,0.000021,12,0.205227,0.229008,34909.250114,0.113636,0.004075
109210,109210,,0,2,2,0,2,2,0,0.000024,0,19747,1,0.00001,18,0.168472,0.186699,0,0,0
109018,109018,,4,8,12,4,8,12,0.000179,0.000668,0,19748,30,0.000011,15,0.190779,0.209431,117.310912,0.143939,0.000985
109019,109019,,14,20,34,14,20,34,0.000465,0.003574,0,16228,3,0.000015,16,0.188897,0.211288,2610.425341,0.12656,0.004705
109020,109020,,5,12,17,5,12,17,0.000332,0.003512,0,18831,30,0.000012,13,0.212965,0.233898,8833.71031,0.194853,0.001454
109021,109021,,11,14,25,11,14,25,0.000566,0.000354,0,19095,52,0.000013,14,0.190494,0.210535,11732.788235,0.13,0.002894
109022,109022,,4,7,11,4,7,11,0.000013,0.000199,0,19749,8,0.000013,16,0.166525,0.185778,189.693378,0.245455,0.000916
109023,109023,,2,3,5,2,3,5,0.000001,0.000003,0,19750,23,0.000012,16,0.120061,0.129473,3.866667,0.25,0.000438
109024,109024,,4,16,20,4,16,20,0.000055,0.00322,0,19751,25,0.000013,12,0.195859,0.215553,1252.85042,0.142105,0.000916
109027,109027,,0,6,6,0,6,6,0,0.002179,0,19752,0,0.00001,15,0.153101,0.17558,0,0.166667,0
109028,109028,,0,1,1,0,1,1,0,0,0,19753,30,0.00001,15,0.156437,0.166059,0,0,0
109029,109029,,1,40,41,1,40,41,0.000008,0.004577,0,19754,3,0.000011,13,0.228932,0.262514,1379.102208,0.064024,0.000219
109030,109030,,11,18,29,11,18,29,0.000393,0.004263,0,19755,2,0.000017,15,0.189651,0.212291,4627.503741,0.220443,0.002667
109031,109031,,0,12,12,0,12,12,0,0.0007,0,19756,2,0.00001,16,0.167785,0.187236,0,0.189394,0
109032,109032,,5,32,37,5,32,37,0.000458,0.002404,0,18826,3,0.000011,17,0.193614,0.21485,915.123493,0.234985,0.001147
109034,109034,,0,4,4,0,4,4,0,0.000001,0,19757,23,0.00001,18,0.121571,0.131242,0,0.25,0
109035,109035,,0,3,3,0,3,3,0,0.000005,0,19758,15,0.00001,15,0.150134,0.164146,0,0.166667,0
109036,109036,,1,6,7,1,6,7,0.000057,0.000017,0,19759,41,0.00001,16,0.171489,0.186538,338.561843,0.214286,0.000248
109037,109037,,0,1,1,0,1,1,0,0,0,19760,9,0.00001,1,1,1,0,0,0
109038,109038,,3,33,36,3,33,36,0.000152,0.003496,0,19761,25,0.000011,13,0.201665,0.223642,3166.221306,0.17619,0.000751
109039,109039,,18,24,42,18,24,42,0.002312,0.00751,0,18575,10,0.000015,16,0.195387,0.223091,2888.98444,0.257259,0.005492
109040,109040,,2,11,13,2,11,13,0.000048,0.001549,0,19762,25,0.000012,12,0.199032,0.220035,8121.253843,0.224359,0.000472
109041,109041,,2,3,5,2,3,5,0.000012,0.001533,0,19763,13,0.000015,12,0.188538,0.205513,2775.169409,0.1,0.000453
109042,109042,,2,2,4,2,2,4,0,0,0,19764,2,0.000016,1,1,1,0,0.416667,0.000452
109043,109043,,0,8,8,0,8,8,0,0.000002,0,19765,26,0.00001,14,0.172741,0.21248,0,0.142857,0
9205073,9205073,,7,0,7,7,0,7,0.000001,0,0,10459,17,0.000028,0,0,0,0,0.095238,0.001603
9304059,9304059,,1,2,3,1,2,3,0,0,0,13144,17,0.000013,1,1,1,176.791302,0,0.000239
9312111,9312111,,1,2,3,1,2,3,0,0.000003,0,13143,0,0.000013,1,1,1,73.387179,0,0.000239
109044,109044,,0,10,10,0,10,10,0,0.000716,0,19766,3,0.00001,13,0.21375,0.238849,0,0.2,0
109045,109045,,1,15,16,1,15,16,0,0.000136,0,19767,26,0.000012,15,0.168049,0.183973,10502.086461,0.104167,0.000219
109046,109046,,0,3,3,0,3,3,0,0.000001,0,19768,28,0.00001,11,0.160675,0.185523,0,0.166667,0
109047,109047,,0,4,4,0,4,4,0,0.000026,0,19769,1,0.00001,14,0.155173,0.166003,0,0.25,0
109048,109048,,6,13,19,6,13,19,0.000226,0.00013,0,19770,4,0.000012,16,0.135111,0.151348,1280.691723,0.169591,0.001694
109049,109049,,1,25,26,1,25,26,0.000076,0.002874,0,19771,3,0.00001,15,0.196593,0.218371,129.282917,0.230769,0.000219
109051,109051,,9,7,16,9,7,16,0.00012,0.000083,0,19772,2,0.000015,15,0.143872,0.155393,30.778505,0.3375,0.002248
109052,109052,,0,9,9,0,9,9,0,0.00013,0,19773,1,0.00001,13,0.186314,0.203554,0,0.236111,0
109053,109053,,25,18,43,25,18,43,0.001701,0.005238,0,16170,52,0.000021,14,0.210731,0.242663,35007.402982,0.14175,0.007886
109054,109054,,8,64,72,8,64,72,0.000329,0.022199,0,19774,0,0.000017,14,0.210552,0.241611,45918.364948,0.11698,0.001901
109055,109055,,4,47,51,4,47,51,0.000117,0.007512,0,19775,0,0.000012,14,0.20591,0.236758,10426.484643,0.109412,0.000903
109056,109056,,2,2,4,2,2,4,0.00001,0.000001,0,19777,8,0.000014,15,0.151001,0.162701,0.5,0.25,0.000438
9902039,9902039,,4,0,4,4,0,4,0.00001,0,0,19776,8,0.000034,0,0,0,0,0.25,0.000935
109058,109058,,2,17,19,2,17,19,0.000014,0.001361,0,19353,3,0.000011,14,0.191123,0.212343,7365.853164,0.146199,0.00048
109059,109059,,2,26,28,2,26,28,0.000205,0.001322,0,18621,1,0.000011,15,0.19427,0.217579,2322.97776,0.239418,0.000686
109060,109060,,0,7,7,0,7,7,0,0.000007,0,19778,23,0.00001,15,0.136096,0.145689,0,0.238095,0
109062,109062,,0,5,5,0,5,5,0,0.000013,0,19779,6,0.00001,14,0.163466,0.175631,0,0.05,0
109063,109063,,23,32,55,23,32,55,0.001684,0.004488,0,16172,52,0.000019,15,0.192806,0.220244,13407.500102,0.147138,0.007341
9712225,9712225,,1,5,6,1,5,6,0.000086,0.001603,0,11727,2,0.000011,11,0.189102,0.211234,109.202004,0.166667,0.000253
109064,109064,,12,27,39,12,27,39,0.002285,0.019311,0,18537,1,0.000014,16,0.201271,0.235119,12283.283636,0.230769,0.003387
109065,109065,,12,35,47,12,35,47,0.002103,0.020472,0,18512,1,0.000015,16,0.197261,0.233052,9316.279859,0.232192,0.004052
109066,109066,,0,11,11,0,11,11,0,0.0019,0,19780,30,0.00001,14,0.186848,0.206439,0,0.363636,0
109068,109068,,5,5,10,5,5,10,0.000069,0.000996,0,19781,0,0.000014,16,0.177474,0.194857,2821.832155,0.233333,0.001168
109069,109069,,9,52,61,9,52,61,0.00033,0.002117,0,19782,52,0.000013,15,0.211348,0.237947,25252.579458,0.119399,0.002521
109071,109071,,2,3,5,2,3,5,0.000001,0.000059,0,19783,23,0.000013,15,0.146769,0.155976,8.338889,0.3,0.000497
109072,109072,,0,6,6,0,6,6,0,0.000008,0,19784,28,0.00001,17,0.125056,0.136725,0,0.233333,0
9409160,9409160,,5,4,9,5,4,9,0.000015,0.000007,0,3681,28,0.000035,2,0.75,0.833333,3819.537692,0.166667,0.001228
109073,109073,,5,5,10,5,5,10,0.000031,0.000011,0,19785,1,0.000014,14,0.158144,0.171291,897.548441,0.144444,0.001141
109074,109074,,0,9,9,0,9,9,0,0.001349,0,19786,25,0.00001,15,0.184063,0.204063,0,0.361111,0
109075,109075,,11,18,29,11,18,29,0.000238,0.000543,0,19014,4,0.000014,14,0.19158,0.212216,4829.007249,0.247537,0.003208
109076,109076,,5,37,42,5,37,42,0.000108,0.001055,0,19020,10,0.000011,14,0.206463,0.232101,6465.721655,0.123113,0.001495
109077,109077,,4,14,18,4,14,18,0.000033,0.000124,0,19787,22,0.000012,16,0.168183,0.183125,11402.020814,0.173203,0.00089
109078,109078,,0,3,3,0,3,3,0,0.000013,0,19788,6,0.00001,15,0.16722,0.181185,0,0,0
109079,109079,,7,16,23,7,16,23,0.000203,0.002392,0,19789,30,0.000012,15,0.195707,0.217361,1412.410434,0.22332,0.00175
109080,109080,,0,1,1,0,1,1,0,0.000013,0,19790,0,0.00001,16,0.160078,0.177029,0,0,0
109081,109081,,1,20,21,1,20,21,0.000347,0.021865,0,19791,1,0.00001,17,0.203212,0.237281,89.424821,0.140476,0.000219
109082,109082,,15,12,27,15,12,27,0.000725,0.001904,0,18886,0,0.00002,13,0.18503,0.203178,25428.886345,0.132479,0.004007
109083,109083,,2,5,7,2,5,7,0.000001,0.00004,0,19792,52,0.000011,15,0.148477,0.165355,1382.883743,0.119048,0.000451
109084,109084,,13,22,35,13,22,35,0.000141,0.000482,0,19793,30,0.000016,12,0.194502,0.21101,6981.751319,0.157983,0.003048
109085,109085,,0,8,8,0,8,8,0,0.000026,0,19795,9,0.00001,5,0.315589,0.372189,0,0.142857,0
9510185,9510185,,7,8,15,7,8,15,0,0.000001,0,3950,9,0.000023,5,0.346008,0.415385,37195.893722,0.109524,0.001702
9903198,9903198,,1,7,8,1,7,8,0,0,0,19794,9,0.000011,3,0.555556,0.65,13.583333,0.035714,0.000219
9211014,9211014,,3,0,3,3,0,3,0.000001,0,0,3179,9,0.000056,0,0,0,0,0,0.000786
9303073,9303073,,2,2,4,2,2,4,0,0,0,3182,6,0.000016,2,0.75,0.833333,1581.248382,0.25,0.000554
9304152,9304152,,8,4,12,8,4,12,0,0,0,1288,9,0.000025,2,0.833333,0.9,467.815036,0.113636,0.002134
9310062,9310062,,2,3,5,2,3,5,0.000002,0,0,3183,6,0.000013,2,0.8,0.875,1585.248382,0.15,0.000539
9305059,9305059,,2,1,3,2,1,3,0,0,0,3949,9,0.000014,1,1,1,0.25,0.166667,0.000486
9502076,9502076,,1,1,2,1,1,2,0,0,0,3948,9,0.000012,4,0.371429,0.410256,6.080952,0,0.000267
9811223,9811223,,2,6,8,2,6,8,0,0.000006,0,10209,23,0.000015,2,0.75,0.833333,9,0.142857,0.000478
109086,109086,,6,7,13,6,7,13,0.000927,0.00101,0,19796,25,0.000014,16,0.178089,0.197598,527.282352,0.230769,0.001456
109087,109087,,6,6,12,6,6,12,0.000133,0.001199,0,19797,25,0.000013,17,0.18612,0.203999,897.073585,0.333333,0.001401
109088,109088,,0,1,1,0,1,1,0,0,0,19798,9,0.00001,1,1,1,0,0,0
109089,109089,,4,7,11,4,7,11,0,0.000002,0,19799,23,0.000013,14,0.143786,0.162614,955.536815,0.163636,0.000942
109090,109090,,6,8,14,6,8,14,0.000288,0.000179,0,19800,25,0.000012,14,0.186795,0.205404,2336.127333,0.203297,0.00139
109091,109091,,2,27,29,2,27,29,0.000036,0.002446,0,19801,30,0.000011,12,0.210846,0.234917,3584.703801,0.152709,0.000519
109092,109092,,1,109,110,1,109,110,0.000072,0.028862,0,19241,1,0.00001,16,0.212468,0.253241,26821.514839,0.059383,0.000813
109094,109094,,11,17,28,11,17,28,0.000797,0.003237,0,15738,25,0.000016,13,0.215926,0.246429,47551.92606,0.186508,0.003076
109095,109095,,2,9,11,2,9,11,0.000073,0.001935,0,19802,30,0.000011,13,0.208405,0.228217,3599.642066,0.354545,0.000445
109097,109097,,5,15,20,5,15,20,0.000074,0.001443,0,19804,4,0.000016,13,0.170186,0.190876,12315.767246,0.163158,0.001142
9905025,9905025,,2,2,4,2,2,4,0.000017,0,0,19803,41,0.000013,2,0.75,0.833333,47.406798,0.083333,0.000471
205025,205025,,6,16,22,6,16,22,0.000439,0.002289,0,19806,4,0.000012,13,0.194475,0.213249,15947.843031,0.257576,0.001374
110178,110178,,2,34,36,2,34,36,0.00007,0.019975,0,19004,30,0.000011,13,0.223609,0.250063,34770.887154,0.096032,0.000671
202172,202172,,5,26,31,5,26,31,0.00041,0.00365,0,19805,4,0.000012,15,0.185509,0.208935,4742.10418,0.190323,0.001162
109098,109098,,7,7,14,7,7,14,0.000091,0.000238,0,19807,52,0.000023,15,0.183615,0.200751,36913.295406,0.137363,0.001607
109099,109099,,4,50,54,4,50,54,0.000159,0.014409,0,17725,25,0.000013,13,0.213918,0.239777,19432.524354,0.090846,0.000972
109100,109100,,6,21,27,6,21,27,0.00025,0.000866,0,19354,3,0.000012,15,0.180623,0.20166,5514.813887,0.138177,0.001515
109101,109101,,3,9,12,3,9,12,0.000011,0.000022,0,19082,0,0.000013,13,0.178937,0.195554,14431.729813,0.166667,0.000718
109102,109102,,6,40,46,6,40,46,0.000095,0.002048,0,19808,30,0.000012,13,0.213148,0.23696,5326.735138,0.140097,0.001368
109103,109103,,0,5,5,0,5,5,0,0.000274,0,19810,2,0.00001,14,0.167282,0.183031,0,0.2,0
9912043,9912043,,1,11,12,1,11,12,0.000003,0.002415,0,19809,2,0.000012,13,0.194634,0.219477,6193.743248,0.159091,0.000219
109104,109104,,1,3,4,1,3,4,0,0,0,19812,3,0.000013,2,0.714286,0.8,5,0.083333,0.000219
9507095,9507095,,1,1,2,1,1,2,0,0,0,19811,3,0.000014,2,0.6,0.666667,0,0.5,0.000226
109105,109105,,0,13,13,0,13,13,0,0.000002,0,19813,22,0.00001,18,0.134909,0.145827,0,0.391026,0
109106,109106,,2,11,13,2,11,13,0.000001,0.000007,0,19814,22,0.000011,11,0.17432,0.206015,0,0.429487,0.000458
109107,109107,,7,40,47,7,40,47,0.000557,0.003756,0,19282,30,0.000013,14,0.220224,0.245252,14742.776754,0.191489,0.00163
109108,109108,,3,7,10,3,7,10,0.000258,0.00085,0,19815,8,0.000013,15,0.184053,0.202085,53.504151,0.233333,0.000704
109109,109109,,1,5,6,1,5,6,0,0.000007,0,19816,1,0.000011,14,0.15668,0.168393,0,0.4,0.000219
109110,109110,,10,5,15,10,5,15,0.000017,0.000027,0,19817,5,0.000018,14,0.152162,0.161415,24388.506016,0.314286,0.002443
109111,109111,,10,15,25,10,15,25,0.000422,0.002133,0,19818,30,0.000014,13,0.215283,0.2371,7832.903158,0.305,0.002557
109112,109112,,0,18,18,0,18,18,0,0.008517,0,19819,2,0.00001,15,0.200906,0.232125,0,0.169935,0
109113,109113,,0,3,3,0,3,3,0,0.000017,0,19820,28,0.00001,13,0.145897,0.157555,0,0.333333,0
109114,109114,,4,31,35,4,31,35,0.000121,0.004624,0,19821,25,0.000012,16,0.193037,0.220329,2943.14652,0.188235,0.000944
109115,109115,,4,7,11,4,7,11,0,0.000006,0,19822,6,0.000014,16,0.156768,0.171409,7928.945921,0.118182,0.00091
109117,109117,,2,7,9,2,7,9,0.000126,0.000005,0,19823,6,0.000011,14,0.156793,0.171706,66.10404,0.208333,0.000451
109118,109118,,1,4,5,1,4,5,0.000006,0,0,19825,23,0.000011,13,0.123302,0.131755,342.85212,0.05,0.000239
104148,104148,,2,0,2,2,0,2,0,0,0,19824,23,0.000015,0,0,0,0,0,0.000452
109119,109119,,9,10,19,9,10,19,0.000017,0.001894,0,19826,5,0.000016,13,0.176315,0.191188,6851.7487,0.254386,0.002177
109198,109198,,7,15,22,7,15,22,0.001141,0.012372,0,16020,1,0.000013,14,0.18743,0.211186,6316.297045,0.123377,0.002091
9207012,9207012,,1,1,2,1,1,2,0.000109,0.000003,0,15397,8,0.00001,1,1,1,45.908148,0,0.000538
110213,110213,,4,24,28,4,24,28,0.000834,0.002226,0,17768,1,0.000011,14,0.200851,0.22425,16758.202735,0.112434,0.000942
110105,110105,,1,8,9,1,8,9,0.000274,0.001246,0,17757,2,0.00001,13,0.189947,0.208047,3172.781827,0.236111,0.000365
112037,112037,,3,37,40,3,37,40,0.000839,0.02232,0,19216,1,0.00001,12,0.21835,0.250242,2403.700307,0.221154,0.000726
111136,111136,,2,35,37,2,35,37,0.000278,0.01963,0,18463,8,0.00001,13,0.197594,0.222276,2473.559024,0.244745,0.000692
201128,201128,,11,28,39,11,28,39,0.001346,0.002602,0,19171,8,0.000013,13,0.198982,0.219861,6530.184071,0.252362,0.002722
201117,201117,,6,5,11,6,5,11,0.000201,0.000235,0,19190,8,0.000011,14,0.165238,0.183648,2102.988815,0.090909,0.001626
111190,111190,,4,21,25,4,21,25,0.000305,0.011872,0,19183,4,0.000012,13,0.196628,0.224562,21067.54355,0.12,0.000974
112196,112196,,2,15,17,2,15,17,0.000313,0.019188,0,19188,1,0.000011,16,0.210791,0.24411,2910.70466,0.246324,0.000494
201247,201247,,7,40,47,7,40,47,0.000717,0.013452,0,18467,8,0.000012,13,0.19725,0.220579,1492.29103,0.231267,0.001854
202048,202048,,7,30,37,7,30,37,0.000358,0.001517,0,19207,8,0.000017,13,0.198577,0.219796,60164.222982,0.228228,0.001749
202052,202052,,3,34,37,3,34,37,0.000621,0.002786,0,19204,8,0.00001,13,0.194909,0.216654,274.352736,0.267267,0.000818
110001,110001,,3,3,6,3,3,6,0.000023,0.000008,0,19202,1,0.000013,19,0.155334,0.170927,109.404467,0.333333,0.000718
112258,112258,,23,19,42,23,19,42,0.004007,0.016704,0,18638,1,0.00002,12,0.201343,0.221339,105435.363169,0.115563,0.006107
204065,204065,,5,3,8,5,3,8,0.000282,0.00077,0,19213,25,0.000012,12,0.181736,0.196066,8374.998334,0.071429,0.001224
204066,204066,,17,21,38,17,21,38,0.002218,0.01786,0,17744,25,0.000018,15,0.197765,0.220647,35763.307131,0.135135,0.004088
204083,204083,,5,56,61,5,56,61,0.000752,0.004589,0,19212,8,0.000011,13,0.207052,0.231552,2763.34234,0.140984,0.001191
203258,203258,,4,1,5,4,1,5,0.000129,0.000163,0,19200,8,0.000014,14,0.173365,0.187967,4162.137803,0.2,0.000917
204014,204014,,6,9,15,6,9,15,0.000671,0.001237,0,19182,8,0.000012,14,0.190584,0.208348,2153.928205,0.219048,0.00146
204030,204030,,8,13,21,8,13,21,0.000916,0.002829,0,19181,1,0.000014,14,0.19935,0.229885,12640.781185,0.180952,0.001905
109123,109123,,1,12,13,1,12,13,0.000016,0.00022,0,19828,1,0.00001,15,0.188268,0.210092,737.764289,0.083333,0.000232
9903264,9903264,,1,3,4,1,3,4,0.000003,0,0,19827,1,0.000011,4,0.5,0.680556,7,0.25,0.000226
109124,109124,,1,9,10,1,9,10,0.000003,0.000068,0,19829,30,0.00001,18,0.132821,0.148359,0.395833,0.244444,0.000219
109125,109125,,2,18,20,2,18,20,0.000041,0.003247,0,19830,30,0.000011,14,0.203329,0.22576,2126.004729,0.242105,0.000492
109126,109126,,4,18,22,4,18,22,0.000068,0.00065,0,19028,10,0.000011,14,0.194372,0.219134,5596.243489,0.177489,0.001048
109127,109127,,10,48,58,10,48,58,0.001035,0.022431,0,19274,1,0.000014,14,0.233143,0.268569,35695.132414,0.115245,0.00265
109128,109128,,12,4,16,12,4,16,0.000045,0.000035,0,18951,8,0.000029,13,0.167371,0.179899,9811.518383,0.2125,0.003417
109129,109129,,1,21,22,1,21,22,0.000367,0.016852,0,18959,8,0.00001,13,0.203965,0.225865,46958.872629,0.179654,0.000447
109130,109130,,4,33,37,4,33,37,0.000216,0.003126,0,18817,30,0.000011,13,0.216896,0.239997,3615.70134,0.175676,0.001206
109131,109131,,1,32,33,1,32,33,0.000053,0.002898,0,19831,3,0.00001,13,0.224505,0.249914,200.221501,0.161932,0.000219
109132,109132,,8,5,13,8,5,13,0.000194,0.000134,0,19266,30,0.000013,13,0.206547,0.224738,7895.785353,0.153846,0.002196
109134,109134,,1,5,6,1,5,6,0,0.000052,0,19832,30,0.000014,11,0.171954,0.194785,690.603882,0.033333,0.000219
109136,109136,,1,4,5,1,4,5,0.00004,0.000022,0,19833,28,0.00001,16,0.129416,0.149437,134.680029,0.1,0.000219
109137,109137,,2,23,25,2,23,25,0.000114,0.000352,0,19834,0,0.000011,16,0.188247,0.212081,800.744408,0.215,0.000587
109138,109138,,0,1,1,0,1,1,0,0,0,19835,52,0.00001,1,1,1,0,0,0
109139,109139,,1,9,10,1,9,10,0,0.000006,0,19837,2,0.000011,14,0.166126,0.184813,0,0.2,0.000219
9702036,9702036,,2,2,4,2,2,4,0,0.000016,0,19836,2,0.000012,13,0.155374,0.172026,151.627731,0.333333,0.000445
109140,109140,,1,11,12,1,11,12,0.000017,0.002659,0,19838,25,0.000011,13,0.187851,0.208443,634.230155,0.234848,0.000246
109141,109141,,2,10,12,2,10,12,0.000012,0.002611,0,19031,4,0.000012,14,0.167221,0.190348,6547.743074,0.128788,0.000549
109142,109142,,0,3,3,0,3,3,0,0,0,19839,26,0.00001,18,0.121039,0.129863,0,0,0
109143,109143,,0,1,1,0,1,1,0,0,0,19842,21,0.00001,2,0.666667,0.75,0,0,0
9404144,9404144,,3,1,4,3,1,4,0,0,0,19841,21,0.000025,1,1,1,4,0,0.000664
9310010,9310010,,2,0,2,2,0,2,0,0,0,19840,21,0.000041,0,0,0,0,0,0.000458
109144,109144,,0,2,2,0,2,2,0,0.000021,0,19843,5,0.00001,13,0.174423,0.189899,0,0,0
109145,109145,,7,1,8,7,1,8,0,0.000001,0,19844,23,0.000054,14,0.161822,0.171981,21570,0.267857,0.001613
109146,109146,,2,9,11,2,9,11,0.000056,0.000104,0,19845,30,0.000011,14,0.176826,0.191755,220.884978,0.145455,0.000438
109147,109147,,6,42,48,6,42,48,0.00035,0.004714,0,18980,0,0.000012,14,0.224824,0.262568,17746.953837,0.109929,0.001533
109148,109148,,3,15,18,3,15,18,0,0.000026,0,19846,23,0.000012,19,0.151634,0.168536,9735.992239,0.140523,0.00067
109149,109149,,0,15,15,0,15,15,0,0.009641,0,19847,2,0.00001,13,0.203719,0.233047,0,0.17619,0
109150,109150,,14,25,39,14,25,39,0.000975,0.001205,0,18631,52,0.000016,18,0.206823,0.232667,20101.927552,0.179487,0.003952
109151,109151,,1,32,33,1,32,33,0.000012,0.002854,0,19848,13,0.00001,16,0.183737,0.209388,4199.498224,0.050189,0.000226
9912127,9912127,,2,10,12,2,10,12,0.000419,0.000397,0,18914,13,0.00001,15,0.174054,0.196145,622.071105,0.174242,0.000521
9606041,9606041,,1,11,12,1,11,12,0.000011,0.000136,0,12010,13,0.000011,10,0.234478,0.276939,67.470056,0.227273,0.000239
9606042,9606042,,1,17,18,1,17,18,0.000011,0.001183,0,12009,13,0.000011,4,0.403599,0.471338,15.641529,0.117647,0.000239
109152,109152,,65,14,79,65,14,79,0.003747,0.002331,0,18865,10,0.000036,15,0.194761,0.217887,22481.358301,0.086336,0.019341
109153,109153,,2,6,8,2,6,8,0.000011,0.000072,0,19849,2,0.000011,16,0.175856,0.193407,2139.575464,0.196429,0.000438
109154,109154,,9,46,55,9,46,55,0.001416,0.024676,0,19319,1,0.000013,13,0.222563,0.257008,17582.241709,0.120539,0.00226
9209036,9209036,,3,3,6,3,3,6,0.000028,0,0,2002,5,0.000015,1,1,1,13343.608736,0.033333,0.000837
9211085,9211085,,4,0,4,4,0,4,0.000134,0,0,2000,5,0.000012,0,0,0,0,0.333333,0.001034
109155,109155,,0,33,33,0,33,33,0,0.003949,0,19851,0,0.00001,17,0.165539,0.199647,0,0.211174,0
9904155,9904155,,1,21,22,1,21,22,0.000046,0.002922,0,19850,0,0.00001,13,0.19584,0.231594,1.52197,0.290043,0.000219
109156,109156,,1,2,3,1,2,3,0,0.000001,0,19852,4,0.000013,12,0.161265,0.176843,0,0.333333,0.000226
109157,109157,,0,11,11,0,11,11,0,0.002694,0,19853,30,0.00001,14,0.188269,0.206426,0,0.263636,0
109158,109158,,0,4,4,0,4,4,0,0.000919,0,19854,30,0.00001,14,0.184699,0.201401,0,0.25,0
109159,109159,,6,8,14,6,8,14,0.000121,0.000657,0,18999,0,0.000013,18,0.179487,0.20096,1669.128816,0.252747,0.00139
109160,109160,,1,25,26,1,25,26,0.000033,0.001326,0,19855,30,0.00001,14,0.190642,0.216277,104.414049,0.310769,0.000219
109161,109161,,1,8,9,1,8,9,0,0.000038,0,19856,30,0.000014,14,0.160895,0.171788,7947.396118,0.013889,0.000219
9707165,9707165,,2,1,3,2,1,3,0,0,0,16053,30,0.000015,2,0.666667,0.75,5,0.166667,0.000458
109162,109162,,105,211,316,105,211,316,0.00274,0.018745,0,17833,30,0.000079,13,0.247795,0.287911,732480.596181,0.039783,0.025504
110113,110113,,17,40,57,17,40,57,0.000714,0.00381,0,18816,30,0.000016,13,0.223823,0.249558,65262.320365,0.141291,0.00424
110066,110066,,11,30,41,11,30,41,0.000638,0.002728,0,18815,30,0.000014,16,0.198748,0.22094,7328.144586,0.190854,0.0028
110093,110093,,25,25,50,25,25,50,0.000952,0.005513,0,17834,30,0.000019,12,0.221408,0.245426,44340.209285,0.131429,0.006037
109163,109163,,3,11,14,3,11,14,0.000021,0.002314,0,19857,30,0.000014,14,0.203862,0.223375,8065.175665,0.126374,0.000664
109164,109164,,0,17,17,0,17,17,0,0.004134,0,19858,0,0.00001,16,0.176512,0.198238,0,0.165441,0
109165,109165,,18,7,25,18,7,25,0.00078,0.001377,0,18895,0,0.000024,16,0.201761,0.227856,20864.660231,0.153333,0.004649
109166,109166,,1,2,3,1,2,3,0,0.00001,0,19859,5,0.000012,16,0.131656,0.143539,1,0.166667,0.000219
109167,109167,,0,2,2,0,2,2,0,0,0,19862,20,0.00001,2,0.625,0.7,0,0.5,0
9606137,9606137,,1,4,5,1,4,5,0,0.000001,0,19861,20,0.000014,1,1,1,2.5,0.1,0.000219
9212022,9212022,,4,0,4,4,0,4,0.000023,0,0,5646,5,0.000016,0,0,0,0,0.083333,0.000999
9310038,9310038,,3,0,3,3,0,3,0.000004,0,0,19860,52,0.000014,0,0,0,0,0.166667,0.000677
109169,109169,,0,1,1,0,1,1,0,0,0,19863,23,0.00001,1,1,1,0,0,0
109170,109170,,0,24,24,0,24,24,0,0.001447,0,19864,52,0.00001,18,0.196341,0.222371,0,0.213768,0
109171,109171,,1,3,4,1,3,4,0,0.000001,0,19865,23,0.00001,16,0.119588,0.131443,31.626428,0.25,0.000219
109172,109172,,6,1,7,6,1,7,0.000415,0.000003,0,18532,23,0.000028,12,0.15257,0.166069,6218.607223,0.02381,0.003209
109173,109173,,5,30,35,5,30,35,0.000123,0.003132,0,19195,0,0.000012,13,0.193379,0.216945,6348.160982,0.171429,0.001164
109174,109174,,22,24,46,22,24,46,0.00382,0.022116,0,18522,1,0.000024,15,0.208164,0.233434,25047.809341,0.117391,0.005597
109175,109175,,11,18,29,11,18,29,0.001061,0.002904,0,19287,1,0.000014,13,0.201843,0.224359,123878.271089,0.105911,0.00355
109176,109176,,8,57,65,8,57,65,0.000223,0.004414,0,19866,30,0.000013,12,0.22342,0.249789,16829.572238,0.107933,0.001956
109177,109177,,21,24,45,21,24,45,0.001868,0.00275,0,18576,10,0.000017,16,0.202893,0.230932,35983.145921,0.241414,0.006656
109178,109178,,3,2,5,3,2,5,0,0.000004,0,19867,25,0.00002,15,0.148156,0.15763,3,0.3,0.000671
109179,109179,,3,15,18,3,15,18,0.000001,0.000026,0,19868,22,0.000016,15,0.163321,0.176752,9260.965369,0.202614,0.000664
109180,109180,,1,14,15,1,14,15,0.000029,0.002434,0,19869,25,0.00001,16,0.187602,0.209452,14.425527,0.342857,0.000226
109182,109182,,23,69,92,23,69,92,0.000605,0.002149,0,18830,3,0.00002,15,0.193021,0.215889,7318.135618,0.169852,0.006945
109183,109183,,5,21,26,5,21,26,0.000583,0.00703,0,18530,2,0.000012,15,0.205983,0.234967,6594.023909,0.155385,0.001258
109184,109184,,0,25,25,0,25,25,0,0.000034,0,19870,9,0.00001,13,0.17983,0.205186,0,0.161667,0
9308038,9308038,,2,3,5,2,3,5,0,0.000011,0,7499,9,0.000016,2,0.714286,0.8,60.055385,0.15,0.00048
9411185,9411185,,1,4,5,1,4,5,0.000002,0.000001,0,7497,9,0.000022,3,0.6,0.703704,16.805195,0.25,0.000304
109185,109185,,1,1,2,1,1,2,0,0,0,19871,22,0.000012,1,1,1,0,0.5,0.000226
109186,109186,,5,24,29,5,24,29,0.000053,0.000356,0,19503,30,0.000015,14,0.197112,0.215143,12405.791319,0.107143,0.001268
109187,109187,,5,30,35,5,30,35,0.000254,0.001246,0,18827,3,0.000011,13,0.202642,0.224182,42539.808208,0.256303,0.001448
109189,109189,,5,3,8,5,3,8,0.000001,0.000004,0,19872,23,0.000015,15,0.146911,0.156357,30.572536,0.410714,0.001148
109190,109190,,0,8,8,0,8,8,0,0.000574,0,19873,1,0.00001,14,0.174286,0.191613,0,0.392857,0
109191,109191,,9,28,37,9,28,37,0.000187,0.003259,0,18823,30,0.000014,13,0.213348,0.235769,24115.004886,0.126126,0.002103
109192,109192,,2,24,26,2,24,26,0.000053,0.007636,0,19874,2,0.000011,14,0.211571,0.238736,835.344548,0.204615,0.000492
109193,109193,,2,10,12,2,10,12,0.000063,0.002449,0,19875,0,0.000011,13,0.192169,0.213475,1255.259118,0.136364,0.000475
109194,109194,,1,23,24,1,23,24,0.000029,0.002025,0,19876,25,0.00001,13,0.196933,0.219117,511.952424,0.132246,0.000219
109195,109195,,1,18,19,1,18,19,0.000136,0.001065,0,18825,30,0.00001,13,0.214827,0.236265,521.768545,0.295322,0.000518
109196,109196,,2,15,17,2,15,17,0.000002,0.000892,0,19877,13,0.000015,13,0.196234,0.217301,17002.249737,0.095588,0.000445
109197,109197,,1,25,26,1,25,26,0.000047,0.002218,0,19878,0,0.00001,15,0.199756,0.227584,671.194419,0.090769,0.000233
109200,109200,,8,22,30,8,22,30,0.000337,0.001614,0,18632,52,0.000013,19,0.200972,0.226682,5535.464575,0.166667,0.002267
109201,109201,,3,2,5,3,2,5,0.000226,0.000006,0,18943,8,0.00002,14,0.166083,0.182196,16768.017361,0.1,0.000698
109202,109202,,1,11,12,1,11,12,0,0.000008,0,19879,20,0.000012,13,0.162542,0.175017,1558.583637,0.272727,0.000219
109203,109203,,0,1,1,0,1,1,0,0,0,19880,23,0.00001,3,0.458333,0.5,0,0,0
109204,109204,,8,14,22,8,14,22,0.000146,0.000231,0,18820,30,0.000013,14,0.189532,0.206309,4110.024694,0.225108,0.001986
109205,109205,,1,2,3,1,2,3,0,0,0,19881,23,0.000014,2,0.6,0.666667,1,0.166667,0.000219
9510196,9510196,,2,0,2,2,0,2,0,0,0,13847,23,0.000041,0,0,0,0,0,0.000459
109207,109207,,0,4,4,0,4,4,0,0.000329,0,19882,15,0.00001,17,0.191488,0.211401,0,0.083333,0
109208,109208,,1,3,4,1,3,4,0.000018,0.000009,0,19883,26,0.000011,17,0.123055,0.13188,9.242857,0.25,0.000239
109209,109209,,18,43,61,18,43,61,0.000615,0.002419,0,19884,30,0.000016,13,0.212525,0.238149,10417.303615,0.163388,0.004417
109211,109211,,0,6,6,0,6,6,0,0.001633,0,19885,0,0.00001,14,0.166061,0.183372,0,0.266667,0
109212,109212,,0,101,101,0,101,101,0,0.000049,0,19888,6,0.00001,15,0.178984,0.206812,0,0.038713,0
9802070,9802070,,2,5,7,2,5,7,0.000001,0.000028,0,19887,9,0.000012,7,0.244792,0.330243,43.353968,0.071429,0.000438
9208079,9208079,,7,0,7,7,0,7,0.000002,0,0,1896,6,0.000026,0,0,0,0,0.095238,0.00164
9209015,9209015,,4,0,4,4,0,4,0,0,0,8223,6,0.000019,0,0,0,0,0,0.000926
9304140,9304140,,1,0,1,1,0,1,0,0,0,6777,6,0.000012,0,0,0,0,0,0.000311
9501138,9501138,,1,2,3,1,2,3,0,0,0,9305,6,0.000012,1,1,1,0,0.5,0.000241
9505180,9505180,,1,0,1,1,0,1,0,0,0,19886,9,0.000012,0,0,0,0,0,0.000232
9612029,9612029,,2,16,18,2,16,18,0.000026,0.000458,0,10683,6,0.000011,12,0.195072,0.227814,1333.098326,0.120915,0.000473
9612252,9612252,,2,1,3,2,1,3,0.000004,0,0,10686,6,0.000015,1,1,1,147,0.166667,0.000466
9712249,9712249,,1,19,20,1,19,20,0.000004,0.001886,0,10684,6,0.00001,12,0.176143,0.208303,375.771416,0.113158,0.000247
9708047,9708047,,3,7,10,3,7,10,0.000235,0.000181,0,7692,0,0.000012,12,0.201874,0.226878,3189.261489,0.344444,0.000801
9710096,9710096,,1,14,15,1,14,15,0.000024,0.001786,0,11039,0,0.000011,13,0.177739,0.208275,4283.144217,0.214286,0.000247
109214,109214,,11,19,30,11,19,30,0.000296,0.000622,0,19015,4,0.000013,14,0.197831,0.220374,3894.550697,0.278161,0.00341
109215,109215,,0,6,6,0,6,6,0,0.000003,0,19890,22,0.00001,14,0.190266,0.204733,0,0.166667,0
9907049,9907049,,1,4,5,1,4,5,0,0.000001,0,19889,22,0.000011,16,0.119173,0.131295,139.310497,0.25,0.000219
9401063,9401063,,1,0,1,1,0,1,0,0,0,10812,22,0.000013,0,0,0,0,0,0.000259
9504125,9504125,,5,0,5,5,0,5,0.000002,0,0,10810,22,0.000018,0,0,0,0,0.1,0.001155
9505165,9505165,,2,1,3,2,1,3,0,0,0,8387,21,0.000017,2,0.666667,0.75,68.836513,0.166667,0.000501
109216,109216,,1,28,29,1,28,29,0.000103,0.001915,0,19891,25,0.00001,13,0.200886,0.221632,201.719298,0.181034,0.000253
109217,109217,,5,39,44,5,39,44,0.000276,0.007299,0,19892,4,0.000011,15,0.201122,0.228645,4450.107557,0.073996,0.001309
109218,109218,,2,4,6,2,4,6,0,0.000002,0,19893,26,0.000012,4,0.538462,0.72619,10.5,0.166667,0.000438
109219,109219,,4,10,14,4,10,14,0.00003,0.000065,0,19304,9,0.000011,13,0.175839,0.193566,7882.611488,0.148352,0.000986
109220,109220,,3,15,18,3,15,18,0.000008,0.000026,0,19894,23,0.000014,14,0.165109,0.187626,1711.907295,0.111111,0.000677
109223,109223,,1,5,6,1,5,6,0,0.000004,0,19895,2,0.000013,18,0.12719,0.144122,912.134889,0.066667,0.000232
109224,109224,,7,5,12,7,5,12,0.000001,0.000002,0,19896,23,0.000018,19,0.158557,0.168747,39291.541713,0.075758,0.001634
9410019,9410019,,3,0,3,3,0,3,0,0,0,3635,26,0.00002,0,0,0,0,0,0.0008
110002,110002,,5,38,43,5,38,43,0.000141,0.005648,0,19897,3,0.000012,15,0.209925,0.237296,4438.485677,0.136213,0.001155
110003,110003,,0,2,2,0,2,2,0,0,0,19899,26,0.00001,11,0.141204,0.160394,0,0,0
9706220,9706220,,3,4,7,3,4,7,0,0,0,19898,26,0.000018,10,0.162891,0.190261,421.808672,0.095238,0.000664
9607199,9607199,,2,1,3,2,1,3,0,0,0,13761,26,0.000018,1,1,1,0,0.5,0.000471
9610240,9610240,,2,3,5,2,3,5,0.000004,0.000001,0,13762,26,0.000015,1,1,1,1073.10041,0.15,0.000465
110004,110004,,2,10,12,2,10,12,0.000199,0.000068,0,19900,23,0.00001,15,0.153881,0.170611,574.240279,0.25,0.000492
110005,110005,,1,39,40,1,39,40,0.000013,0.002916,0,19901,30,0.000011,13,0.219263,0.243475,867.464274,0.116026,0.000219
110006,110006,,7,31,38,7,31,38,0.000044,0.000915,0,19902,30,0.000013,13,0.209902,0.233985,8743.466438,0.13798,0.001627
110008,110008,,1,19,20,1,19,20,0.000218,0.001095,0,18629,52,0.00001,12,0.207143,0.229151,3228.386793,0.281579,0.000329
110009,110009,,0,1,1,0,1,1,0,0.000001,0,19903,17,0.00001,1,1,1,0,0,0
110010,110010,,0,5,5,0,5,5,0,0.000005,0,19904,20,0.00001,17,0.136379,0.147745,0,0.05,0
110011,110011,,0,4,4,0,4,4,0,0.000113,0,19905,13,0.00001,14,0.1527,0.167086,0,0.25,0
9801203,9801203,,1,1,2,1,1,2,0.000019,0.000001,0,14945,5,0.000011,13,0.154352,0.164973,0,0.5,0.000232
110013,110013,,0,7,7,0,7,7,0,0.001117,0,19906,25,0.00001,14,0.188804,0.207549,0,0.309524,0
110015,110015,,0,2,2,0,2,2,0,0,0,19907,21,0.00001,14,0.111584,0.126346,0,0.5,0
110016,110016,,1,4,5,1,4,5,0,0.000001,0,19912,26,0.00001,15,0.144928,0.154699,0.25,0.4,0.000219
9811070,9811070,,2,9,11,2,9,11,0,0.000062,0,19911,26,0.000013,14,0.16903,0.184461,9954.960441,0.127273,0.000445
9806210,9806210,,1,5,6,1,5,6,0.000001,0.000003,0,19910,26,0.000011,9,0.199274,0.224191,374.140254,0.033333,0.000232
110017,110017,,0,5,5,0,5,5,0,0.000025,0,19913,9,0.00001,18,0.175933,0.191003,0,0.3,0
110018,110018,,4,17,21,4,17,21,0.000131,0.001012,0,19917,25,0.000012,14,0.172829,0.191831,1978.909489,0.097619,0.000977
9808110,9808110,,3,3,6,3,3,6,0.000021,0.000006,0,19915,23,0.000013,11,0.160876,0.184454,410.021795,0.266667,0.000698
9907025,9907025,,2,5,7,2,5,7,0.000021,0.000033,0,19916,23,0.000011,11,0.164878,0.198495,59.599673,0.214286,0.000466
9306015,9306015,,1,5,6,1,5,6,0.000003,0.000223,0,7545,13,0.000012,3,0.521739,0.652778,4.630139,0.233333,0.000267
9312034,9312034,,2,0,2,2,0,2,0,0,0,19914,23,0.000023,0,0,0,0,0,0.000458
110019,110019,,1,22,23,1,22,23,0.000063,0.004266,0,19918,30,0.00001,14,0.198703,0.22015,44.774203,0.264822,0.000232
110020,110020,,2,22,24,2,22,24,0,0.000022,0,19919,22,0.000012,13,0.176585,0.194263,4208.955717,0.197464,0.000445
110021,110021,,13,23,36,13,23,36,0.00023,0.000016,0,16332,20,0.000017,13,0.16701,0.18389,17059.025232,0.145238,0.003172
110022,110022,,7,17,24,7,17,24,0.000472,0.001673,0,19077,0,0.000013,13,0.186056,0.204706,3276.394604,0.211957,0.001648
110023,110023,,2,1,3,2,1,3,0,0,0,19920,23,0.000014,8,0.251001,0.269738,304.589103,0,0.000451
9504009,9504009,,3,3,6,3,3,6,0,0.000002,0,13921,23,0.000023,2,0.714286,0.8,304.353301,0.233333,0.000698
110024,110024,,4,20,24,4,20,24,0.000958,0.019857,0,19921,1,0.000011,16,0.217274,0.249633,7606.434494,0.23913,0.000943
110025,110025,,1,15,16,1,15,16,0.000105,0.004463,0,19922,0,0.00001,17,0.168215,0.204944,0.24359,0.266667,0.000226
110026,110026,,6,48,54,6,48,54,0.000136,0.000036,0,19923,20,0.000016,12,0.178565,0.199021,21665.463349,0.063242,0.001322
110027,110027,,0,4,4,0,4,4,0,0.000034,0,19924,1,0.00001,18,0.175365,0.193393,0,0.5,0
110028,110028,,60,74,134,60,74,134,0.003812,0.0106,0,16222,4,0.000036,15,0.217357,0.257803,226061.932792,0.075917,0.021083
9411183,9411183,,1,8,9,1,8,9,0.000045,0.001337,0,3494,0,0.000012,6,0.279116,0.339209,2004.098851,0.083333,0.000385
110029,110029,,2,8,10,2,8,10,0,0.000005,0,19925,5,0.000012,16,0.122663,0.131616,3704.342732,0.311111,0.000445
110030,110030,,0,5,5,0,5,5,0,0.002047,0,19927,2,0.00001,13,0.199542,0.225092,0,0.25,0
109120,109120,,2,0,2,2,0,2,0.000024,0,0,19926,23,0.000014,0,0,0,0,0,0.000445
110032,110032,,0,17,17,0,17,17,0,0.002192,0,19928,5,0.00001,13,0.172936,0.20273,0,0.205882,0
110033,110033,,0,5,5,0,5,5,0,0,0,19929,26,0.00001,12,0.139325,0.16552,0,0.3,0
110034,110034,,32,30,62,32,30,62,0.002582,0.003222,0,18577,10,0.000021,16,0.199837,0.227963,30226.367512,0.163141,0.009802
110035,110035,,11,21,32,11,21,32,0.000361,0.001783,0,19930,30,0.000014,15,0.204281,0.225446,6327.911844,0.144153,0.00268
206013,206013,,6,30,36,6,30,36,0.000089,0.001172,0,19940,30,0.000013,17,0.200752,0.224901,10713.776569,0.097619,0.001361
110101,110101,,6,8,14,6,8,14,0.000154,0.000847,0,19939,30,0.000012,14,0.18969,0.207164,4334.553955,0.197802,0.001401
110177,110177,,8,7,15,8,7,15,0.000209,0.000877,0,19938,30,0.000013,14,0.201607,0.22133,5975.640026,0.266667,0.001958
111006,111006,,3,12,15,3,12,15,0.000119,0.001655,0,19937,30,0.000011,14,0.194343,0.21197,267.867227,0.219048,0.000723
112027,112027,,3,22,25,3,22,25,0.000119,0.001511,0,19936,30,0.000011,16,0.211253,0.236494,11386.18115,0.141667,0.000723
201251,201251,,6,3,9,6,3,9,0.000112,0.000804,0,19934,30,0.000013,14,0.177894,0.193268,137.698841,0.166667,0.001454
202065,202065,,5,50,55,5,50,55,0.000119,0.007349,0,19933,30,0.000012,13,0.216087,0.24495,15336.030454,0.073401,0.001263
205094,205094,,3,6,9,3,6,9,0.000044,0.000851,0,19932,30,0.000011,14,0.17944,0.197663,402.993323,0.222222,0.000737
110036,110036,,1,33,34,1,33,34,0.000085,0.003675,0,19941,0,0.00001,13,0.210973,0.240322,705.817025,0.125668,0.000267
110038,110038,,0,1,1,0,1,1,0,0,0,19942,23,0.00001,2,0.6,0.666667,0,0,0
110039,110039,,23,22,45,23,22,45,0.000665,0.004094,0,18995,2,0.000026,19,0.204298,0.231347,29580.275201,0.121212,0.006606
110040,110040,,4,4,8,4,4,8,0.000016,0.000005,0,19943,15,0.000015,14,0.162262,0.173997,6056.615262,0.196429,0.000923
110041,110041,,6,42,48,6,42,48,0.000551,0.004722,0,18891,3,0.000012,14,0.209706,0.238745,12202.37948,0.14273,0.001676
110042,110042,,0,2,2,0,2,2,0,0,0,19946,23,0.00001,7,0.220322,0.238715,0,0,0
9704084,9704084,,3,2,5,3,2,5,0.000019,0.000589,0,19945,23,0.00002,6,0.28,0.310829,471.800524,0.1,0.000658
9906050,9906050,,2,0,2,2,0,2,0,0,0,19944,23,0.000019,0,0,0,0,0,0.000438
110043,110043,,0,5,5,0,5,5,0,0,0,19947,23,0.00001,15,0.117801,0.127225,0,0.2,0
110044,110044,,2,5,7,2,5,7,0,0.000004,0,19948,5,0.000012,17,0.109464,0.116598,95.054001,0.142857,0.000458
110045,110045,,0,3,3,0,3,3,0,0.000001,0,19949,23,0.00001,16,0.134579,0.144859,0,0.5,0
110046,110046,,7,32,39,7,32,39,0.000123,0.000902,0,18822,30,0.000014,13,0.217898,0.241204,47920.877189,0.145074,0.001734
9907162,9907162,,1,1,2,1,1,2,0.000011,0.000027,0,18819,30,0.00001,14,0.143075,0.156981,19.203054,0,0.000267
110047,110047,,0,8,8,0,8,8,0,0,0,19950,23,0.00001,15,0.12922,0.137324,0,0.125,0
110049,110049,,6,18,24,6,18,24,0.000579,0.004714,0,17746,25,0.000012,16,0.182503,0.206319,656.452477,0.208333,0.001352
110117,110117,,4,21,25,4,21,25,0.000121,0.005056,0,17745,25,0.000012,17,0.18157,0.206431,615.527376,0.195,0.000898
110050,110050,,36,50,86,36,50,86,0.002904,0.019335,0,18874,4,0.000025,15,0.216002,0.248959,128136.25624,0.093023,0.01386
110051,110051,,2,7,9,2,7,9,0.000266,0.000944,0,19951,25,0.000011,12,0.190562,0.207483,198.682024,0.125,0.000445
9502016,9502016,,5,0,5,5,0,5,0.000018,0,0,4610,5,0.000023,0,0,0,0,0.1,0.001221
110052,110052,,0,3,3,0,3,3,0,0.000002,0,19953,22,0.00001,2,0.8,0.875,0,0.166667,0
9707030,9707030,,2,1,3,2,1,3,0,0,0,19952,22,0.000015,1,1,1,0.5,0.166667,0.000438
110053,110053,,2,4,6,2,4,6,0.000034,0.000312,0,19954,2,0.000011,15,0.158572,0.17566,4.569725,0.4,0.000458
110054,110054,,8,21,29,8,21,29,0.000013,0.000017,0,19955,20,0.000014,13,0.168302,0.184666,3848.992974,0.176108,0.001872
110055,110055,,5,301,306,5,301,306,0.000336,0.060279,0,18571,25,0.000013,12,0.269291,0.324299,202843.785125,0.030719,0.001223
9309064,9309064,,5,0,5,5,0,5,0.000062,0,0,508,3,0.000017,0,0,0,0,0.05,0.001935
9309101,9309101,,1,2,3,1,2,3,0.000003,0.000242,0,507,13,0.000015,1,1,1,15.577129,0,0.00042
9507055,9507055,,1,2,3,1,2,3,0.000009,0.000002,0,3275,20,0.000011,2,0.75,0.833333,2556.974311,0,0.000268
9704110,9704110,,1,61,62,1,61,62,0.000204,0.017769,0,4638,13,0.000011,13,0.220068,0.277599,1381.938165,0.116076,0.000519
9510068,9510068,,4,0,4,4,0,4,0.000439,0,0,1430,6,0.000031,0,0,0,0,0,0.001058
110056,110056,,1,3,4,1,3,4,0.000199,0.000045,0,19956,1,0.00001,14,0.168236,0.181398,0,0.333333,0.000259
110058,110058,,1,20,21,1,20,21,0.000003,0.000182,0,19957,26,0.00001,12,0.196987,0.217487,523.318491,0.264286,0.000265
110059,110059,,5,15,20,5,15,20,0.000056,0.001161,0,19958,30,0.000014,14,0.189505,0.209433,1935.667268,0.202632,0.001129
110061,110061,,1,1,2,1,1,2,0.000064,0,0,19960,8,0.00001,1,1,1,1,0,0.000219
104019,104019,,1,0,1,1,0,1,0,0,0,19959,8,0.000019,0,0,0,0,0,0.000226
110063,110063,,5,16,21,5,16,21,0.00001,0.000091,0,19961,0,0.000013,19,0.165753,0.183348,3926.867122,0.169048,0.001155
110065,110065,,3,9,12,3,9,12,0.000002,0.00012,0,19962,0,0.000013,14,0.166257,0.183441,1667.330107,0.204545,0.000697
110067,110067,,3,32,35,3,32,35,0.000343,0.003936,0,19129,52,0.000011,15,0.191201,0.215728,15410.678545,0.088235,0.000901
110068,110068,,0,11,11,0,11,11,0,0.000092,0,19963,30,0.00001,17,0.146978,0.159199,0,0.172727,0
9310147,9310147,,1,0,1,1,0,1,0,0,0,6828,30,0.000013,0,0,0,0,0,0.00024
110069,110069,,8,18,26,8,18,26,0.000198,0.000946,0,19964,2,0.000013,16,0.187502,0.211821,4807.767225,0.146154,0.00194
110070,110070,,12,13,25,12,13,25,0.000662,0.001815,0,18851,25,0.000017,15,0.190655,0.211998,7314.423431,0.161667,0.002896
110071,110071,,17,35,52,17,35,52,0.001216,0.002639,0,19965,52,0.000018,16,0.199643,0.225248,32621.92179,0.121418,0.004038
110073,110073,,17,5,22,17,5,22,0.000122,0.001408,0,19067,0,0.000038,13,0.162446,0.175693,11456.072478,0.207792,0.004217
110074,110074,,5,17,22,5,17,22,0.000217,0.000661,0,19966,2,0.000014,14,0.198622,0.220393,11707.438838,0.177489,0.001141
110075,110075,,2,1,3,2,1,3,0,0,4,19967,16,0.000017,3,0.428571,0.5,0,0.333333,0.000438
110076,110076,,0,14,14,0,14,14,0,0.000013,0,19968,23,0.00001,20,0.140509,0.155155,0,0.258242,0
110077,110077,,24,18,42,24,18,42,0.000831,0.000757,0,16235,3,0.00002,16,0.196402,0.219544,7944.980972,0.227062,0.007487
110078,110078,,0,2,2,0,2,2,0,0,0,19972,9,0.00001,11,0.148419,0.171639,0,0,0
9805010,9805010,,1,9,10,1,9,10,0,0.000005,0,19971,22,0.000014,10,0.172844,0.212479,441,0.122222,0.000219
9611102,9611102,,1,7,8,1,7,8,0,0,0,19970,22,0.000011,5,0.376147,0.478049,46.9,0.196429,0.000226
110079,110079,,7,14,21,7,14,21,0.000003,0.001529,0,19973,15,0.000015,16,0.17552,0.193942,7418.833245,0.121429,0.001633
111257,111257,,1,4,5,1,4,5,0,0,0,19974,28,0.000013,15,0.123886,0.131324,1,0.25,0.000219
110080,110080,,5,6,11,5,6,11,0.000005,0.000002,0,19976,23,0.000015,14,0.132633,0.142601,11.808333,0.218182,0.001141
9808010,9808010,,2,2,4,2,2,4,0.000005,0,0,19975,23,0.000012,1,1,1,3.809524,0.25,0.000491
110081,110081,,2,8,10,2,8,10,0,0.00001,0,19977,6,0.000013,14,0.135128,0.144313,32633.29144,0.177778,0.000478
110082,110082,,2,1,3,2,1,3,0,0,0,19979,5,0.000011,1,1,1,0,0.333333,0.000438
12243,12243,,3,0,3,3,0,3,0,0,0,19978,5,0.000021,0,0,0,0,0.333333,0.00067
110084,110084,,0,96,96,0,96,96,0,0.026514,0,19980,1,0.00001,12,0.230733,0.26656,0,0.068969,0
9909184,9909184,,2,24,26,2,24,26,0.000343,0.003034,0,19254,13,0.00001,16,0.184541,0.216526,204.316012,0.118462,0.000461
110085,110085,,0,14,14,0,14,14,0,0.006817,0,19981,1,0.00001,13,0.200985,0.224225,0,0.186813,0
110088,110088,,0,21,21,0,21,21,0,0.002414,0,19982,25,0.00001,12,0.208766,0.231098,0,0.080952,0
110090,110090,,0,9,9,0,9,9,0,0.000937,0,19983,30,0.00001,13,0.209372,0.229205,0,0.236111,0
110091,110091,,0,6,6,0,6,6,0,0.000185,0,19984,3,0.00001,15,0.179691,0.197836,0,0.1,0
110092,110092,,4,13,17,4,13,17,0.000131,0.0008,0,19985,3,0.000011,16,0.193993,0.214767,394.160016,0.1875,0.00091
110094,110094,,1,16,17,1,16,17,0.000002,0.002086,0,19986,3,0.00001,16,0.19194,0.21743,773.655198,0.139706,0.000232
110096,110096,,7,19,26,7,19,26,0.000846,0.001227,0,19987,2,0.000012,13,0.210311,0.232577,7856.850343,0.164615,0.001671
110097,110097,,2,4,6,2,4,6,0,0.000004,0,19988,2,0.000014,19,0.149485,0.163333,8992.362749,0.166667,0.000445
110098,110098,,3,15,18,3,15,18,0.000092,0.002979,0,19989,4,0.000011,12,0.190005,0.21402,657.904418,0.313726,0.000724
110099,110099,,27,30,57,27,30,57,0.001254,0.001503,0,16237,3,0.000021,14,0.203215,0.228657,29267.289686,0.154135,0.009652
110107,110107,,25,39,64,25,39,64,0.001165,0.00233,0,16242,3,0.00002,13,0.20765,0.234304,46103.73323,0.134921,0.008893
110200,110200,,17,67,84,17,67,84,0.00115,0.0071,0,16281,3,0.000016,12,0.225353,0.257329,136710.869373,0.092369,0.0054
110170,110170,,31,24,55,31,24,55,0.001615,0.000995,0,16273,3,0.000024,14,0.198846,0.221987,16732.386385,0.140404,0.00911
110186,110186,,18,33,51,18,33,51,0.001227,0.004966,0,16272,3,0.000015,13,0.2278,0.259878,59923.060986,0.160392,0.00526
110100,110100,,0,11,11,0,11,11,0,0.001805,0,19990,30,0.00001,15,0.184063,0.20309,0,0.227273,0
110102,110102,,5,1,6,5,1,6,0,0,0,19991,2,0.000024,2,0.666667,0.75,0,0.366667,0.001135
110103,110103,,4,25,29,4,25,29,0.000072,0.001961,0,19992,25,0.000013,14,0.188882,0.211085,4009.107914,0.169951,0.000937
110104,110104,,0,9,9,0,9,9,0,0.001944,0,19993,4,0.00001,13,0.187801,0.207435,0,0.222222,0
110106,110106,,2,10,12,2,10,12,0.000017,0.00246,0,19994,30,0.000011,15,0.180358,0.198808,705.968378,0.204545,0.000438
110109,110109,,11,26,37,11,26,37,0.001136,0.007927,0,19042,1,0.000014,15,0.216286,0.249792,11683.463347,0.092342,0.00278
110110,110110,,1,20,21,1,20,21,0.000006,0.000145,0,19996,0,0.00001,19,0.1567,0.177605,291.782368,0.15,0.000239
9506056,9506056,,1,4,5,1,4,5,0.000002,0.000063,0,19995,0,0.00001,5,0.326797,0.39,4.212437,0.15,0.000226
110111,110111,,4,38,42,4,38,42,0.000243,0.01808,0,19997,25,0.000012,14,0.214366,0.246086,5772.438167,0.099884,0.000897
110112,110112,,5,43,48,5,43,48,0.000197,0.003223,0,18824,30,0.000012,14,0.200403,0.222463,58040.384716,0.185284,0.001518
110114,110114,,17,16,33,17,16,33,0.000305,0.001178,0,19505,30,0.000035,13,0.220834,0.245545,123507.204122,0.066288,0.004062
9611126,9611126,,3,1,4,3,1,4,0,0,0,12053,23,0.000025,1,1,1,1730.172761,0,0.00068
9702125,9702125,,3,1,4,3,1,4,0,0,0,12050,23,0.000035,1,1,1,1348.530983,0.333333,0.000706
9703006,9703006,,2,2,4,2,2,4,0,0,0,12052,23,0.000029,1,1,1,1825.667393,0.166667,0.000467
9703018,9703018,,2,2,4,2,2,4,0,0,0,12051,23,0.000016,1,1,1,1350.530983,0.166667,0.000461
110115,110115,,17,52,69,17,52,69,0.000981,0.005736,0,19012,10,0.000015,15,0.212511,0.246531,21736.003457,0.121697,0.005552
110116,110116,,4,8,12,4,8,12,0,0.000003,0,19999,6,0.000014,15,0.121588,0.130721,10816.94421,0.174242,0.000916
9601049,9601049,,2,10,12,2,10,12,0,0.000035,0,19998,6,0.000013,7,0.240709,0.290835,403.804127,0.166667,0.000478
110118,110118,,2,31,33,2,31,33,0.000079,0.002106,0,20000,25,0.00001,16,0.189071,0.214747,6345.459732,0.133523,0.000506
110119,110119,,1,18,19,1,18,19,0.000013,0.002832,0,20001,30,0.000012,13,0.228283,0.254918,6711.733324,0.152047,0.000219
110120,110120,,1,2,3,1,2,3,0,0.000004,0,20003,20,0.000011,13,0.163602,0.175958,0,0.333333,0.000219
9902114,9902114,,2,5,7,2,5,7,0,0.000003,0,20002,20,0.000015,5,0.369369,0.451626,16.29359,0.214286,0.000445
110121,110121,,5,24,29,5,24,29,0.000088,0.001606,0,19137,0,0.000012,15,0.187674,0.212514,9852.04301,0.165025,0.001204
110122,110122,,4,17,21,4,17,21,0.000145,0.001968,0,20004,30,0.000011,13,0.215152,0.236517,2013.691014,0.252381,0.000958
302221,302221,,7,56,63,7,56,63,0.000113,0.001931,0,20109,0,0.000012,14,0.214411,0.242899,11654.337533,0.141577,0.001626
201205,201205,,35,59,94,35,59,94,0.001063,0.006641,0,18888,0,0.000021,14,0.212342,0.244696,107673.967216,0.145276,0.010999
202024,202024,,15,35,50,15,35,50,0.000667,0.002038,0,18889,0,0.000021,15,0.19498,0.22322,33959.64871,0.194286,0.00472
203160,203160,,33,50,83,33,50,83,0.001422,0.002619,0,18991,0,0.000019,14,0.205499,0.235059,50289.686184,0.174405,0.01012
203187,203187,,29,54,83,29,54,83,0.001103,0.003371,0,19087,0,0.000019,15,0.198582,0.229561,31410.133772,0.161034,0.008919
204037,204037,,3,25,28,3,25,28,0.00007,0.000681,0,20108,30,0.000011,14,0.21457,0.236102,9441.114232,0.148148,0.000724
206038,206038,,42,135,177,42,135,177,0.002175,0.007619,0,20029,0,0.000021,15,0.229469,0.267181,174922.413568,0.067187,0.011175
208014,208014,,17,80,97,17,80,97,0.000497,0.006051,0,20050,0,0.000014,13,0.215868,0.248302,26366.917793,0.109214,0.004577
208103,208103,,16,28,44,16,28,44,0.000421,0.001156,0,20030,0,0.000014,16,0.207125,0.232799,28946.350239,0.235201,0.004257
209064,209064,,7,25,32,7,25,32,0.000226,0.002713,0,20102,0,0.000013,14,0.195857,0.221344,6606.324934,0.087702,0.001673
209202,209202,,16,45,61,16,45,61,0.000385,0.001579,0,20052,0,0.000014,14,0.203329,0.230649,8437.864703,0.221585,0.004128
210083,210083,,13,77,90,13,77,90,0.000593,0.004892,0,20089,0,0.000013,14,0.220955,0.252285,39501.167397,0.122597,0.003489
210088,210088,,8,46,54,8,46,54,0.000195,0.005916,0,20057,0,0.000012,14,0.216406,0.247985,17008.017256,0.183089,0.002115
210200,210200,,13,52,65,13,52,65,0.000276,0.002621,0,20056,0,0.000013,14,0.205084,0.233486,4542.473989,0.211058,0.003281
210227,210227,,2,25,27,2,25,27,0.000054,0.001051,0,20031,0,0.00001,16,0.204809,0.229239,3934.288831,0.230769,0.000609
211059,211059,,18,57,75,18,57,75,0.000441,0.002699,0,20091,0,0.000014,14,0.213698,0.244078,27507.370144,0.183243,0.004467
211269,211269,,14,22,36,14,22,36,0.000367,0.001945,0,20094,10,0.000014,15,0.19816,0.222599,19533.21782,0.115873,0.003296
212177,212177,,13,49,62,13,49,62,0.000307,0.002817,0,20095,0,0.000013,15,0.201533,0.229434,2958.131561,0.205182,0.003137
110124,110124,,33,10,43,33,10,43,0.000912,0.000222,0,18469,3,0.000026,15,0.180898,0.197603,2163.37814,0.275194,0.011497
110125,110125,,0,4,4,0,4,4,0,0.000001,0,20110,9,0.00001,19,0.147653,0.16079,0,0.166667,0
110126,110126,,0,1,1,0,1,1,0,0,0,20111,6,0.00001,9,0.189655,0.209208,0,0,0
110127,110127,,2,10,12,2,10,12,0.000001,0.001768,0,20112,23,0.000012,11,0.226426,0.255341,14530.199932,0.204545,0.000438
110129,110129,,5,10,15,5,10,15,0.000713,0.000717,0,18958,0,0.000014,12,0.190249,0.210058,14764.354437,0.071429,0.001488
110131,110131,,0,13,13,0,13,13,0,0.001266,0,20113,4,0.00001,12,0.194366,0.214722,0,0.108974,0
110132,110132,,4,29,33,4,29,33,0.000102,0.000547,0,19083,0,0.000011,13,0.195505,0.217042,27394.350152,0.094697,0.000987
110133,110133,,9,15,24,9,15,24,0.000499,0.000133,0,19091,52,0.000016,15,0.174436,0.194102,17029.262141,0.106884,0.002386
9212154,9212154,,10,0,10,10,0,10,0.000103,0,0,4809,52,0.000027,0,0,0,0,0.1,0.002491
9308043,9308043,,4,1,5,4,1,5,0.000017,0,0,19089,52,0.000018,1,1,1,134.296523,0.1,0.001001
9205031,9205031,,9,0,9,9,0,9,0.000017,0,0,4810,15,0.000047,0,0,0,0,0.083333,0.002149
110134,110134,,5,26,31,5,26,31,0.000104,0.003239,0,20114,30,0.000012,13,0.210625,0.232461,1044.666969,0.202151,0.001161
110135,110135,,3,8,11,3,8,11,0,0.00004,0,20115,22,0.000016,16,0.164052,0.176518,27060.049962,0.136364,0.000677
110136,110136,,22,29,51,22,29,51,0.000427,0.000888,0,18471,3,0.000022,17,0.186243,0.207311,3544.60443,0.248235,0.008162
110137,110137,,1,4,5,1,4,5,0.000112,0.000302,0,20116,25,0.00001,14,0.179155,0.195143,68.78905,0.15,0.000245
110138,110138,,0,3,3,0,3,3,0,0.000003,0,20117,23,0.00001,14,0.167662,0.178721,0,0.333333,0
110139,110139,,0,4,4,0,4,4,0,0.000026,0,20118,13,0.00001,16,0.144277,0.163317,0,0.5,0
110140,110140,,4,10,14,4,10,14,0.000011,0.000032,0,20119,5,0.000012,16,0.177495,0.194124,6953.73104,0.175824,0.000909
110141,110141,,4,15,19,4,15,19,0.000065,0.002258,0,20070,25,0.000012,15,0.193799,0.218976,1906.32605,0.122807,0.000953
110142,110142,,1,25,26,1,25,26,0.000316,0.011257,0,20120,1,0.00001,15,0.206783,0.240851,54.107305,0.156923,0.000278
110145,110145,,0,7,7,0,7,7,0,0.000001,0,20121,22,0.00001,19,0.116218,0.137054,0,0.428571,0
110146,110146,,19,29,48,19,29,48,0.001361,0.01234,0,19288,0,0.000019,14,0.197158,0.223716,45045.445084,0.090426,0.005489
110147,110147,,6,22,28,6,22,28,0.000315,0.008143,0,19265,30,0.000013,13,0.218148,0.241506,10216.740171,0.165344,0.001491
110149,110149,,10,4,14,10,4,14,0.000468,0.000093,0,19153,25,0.000023,17,0.165493,0.183096,12887.202438,0.071429,0.002403
110150,110150,,1,2,3,1,2,3,0,0.000001,0,20123,23,0.000019,3,0.5,0.633333,5,0,0.000219
109135,109135,,5,0,5,5,0,5,0.000011,0,0,20122,23,0.000034,0,0,0,0,0,0.001115
110151,110151,,3,6,9,3,6,9,0.000014,0.000453,0,20124,4,0.000014,14,0.195389,0.215197,5397.254387,0.152778,0.000677
110152,110152,,4,13,17,4,13,17,0.00032,0.000544,0,20125,30,0.000011,13,0.197506,0.216849,4643.534706,0.220588,0.000917
110153,110153,,2,11,13,2,11,13,0,0.000004,0,20126,23,0.000012,16,0.132758,0.145297,570.39041,0.314103,0.000567
110154,110154,,0,4,4,0,4,4,0,0.000009,0,20127,5,0.00001,8,0.188107,0.222888,0,0.25,0
110155,110155,,1,1,2,1,1,2,0,0,0,20128,28,0.000012,12,0.133653,0.152244,0,0.5,0.000226
110156,110156,,0,7,7,0,7,7,0,0.000016,0,20129,26,0.00001,15,0.13649,0.14639,0,0.214286,0
9707086,9707086,,1,1,2,1,1,2,0,0,0,7585,26,0.000011,4,0.363636,0.416667,0,0.5,0.000256
110157,110157,,0,10,10,0,10,10,0,0.000004,0,20130,17,0.00001,13,0.143095,0.173576,0,0.222222,0
110158,110158,,5,7,12,5,7,12,0.000374,0.000067,0,19092,52,0.000014,16,0.153991,0.167652,9373.243044,0.159091,0.001468
110159,110159,,2,4,6,2,4,6,0.000036,0.000204,0,19024,10,0.000011,15,0.185817,0.20459,80.991496,0.266667,0.000512
110160,110160,,3,13,16,3,13,16,0.000034,0.000007,0,20131,23,0.000014,14,0.154724,0.170974,3847.599755,0.191667,0.00067
110161,110161,,0,8,8,0,8,8,0,0.016106,0,20132,1,0.00001,12,0.197533,0.218868,0,0.25,0
110162,110162,,6,19,25,6,19,25,0.000118,0.00164,0,20071,25,0.000014,13,0.217611,0.243421,77534.294564,0.158333,0.001599
110163,110163,,0,1,1,0,1,1,0,0.0001,0,20133,0,0.00001,14,0.169929,0.191305,0,0,0
110164,110164,,9,16,25,9,16,25,0.000476,0.000347,0,18912,3,0.000014,14,0.192535,0.213324,5573.342744,0.275,0.002795
110165,110165,,2,3,5,2,3,5,0,0.000035,0,20134,6,0.000012,13,0.187052,0.201746,20389.32548,0.05,0.000438
9306134,9306134,,6,1,7,6,1,7,0.000001,0,0,457,9,0.000021,1,1,1,596.105776,0.095238,0.001433
110167,110167,,16,16,32,16,16,32,0.000649,0.000283,0,19632,8,0.000027,19,0.181372,0.203407,26707.082073,0.076613,0.004123
109033,109033,,4,0,4,4,0,4,0.00003,0,0,19631,8,0.000013,0,0,0,0,0.333333,0.001002
9902127,9902127,,3,0,3,3,0,3,0.000007,0,0,19630,8,0.000029,0,0,0,0,0.166667,0.000776
9502130,9502130,,4,3,7,4,3,7,0.000225,0.000081,0,4552,0,0.000014,4,0.392157,0.466667,1199.614511,0.214286,0.000989
110168,110168,,0,12,12,0,12,12,0,0.000506,0,20135,2,0.00001,15,0.154245,0.171882,0,0.227273,0
9604120,9604120,,2,9,11,2,9,11,0.000007,0.002109,0,9906,2,0.000014,10,0.206941,0.237133,4550.908116,0.136364,0.000452
110171,110171,,22,44,66,22,44,66,0.000848,0.00286,0,19016,10,0.000018,15,0.207017,0.236772,36817.735951,0.157343,0.007881
110172,110172,,7,26,33,7,26,33,0.000332,0.003164,0,19101,2,0.000012,15,0.222546,0.252131,29172.566042,0.10322,0.001684
9709201,9709201,,3,3,6,3,3,6,0.000288,0.000003,0,18643,28,0.000013,11,0.160287,0.183839,350.962799,0.166667,0.000746
9503160,9503160,,3,1,4,3,1,4,0.000049,0,0,18642,28,0.000016,1,1,1,94,0.083333,0.000678
110174,110174,,8,44,52,8,44,52,0.001843,0.00561,0,18517,1,0.000012,15,0.212595,0.245786,7134.071063,0.149321,0.002583
110175,110175,,1,19,20,1,19,20,0.000367,0.019145,0,18957,8,0.00001,13,0.186101,0.207858,0,0.307895,0.000447
110176,110176,,2,13,15,2,13,15,0.000001,0.000009,0,20136,8,0.000012,7,0.311475,0.432926,49.471573,0.171429,0.000478
110179,110179,,0,3,3,0,3,3,0,0,0,20141,15,0.00001,16,0.121409,0.126306,0,0.166667,0
9412069,9412069,,1,5,6,1,5,6,0,0.000001,0,20140,15,0.000013,4,0.517241,0.627778,15,0.033333,0.000219
9401151,9401151,,1,0,1,1,0,1,0,0,0,20139,15,0.000012,0,0,0,0,0,0.000226
9408114,9408114,,3,1,4,3,1,4,0.000033,0,0,5419,15,0.000013,2,0.666667,0.75,0,0.333333,0.000698
9411087,9411087,,1,6,7,1,6,7,0,0.00001,0,20138,15,0.000012,3,0.692308,0.814815,18,0.095238,0.000226
110180,110180,,2,3,5,2,3,5,0,0.000008,0,20142,28,0.000023,16,0.166779,0.180203,20323,0.05,0.000438
9209033,9209033,,2,0,2,2,0,2,0.000004,0,0,609,5,0.000051,0,0,0,0,0.5,0.000523
9209081,9209081,,3,1,4,3,1,4,0.000033,0,0,607,5,0.000054,1,1,1,883.48308,0.083333,0.000828
110181,110181,,0,4,4,0,4,4,0,0,0,20143,6,0.00001,12,0.162008,0.191005,0,0.5,0
110182,110182,,0,11,11,0,11,11,0,0.000023,0,20145,8,0.00001,15,0.160885,0.172368,0,0.1,0
9310132,9310132,,2,0,2,2,0,2,0,0,0,20144,8,0.000013,0,0,0,0,0,0.000438
110183,110183,,7,15,22,7,15,22,0.00012,0.002627,0,20146,30,0.000017,13,0.198258,0.218003,3041.179654,0.199134,0.001653
110184,110184,,4,38,42,4,38,42,0.000381,0.019982,0,20040,52,0.000011,16,0.208848,0.239011,6634.176767,0.13705,0.001379
110185,110185,,3,3,6,3,3,6,0.000018,0.000009,0,20147,26,0.000017,15,0.136289,0.145349,7405.28972,0.2,0.00069
110187,110187,,15,33,48,15,33,48,0.000606,0.004497,0,18881,0,0.000015,13,0.210619,0.240288,16002.198565,0.124113,0.004979
110188,110188,,10,48,58,10,48,58,0.000441,0.004243,0,20149,4,0.000016,14,0.18964,0.216853,31505.940606,0.082577,0.002291
9704092,9704092,,1,9,10,1,9,10,0.00005,0.002159,0,20148,4,0.00001,12,0.196279,0.224101,444.571673,0.177778,0.000285
9910017,9910017,,3,25,28,3,25,28,0.000809,0.020093,0,18556,1,0.000011,14,0.186544,0.211428,33.607721,0.280423,0.000749
110190,110190,,0,4,4,0,4,4,0,0.000929,0,20150,23,0.00001,17,0.175594,0.194277,0,0.166667,0
110191,110191,,12,32,44,12,32,44,0.000249,0.003214,0,19267,30,0.000017,13,0.212948,0.234964,34525.886296,0.109408,0.002923
110192,110192,,0,45,45,0,45,45,0,0.021289,0,20152,1,0.00001,16,0.225546,0.260816,0,0.116162,0
9806175,9806175,,3,19,22,3,19,22,0.000323,0.001298,0,20151,2,0.000011,14,0.185763,0.215866,80.156441,0.21645,0.00067
110193,110193,,18,8,26,18,8,26,0.001108,0.000498,0,19152,25,0.00002,15,0.181878,0.201621,4027.261781,0.243077,0.004629
110195,110195,,5,7,12,5,7,12,0.000112,0.000272,0,18850,8,0.000015,13,0.177729,0.192646,7003.519259,0.121212,0.001349
110198,110198,,3,7,10,3,7,10,0.00007,0.006534,0,20153,8,0.000011,12,0.194483,0.21402,186.436381,0.288889,0.00069
110199,110199,,1,1,2,1,1,2,0,0.000002,0,20154,28,0.000012,5,0.333333,0.421429,0,0.5,0.000219
110201,110201,,1,54,55,1,54,55,0.000013,0.008904,0,20155,0,0.000011,15,0.197701,0.229726,3432.229693,0.132997,0.000219
110202,110202,,5,8,13,5,8,13,0.000452,0.000285,0,20156,1,0.000013,14,0.179529,0.199525,8780.994587,0.089744,0.001176
110203,110203,,3,31,34,3,31,34,0.00018,0.003078,0,18818,30,0.00001,14,0.219466,0.243426,24692.265545,0.205882,0.000963
110204,110204,,19,13,32,19,13,32,0.000357,0.000268,0,18472,3,0.000022,15,0.179203,0.195491,63.01453,0.389113,0.007804
110206,110206,,3,19,22,3,19,22,0.00002,0.001391,0,20162,13,0.000012,11,0.212863,0.252521,85.727375,0.170996,0.000658
9806154,9806154,,7,20,27,7,20,27,0.000111,0.001147,0,20157,13,0.000016,13,0.204596,0.241994,1051.928062,0.128205,0.001633
9811189,9811189,,7,12,19,7,12,19,0.000099,0.002947,0,20161,13,0.000015,12,0.210994,0.241975,3193.732842,0.21345,0.001573
110207,110207,,1,12,13,1,12,13,0.000009,0.001802,0,20163,13,0.00001,11,0.210907,0.249128,13.445749,0.288462,0.000219
9608140,9608140,,2,15,17,2,15,17,0.000024,0.000844,0,20159,13,0.000013,11,0.198536,0.237413,58.711418,0.198529,0.000452
9806247,9806247,,1,4,5,1,4,5,0.000035,0.000258,0,20160,13,0.000011,11,0.224176,0.260891,684.716718,0.15,0.000265
9807009,9807009,,2,11,13,2,11,13,0.000041,0.00065,0,20158,13,0.000012,13,0.209613,0.242502,98.816927,0.205128,0.000491
9604175,9604175,,6,7,13,6,7,13,0.000049,0.000337,0,5335,13,0.000016,9,0.225581,0.262527,151.561632,0.211538,0.001389
9610222,9610222,,3,13,16,3,13,16,0.00002,0.000833,0,5336,13,0.00002,13,0.189747,0.235248,12302.423768,0.220833,0.000753
110208,110208,,0,2,2,0,2,2,0,0,0,20164,0,0.00001,12,0.149577,0.169955,0,0.5,0
110209,110209,,4,39,43,4,39,43,0.000838,0.019396,0,20039,4,0.000011,15,0.204029,0.233513,6543.47231,0.121262,0.001126
110210,110210,,0,1,1,0,1,1,0,0,0,20165,6,0.00001,3,0.5,0.566667,0,0,0
110211,110211,,3,8,11,3,8,11,0.000013,0.000015,0,20166,23,0.000014,16,0.154042,0.169291,3254.598462,0.181818,0.000677
110212,110212,,0,5,5,0,5,5,0,0.000003,0,20167,28,0.00001,3,0.578947,0.69697,0,0.15,0
110214,110214,,1,19,20,1,19,20,0.000144,0.017801,0,20168,1,0.00001,13,0.20358,0.228134,1303.475414,0.202632,0.000226
9708080,9708080,,5,15,20,5,15,20,0.000245,0.000044,0,8031,26,0.000013,16,0.159399,0.188093,50565.762209,0.089474,0.00115
9701138,9701138,,2,8,10,2,8,10,0.000036,0.000003,0,8029,26,0.000012,14,0.136211,0.15769,23257.789438,0.266667,0.000493
110215,110215,,11,29,40,11,29,40,0.000685,0.00118,0,20103,30,0.000013,14,0.204713,0.22673,9840.076845,0.151282,0.002635
110216,110216,,6,26,32,6,26,32,0.000029,0.001276,0,19035,10,0.000017,14,0.197711,0.222066,36107.088901,0.15121,0.00146
110217,110217,,0,6,6,0,6,6,0,0,0,20169,5,0.00001,16,0.116454,0.128056,0,0.233333,0
110218,110218,,2,17,19,2,17,19,0.000001,0.00004,0,19116,6,0.000011,14,0.152905,0.166037,14765.520725,0.154971,0.000478
110219,110219,,12,24,36,12,24,36,0.00056,0.000724,0,19098,52,0.000014,14,0.195612,0.218341,6745.643621,0.17619,0.003267
110220,110220,,1,1,2,1,1,2,0,0,22,20171,44,0.000014,1,1,1,0,0.5,0.000219
12127,12127,,2,0,2,2,0,2,0,0,22,20170,44,0.000027,0,0,0,0,0.5,0.000445
110221,110221,,3,4,7,3,4,7,0.000016,0.000001,0,20172,15,0.000012,15,0.14562,0.153917,6.591049,0.333333,0.000684
110222,110222,,0,6,6,0,6,6,0,0.016859,0,20173,1,0.00001,17,0.194368,0.227108,0,0.433333,0
110223,110223,,1,7,8,1,7,8,0,0.000008,0,20174,9,0.000011,13,0.185886,0.20775,0,0.410714,0.000219
110224,110224,,0,2,2,0,2,2,0,0,0,20175,20,0.00001,4,0.384615,0.466667,0,0.5,0
110225,110225,,10,21,31,10,21,31,0.000194,0.005901,0,20176,0,0.00002,12,0.206708,0.234533,21201.196558,0.12043,0.002435
110226,110226,,25,4,29,25,4,29,0.00136,0.000114,0,18953,8,0.000028,13,0.167368,0.17991,2619.864301,0.230296,0.007269
110227,110227,,1,11,12,1,11,12,0.000003,0.002956,0,20177,0,0.000011,14,0.189957,0.210359,490.311817,0.090909,0.000219
110229,110229,,0,2,2,0,2,2,0,0,0,20178,28,0.00001,4,0.421053,0.541667,0,0.5,0
110230,110230,,1,5,6,1,5,6,0.000002,0.000247,0,20179,1,0.000012,16,0.173849,0.192183,2727.700564,0.233333,0.000219
110231,110231,,5,4,9,5,4,9,0.000079,0.000831,0,19931,30,0.000014,14,0.174366,0.190899,13.52645,0.305556,0.001317
110232,110232,,22,44,66,22,44,66,0.001041,0.001662,0,19017,10,0.000017,15,0.213802,0.244452,71537.523812,0.142657,0.00713
9301089,9301089,,3,0,3,3,0,3,0.000029,0,0,805,0,0.000014,0,0,0,0,0,0.000851
9604140,9604140,,7,13,20,7,13,20,0.00015,0.00029,0,3139,0,0.000015,13,0.198726,0.233396,999.8045,0.289474,0.001923
110233,110233,,0,1,1,0,1,1,0,0,23,20181,45,0.00001,1,1,1,0,0,0
9810196,9810196,,1,0,1,1,0,1,0,0,23,20180,45,0.000019,0,0,0,0,0,0.000219
110235,110235,,3,11,14,3,11,14,0.00022,0.002496,0,18808,1,0.000011,13,0.192903,0.211786,2057.75187,0.148352,0.000718
110252,110252,,8,23,31,8,23,31,0.00075,0.009286,0,18809,1,0.000014,14,0.208262,0.239792,13717.710644,0.137634,0.002417
110236,110236,,0,3,3,0,3,3,0,0.000001,0,20183,4,0.00001,15,0.141885,0.155569,0,0.166667,0
9709149,9709149,,1,2,3,1,2,3,0,0.000002,0,20182,4,0.000013,11,0.1498,0.170136,1,0.166667,0.000219
110237,110237,,0,1,1,0,1,1,0,0,0,20185,22,0.00001,1,1,1,0,0,0
104096,104096,,2,0,2,2,0,2,0,0,0,20184,22,0.00002,0,0,0,0,0,0.000438
110239,110239,,1,10,11,1,10,11,0.000067,0.000331,0,20186,1,0.00001,17,0.162115,0.178447,8.119994,0.327273,0.000219
110240,110240,,5,25,30,5,25,30,0.000788,0.008998,0,20187,4,0.000012,12,0.211654,0.24,8533.219403,0.181609,0.001355
110241,110241,,7,13,20,7,13,20,0.000008,0.000012,0,20188,20,0.000013,14,0.154065,0.167042,8238.509722,0.194737,0.001728
110242,110242,,205,10,215,205,10,215,0.022013,0.00086,0,18533,41,0.000165,18,0.172694,0.195026,43530.331501,0.074875,0.083961
110243,110243,,2,7,9,2,7,9,0.000056,0.000147,0,20189,26,0.000011,15,0.143924,0.159102,14.485509,0.291667,0.000459
110244,110244,,16,9,25,16,9,25,0.000369,0.000099,0,18936,52,0.000021,14,0.170634,0.184666,11341.315867,0.18,0.004297
110245,110245,,0,13,13,0,13,13,0,0.002472,0,20190,2,0.00001,18,0.184966,0.209439,0,0.224359,0
110246,110246,,0,15,15,0,15,15,0,0.000002,0,20191,22,0.00001,15,0.178341,0.193804,0,0.12381,0
110247,110247,,16,10,26,16,10,26,0.001478,0.000387,0,18555,0,0.000032,12,0.208949,0.236144,14270.50152,0.14,0.004263
110248,110248,,4,12,16,4,12,16,0.000084,0.000868,0,18998,2,0.000014,15,0.173767,0.193161,14538.84985,0.079167,0.000932
110249,110249,,1,9,10,1,9,10,0.000003,0.000015,0,20192,28,0.000011,15,0.132648,0.153832,67.769498,0.133333,0.000219
110250,110250,,7,35,42,7,35,42,0.000267,0.004268,0,20065,25,0.000013,14,0.195842,0.218648,10141.365257,0.108014,0.001676
9411089,9411089,,2,1,3,2,1,3,0,0,0,17945,25,0.000038,4,0.428571,0.513889,455.432689,0.166667,0.000499
110251,110251,,2,1,3,2,1,3,0.000067,0.000001,0,20193,28,0.000014,15,0.13803,0.145358,8771.803661,0,0.000438
110255,110255,,1,16,17,1,16,17,0.000011,0.001134,0,20194,25,0.000011,15,0.186163,0.205866,1858.342897,0.183824,0.000232
110256,110256,,1,3,4,1,3,4,0.000066,0.000001,0,20195,4,0.00001,15,0.131067,0.145937,17.25,0.166667,0.000226
110257,110257,,1,2,3,1,2,3,0.000001,0.000058,0,20196,2,0.000012,15,0.168234,0.183037,0,0.333333,0.000219
110258,110258,,11,13,24,11,13,24,0.000147,0.000386,0,20064,25,0.000018,18,0.190008,0.21153,15392.982126,0.074275,0.002648
110260,110260,,26,7,33,26,7,33,0.001446,0.000289,0,18956,25,0.000028,18,0.184152,0.203541,42067.322286,0.088068,0.006971
110259,110259,,1,7,8,1,7,8,0,0.000003,0,20197,15,0.000012,16,0.131066,0.139755,595.408112,0.053571,0.000219
110261,110261,,0,36,36,0,36,36,0,0.000048,0,20198,6,0.00001,15,0.180738,0.209077,0,0.088095,0
110262,110262,,1,17,18,1,17,18,0.000045,0.000133,0,19057,13,0.000011,17,0.129891,0.152274,3738.505647,0.199346,0.000542
9202005,9202005,,4,0,4,4,0,4,0.000017,0,0,225,13,0.000019,0,0,0,0,0.166667,0.001169
9312154,9312154,,3,12,15,3,12,15,0.000006,0.000097,0,19055,13,0.000011,4,0.522727,0.603261,43.635504,0.12381,0.000696
9701131,9701131,,3,8,11,3,8,11,0.000007,0.000101,0,4984,13,0.000012,9,0.237067,0.275715,353.211827,0.227273,0.000717
9704146,9704146,,3,8,11,3,8,11,0.000069,0.000338,0,4985,13,0.000012,9,0.237333,0.276248,14551.107991,0.181818,0.000778
9906218,9906218,,4,17,21,4,17,21,0.000116,0.000135,0,19056,13,0.000013,16,0.145692,0.168896,6107.025952,0.142857,0.00103
110263,110263,,2,28,30,2,28,30,0.000077,0.005585,0,20199,0,0.000011,13,0.211749,0.24445,783.140639,0.11954,0.000484
110264,110264,,2,7,9,2,7,9,0,0.000006,0,20201,23,0.000014,15,0.157111,0.180674,446.992867,0.055556,0.000445
9911244,9911244,,1,10,11,1,10,11,0,0.000105,0,20200,23,0.000012,9,0.210906,0.247489,149.408623,0.081818,0.000232
110266,110266,,2,7,9,2,7,9,0.000031,0.000004,0,20203,4,0.000012,16,0.130034,0.151503,1854.176083,0.111111,0.00048
9911078,9911078,,2,3,5,2,3,5,0,0.000004,0,20202,6,0.000013,1,1,1,11.500248,0.15,0.000452
9402126,9402126,,2,0,2,2,0,2,0.000004,0,0,6338,6,0.000013,0,0,0,0,0,0.000465
9511120,9511120,,3,1,4,3,1,4,0.000057,0,0,2771,4,0.000013,2,0.666667,0.75,793.13553,0,0.000738
110267,110267,,12,18,30,12,18,30,0.000558,0.002616,0,19099,52,0.000013,15,0.191118,0.214057,2639.031219,0.170115,0.003199
110268,110268,,0,6,6,0,6,6,0,0.001818,0,20204,30,0.00001,13,0.21113,0.23195,0,0.3,0
110269,110269,,6,9,15,6,9,15,0.000481,0.001436,0,20205,25,0.000012,14,0.18948,0.207389,268.969981,0.252381,0.001401
110270,110270,,1,14,15,1,14,15,0.000013,0.000516,0,20206,52,0.00001,15,0.20554,0.227209,1350.451244,0.190476,0.000232
110272,110272,,3,4,7,3,4,7,0.000128,0.000011,0,20207,25,0.000011,14,0.157208,0.167886,12.427632,0.309524,0.000684
110273,110273,,0,15,15,0,15,15,0,0.002064,0,20208,25,0.00001,13,0.192729,0.213949,0,0.157143,0
110274,110274,,11,120,131,11,120,131,0.000506,0.032808,0,18917,13,0.000015,13,0.228616,0.273958,62102.244829,0.066471,0.002779
9804102,9804102,,1,7,8,1,7,8,0.000385,0.000292,0,18916,13,0.00001,14,0.188077,0.213182,0,0.25,0.000296
9904077,9904077,,4,17,21,4,17,21,0.000633,0.004037,0,18915,13,0.000011,15,0.180899,0.218351,1530.731304,0.204762,0.001057
9606030,9606030,,1,2,3,1,2,3,0.000158,0.000023,0,6463,13,0.00001,11,0.186004,0.2109,1688.949909,0.166667,0.000287
110275,110275,,0,2,2,0,2,2,0,0,0,20209,8,0.00001,3,0.461538,0.583333,0,0.5,0
9605120,9605120,,2,3,5,2,3,5,0,0.000004,0,9621,26,0.000033,1,1,1,7572.946841,0.15,0.000486
110276,110276,,0,10,10,0,10,10,0,0.000001,0,20210,9,0.00001,16,0.138183,0.158071,0,0.044444,0
110277,110277,,11,30,41,11,30,41,0.000387,0.003063,0,18879,0,0.000015,15,0.202338,0.228816,44568.41666,0.136585,0.003309
110278,110278,,3,8,11,3,8,11,0.00008,0.000007,0,20211,8,0.000012,7,0.293893,0.384879,6.358081,0.345455,0.000677
110279,110279,,3,18,21,3,18,21,0.000012,0.000002,0,20212,22,0.000012,17,0.149356,0.162598,4630.201221,0.228571,0.000658
110280,110280,,8,15,23,8,15,23,0.000156,0.000666,0,19299,10,0.000013,16,0.198514,0.222082,8041.575912,0.102767,0.002109
110281,110281,,1,42,43,1,42,43,0.000092,0.010616,0,20213,1,0.000011,14,0.216913,0.24609,2709.391753,0.177187,0.000232
110282,110282,,1,4,5,1,4,5,0,0,0,20214,6,0.000011,13,0.153865,0.188206,0,0.35,0.000219
110283,110283,,13,11,24,13,11,24,0.000565,0.000404,0,20020,0,0.000029,12,0.208974,0.236257,12659.116755,0.152174,0.003242
110284,110284,,3,15,18,3,15,18,0.000129,0.003622,0,20066,25,0.000011,13,0.194234,0.214772,5758.03625,0.111111,0.000732
110285,110285,,1,1,2,1,1,2,0.000015,0.00001,0,20215,23,0.00001,1,1,1,2,0,0.000226
110286,110286,,7,56,63,7,56,63,0.00032,0.005733,0,20216,25,0.000013,14,0.208306,0.234486,44601.269612,0.143625,0.001822
111089,111089,,6,20,26,6,20,26,0.00014,0.002102,0,20217,25,0.000018,15,0.191112,0.213858,16148.94078,0.143077,0.001361
111030,111030,,28,8,36,28,8,36,0.0012,0.001064,0,18854,0,0.000026,14,0.181587,0.199935,11092.619725,0.112698,0.008091
112028,112028,,4,13,17,4,13,17,0.00006,0.001594,0,20218,25,0.000016,15,0.190682,0.211579,14109.531129,0.198529,0.000883
110287,110287,,1,12,13,1,12,13,0.000001,0.000078,0,20219,28,0.000011,14,0.179507,0.19631,1364.904088,0.102564,0.000226
110288,110288,,2,25,27,2,25,27,0.000004,0.00047,0,20220,52,0.000011,16,0.197438,0.220194,1806.020101,0.212251,0.000452
110289,110289,,2,18,20,2,18,20,0.000224,0.002476,0,20221,8,0.000011,15,0.192626,0.215816,1802.119853,0.144737,0.000452
110290,110290,,1,1,2,1,1,2,0,0,0,20222,5,0.000011,11,0.149776,0.164539,0,0.5,0.000226
110291,110291,,3,26,29,3,26,29,0.000038,0.001265,0,20223,30,0.000012,13,0.218195,0.241286,9321.772545,0.126847,0.000752
110292,110292,,3,8,11,3,8,11,0.000018,0.000247,0,20224,1,0.000013,18,0.15001,0.164977,57.939415,0.2,0.00069
110293,110293,,9,41,50,9,41,50,0.000282,0.003592,0,20225,30,0.000013,14,0.211559,0.234986,7617.665418,0.129796,0.002178
110294,110294,,2,11,13,2,11,13,0.000017,0.000314,0,16312,5,0.000011,15,0.155638,0.173362,48.331976,0.179487,0.000468
110295,110295,,0,5,5,0,5,5,0,0.000028,0,20226,0,0.00001,17,0.158721,0.174486,0,0,0
9410038,9410038,,3,0,3,3,0,3,0.000045,0,0,5448,15,0.000012,0,0,0,0,0,0.000692
110296,110296,,0,1,1,0,1,1,0,0.000031,0,20227,13,0.00001,7,0.242553,0.28066,0,0,0
110297,110297,,3,9,12,3,9,12,0.000046,0.004089,0,20228,30,0.000012,13,0.194079,0.212501,230.523198,0.212121,0.000704
110298,110298,,10,59,69,10,59,69,0.000847,0.004486,0,20067,25,0.000013,14,0.211073,0.239283,100592.775377,0.099957,0.002402
110299,110299,,4,18,22,4,18,22,0.000201,0.001481,0,20229,25,0.000012,15,0.194271,0.215779,4297.631747,0.155844,0.000903
110300,110300,,2,14,16,2,14,16,0.000022,0.000078,0,20230,22,0.000011,14,0.189845,0.205906,1823.802421,0.179167,0.000471
110301,110301,,6,9,15,6,9,15,0.000782,0.015087,0,20231,41,0.000019,14,0.178084,0.200653,5943.077094,0.180952,0.001412
110302,110302,,15,19,34,15,19,34,0.000778,0.00075,0,19018,10,0.000015,16,0.190064,0.214117,21277.998387,0.11943,0.004513
9209042,9209042,,8,0,8,8,0,8,0.000017,0,0,970,52,0.000084,0,0,0,0,0.089286,0.002121
9211073,9211073,,2,1,3,2,1,3,0,0,0,971,52,0.000062,1,1,1,1004.8905,0.166667,0.000561
111001,111001,,17,15,32,17,15,32,0.001559,0.001629,0,16291,8,0.000018,15,0.185022,0.208645,21816.631982,0.076613,0.003985
9704179,9704179,,3,2,5,3,2,5,0.000061,0.000004,0,7395,5,0.000013,1,1,1,177.455769,0.15,0.000784
9602044,9602044,,7,0,7,7,0,7,0,0,0,7394,5,0.000061,0,0,0,0,0.047619,0.001588
111002,111002,,13,32,45,13,32,45,0.00058,0.003085,0,19103,52,0.000013,15,0.219328,0.248943,60696.718264,0.125253,0.003354
111004,111004,,11,14,25,11,14,25,0.000793,0.005728,0,16153,3,0.000016,16,0.203095,0.233897,15402.304638,0.14,0.003989
111005,111005,,1,9,10,1,9,10,0.00001,0.000232,0,20233,30,0.000011,14,0.181507,0.1988,9311.050075,0.1,0.000252
108019,108019,,3,0,3,3,0,3,0.000003,0,0,20232,5,0.000013,0,0,0,0,0,0.000665
111027,111027,,3,29,32,3,29,32,0.00063,0.010366,0,20234,30,0.000011,14,0.216855,0.249015,2253.972768,0.207661,0.000704
111009,111009,,1,2,3,1,2,3,0,0,0,20235,26,0.000011,17,0.123073,0.131682,52.809605,0,0.000219
111010,111010,,0,1,1,0,1,1,0,0,0,20236,17,0.00001,13,0.130727,0.149808,0,0,0
111011,111011,,2,3,5,2,3,5,0.000069,0,0,20237,8,0.000011,16,0.133738,0.14721,608.186927,0.1,0.000471
111012,111012,,15,27,42,15,27,42,0.000775,0.001018,0,19019,10,0.000014,15,0.204146,0.231161,9905.687833,0.218931,0.004467
208165,208165,,12,45,57,12,45,57,0.00085,0.01861,0,20253,3,0.000013,13,0.224774,0.256066,24053.467899,0.160088,0.003016
201039,201039,,30,12,42,30,12,42,0.001535,0.001164,0,18804,3,0.000027,14,0.18868,0.208717,14119.640119,0.163763,0.011004
201081,201081,,212,10,222,212,10,222,0.021356,0.000834,0,18536,41,0.000148,14,0.180094,0.198755,28826.573716,0.077351,0.083655
202187,202187,,49,28,77,49,28,77,0.003966,0.002457,0,18810,3,0.000041,12,0.208841,0.234801,186721.078811,0.114491,0.018079
202210,202210,,89,19,108,89,19,108,0.00491,0.018501,0,18811,3,0.000058,13,0.204929,0.229398,190023.404585,0.082814,0.030772
203031,203031,,53,29,82,53,29,82,0.003296,0.002796,0,18909,3,0.000041,13,0.209712,0.236228,103491.820504,0.115026,0.018312
203112,203112,,46,10,56,46,10,56,0.00313,0.001054,0,18911,3,0.000033,13,0.197361,0.216821,33710.88938,0.180844,0.016104
203201,203201,,37,11,48,37,11,48,0.002618,0.00084,0,18965,3,0.000025,13,0.19365,0.21233,8999.75756,0.212323,0.012483
204071,204071,,41,36,77,41,36,77,0.002225,0.020303,0,18919,3,0.000034,13,0.22441,0.256758,135290.979616,0.10663,0.013075
204144,204144,,37,30,67,37,30,67,0.002502,0.00484,0,18947,3,0.000026,14,0.224132,0.258213,160984.758965,0.093397,0.011482
204158,204158,,38,42,80,38,42,80,0.002649,0.002035,0,18975,3,0.000029,15,0.215232,0.241139,242536.685567,0.091139,0.012317
204168,204168,,62,18,80,62,18,80,0.004588,0.001109,0,19062,3,0.000034,16,0.200822,0.222844,92722.260006,0.115506,0.018352
204189,204189,,42,27,69,42,27,69,0.002789,0.003812,0,19058,3,0.000025,13,0.206511,0.237937,62944.64422,0.101876,0.012857
204261,204261,,36,34,70,36,34,70,0.002507,0.002016,0,19135,3,0.000025,15,0.223426,0.252462,233275.68576,0.124845,0.011365
205246,205246,,12,14,26,12,14,26,0.000982,0.000594,0,19175,3,0.000015,16,0.193683,0.214658,20268.306732,0.121538,0.003691
205288,205288,,27,17,44,27,17,44,0.00205,0.001097,0,19178,3,0.000018,16,0.198885,0.219497,5204.48764,0.223573,0.008078
205290,205290,,18,19,37,18,19,37,0.001372,0.003449,0,19176,3,0.000017,16,0.210653,0.239825,40294.085845,0.154655,0.005641
206057,206057,,22,23,45,22,23,45,0.001046,0.018474,0,19145,3,0.00002,15,0.208278,0.233042,15585.53417,0.157071,0.006477
206182,206182,,46,29,75,46,29,75,0.003147,0.001721,0,19247,3,0.000026,14,0.211823,0.235611,138384.102459,0.118018,0.012325
206196,206196,,34,47,81,34,47,81,0.002866,0.001298,0,19224,3,0.00002,15,0.214357,0.240659,50749.809528,0.116821,0.009556
206223,206223,,7,26,33,7,26,33,0.000685,0.01818,0,20242,3,0.000012,15,0.203822,0.226617,14807.400872,0.164773,0.001824
206228,206228,,38,22,60,38,22,60,0.002925,0.000712,0,19322,3,0.000022,15,0.201741,0.226298,70375.057744,0.140395,0.010222
207123,207123,,5,46,51,5,46,51,0.000437,0.003318,0,20243,8,0.000012,16,0.205738,0.230259,19766.903196,0.123529,0.00133
207214,207214,,15,54,69,15,54,69,0.00108,0.01126,0,20241,3,0.000014,13,0.227155,0.260792,44611.116292,0.10422,0.003743
208107,208107,,10,66,76,10,66,76,0.000603,0.011061,0,20250,3,0.000014,13,0.227574,0.262301,34441.601827,0.109123,0.002517
208108,208108,,4,10,14,4,10,14,0.000255,0.000308,0,20252,3,0.000011,14,0.190323,0.209125,708.118601,0.164835,0.001001
208126,208126,,18,14,32,18,14,32,0.001205,0.002462,0,20251,3,0.000016,14,0.201543,0.224544,19393.615331,0.153226,0.004668
9908192,9908192,,5,15,20,5,15,20,0.000641,0.008783,0,19156,1,0.000012,15,0.201764,0.227939,932.345831,0.123684,0.001721
111013,111013,,6,45,51,6,45,51,0.000161,0.002598,0,20254,30,0.000013,13,0.226161,0.25394,30538.400245,0.068627,0.001498
111014,111014,,0,7,7,0,7,7,0,0,0,20255,9,0.00001,17,0.127825,0.137139,0,0.261905,0
111015,111015,,2,21,23,2,21,23,0.00008,0.006133,0,20256,25,0.000011,17,0.185109,0.214854,1428.148774,0.225296,0.000451
111016,111016,,10,2,12,10,2,12,0.000441,0.000024,0,20100,0,0.000018,13,0.172878,0.187367,0,0.356061,0.002474
111017,111017,,4,23,27,4,23,27,0.000622,0.011194,0,20240,1,0.000011,14,0.221859,0.253173,819.707511,0.225071,0.001042
111018,111018,,1,4,5,1,4,5,0.000008,0.000519,0,20257,1,0.00001,14,0.164972,0.184094,193.394823,0.05,0.000232
111019,111019,,0,8,8,0,8,8,0,0.001315,0,20258,25,0.00001,17,0.190502,0.213647,0,0.178571,0
111020,111020,,4,14,18,4,14,18,0.000004,0.000975,0,20259,30,0.000013,13,0.188925,0.207376,1693.934593,0.24183,0.000942
111022,111022,,0,4,4,0,4,4,0,0.000026,0,20262,23,0.00001,16,0.162996,0.179649,0,0.083333,0
9712041,9712041,,1,1,2,1,1,2,0,0,0,20261,23,0.000012,2,0.666667,0.75,2,0,0.000219
9212033,9212033,,1,1,2,1,1,2,0,0,0,20260,23,0.000021,1,1,1,2,0,0.000226
111023,111023,,0,5,5,0,5,5,0,0.00002,0,20263,22,0.00001,4,0.486486,0.587963,0,0.3,0
111024,111024,,0,3,3,0,3,3,0,0.000003,0,20264,0,0.00001,19,0.134075,0.142681,0,0.333333,0
111026,111026,,4,13,17,4,13,17,0.000222,0.001329,0,19002,2,0.000012,19,0.196426,0.222005,4588.903536,0.172794,0.001171
112073,112073,,5,30,35,5,30,35,0.000195,0.010701,0,19070,2,0.000013,17,0.216515,0.248088,17887.882197,0.105882,0.001313
111028,111028,,2,3,5,2,3,5,0.000059,0.00002,0,20265,5,0.000011,13,0.160112,0.170253,47.373854,0.1,0.000445
111029,111029,,0,3,3,0,3,3,0,0,0,20266,28,0.00001,4,0.444444,0.604167,0,0.333333,0
111031,111031,,13,3,16,13,3,16,0.001039,0.000647,0,18535,41,0.000031,18,0.162714,0.177368,100.415442,0.225,0.007353
111032,111032,,0,2,2,0,2,2,0,0.000064,0,20267,25,0.00001,17,0.184476,0.201924,0,0.5,0
111033,111033,,0,13,13,0,13,13,0,0.000059,0,20268,30,0.00001,15,0.172097,0.186156,0,0.173077,0
111034,111034,,40,17,57,40,17,57,0.000652,0.000695,0,18473,3,0.000033,15,0.184411,0.203614,2387.133506,0.26817,0.013593
111035,111035,,1,6,7,1,6,7,0,0.000013,0,20269,5,0.000012,18,0.160625,0.17423,2357.874497,0.166667,0.000219
111036,111036,,6,14,20,6,14,20,0.000299,0.000397,0,20270,2,0.000012,19,0.194016,0.218701,34254.131194,0.123684,0.001477
111037,111037,,0,2,2,0,2,2,0,0,0,20271,5,0.00001,10,0.157776,0.184913,0,0,0
111038,111038,,3,14,17,3,14,17,0.000053,0.000934,0,19935,30,0.000011,16,0.18387,0.201191,75.409083,0.253676,0.000718
111039,111039,,1,9,10,1,9,10,0.000001,0.000938,0,20273,22,0.00001,12,0.188599,0.205554,529.948243,0.088889,0.000259
107076,107076,,1,0,1,1,0,1,0.000011,0,0,20272,22,0.000011,0,0,0,0,0,0.000226
111040,111040,,10,4,14,10,4,14,0.000561,0.000041,0,20101,0,0.000016,13,0.173703,0.188822,32.129955,0.307692,0.002406
111041,111041,,5,10,15,5,10,15,0.000132,0.000874,0,20274,30,0.000015,15,0.209686,0.23044,31574.000356,0.2,0.001163
111042,111042,,1,3,4,1,3,4,0,0.000009,0,20275,5,0.000013,8,0.182406,0.213458,5.571429,0.083333,0.000219
111043,111043,,0,4,4,0,4,4,0,0.002349,0,20276,52,0.00001,16,0.158227,0.171658,0,0.25,0
111044,111044,,1,49,50,1,49,50,0.000024,0.004601,0,20277,1,0.00001,14,0.217598,0.250259,4242.006026,0.079184,0.000233
111045,111045,,1,9,10,1,9,10,0.000064,0.001024,0,20278,25,0.00001,15,0.184466,0.203808,47.472053,0.155556,0.000226
111046,111046,,1,21,22,1,21,22,0.000241,0.003879,0,18551,0,0.00001,16,0.202234,0.229337,10148.059532,0.166667,0.000274
111047,111047,,0,5,5,0,5,5,0,0.000019,0,20279,5,0.00001,15,0.181824,0.197906,0,0.2,0
111048,111048,,11,42,53,11,42,53,0.000563,0.001341,0,19021,10,0.000015,15,0.208987,0.237578,41197.457052,0.162554,0.003729
111050,111050,,6,40,46,6,40,46,0.000374,0.002467,0,19026,10,0.000011,15,0.20596,0.233443,5212.19901,0.144444,0.001725
111051,111051,,32,25,57,32,25,57,0.000992,0.003369,0,16226,3,0.000025,15,0.198847,0.22529,93423.589498,0.094298,0.009548
111052,111052,,0,14,14,0,14,14,0,0.003693,0,20280,25,0.00001,16,0.190571,0.217276,0,0.252747,0
111053,111053,,1,5,6,1,5,6,0,0.000001,0,20281,6,0.00001,8,0.233333,0.289724,0,0.366667,0.000219
9506215,9506215,,2,12,14,2,12,14,0,0.000006,0,10945,6,0.000011,6,0.319088,0.409821,97.484038,0.197802,0.000466
111054,111054,,1,18,19,1,18,19,0.000004,0.002009,0,20282,30,0.000011,15,0.196972,0.217201,246.629302,0.230994,0.000226
111055,111055,,4,17,21,4,17,21,0.000154,0.002704,0,20283,0,0.000012,12,0.204034,0.228705,4532.069717,0.140476,0.001072
111056,111056,,1,2,3,1,2,3,0,0.000018,0,20284,25,0.000013,15,0.165154,0.177011,0,0.5,0.000226
111057,111057,,17,33,50,17,33,50,0.001553,0.004056,0,20063,25,0.000018,13,0.196163,0.219635,29456.378502,0.139592,0.00451
111059,111059,,4,33,37,4,33,37,0.000025,0.005307,0,20107,30,0.000013,15,0.203649,0.226472,1911.220712,0.130631,0.000936
111060,111060,,18,30,48,18,30,48,0.002143,0.001978,0,18586,10,0.000016,15,0.201407,0.227017,54391.8058,0.137411,0.005814
111061,111061,,5,11,16,5,11,16,0.00031,0.001255,0,19283,30,0.000011,15,0.19337,0.212075,453.239473,0.333333,0.001159
111062,111062,,5,24,29,5,24,29,0.000329,0.002529,0,20285,4,0.000011,14,0.208496,0.242971,5297.434173,0.267241,0.001142
111063,111063,,3,1,4,3,1,4,0,0.000001,0,20286,20,0.000023,1,1,1,0,0.333333,0.000664
111064,111064,,3,19,22,3,19,22,0.000026,0.002201,0,20287,30,0.000011,13,0.210997,0.232023,3556.55188,0.199134,0.000691
111065,111065,,0,1,1,0,1,1,0,0,0,20288,22,0.00001,2,0.666667,0.75,0,0,0
111066,111066,,2,28,30,2,28,30,0.000346,0.000392,0,20289,4,0.00001,15,0.18867,0.218018,3598.159973,0.091954,0.000438
111068,111068,,13,9,22,13,9,22,0.000283,0.003149,0,18997,0,0.000019,11,0.213338,0.241418,16324.830825,0.071429,0.003153
111069,111069,,40,31,71,40,31,71,0.001427,0.001843,0,18476,3,0.00003,13,0.215074,0.238516,116371.663783,0.165191,0.013158
111070,111070,,1,23,24,1,23,24,0.000007,0.004202,0,19174,25,0.000011,12,0.196502,0.217543,2367.541069,0.195652,0.000312
111073,111073,,1,19,20,1,19,20,0,0.001422,0,20290,5,0.000011,14,0.204352,0.225817,43559.297925,0.060526,0.000312
111074,111074,,2,2,4,2,2,4,0.000002,0,0,20291,17,0.000014,6,0.291667,0.381746,0,0.5,0.000445
111075,111075,,0,2,2,0,2,2,0,0,0,20293,18,0.00001,3,0.545455,0.638889,0,0,0
9905119,9905119,,1,1,2,1,1,2,0,0,0,20292,18,0.000014,1,1,1,1,0,0.000219
111076,111076,,0,4,4,0,4,4,0,0.000878,0,20294,30,0.00001,13,0.207972,0.227144,0,0.416667,0
111077,111077,,1,16,17,1,16,17,0.000008,0.002787,0,20106,30,0.00001,13,0.216173,0.239122,422.083181,0.231618,0.00024
111079,111079,,1,48,49,1,48,49,0.000002,0.005109,0,20295,30,0.00001,13,0.220788,0.249632,5449.150231,0.07483,0.000219
111080,111080,,5,8,13,5,8,13,0.000134,0.000447,0,19297,0,0.000013,13,0.187661,0.20994,4451.232557,0.282051,0.001309
111081,111081,,2,10,12,2,10,12,0.000188,0.002618,0,20296,25,0.000011,14,0.17961,0.199378,44.557431,0.227273,0.000465
111082,111082,,5,36,41,5,36,41,0.000962,0.020966,0,18968,1,0.000012,14,0.211492,0.239929,3036.037383,0.25061,0.001505
111084,111084,,1,1,2,1,1,2,0,0,0,20297,5,0.000019,4,0.365385,0.412281,19,0,0.000219
111086,111086,,3,32,35,3,32,35,0.000271,0.00456,0,20028,52,0.00001,13,0.195243,0.221057,507.460611,0.127731,0.000983
111087,111087,,29,19,48,29,19,48,0.000439,0.000315,0,18474,3,0.000023,15,0.182608,0.20025,2926.20682,0.279255,0.009643
111088,111088,,0,1,1,0,1,1,0,0,24,20299,46,0.00001,1,1,1,0,0,0
5216,5216,,1,0,1,1,0,1,0,0,24,20298,46,0.000019,0,0,0,0,0,0.000219
111091,111091,,4,31,35,4,31,35,0.00026,0.007828,0,16309,5,0.000011,14,0.182594,0.210442,1688.698208,0.136975,0.00105
111092,111092,,26,19,45,26,19,45,0.0007,0.015787,0,18470,3,0.000022,16,0.189443,0.21236,18818.205196,0.14798,0.009194
111094,111094,,1,15,16,1,15,16,0.000054,0.001959,0,20300,30,0.00001,13,0.213998,0.235453,0,0.395833,0.000232
111095,111095,,0,8,8,0,8,8,0,0.000041,0,20303,30,0.00001,12,0.140629,0.153062,0,0.232143,0
9905047,9905047,,1,5,6,1,5,6,0,0.000009,0,20302,30,0.000011,12,0.140534,0.151965,1.166667,0.266667,0.000219
9706200,9706200,,2,6,8,2,6,8,0.000003,0.000055,0,20301,30,0.000012,11,0.162937,0.177731,832.854167,0.142857,0.000445
111096,111096,,15,18,33,15,18,33,0.000667,0.000776,0,19032,10,0.000018,14,0.188768,0.209231,20692.250036,0.117424,0.00428
9505141,9505141,,2,1,3,2,1,3,0.000015,0.001027,0,19030,10,0.000011,6,0.262295,0.292839,11.793466,0.166667,0.000549
111097,111097,,1,18,19,1,18,19,0.000007,0.012264,0,20305,1,0.00001,14,0.193834,0.216737,1633.742358,0.143275,0.000246
9411042,9411042,,1,0,1,1,0,1,0.000144,0,0,20304,1,0.00001,0,0,0,0,0,0.000226
111098,111098,,32,11,43,32,11,43,0.000964,0.000297,0,18855,0,0.000027,14,0.188112,0.209145,15750.22152,0.08804,0.008054
111277,111277,,12,15,27,12,15,27,0.000677,0.001927,0,20306,25,0.000016,14,0.188143,0.209253,6461.02163,0.139601,0.002954
204091,204091,,21,20,41,21,20,41,0.001632,0.000992,0,18964,0,0.000018,13,0.202034,0.225813,51468.698071,0.15122,0.006835
112026,112026,,7,6,13,7,6,13,0.000071,0.000147,0,18853,0,0.000015,14,0.182506,0.20052,546.541036,0.365385,0.002122
112128,112128,,15,20,35,15,20,35,0.000414,0.002913,0,18856,0,0.000019,14,0.200225,0.22628,10370.176602,0.210084,0.004194
112249,112249,,14,26,40,14,26,40,0.000293,0.000439,0,18962,0,0.000017,14,0.193934,0.220178,17574.135357,0.187179,0.003778
203013,203013,,13,23,36,13,23,36,0.000271,0.001083,0,18963,0,0.000017,15,0.1909,0.217878,7607.012753,0.157937,0.003432
111099,111099,,3,14,17,3,14,17,0.000064,0.000692,0,20307,2,0.000021,16,0.186424,0.210135,15292.840715,0.099265,0.000671
111100,111100,,0,7,7,0,7,7,0,0.000066,0,20309,4,0.00001,12,0.185567,0.202471,0,0.190476,0
9406170,9406170,,1,0,1,1,0,1,0.000001,0,0,20308,4,0.000011,0,0,0,0,0,0.000219
111101,111101,,2,18,20,2,18,20,0,0.00001,0,20310,23,0.000013,13,0.162572,0.176561,4959.947606,0.144737,0.000479
111103,111103,,1,9,10,1,9,10,0,0.000306,0,20311,30,0.000011,15,0.19442,0.214448,5820.89217,0.155556,0.000226
111104,111104,,0,20,20,0,20,20,0,0.020245,0,20312,1,0.00001,17,0.211158,0.244719,0,0.310526,0
111105,111105,,0,3,3,0,3,3,0,0.000096,0,20313,0,0.00001,18,0.173268,0.196621,0,0.5,0
111106,111106,,8,31,39,8,31,39,0.000773,0.017184,0,18531,2,0.000022,14,0.198001,0.224097,64444.873976,0.153171,0.004075
111107,111107,,3,19,22,3,19,22,0.000366,0.002792,0,20314,25,0.000012,13,0.21217,0.234225,21598.814167,0.132035,0.000711
111108,111108,,1,3,4,1,3,4,0.000018,0.00002,0,19206,22,0.00001,15,0.142634,0.150427,1555.705929,0.083333,0.000268
111109,111109,,1,21,22,1,21,22,0.00003,0.002408,0,20315,30,0.00001,13,0.213244,0.234931,113.298193,0.17316,0.000226
111110,111110,,3,12,15,3,12,15,0.000011,0.000107,0,20316,15,0.000013,14,0.187406,0.203752,3739.447176,0.142857,0.000731
111111,111111,,0,5,5,0,5,5,0,0.001071,0,20317,30,0.00001,14,0.193636,0.211413,0,0.3,0
111112,111112,,0,4,4,0,4,4,0,0,0,20318,20,0.00001,14,0.147368,0.157632,0,0.5,0
111113,111113,,13,35,48,13,35,48,0.000361,0.002216,0,20026,4,0.000014,16,0.19286,0.220958,13999.076607,0.163564,0.003619
111114,111114,,0,5,5,0,5,5,0,0.00002,0,20319,6,0.00001,17,0.115457,0.132527,0,0.15,0
111116,111116,,2,2,4,2,2,4,0,0,0,20320,6,0.000016,15,0.138214,0.149325,6697.793536,0.166667,0.000445
111117,111117,,2,5,7,2,5,7,0.000258,0.000085,0,20321,4,0.000011,13,0.196776,0.215854,71.375389,0.404762,0.000783
111118,111118,,0,11,11,0,11,11,0,0.001442,0,20322,25,0.00001,14,0.193099,0.213493,0,0.336364,0
111120,111120,,1,2,3,1,2,3,0,0.000001,0,20323,20,0.000011,2,0.571429,0.625,0,0.5,0.000239
111121,111121,,9,24,33,9,24,33,0.000372,0.005065,0,19258,2,0.000014,17,0.208433,0.235744,14363.897462,0.162879,0.002179
111123,111123,,2,6,8,2,6,8,0.000012,0.000056,0,20324,3,0.000012,14,0.171974,0.185506,241.780674,0.303571,0.000458
111124,111124,,0,9,9,0,9,9,0,0.000109,0,20325,13,0.00001,16,0.130722,0.154003,0,0.138889,0
111125,111125,,0,3,3,0,3,3,0,0,0,20326,26,0.00001,12,0.148623,0.18693,0,0,0
111126,111126,,6,16,22,6,16,22,0.000075,0.002869,0,19000,0,0.000014,15,0.184343,0.206951,13838.768123,0.108225,0.001533
111127,111127,,7,30,37,7,30,37,0.000166,0.001777,0,20068,25,0.000014,15,0.185404,0.206806,48932.101613,0.148649,0.001756
111128,111128,,5,37,42,5,37,42,0.000404,0.007582,0,19038,1,0.000012,15,0.208192,0.235923,13462.905316,0.090592,0.001444
111129,111129,,65,58,123,65,58,123,0.001064,0.002037,0,18477,3,0.000045,14,0.19644,0.21821,50213.673263,0.138478,0.020687
111130,111130,,7,23,30,7,23,30,0.000451,0.000901,0,20327,13,0.000013,15,0.19164,0.218084,4018.218909,0.143678,0.001772
111131,111131,,1,8,9,1,8,9,0,0.000001,0,20328,5,0.000011,12,0.131281,0.157053,16.729155,0.111111,0.000226
9611030,9611030,,1,1,2,1,1,2,0,0,0,15176,5,0.000017,1,1,1,7,0,0.000239
111132,111132,,2,7,9,2,7,9,0.00004,0.001107,0,20329,25,0.000013,15,0.186883,0.206789,3031.747967,0.319444,0.000438
111133,111133,,1,15,16,1,15,16,0.000608,0.003259,0,20330,2,0.00001,15,0.208696,0.234736,240.808249,0.179167,0.000245
111134,111134,,4,9,13,4,9,13,0.000001,0.000095,0,20331,28,0.000014,14,0.184924,0.205719,43663.980504,0.160256,0.000903
111135,111135,,36,20,56,36,20,56,0.003916,0.020393,0,18933,41,0.000026,16,0.223478,0.255632,104832.245543,0.084091,0.010497
111180,111180,,28,32,60,28,32,60,0.004084,0.012494,0,18623,1,0.000023,15,0.200497,0.236041,54788.130076,0.103672,0.009576
111210,111210,,28,35,63,28,35,63,0.002364,0.006659,0,18934,52,0.000024,17,0.222021,0.253206,143174.068053,0.047875,0.008592
111161,111161,,10,8,18,10,8,18,0.000172,0.001299,0,18932,52,0.00002,15,0.175675,0.196778,8780.447288,0.111111,0.002565
9708135,9708135,,6,8,14,6,8,14,0.000235,0.000022,0,18931,6,0.000012,11,0.162428,0.192665,14669.072152,0.131868,0.001766
203020,203020,,16,22,38,16,22,38,0.00205,0.001801,0,19088,41,0.000016,17,0.201041,0.226013,30466.152346,0.067568,0.005093
111138,111138,,3,4,7,3,4,7,0.000215,0.000021,0,16327,5,0.000011,17,0.156634,0.173461,1.85,0.309524,0.000802
111140,111140,,1,1,2,1,1,2,0,0,25,20333,47,0.000014,1,1,1,0,0.5,0.000219
3107,3107,,2,0,2,2,0,2,0,0,25,20332,47,0.000027,0,0,0,0,0.5,0.000445
111141,111141,,1,7,8,1,7,8,0.000001,0.000033,0,20334,5,0.00001,18,0.123132,0.143548,24.838327,0.178571,0.000226
111142,111142,,9,18,27,9,18,27,0.000692,0.003908,0,18861,0,0.000018,15,0.18906,0.210486,38245.575166,0.075499,0.00243
111143,111143,,0,1,1,0,1,1,0,0.000001,0,20335,15,0.00001,2,0.6,0.666667,0,0,0
111144,111144,,0,11,11,0,11,11,0,0.000001,0,20336,6,0.00001,13,0.162706,0.210838,0,0.172727,0
111145,111145,,5,28,33,5,28,33,0.000254,0.002266,0,20104,30,0.000011,14,0.200541,0.221103,401.849982,0.238636,0.001135
111146,111146,,2,16,18,2,16,18,0,0.000007,0,20337,23,0.000012,16,0.144018,0.160853,2221.315588,0.114379,0.000445
111148,111148,,0,5,5,0,5,5,0,0.000002,0,20343,17,0.00001,6,0.303371,0.420988,0,0.15,0
9801186,9801186,,2,0,2,2,0,2,0,0,0,20339,17,0.000014,0,0,0,0,0.5,0.000445
9804054,9804054,,2,0,2,2,0,2,0,0,0,20338,17,0.000014,0,0,0,0,0.5,0.000445
9904057,9904057,,1,5,6,1,5,6,0,0.000001,0,20342,17,0.000012,6,0.294118,0.414667,2,0.133333,0.000219
9710131,9710131,,3,0,3,3,0,3,0,0,0,20341,17,0.000018,0,0,0,0,0.166667,0.00067
9710132,9710132,,3,1,4,3,1,4,0,0.000001,0,20340,17,0.000018,6,0.259259,0.303175,10.5,0.25,0.00067
111149,111149,,5,46,51,5,46,51,0.000531,0.015349,0,20344,2,0.000015,16,0.221578,0.25619,16922.027067,0.08549,0.001135
111150,111150,,2,9,11,2,9,11,0.000434,0.001378,0,19111,2,0.00001,15,0.193451,0.21429,758.133217,0.2,0.000481
111151,111151,,2,45,47,2,45,47,0.000038,0.007249,0,19126,3,0.00001,14,0.217337,0.245935,28230.38938,0.118871,0.000488
111152,111152,,0,5,5,0,5,5,0,0.000001,0,20346,20,0.00001,17,0.133681,0.145347,0,0,0
9904093,9904093,,1,8,9,1,8,9,0,0.000002,0,20345,20,0.000012,16,0.152743,0.169058,3694.782073,0.041667,0.000219
111154,111154,,38,43,81,38,43,81,0.001702,0.002937,0,16282,3,0.000031,15,0.208312,0.23915,185432.662069,0.071914,0.011009
111155,111155,,20,11,31,20,11,31,0.000577,0.000233,0,18910,3,0.000021,15,0.186942,0.208311,2752.14506,0.174194,0.006633
111156,111156,,7,28,35,7,28,35,0.00056,0.009217,0,18993,2,0.000013,18,0.210475,0.239924,11314.619478,0.123529,0.001947
112180,112180,,10,42,52,10,42,52,0.000655,0.006354,0,20347,2,0.000013,18,0.214045,0.244065,8825.575727,0.11463,0.002323
111157,111157,,2,6,8,2,6,8,0.000001,0.000004,0,20349,52,0.000013,14,0.144395,0.154287,1084.311109,0.25,0.000458
111083,111083,,2,0,2,2,0,2,0,0,0,20348,52,0.000014,0,0,0,0,0.5,0.000465
111158,111158,,2,16,18,2,16,18,0.000031,0.000763,0,20350,13,0.00001,15,0.169085,0.192543,106.479693,0.228758,0.000445
9606029,9606029,,3,13,16,3,13,16,0,0.000009,0,12614,22,0.000017,3,0.666667,0.780303,3075.211935,0.133333,0.000712
111159,111159,,8,25,33,8,25,33,0.000001,0.000015,0,20351,20,0.000014,13,0.164982,0.181096,5269.304996,0.188447,0.001866
111160,111160,,8,29,37,8,29,37,0.000152,0.002966,0,19142,30,0.000015,13,0.195453,0.218266,14193.583015,0.128378,0.002212
9303109,9303109,,2,4,6,2,4,6,0.000015,0,0,1330,5,0.000022,2,0.833333,0.9,47893.225297,0.066667,0.000605
9207117,9207117,,8,1,9,8,1,9,0.000001,0.000001,0,1327,5,0.000056,1,1,1,860.132558,0.069444,0.001836
9210081,9210081,,3,1,4,3,1,4,0.000001,0,0,1329,5,0.000017,2,0.666667,0.75,0,0.25,0.000694
9210082,9210082,,1,1,2,1,1,2,0,0,0,1328,5,0.000015,2,0.666667,0.75,0,0.5,0.000234
111162,111162,,2,7,9,2,7,9,0.000001,0.000001,0,20352,52,0.000013,4,0.440678,0.557692,3.333333,0.277778,0.000438
111163,111163,,6,23,29,6,23,29,0.000719,0.018188,0,19275,1,0.000013,14,0.213885,0.239537,4336.074101,0.182266,0.001669
111165,111165,,28,65,93,28,65,93,0.002585,0.004476,0,19022,10,0.000017,15,0.22008,0.250249,116611.405781,0.089294,0.008878
9802193,9802193,,1,13,14,1,13,14,0.000053,0.000968,0,19011,0,0.00001,13,0.195005,0.225971,345.01357,0.181319,0.000438
111166,111166,,0,15,15,0,15,15,0,0.001062,0,20353,25,0.00001,13,0.196263,0.216524,0,0.12381,0
202105,202105,,0,1,1,0,1,1,0,0,0,20354,22,0.00001,16,0.140609,0.153986,0,0,0
111168,111168,,11,9,20,11,9,20,0.000098,0.000279,0,20062,25,0.000019,14,0.177847,0.198017,1651.035239,0.210526,0.0028
111169,111169,,5,21,26,5,21,26,0.000142,0.00269,0,20355,3,0.000013,15,0.190771,0.218606,10098.0298,0.113846,0.001135
111171,111171,,3,2,5,3,2,5,0,0.000001,0,20356,20,0.000016,2,0.545455,0.583333,84.00119,0.25,0.000698
111172,111172,,0,3,3,0,3,3,0,0.000005,0,20357,15,0.00001,2,0.714286,0.8,0,0.166667,0
111173,111173,,1,5,6,1,5,6,0.000011,0.000017,0,20358,30,0.000011,14,0.184272,0.198985,4202.263275,0.166667,0.000219
111174,111174,,3,2,5,3,2,5,0.000209,0.000017,0,20359,30,0.00001,14,0.167771,0.179206,15.421546,0.05,0.000717
111175,111175,,0,8,8,0,8,8,0,0.00002,0,20360,28,0.00001,18,0.141626,0.157479,0,0.160714,0
111177,111177,,10,29,39,10,29,39,0.000586,0.00057,0,18913,3,0.000013,13,0.207563,0.231224,5564.330379,0.230094,0.002635
111178,111178,,4,15,19,4,15,19,0.000463,0.002672,0,19276,1,0.000012,13,0.204779,0.228961,4264.554683,0.181287,0.001187
111179,111179,,30,57,87,30,57,87,0.001803,0.003591,0,18867,0,0.000021,14,0.214962,0.244595,100451.109422,0.120021,0.009619
111181,111181,,7,29,36,7,29,36,0.000222,0.005472,0,19629,8,0.000013,14,0.215207,0.241505,17112.506484,0.129365,0.001689
201017,201017,,6,33,39,6,33,39,0.00013,0.006189,0,19633,8,0.000014,14,0.217191,0.244144,21997.211381,0.11471,0.001423
204049,204049,,5,42,47,5,42,47,0.000038,0.006398,0,20367,8,0.000014,14,0.218556,0.24603,19461.720201,0.089732,0.001109
201187,201187,,5,25,30,5,25,30,0.000627,0.002443,0,19634,8,0.000012,13,0.210095,0.232097,22435.930791,0.137931,0.001269
202173,202173,,5,22,27,5,22,27,0.000136,0.00203,0,20366,2,0.000014,14,0.201904,0.222964,36966.356899,0.141026,0.001187
111183,111183,,1,20,21,1,20,21,0,0.00103,0,20368,25,0.000011,12,0.193137,0.21185,2300.206073,0.12619,0.000219
111184,111184,,0,2,2,0,2,2,0,0.000001,0,20370,26,0.00001,1,1,1,0,0,0
105150,105150,,1,0,1,1,0,1,0,0,0,20369,26,0.000014,0,0,0,0,0,0.000219
111185,111185,,1,2,3,1,2,3,0,0.000004,0,20371,25,0.000013,15,0.148163,0.157645,0,0.5,0.000226
111186,111186,,1,4,5,1,4,5,0,0,0,20372,6,0.000011,15,0.136893,0.158841,0,0.35,0.000219
111187,111187,,2,52,54,2,52,54,0.000358,0.013164,0,19132,0,0.00001,17,0.197982,0.231384,3712.755296,0.138714,0.000673
111188,111188,,0,7,7,0,7,7,0,0.000179,0,20373,1,0.00001,15,0.182375,0.20283,0,0.190476,0
111189,111189,,20,42,62,20,42,62,0.000552,0.001846,0,19108,52,0.000019,17,0.210224,0.240074,57743.310613,0.130354,0.005074
111205,111205,,5,7,12,5,7,12,0.000133,0.000064,0,20374,52,0.000013,18,0.177924,0.196461,18452.754449,0.25,0.001228
111191,111191,,9,9,18,9,9,18,0.000003,0.000005,0,20375,20,0.000014,13,0.163104,0.17682,875.836234,0.264706,0.002118
202188,202188,,5,23,28,5,23,28,0.000001,0.000017,0,20378,20,0.000012,13,0.164289,0.179439,1603.012766,0.224868,0.001187
112087,112087,,2,11,13,2,11,13,0,0.000009,0,20376,20,0.000011,14,0.166075,0.182133,930.470467,0.205128,0.000479
202167,202167,,1,19,20,1,19,20,0,0.000007,0,20377,20,0.00001,13,0.162493,0.177372,37.47418,0.197368,0.000253
111192,111192,,2,13,15,2,13,15,0.000002,0.000035,0,20379,22,0.000011,16,0.162271,0.174482,1.469322,0.357143,0.000451
111194,111194,,0,3,3,0,3,3,0,0,0,20382,23,0.00001,5,0.366667,0.510606,0,0,0
103065,103065,,1,0,1,1,0,1,0,0,0,20381,23,0.000013,0,0,0,0,0,0.000219
107249,107249,,1,0,1,1,0,1,0,0,0,20380,23,0.000013,0,0,0,0,0,0.000219
111195,111195,,0,6,6,0,6,6,0,0.000003,0,20383,6,0.00001,16,0.156454,0.170628,0,0.433333,0
111198,111198,,8,26,34,8,26,34,0.000346,0.001814,0,19036,10,0.000013,15,0.204425,0.229934,10346.535277,0.21123,0.002271
111199,111199,,15,43,58,15,43,58,0.00051,0.002782,0,18940,3,0.000015,15,0.20597,0.233762,65319.017517,0.132486,0.004919
111212,111212,,30,36,66,30,36,66,0.001038,0.001765,0,18941,3,0.000022,15,0.207028,0.235925,58970.325669,0.114452,0.008881
111200,111200,,10,10,20,10,10,20,0.000531,0.003078,0,19264,30,0.000014,15,0.182345,0.201168,2890.199245,0.231579,0.002565
201070,201070,,10,37,47,10,37,47,0.000238,0.002859,0,19269,30,0.000016,15,0.21985,0.245613,189034.032951,0.091119,0.002822
111249,111249,,12,22,34,12,22,34,0.000234,0.003418,0,19268,30,0.000015,13,0.213676,0.236217,37134.648958,0.14795,0.002948
112114,112114,,12,21,33,12,21,33,0.000264,0.002234,0,19263,30,0.00002,14,0.217455,0.240589,54759.8274,0.095644,0.002949
111202,111202,,0,9,9,0,9,9,0,0.000002,0,20384,22,0.00001,6,0.265446,0.333764,0,0.388889,0
111203,111203,,4,4,8,4,4,8,0.000214,0.000019,0,20385,26,0.000016,16,0.143517,0.155846,1.166667,0.321429,0.00089
111204,111204,,0,1,1,0,1,1,0,0,0,20386,30,0.00001,3,0.5,0.547619,0,0,0
111206,111206,,5,2,7,5,2,7,0.00001,0.000001,0,20387,25,0.000019,1,1,1,13.5,0.261905,0.001189
111207,111207,,1,20,21,1,20,21,0.000017,0.001885,0,20388,25,0.000011,15,0.195542,0.219574,4451.181046,0.119048,0.000219
111208,111208,,42,200,242,42,200,242,0.000899,0.011559,0,18833,3,0.000032,13,0.240134,0.27809,466848.494427,0.058726,0.011177
9902176,9902176,,1,0,1,1,0,1,0.000136,0,0,18814,3,0.00001,0,0,0,0,0,0.000518
9911149,9911149,,2,23,25,2,23,25,0.000194,0.00559,0,18813,2,0.00001,14,0.180688,0.206286,2004.664318,0.185,0.000738
9404110,9404110,,2,8,10,2,8,10,0.000002,0.000008,0,5119,15,0.000015,2,0.833333,0.9,59590.120294,0.111111,0.000624
111209,111209,,9,51,60,9,51,60,0.000165,0.004528,0,19084,0,0.000014,14,0.223016,0.256427,52781.678896,0.086723,0.002382
9709111,9709111,,3,0,3,3,0,3,0.000053,0,0,19073,0,0.000021,0,0,0,0,0.166667,0.000742
9801003,9801003,,1,1,2,1,1,2,0.000053,0.000001,0,19074,0,0.00001,1,1,1,0,0.5,0.000283
9703085,9703085,,7,4,11,7,4,11,0.000003,0.000006,0,18930,6,0.000015,11,0.156993,0.17921,631.897757,0.272727,0.001658
111211,111211,,2,12,14,2,12,14,0,0.000002,0,20394,23,0.000012,14,0.162352,0.174352,9331.227411,0.181319,0.000458
9605084,9605084,,4,0,4,4,0,4,0,0,0,20393,23,0.000015,0,0,0,0,0,0.000936
9712053,9712053,,2,9,11,2,9,11,0,0.000003,0,20392,23,0.000012,10,0.17086,0.21562,62.505429,0.218182,0.000458
9801096,9801096,,4,3,7,4,3,7,0,0,0,20391,23,0.000016,4,0.40678,0.475694,109,0.142857,0.000916
9506163,9506163,,2,4,6,2,4,6,0,0,0,20390,23,0.000017,1,1,1,29.5,0.1,0.000471
111213,111213,,1,3,4,1,3,4,0,0,0,20395,6,0.00001,16,0.139467,0.148658,2.833333,0.166667,0.000219
111214,111214,,0,2,2,0,2,2,0,0,0,20398,23,0.00001,2,0.75,0.833333,0,0.5,0
9802166,9802166,,2,1,3,2,1,3,0,0.000001,0,20396,23,0.000027,1,1,1,2,0.166667,0.000445
9904158,9904158,,1,1,2,1,1,2,0,0,0,20397,23,0.000014,2,0.666667,0.75,0,0.5,0.000219
111215,111215,,1,23,24,1,23,24,0.000001,0.00101,0,20399,2,0.00001,15,0.184986,0.206652,465.279688,0.097826,0.000219
111216,111216,,1,6,7,1,6,7,0.000001,0.000017,0,20400,23,0.00001,13,0.165319,0.177893,147.486048,0.333333,0.000232
111218,111218,,1,19,20,1,19,20,0.000042,0.001662,0,20401,25,0.00001,14,0.189355,0.21159,507.635524,0.218421,0.000239
111219,111219,,1,10,11,1,10,11,0.000011,0.000276,0,20402,13,0.00001,14,0.188669,0.212739,0,0.409091,0.000219
111220,111220,,3,11,14,3,11,14,0.000103,0.003006,0,19048,0,0.000011,16,0.183724,0.207964,331.560963,0.148352,0.000711
111221,111221,,11,15,26,11,15,26,0.00035,0.000425,0,19121,52,0.000015,13,0.19558,0.216806,20026.585283,0.206154,0.002632
111222,111222,,14,40,54,14,40,54,0.002202,0.02163,0,18539,2,0.000025,16,0.215427,0.25136,48062.607889,0.108316,0.008247
111223,111223,,2,3,5,2,3,5,0.000001,0.000004,0,20403,23,0.000013,15,0.146911,0.156357,22.149932,0.35,0.000497
111224,111224,,5,30,35,5,30,35,0.000166,0.003725,0,20405,8,0.000012,14,0.189988,0.210982,18446.410623,0.105042,0.001135
9910213,9910213,,4,12,16,4,12,16,0.000092,0.000946,0,20404,1,0.000014,12,0.190423,0.209388,6044.708659,0.204167,0.000936
111225,111225,,0,30,30,0,30,30,0,0.00535,0,20406,8,0.00001,12,0.228272,0.253552,0,0.065517,0
111226,111226,,3,6,9,3,6,9,0.000024,0.000284,0,20407,0,0.000013,12,0.186928,0.208457,90.887163,0.208333,0.000684
111227,111227,,5,6,11,5,6,11,0.000167,0.01524,0,20408,1,0.000014,17,0.174588,0.194386,1748.142522,0.118182,0.001116
9905068,9905068,,2,25,27,2,25,27,0.0001,0.008455,0,16708,2,0.000012,12,0.212405,0.243946,881.387677,0.168091,0.00046
111229,111229,,2,16,18,2,16,18,0.000044,0.007847,0,20409,1,0.000012,15,0.199165,0.222995,3559.655755,0.196078,0.000451
111230,111230,,11,13,24,11,13,24,0.000222,0.000237,0,19109,52,0.000014,18,0.187045,0.206644,392.351486,0.246377,0.002823
111231,111231,,2,16,18,2,16,18,0.000228,0.018134,0,20010,25,0.000011,12,0.211794,0.242361,3864.324946,0.212418,0.000487
111232,111232,,0,5,5,0,5,5,0,0.000383,0,20410,28,0.00001,13,0.174452,0.189474,0,0.2,0
111233,111233,,0,2,2,0,2,2,0,0,0,20411,6,0.00001,8,0.21374,0.310969,0,0.5,0
111235,111235,,2,17,19,2,17,19,0.00008,0.002651,0,20412,0,0.000011,17,0.189359,0.212882,1707.079915,0.111111,0.000591
111236,111236,,0,38,38,0,38,38,0,0.000244,0,20415,30,0.00001,15,0.174615,0.193074,0,0.081081,0
111115,111115,,2,0,2,2,0,2,0.000016,0,0,20414,30,0.000011,0,0,0,0,0,0.000458
9709009,9709009,,1,7,8,1,7,8,0.000003,0.000018,0,20413,30,0.00001,11,0.16441,0.180944,2.458333,0.160714,0.000219
9610114,9610114,,3,5,8,3,5,8,0.000001,0.000054,0,6824,30,0.000015,11,0.162989,0.177421,8838.849542,0.142857,0.000717
111237,111237,,0,1,1,0,1,1,0,0.000031,0,20416,13,0.00001,7,0.242553,0.28066,0,0,0
111239,111239,,1,19,20,1,19,20,0.000002,0.00017,0,20418,52,0.00001,17,0.18375,0.202968,51.933445,0.189474,0.000226
9704159,9704159,,1,5,6,1,5,6,0.000002,0.000008,0,20417,5,0.00001,9,0.170946,0.19781,6.825,0.1,0.000226
9401060,9401060,,3,1,4,3,1,4,0.00001,0.000004,0,2632,5,0.000014,1,1,1,325.638975,0,0.000707
111240,111240,,0,2,2,0,2,2,0,0.001866,0,20419,30,0.00001,11,0.179668,0.19725,0,0.5,0
111241,111241,,0,4,4,0,4,4,0,0.000052,0,20420,26,0.00001,13,0.16903,0.183774,0,0.083333,0
111242,111242,,0,6,6,0,6,6,0,0.000001,0,20421,5,0.00001,17,0.131179,0.139441,0,0.4,0
111243,111243,,2,2,4,2,2,4,0.000163,0.000001,0,20422,4,0.00001,13,0.144213,0.154939,946.722361,0.166667,0.000768
111244,111244,,2,6,8,2,6,8,0,0.000002,0,20423,23,0.000012,12,0.142857,0.156775,180.70519,0.214286,0.000458
111245,111245,,0,13,13,0,13,13,0,0.000543,0,20424,52,0.00001,15,0.203999,0.232107,0,0.275641,0
111246,111246,,6,13,19,6,13,19,0.000265,0.000058,0,20425,23,0.000016,12,0.194203,0.213536,10832.518583,0.105263,0.001381
111248,111248,,0,7,7,0,7,7,0,0.000905,0,20426,26,0.00001,12,0.193089,0.212477,0,0.285714,0
111251,111251,,0,1,1,0,1,1,0,0,0,20427,23,0.00001,4,0.375,0.472222,0,0,0
111252,111252,,2,2,4,2,2,4,0,0.000002,0,20428,9,0.000011,10,0.174237,0.205817,0,0.5,0.000445
111253,111253,,5,8,13,5,8,13,0.000012,0.000008,0,20429,23,0.000013,14,0.162257,0.175226,242.872504,0.326923,0.001168
111254,111254,,1,31,32,1,31,32,0.000027,0.002748,0,20430,13,0.00001,17,0.207665,0.243252,400.907228,0.152218,0.000226
111255,111255,,0,6,6,0,6,6,0,0.006678,0,20431,1,0.00001,12,0.191438,0.210336,0,0.233333,0
111256,111256,,18,16,34,18,16,34,0.000009,0.00002,0,20432,23,0.000027,16,0.138154,0.152124,2713.51094,0.191622,0.004368
111258,111258,,1,28,29,1,28,29,0.000001,0.000034,0,20434,23,0.000011,19,0.160335,0.187833,2683.978346,0.04803,0.000219
9609108,9609108,,1,2,3,1,2,3,0,0.000001,0,20433,23,0.00001,4,0.461538,0.534722,0.826923,0.333333,0.000226
9803029,9803029,,2,13,15,2,13,15,0,0.00188,0,14350,23,0.000012,13,0.173401,0.207098,1744.588551,0.17619,0.000458
111273,111273,,0,12,12,0,12,12,0,0.000046,0,20435,23,0.00001,19,0.146612,0.167148,0,0.098485,0
111259,111259,,1,9,10,1,9,10,0,0.000023,0,20441,1,0.000011,13,0.166047,0.18144,137.0184,0.055556,0.000219
9211141,9211141,,5,0,5,5,0,5,0,0,0,10419,17,0.000018,0,0,0,0,0,0.001124
9901040,9901040,,3,2,5,3,2,5,0.00014,0,0,20439,1,0.000014,1,1,1,18,0.15,0.000684
9901047,9901047,,3,1,4,3,1,4,0.00014,0,0,20436,1,0.000014,2,0.6,0.666667,16.738095,0.25,0.000684
9902167,9902167,,3,10,13,3,10,13,0.000164,0.011856,0,20440,1,0.000013,12,0.195768,0.219168,7074.409429,0.153846,0.000684
9602025,9602025,,5,0,5,5,0,5,0,0,0,20438,4,0.000029,0,0,0,0,0.1,0.001129
9607039,9607039,,3,0,3,3,0,3,0,0,0,20437,4,0.00002,0,0,0,0,0.166667,0.000684
111260,111260,,11,42,53,11,42,53,0.000057,0.000369,0,20442,9,0.000015,14,0.181663,0.203147,3225.421567,0.187228,0.002588
9209001,9209001,,1,0,1,1,0,1,0,0,0,1044,9,0.00002,0,0,0,0,0,0.000373
111261,111261,,3,33,36,3,33,36,0.000002,0.000014,0,20445,6,0.000011,18,0.146106,0.165315,756.070378,0.135714,0.000671
9805197,9805197,,2,4,6,2,4,6,0,0.000004,0,20443,6,0.000011,8,0.220608,0.273945,149.527605,0.3,0.000465
9908184,9908184,,1,7,8,1,7,8,0,0.000004,0,20444,6,0.00001,15,0.105667,0.119572,0,0.339286,0.000239
111263,111263,,3,10,13,3,10,13,0.000019,0.00035,0,20449,26,0.000025,16,0.150974,0.169447,21392.932528,0.070513,0.000691
9410053,9410053,,3,9,12,3,9,12,0.000004,0.000013,0,6847,26,0.000019,6,0.262693,0.339636,18599.196223,0.068182,0.000738
9905072,9905072,,3,8,11,3,8,11,0.000029,0.00001,0,20448,26,0.000015,15,0.1705,0.191551,24541.338449,0.2,0.00069
9806019,9806019,,3,18,21,3,18,21,0.000067,0.005629,0,20447,2,0.000013,14,0.202522,0.237606,26988.630952,0.15,0.00069
9810233,9810233,,3,5,8,3,5,8,0.000042,0.000009,0,20446,26,0.000014,16,0.160377,0.179614,894.141009,0.267857,0.000677
111264,111264,,3,4,7,3,4,7,0.000009,0.006683,0,20450,0,0.000012,16,0.180975,0.200853,4607.028439,0.047619,0.000684
111265,111265,,1,6,7,1,6,7,0,0.000001,0,20451,23,0.000011,17,0.137475,0.152639,5,0.238095,0.000219
111266,111266,,12,25,37,12,25,37,0.00014,0.002729,0,20072,25,0.00002,15,0.208214,0.24064,76263.557194,0.128378,0.002902
111267,111267,,8,10,18,8,10,18,0.000063,0.000033,0,19504,30,0.000033,14,0.184582,0.198498,35990.038128,0.104575,0.001847
111268,111268,,1,7,8,1,7,8,0.000032,0.002149,0,20452,25,0.00001,16,0.185391,0.20816,146.884594,0.267857,0.000246
111269,111269,,5,14,19,5,14,19,0.00013,0.001072,0,19086,0,0.000012,12,0.203286,0.227841,1481.375177,0.187135,0.001394
111270,111270,,0,7,7,0,7,7,0,0.000001,0,20453,23,0.00001,17,0.137493,0.152763,0,0.214286,0
111271,111271,,0,1,1,0,1,1,0,0,0,20454,2,0.00001,1,1,1,0,0,0
111272,111272,,0,1,1,0,1,1,0,0,0,20455,23,0.00001,5,0.333333,0.415152,0,0,0
111274,111274,,21,10,31,21,10,31,0.000481,0.000143,0,19034,10,0.000021,15,0.184699,0.203152,8001.923648,0.116129,0.00552
111275,111275,,4,28,32,4,28,32,0.000563,0.003769,0,20456,9,0.00001,12,0.197404,0.221846,7324.418353,0.069556,0.001097
111278,111278,,12,18,30,12,18,30,0.000663,0.001332,0,19260,2,0.000016,14,0.208613,0.233399,17097.512543,0.154023,0.003082
111279,111279,,6,40,46,6,40,46,0.000127,0.003846,0,18860,0,0.000014,14,0.200307,0.226155,28267.715907,0.142029,0.001663
111280,111280,,2,8,10,2,8,10,0.000199,0.000079,0,20459,26,0.000012,15,0.154664,0.169766,1410.171008,0.111111,0.000476
9903131,9903131,,4,7,11,4,7,11,0.000174,0.015047,0,20457,26,0.000016,15,0.176904,0.200242,9378.679308,0.154545,0.00093
9907151,9907151,,1,4,5,1,4,5,0.000001,0.000014,0,20458,26,0.000011,15,0.156492,0.172178,328.124134,0.2,0.000233
111281,111281,,50,16,66,50,16,66,0.001104,0.000309,0,18835,3,0.000036,14,0.187612,0.203944,2857.874847,0.215385,0.014645
111282,111282,,0,4,4,0,4,4,0,0.000003,0,20460,28,0.00001,5,0.432432,0.548958,0,0.083333,0
111283,111283,,0,3,3,0,3,3,0,0,0,20461,2,0.00001,1,1,1,0,0.5,0
111284,111284,,1,107,108,1,107,108,0.000338,0.035161,0,19131,0,0.00001,16,0.195171,0.236288,1202.650617,0.067844,0.000447
111285,111285,,5,6,11,5,6,11,0.0001,0.000205,0,20462,30,0.000013,14,0.20064,0.219782,155.661175,0.218182,0.001182
111286,111286,,0,3,3,0,3,3,0,0.000001,0,20463,23,0.00001,14,0.164769,0.177809,0,0.166667,0
111287,111287,,2,13,15,2,13,15,0.000023,0.000953,0,20464,25,0.000011,16,0.178615,0.198212,181.582096,0.147619,0.000451
111288,111288,,1,8,9,1,8,9,0.000079,0.000046,0,20465,0,0.00001,16,0.173494,0.191306,554.536928,0.111111,0.000219
111289,111289,,0,6,6,0,6,6,0,0.000001,0,20466,6,0.00001,14,0.151748,0.164181,0,0.266667,0
111290,111290,,7,29,36,7,29,36,0.001054,0.0181,0,18561,1,0.000016,16,0.193474,0.216565,6523.725786,0.203175,0.003276
111291,111291,,1,11,12,1,11,12,0.000033,0.002945,0,20467,25,0.000011,14,0.185342,0.205365,717.88099,0.174242,0.000219
112004,112004,,3,11,14,3,11,14,0.000315,0.000218,0,20468,1,0.000011,16,0.182184,0.205111,1394.668323,0.241758,0.000732
112005,112005,,4,33,37,4,33,37,0.000218,0.010902,0,20469,0,0.000011,14,0.196509,0.221719,488.902768,0.179429,0.000916
112006,112006,,0,17,17,0,17,17,0,0.00256,0,20470,0,0.00001,15,0.174609,0.197516,0,0.132353,0
112008,112008,,11,46,57,11,46,57,0.000336,0.00057,0,19305,9,0.000015,14,0.191741,0.219316,64199.132754,0.190163,0.002746
112010,112010,,4,8,12,4,8,12,0.000279,0.009384,0,20471,1,0.000012,17,0.180238,0.199608,128.19054,0.280303,0.00092
112011,112011,,2,1,3,2,1,3,0,0.000001,0,20472,15,0.000029,16,0.124203,0.13045,17888,0.166667,0.000451
112012,112012,,6,22,28,6,22,28,0.000134,0.001331,0,20473,0,0.000013,15,0.196773,0.221123,7291.30754,0.138889,0.00138
112013,112013,,13,27,40,13,27,40,0.000384,0.002483,0,20474,25,0.000015,13,0.192344,0.214869,16496.658801,0.145513,0.003311
112115,112115,,9,19,28,9,19,28,0.000446,0.003233,0,20475,25,0.000014,14,0.195497,0.218213,15588.800318,0.156085,0.002306
112205,112205,,9,22,31,9,22,31,0.000498,0.00348,0,20476,25,0.000013,14,0.186107,0.208192,5374.287986,0.186022,0.002276
112014,112014,,5,6,11,5,6,11,0.000001,0.000002,0,20477,23,0.000014,16,0.132666,0.143109,36.834524,0.309091,0.001251
112015,112015,,11,21,32,11,21,32,0.000506,0.001,0,18869,0,0.000014,15,0.197394,0.221289,4805.097821,0.344758,0.004394
112016,112016,,1,2,3,1,2,3,0,0,0,20478,23,0.000013,14,0.130761,0.139869,12.155988,0.166667,0.000226
112018,112018,,0,2,2,0,2,2,0,0.000009,0,20479,26,0.00001,16,0.119968,0.126093,0,0.5,0
112019,112019,,5,36,41,5,36,41,0.000133,0.005767,0,20480,25,0.000013,13,0.210048,0.244877,7318.706204,0.12378,0.001162
112020,112020,,1,13,14,1,13,14,0.000228,0.0018,0,20481,25,0.00001,14,0.205887,0.225371,3494.971322,0.225275,0.000259
112021,112021,,0,1,1,0,1,1,0,0,0,20482,25,0.00001,14,0.159342,0.170207,0,0,0
112022,112022,,2,6,8,2,6,8,0.000121,0.000106,0,20485,2,0.000014,12,0.171449,0.189396,2858.771494,0.107143,0.000438
9512057,9512057,,4,2,6,4,2,6,0.000001,0.000004,0,20484,2,0.000022,3,0.545455,0.638889,8.5,0.266667,0.000896
9501031,9501031,,3,2,5,3,2,5,0,0.000006,0,20483,2,0.000026,2,0.625,0.7,13,0.2,0.00069
112023,112023,,5,20,25,5,20,25,0.000002,0.000008,0,20486,6,0.000014,18,0.14673,0.164572,28302.998776,0.106667,0.001141
112024,112024,,1,6,7,1,6,7,0.000011,0.000081,0,20487,28,0.00001,12,0.1887,0.204926,1950.808455,0.142857,0.000274
112025,112025,,2,11,13,2,11,13,0.000014,0.000815,0,20489,30,0.000011,16,0.174722,0.193878,3467.167131,0.096154,0.000465
9401032,9401032,,3,0,3,3,0,3,0.000024,0,0,20488,30,0.000012,0,0,0,0,0.166667,0.000697
112029,112029,,1,25,26,1,25,26,0.000008,0.000171,0,20490,52,0.00001,17,0.184865,0.205008,3172.784415,0.136923,0.000232
112030,112030,,1,10,11,1,10,11,0,0.000007,0,20491,23,0.000011,13,0.154125,0.169774,456.454759,0.209091,0.000219
112032,112032,,0,29,29,0,29,29,0,0.001013,0,20492,20,0.00001,12,0.193855,0.215958,0,0.097291,0
112033,112033,,2,2,4,2,2,4,0,0.000001,0,20493,22,0.000013,8,0.17704,0.207515,32.284314,0,0.000438
112034,112034,,13,12,25,13,12,25,0.0004,0.000336,0,18996,2,0.000017,19,0.195308,0.216958,7770.294512,0.19,0.00356
112035,112035,,2,11,13,2,11,13,0.000291,0.00014,0,20494,13,0.00001,16,0.174348,0.194839,213.830637,0.121795,0.000445
112038,112038,,3,40,43,3,40,43,0.000019,0.000404,0,20497,2,0.000012,16,0.204465,0.232669,21870.434663,0.062569,0.000664
9909018,9909018,,1,8,9,1,8,9,0.000005,0.011434,0,20496,23,0.00001,15,0.177565,0.201343,68.675541,0.069444,0.000239
9909160,9909160,,1,5,6,1,5,6,0.000005,0.000017,0,20495,23,0.00001,15,0.128974,0.149029,16.066667,0.333333,0.000239
112039,112039,,7,2,9,7,2,9,0.000218,0.000057,0,20024,4,0.000012,15,0.176325,0.191456,206.370349,0.236111,0.002205
112040,112040,,19,75,94,19,75,94,0.001165,0.007076,0,19023,4,0.000018,15,0.219349,0.252842,92005.754269,0.106497,0.007574
112041,112041,,16,8,24,16,8,24,0.000221,0.000479,0,16285,8,0.000021,16,0.176279,0.195062,87023.225006,0.130435,0.003759
112042,112042,,1,15,16,1,15,16,0.000008,0.001486,0,20498,2,0.00001,15,0.183024,0.205332,347.34715,0.170833,0.000219
112043,112043,,3,44,47,3,44,47,0.000208,0.004613,0,20499,2,0.000011,14,0.207766,0.23668,7621.00082,0.13321,0.00076
112044,112044,,242,20,262,242,20,262,0.025064,0.001984,0,18534,41,0.000182,19,0.179065,0.205404,125270.781319,0.068819,0.096826
9701141,9701141,,3,7,10,3,7,10,0.000288,0.000167,0,18529,41,0.000023,5,0.352212,0.392044,285.019378,0.222222,0.004584
112046,112046,,4,6,10,4,6,10,0.000042,0.000014,0,20500,0,0.000012,14,0.161959,0.175966,1091.285318,0.311111,0.000903
112047,112047,,7,44,51,7,44,51,0.000276,0.009359,0,20501,25,0.000014,14,0.211913,0.237564,23109.341756,0.095686,0.0016
112048,112048,,1,26,27,1,26,27,0.000015,0.000444,0,20502,2,0.00001,14,0.194705,0.219502,651.483904,0.263533,0.000247
112049,112049,,3,7,10,3,7,10,0.000004,0.000793,0,20503,4,0.000016,14,0.198824,0.217097,10294.075643,0.111111,0.000664
112050,112050,,14,34,48,14,34,48,0.000403,0.003722,0,20504,30,0.000016,13,0.213908,0.240664,19440.768944,0.16844,0.003418
112051,112051,,0,8,8,0,8,8,0,0.000012,0,20506,23,0.00001,16,0.136118,0.14985,0,0.089286,0
9704155,9704155,,1,0,1,1,0,1,0,0,0,20505,23,0.000011,0,0,0,0,0,0.000219
112052,112052,,2,4,6,2,4,6,0,0,0,20507,2,0.000015,1,1,1,5,0.3,0.000458
112053,112053,,4,27,31,4,27,31,0.000062,0.003141,0,20508,30,0.000012,16,0.191702,0.211791,7699.084443,0.136559,0.000962
112054,112054,,25,13,38,25,13,38,0.000748,0.000631,0,19001,2,0.000025,17,0.197754,0.219395,32439.203625,0.1266,0.006453
112055,112055,,17,10,27,17,10,27,0.001789,0.002661,0,19180,1,0.000024,15,0.203311,0.238089,37411.268113,0.148148,0.004092
112056,112056,,4,27,31,4,27,31,0.000264,0.002205,0,16326,5,0.000011,14,0.179208,0.204844,4384.513477,0.115054,0.001021
112057,112057,,1,5,6,1,5,6,0,0,0,20510,23,0.000011,11,0.136424,0.160956,3.666667,0.3,0.000219
9712210,9712210,,3,4,7,3,4,7,0,0.000001,0,20509,23,0.000015,10,0.15357,0.175403,737.450505,0.285714,0.00067
9207003,9207003,,2,0,2,2,0,2,0,0,0,14455,23,0.000019,0,0,0,0,0.5,0.000472
112058,112058,,1,27,28,1,27,28,0.000032,0.019835,0,20511,1,0.00001,13,0.222946,0.251629,802.996493,0.130952,0.00026
112059,112059,,5,44,49,5,44,49,0.000705,0.021079,0,19071,1,0.000012,13,0.230371,0.26398,36881.993957,0.104167,0.001328
112154,112154,,8,38,46,8,38,46,0.001324,0.021272,0,20512,1,0.000015,14,0.206365,0.234249,10241.638852,0.164734,0.001913
112119,112119,,21,35,56,21,35,56,0.005306,0.020676,0,18554,1,0.000017,14,0.201335,0.226899,51870.470312,0.171104,0.006271
112060,112060,,1,1,2,1,1,2,0.000192,0.000005,0,20513,15,0.00001,3,0.473684,0.518519,26.110989,0,0.000226
112061,112061,,0,4,4,0,4,4,0,0.000033,0,20514,0,0.00001,11,0.197878,0.217559,0,0.083333,0
112062,112062,,2,1,3,2,1,3,0,0,0,20515,23,0.000022,15,0.139296,0.145622,0,0.5,0.000472
112063,112063,,3,17,20,3,17,20,0.000295,0.016273,0,20516,41,0.000011,15,0.196766,0.21868,7041.324415,0.128947,0.000918
112064,112064,,9,26,35,9,26,35,0.000884,0.003435,0,20247,30,0.000014,18,0.206796,0.232779,8684.525186,0.121008,0.002332
112065,112065,,0,26,26,0,26,26,0,0.002986,0,20517,0,0.00001,16,0.189839,0.21856,0,0.133846,0
112068,112068,,0,6,6,0,6,6,0,0.000024,0,20518,5,0.00001,16,0.142085,0.155234,0,0.233333,0
9209021,9209021,,3,1,4,3,1,4,0.000003,0.000023,0,4604,5,0.000031,1,1,1,2.333333,0,0.000676
112069,112069,,1,10,11,1,10,11,0,0.000001,0,20519,22,0.00001,12,0.138715,0.164532,0.166667,0.254545,0.000219
112070,112070,,1,6,7,1,6,7,0,0.000001,0,20520,23,0.00001,15,0.139767,0.147448,7.5,0.238095,0.000232
112071,112071,,8,35,43,8,35,43,0.000683,0.01141,0,18981,13,0.000012,13,0.200963,0.229881,42373.134652,0.091362,0.002218
112072,112072,,4,19,23,4,19,23,0.000093,0.002214,0,20521,2,0.000013,14,0.172437,0.194382,16438.768493,0.128458,0.000923
112074,112074,,1,10,11,1,10,11,0.000012,0.000257,0,20522,5,0.000011,16,0.188017,0.20928,701.160108,0.1,0.000219
112075,112075,,2,21,23,2,21,23,0.000084,0.001212,0,20523,2,0.000011,13,0.184592,0.208529,1311.906794,0.094862,0.000445
112077,112077,,4,7,11,4,7,11,0.000029,0.000086,0,20524,25,0.000012,14,0.188855,0.207706,9259.383261,0.145455,0.00097
112078,112078,,8,21,29,8,21,29,0.000184,0.000526,0,19122,52,0.000012,14,0.199178,0.220266,4831.149962,0.232759,0.001978
112080,112080,,10,31,41,10,31,41,0.001405,0.019736,0,18955,25,0.000016,13,0.200679,0.223579,26448.93968,0.116463,0.002664
112081,112081,,3,31,34,3,31,34,0.00034,0.006407,0,20525,2,0.000011,15,0.212541,0.240696,3155.376019,0.128342,0.00067
112082,112082,,1,13,14,1,13,14,0.000006,0.000949,0,20526,4,0.000011,16,0.140477,0.162243,1024.855039,0.351648,0.000219
112083,112083,,0,16,16,0,16,16,0,0.019109,0,20527,30,0.00001,14,0.218367,0.247267,0,0.179167,0
112084,112084,,6,20,26,6,20,26,0.000202,0.002875,0,19125,3,0.000012,15,0.196294,0.221678,3748.606282,0.183077,0.001397
112085,112085,,1,34,35,1,34,35,0.000001,0.002492,0,20528,25,0.000011,15,0.193973,0.21768,2350.406657,0.130252,0.000219
112086,112086,,1,12,13,1,12,13,0.000213,0.000052,0,16325,5,0.00001,15,0.165265,0.181253,4445.099812,0.198718,0.000344
9911239,9911239,,1,12,13,1,12,13,0.000001,0.000101,0,16316,13,0.000011,15,0.189393,0.217567,610.816123,0.121795,0.000227
112088,112088,,1,14,15,1,14,15,0.000047,0.001874,0,20529,3,0.00001,14,0.185543,0.204174,315.857449,0.271429,0.000239
112089,112089,,3,10,13,3,10,13,0.000001,0.000007,0,20530,20,0.000011,14,0.150229,0.163795,92.752097,0.378205,0.000671
112090,112090,,32,3,35,32,3,35,0.000447,0.000007,0,20531,15,0.000048,15,0.174297,0.186824,36337.484486,0.085714,0.007734
112091,112091,,0,3,3,0,3,3,0,0.000003,0,20532,22,0.00001,13,0.1638,0.188466,0,0,0
112092,112092,,10,17,27,10,17,27,0.000152,0.001907,0,20533,30,0.000019,13,0.219708,0.242602,65638.997504,0.105413,0.002447
112094,112094,,4,50,54,4,50,54,0.000031,0.000572,0,20534,9,0.000011,14,0.193253,0.221545,654.79382,0.200908,0.000929
112095,112095,,4,31,35,4,31,35,0.000005,0.000073,0,20545,6,0.000012,15,0.187644,0.211054,7662.528058,0.044538,0.000936
9502133,9502133,,4,0,4,4,0,4,0.000001,0,0,13221,6,0.000019,0,0,0,0,0.25,0.00095
9502135,9502135,,3,0,3,3,0,3,0.000001,0,0,20540,6,0.000012,0,0,0,0,0.333333,0.000704
9503011,9503011,,2,3,5,2,3,5,0.000001,0,0,20538,6,0.000012,3,0.52381,0.606061,16.570076,0.2,0.000472
9703023,9703023,,3,9,12,3,9,12,0.000001,0,0,20544,6,0.000017,5,0.339869,0.446154,225.239957,0.045455,0.000684
9705180,9705180,,1,7,8,1,7,8,0.000001,0,0,20539,6,0.00001,4,0.481481,0.583333,77.081572,0.071429,0.000246
9708094,9708094,,3,6,9,3,6,9,0.000002,0.000002,0,20535,9,0.000011,11,0.193874,0.221627,50.572793,0.319444,0.000691
9405138,9405138,,6,1,7,6,1,7,0.000007,0,0,2376,6,0.000027,4,0.375,0.453704,93,0.142857,0.001529
9410070,9410070,,1,0,1,1,0,1,0,0,0,20543,6,0.000012,0,0,0,0,0,0.000239
9410071,9410071,,1,1,2,1,1,2,0,0,0,20542,6,0.000012,1,1,1,16,0,0.000239
9604072,9604072,,4,3,7,4,3,7,0,0,0,13222,6,0.000021,5,0.346939,0.451961,97.666667,0.190476,0.000923
9605141,9605141,,3,2,5,3,2,5,0,0,0,13223,6,0.000014,6,0.285714,0.3725,115.2,0.1,0.000697
9511009,9511009,,1,3,4,1,3,4,0.000002,0.000006,0,10664,6,0.00001,5,0.348485,0.402899,24.649783,0.333333,0.000264
9611117,9611117,,1,11,12,1,11,12,0.000002,0.000007,0,10661,6,0.00001,8,0.2,0.2554,185.611323,0.181818,0.000264
9611005,9611005,,2,5,7,2,5,7,0,0,0,20537,6,0.000012,2,0.727273,0.8125,13.792448,0.095238,0.000445
9611006,9611006,,2,0,2,2,0,2,0,0,0,20536,6,0.000012,0,0,0,0,0,0.000445
112096,112096,,1,9,10,1,9,10,0.000082,0.000101,0,20546,4,0.00001,13,0.181395,0.200714,60.540065,0.233333,0.000233
112097,112097,,0,18,18,0,18,18,0,0.000023,0,20547,6,0.00001,15,0.164832,0.183295,0,0.140523,0
112098,112098,,22,11,33,22,11,33,0.001273,0.000825,0,19033,10,0.00002,15,0.195448,0.217555,8016.313962,0.20928,0.006547
112099,112099,,3,25,28,3,25,28,0.001051,0.019235,0,18944,1,0.00001,19,0.174787,0.207054,3824.362551,0.149471,0.000773
112100,112100,,12,18,30,12,18,30,0.000901,0.002324,0,18519,1,0.000017,14,0.211106,0.241827,20726.380814,0.155172,0.00326
112101,112101,,8,47,55,8,47,55,0.000227,0.004495,0,18982,3,0.000013,13,0.214684,0.245316,41876.065113,0.1367,0.002526
112102,112102,,2,9,11,2,9,11,0.000054,0.000002,0,20548,22,0.000011,6,0.265446,0.333764,63.047885,0.336364,0.000451
112103,112103,,1,1,2,1,1,2,0,0,0,20550,23,0.000014,2,0.666667,0.75,2,0,0.000219
9704019,9704019,,2,1,3,2,1,3,0,0,0,20549,23,0.000026,1,1,1,3,0,0.000445
112104,112104,,2,30,32,2,30,32,0.000338,0.00038,0,19130,52,0.000011,15,0.189668,0.210772,9961.196887,0.106855,0.000666
112105,112105,,1,2,3,1,2,3,0,0,0,20551,26,0.000014,10,0.18431,0.202583,0,0.5,0.000226
112106,112106,,6,17,23,6,17,23,0.000159,0.001085,0,20552,2,0.000013,18,0.205163,0.228638,4079.756818,0.167984,0.001501
112107,112107,,0,16,16,0,16,16,0,0.001693,0,20553,1,0.00001,15,0.204153,0.226707,0,0.325,0
112109,112109,,1,36,37,1,36,37,0.000057,0.003312,0,20554,4,0.00001,17,0.199375,0.228846,3683.13029,0.114114,0.00043
201046,201046,,5,6,11,5,6,11,0.000057,0.000006,0,20556,22,0.000031,12,0.175065,0.190852,12643.475388,0.118182,0.001142
112110,112110,,5,0,5,5,0,5,0.000219,0,0,20555,8,0.000022,0,0,0,0,0.15,0.00115
112111,112111,,1,7,8,1,7,8,0,0,0,20561,21,0.000011,8,0.213699,0.28534,5,0.232143,0.000219
9710159,9710159,,4,6,10,4,6,10,0,0,0,20559,21,0.000015,7,0.236667,0.296311,103.971429,0.211111,0.000903
9906083,9906083,,3,9,12,3,9,12,0,0,0,20560,21,0.000013,7,0.23913,0.309391,106.209524,0.234848,0.000664
9609146,9609146,,2,6,8,2,6,8,0,0,0,20558,21,0.000013,7,0.228385,0.282687,9.166667,0.25,0.000484
9609147,9609147,,4,4,8,4,4,8,0,0,0,20557,21,0.000015,7,0.225859,0.272291,1.833333,0.321429,0.000922
112112,112112,,2,28,30,2,28,30,0.000115,0.004433,0,20562,25,0.00001,15,0.198973,0.22312,4833.535011,0.112644,0.000465
112113,112113,,32,36,68,32,36,68,0.001754,0.001698,0,19039,10,0.000023,15,0.209828,0.237531,55064.046934,0.163082,0.009361
112116,112116,,0,34,34,0,34,34,0,0.004704,0,20563,2,0.00001,16,0.204981,0.231035,0,0.105169,0
112117,112117,,6,20,26,6,20,26,0.000248,0.001122,0,19045,10,0.000012,15,0.197655,0.222164,10068.151183,0.103077,0.002059
112118,112118,,0,15,15,0,15,15,0,0.000773,0,20564,0,0.00001,15,0.197007,0.221232,0,0.280952,0
112120,112120,,2,2,4,2,2,4,0.000002,0,0,20565,22,0.00001,12,0.15266,0.160741,83.181495,0.083333,0.000484
112121,112121,,0,6,6,0,6,6,0,0.000008,0,20566,23,0.00001,15,0.139488,0.153023,0,0.066667,0
112122,112122,,18,9,27,18,9,27,0.000805,0.000165,0,18952,8,0.000026,15,0.177748,0.195875,20140.23115,0.24359,0.005499
112125,112125,,2,26,28,2,26,28,0.000001,0.00004,0,20567,22,0.000011,15,0.170566,0.18688,1217.443473,0.136243,0.000491
112158,112158,,6,15,21,6,15,21,0.000058,0.00003,0,20568,22,0.000012,15,0.17094,0.186106,2274.667694,0.204762,0.001381
112126,112126,,18,44,62,18,44,62,0.002242,0.01037,0,19044,1,0.000015,16,0.213733,0.246278,45484.738306,0.153887,0.005388
112129,112129,,0,5,5,0,5,5,0,0.000012,0,20569,5,0.00001,18,0.149771,0.159935,0,0.3,0
112130,112130,,1,9,10,1,9,10,0.000013,0.000235,0,20570,52,0.00001,14,0.171763,0.188413,3.076721,0.422222,0.000232
112131,112131,,4,23,27,4,23,27,0.000621,0.017017,0,19157,1,0.000011,16,0.210446,0.242107,5721.633391,0.115385,0.001045
112132,112132,,1,22,23,1,22,23,0.000052,0.016725,0,20572,1,0.00001,16,0.198246,0.230612,736.605074,0.1917,0.00024
112133,112133,,2,21,23,2,21,23,0.000248,0.002031,0,20571,13,0.000011,15,0.210303,0.242471,3434.542595,0.250988,0.000466
112134,112134,,1,13,14,1,13,14,0.000023,0.002351,0,19508,30,0.00001,14,0.195104,0.213685,567.294585,0.208791,0.000292
112135,112135,,4,18,22,4,18,22,0.000063,0.000532,0,19355,3,0.000011,16,0.180618,0.201487,2955.363993,0.175325,0.001022
112136,112136,,20,38,58,20,38,58,0.001716,0.004072,0,19298,25,0.000017,14,0.207592,0.234587,21745.902468,0.099214,0.00476
112137,112137,,0,38,38,0,38,38,0,0.004264,0,20573,2,0.00001,18,0.20114,0.234204,0,0.096728,0
112138,112138,,24,10,34,24,10,34,0.001398,0.000329,0,19040,10,0.00002,15,0.19305,0.213862,7795.929307,0.180927,0.006843
112139,112139,,6,14,20,6,14,20,0.000162,0.00069,0,19377,30,0.000012,14,0.213894,0.235541,16960.386583,0.228947,0.001498
112141,112141,,0,18,18,0,18,18,0,0.00314,0,20574,22,0.00001,15,0.184445,0.209226,0,0.107843,0
112142,112142,,0,4,4,0,4,4,0,0.000001,0,20575,23,0.00001,18,0.12004,0.133124,0,0.333333,0
112143,112143,,0,3,3,0,3,3,0,0.000001,0,20576,2,0.00001,13,0.146454,0.15743,0,0.333333,0
112145,112145,,3,53,56,3,53,56,0.000493,0.013368,0,20577,1,0.000011,17,0.210863,0.245892,1946.53636,0.117532,0.000698
112146,112146,,2,4,6,2,4,6,0.000258,0.000028,0,20578,22,0.000011,16,0.172534,0.18808,686.368002,0.4,0.000451
112148,112148,,2,11,13,2,11,13,0.000002,0.000015,0,20580,5,0.000011,15,0.120687,0.13175,791.803617,0.237179,0.000545
101142,101142,,2,0,2,2,0,2,0,0,0,20579,5,0.00002,0,0,0,0,0,0.000453
112149,112149,,0,5,5,0,5,5,0,0.000015,0,20581,23,0.00001,21,0.112408,0.124573,0,0.25,0
112150,112150,,5,32,37,5,32,37,0.001285,0.014899,0,18553,1,0.000011,13,0.200473,0.224522,13398.24345,0.178679,0.00141
112151,112151,,7,23,30,7,23,30,0.000134,0.000279,0,20582,26,0.000014,18,0.179837,0.198949,9379.412507,0.185057,0.001586
112153,112153,,2,26,28,2,26,28,0.000096,0.005336,0,20583,30,0.000011,14,0.199607,0.22219,1894.855136,0.203704,0.000438
112155,112155,,0,58,58,0,58,58,0,0.002023,0,20584,2,0.00001,13,0.204313,0.233652,0,0.101936,0
9512102,9512102,,2,11,13,2,11,13,0.000041,0.000729,0,8920,2,0.00001,6,0.298097,0.346217,6.715476,0.24359,0.00047
112156,112156,,0,2,2,0,2,2,0,0,6,20585,24,0.00001,2,0.75,0.833333,0,0.5,0
112157,112157,,6,9,15,6,9,15,0.00018,0.00032,0,20021,0,0.000012,14,0.181949,0.200447,13310.222489,0.090476,0.001538
202077,202077,,2,33,35,2,33,35,0.000056,0.00006,0,20589,22,0.00001,16,0.190341,0.208022,414.777278,0.098319,0.000445
201080,201080,,5,9,14,5,9,14,0.000027,0.000004,0,20588,22,0.000013,16,0.157874,0.17246,993.943555,0.21978,0.001122
9601025,9601025,,4,0,4,4,0,4,0.000001,0,0,13414,22,0.000056,0,0,0,0,0.166667,0.00095
9801101,9801101,,1,5,6,1,5,6,0.000001,0.000001,0,20587,22,0.00001,4,0.461538,0.569444,27.157576,0.266667,0.000232
9509088,9509088,,4,5,9,4,5,9,0.000001,0.000001,0,17955,9,0.000017,4,0.407407,0.487374,167.261262,0.180556,0.000958
9606014,9606014,,2,2,4,2,2,4,0,0.000001,0,17957,9,0.000013,6,0.279279,0.323387,156.9372,0.166667,0.000492
112159,112159,,0,13,13,0,13,13,0,0.000998,0,20590,23,0.00001,13,0.186081,0.202691,0,0.121795,0
112160,112160,,14,24,38,14,24,38,0.000614,0.001117,0,19230,2,0.000018,12,0.194234,0.216665,58118.776057,0.103841,0.003992
112161,112161,,2,3,5,2,3,5,0.000219,0.000032,0,20591,25,0.000011,13,0.16501,0.177054,237.266333,0.15,0.000505
112162,112162,,11,17,28,11,17,28,0.000143,0.000427,0,20361,2,0.000016,16,0.17639,0.195676,18111.56446,0.157407,0.002657
112163,112163,,0,6,6,0,6,6,0,0.000011,0,20592,6,0.00001,6,0.320388,0.454545,0,0,0
112164,112164,,5,21,26,5,21,26,0.000252,0.001342,0,20593,1,0.000015,18,0.17769,0.204266,7891.580285,0.063077,0.001102
112165,112165,,6,10,16,6,10,16,0.000134,0.002652,0,18852,25,0.000014,14,0.182455,0.204997,13470.551702,0.116667,0.001769
112166,112166,,11,14,25,11,14,25,0.0005,0.001979,0,20060,25,0.00002,12,0.20189,0.220967,27581.877594,0.126667,0.002632
112167,112167,,3,11,14,3,11,14,0,0.000001,0,20594,6,0.000012,14,0.132342,0.143123,2521.064301,0.153846,0.000684
112168,112168,,2,15,17,2,15,17,0,0.000064,0,20595,6,0.000012,17,0.184074,0.201165,19072.907481,0.069853,0.000438
112169,112169,,32,41,73,32,41,73,0.000322,0.000961,0,18834,3,0.000023,14,0.200408,0.221609,46666.648931,0.230784,0.009536
112170,112170,,4,18,22,4,18,22,0,0.000005,0,20596,23,0.000015,16,0.145903,0.162788,11686.807388,0.082251,0.000903
112171,112171,,0,1,1,0,1,1,0,0,11,20597,33,0.00001,1,1,1,0,0,0
112173,112173,,5,34,39,5,34,39,0.000909,0.008998,0,18942,3,0.000011,15,0.205178,0.234416,12898.996948,0.115385,0.001405
112174,112174,,11,26,37,11,26,37,0.000431,0.003995,0,18870,0,0.000013,15,0.197412,0.221767,266.957788,0.307808,0.004143
112175,112175,,4,7,11,4,7,11,0.000017,0.000053,0,20599,23,0.000015,13,0.194281,0.214822,16175.844152,0.054545,0.000903
9706044,9706044,,2,8,10,2,8,10,0.000001,0.000001,0,20598,23,0.000014,8,0.231003,0.324671,253.823128,0.133333,0.000471
112176,112176,,3,42,45,3,42,45,0.000289,0.002451,0,20105,30,0.000011,14,0.222663,0.247282,3202.775763,0.221212,0.000698
112178,112178,,15,26,41,15,26,41,0.002577,0.018578,0,18635,1,0.000018,15,0.220044,0.251556,96789.937805,0.127439,0.004233
112264,112264,,15,12,27,15,12,27,0.002488,0.018971,0,18636,1,0.000017,14,0.207058,0.237024,12139.295023,0.198006,0.004027
201100,201100,,6,9,15,6,9,15,0.001225,0.009946,0,18639,1,0.000012,13,0.184789,0.202832,5148.659586,0.257143,0.001718
201172,201172,,7,13,20,7,13,20,0.001527,0.016618,0,18966,1,0.000013,13,0.19189,0.212105,1144.017618,0.313158,0.00198
201258,201258,,4,35,39,4,35,39,0.000774,0.019078,0,18974,1,0.000011,12,0.200872,0.22431,25629.964167,0.190283,0.001197
203041,203041,,8,17,25,8,17,25,0.000712,0.010944,0,18973,1,0.000013,16,0.203504,0.238538,23695.214892,0.165,0.002635
203168,203168,,5,13,18,5,13,18,0.000996,0.018127,0,18967,1,0.000012,12,0.214927,0.243154,49137.925822,0.310458,0.001538
112179,112179,,1,2,3,1,2,3,0,0,0,20600,6,0.000011,16,0.121702,0.129686,0,0.333333,0.000219
112181,112181,,0,4,4,0,4,4,0,0.00011,0,20601,30,0.00001,14,0.19955,0.217842,0,0.166667,0
112182,112182,,4,9,13,4,9,13,0.000008,0.000045,0,20602,1,0.000018,18,0.179151,0.198284,6876.171492,0.179487,0.00091
112183,112183,,6,5,11,6,5,11,0,0.000002,0,20603,23,0.000028,15,0.139694,0.149419,47920,0.190909,0.001414
9307136,9307136,,5,1,6,5,1,6,0,0,0,13917,23,0.000031,1,1,1,8,0.133333,0.001163
112184,112184,,6,1,7,6,1,7,0,0,0,20604,23,0.000028,3,0.5,0.583333,0,0.47619,0.001414
112185,112185,,3,31,34,3,31,34,0.000038,0.002014,0,20605,30,0.000012,14,0.223087,0.247204,11213.627365,0.163993,0.000703
112186,112186,,0,19,19,0,19,19,0,0.001731,0,20606,30,0.00001,15,0.190881,0.21144,0,0.24269,0
112187,112187,,11,30,41,11,30,41,0.001893,0.004086,0,20035,1,0.000015,15,0.215863,0.244375,6232.355886,0.178049,0.002799
112188,112188,,19,26,45,19,26,45,0.001856,0.00927,0,18938,52,0.000018,18,0.216227,0.24909,26447.784402,0.144444,0.005717
112189,112189,,2,28,30,2,28,30,0.000023,0.001492,0,20607,30,0.000011,13,0.213448,0.239068,3106.828151,0.163218,0.000458
112190,112190,,1,23,24,1,23,24,0.000126,0.003954,0,20608,1,0.00001,16,0.203724,0.230145,659.918304,0.231884,0.000246
112191,112191,,5,9,14,5,9,14,0.001556,0.016035,0,18549,1,0.000011,18,0.185216,0.208929,12.932174,0.351648,0.001431
112192,112192,,6,21,27,6,21,27,0.000094,0.000915,0,18880,0,0.000013,15,0.199424,0.224039,21327.949477,0.180912,0.002185
112193,112193,,5,34,39,5,34,39,0.000052,0.001309,0,19124,52,0.000012,13,0.224877,0.253612,56619.746964,0.101215,0.001302
112194,112194,,0,2,2,0,2,2,0,0,0,20609,23,0.00001,3,0.571429,0.708333,0,0.5,0
112195,112195,,15,52,67,15,52,67,0.002675,0.012082,0,20034,1,0.000015,15,0.225774,0.258587,40359.543986,0.134102,0.003728
112198,112198,,24,36,60,24,36,60,0.0026,0.00326,0,18937,52,0.000021,17,0.22172,0.255859,116345.953789,0.107062,0.007188
112199,112199,,8,33,41,8,33,41,0.000391,0.00361,0,19072,3,0.000012,14,0.215311,0.245632,51493.339664,0.142683,0.002077
112200,112200,,3,28,31,3,28,31,0.000189,0.002435,0,18929,52,0.000012,14,0.209805,0.238702,13670.128946,0.093548,0.000712
112201,112201,,0,7,7,0,7,7,0,0.000001,0,20611,21,0.00001,14,0.142367,0.1631,0,0.190476,0
9408067,9408067,,5,5,10,5,5,10,0,0.000004,0,7231,21,0.000021,1,1,1,144.9383,0.155556,0.001143
9502047,9502047,,3,2,5,3,2,5,0.000035,0.000001,0,20610,21,0.000013,1,1,1,1,0.3,0.000658
112202,112202,,13,9,22,13,9,22,0.000136,0.000268,0,18812,3,0.000016,15,0.17436,0.189449,13.641358,0.344156,0.004153
112203,112203,,3,18,21,3,18,21,0.000032,0.000575,0,20612,3,0.000011,16,0.191807,0.210559,884.156816,0.264286,0.000677
112204,112204,,14,7,21,14,7,21,0.002438,0.015798,0,18523,1,0.000018,16,0.202269,0.22496,6430.744334,0.180952,0.003466
112206,112206,,4,23,27,4,23,27,0.000122,0.002125,0,20613,2,0.000012,17,0.195771,0.222339,1950.17238,0.088319,0.000925
112207,112207,,6,8,14,6,8,14,0.00016,0.001068,0,20614,2,0.000014,14,0.184364,0.205249,2033.678915,0.192308,0.00142
112208,112208,,1,1,2,1,1,2,0,0,0,20615,23,0.000019,3,0.470588,0.520833,8,0,0.000219
112209,112209,,0,5,5,0,5,5,0,0.000004,0,20616,20,0.00001,12,0.165049,0.177495,0,0.15,0
112210,112210,,2,10,12,2,10,12,0.00008,0.001562,0,20617,2,0.00001,15,0.188041,0.20899,458.518198,0.219697,0.000471
112211,112211,,5,13,18,5,13,18,0.000818,0.001466,0,20618,4,0.000011,13,0.17861,0.196963,773.686936,0.30719,0.001326
112212,112212,,0,9,9,0,9,9,0,0.000003,0,20621,28,0.00001,13,0.153642,0.166893,0,0.027778,0
9710133,9710133,,1,2,3,1,2,3,0,0,0,20620,28,0.000011,1,1,1,0.5,0.166667,0.000219
9907045,9907045,,4,2,6,4,2,6,0,0,0,20619,6,0.000021,6,0.290323,0.438889,24,0.1,0.00089
112214,112214,,17,41,58,17,41,58,0.000184,0.001319,0,18838,3,0.000016,14,0.203912,0.227227,25791.515327,0.258923,0.005024
112231,112231,,20,35,55,20,35,55,0.000243,0.001261,0,18839,3,0.000018,14,0.203283,0.225891,38122.021969,0.23064,0.005724
112215,112215,,8,5,13,8,5,13,0.000001,0.000001,0,20622,23,0.000026,18,0.148647,0.163127,12858.303723,0.160256,0.001792
112217,112217,,5,7,12,5,7,12,0.000001,0.000009,0,20623,5,0.000017,14,0.12441,0.15258,13.507251,0.325758,0.001215
112219,112219,,2,24,26,2,24,26,0.000108,0.004853,0,20625,13,0.000011,12,0.20962,0.234223,3420.829597,0.098462,0.000546
9411011,9411011,,1,1,2,1,1,2,0.000057,0.000007,0,20624,3,0.00001,1,1,1,4.01658,0,0.000234
112220,112220,,2,13,15,2,13,15,0.000032,0.000095,0,20626,30,0.00001,14,0.191926,0.208175,934.418905,0.147619,0.000445
112221,112221,,2,32,34,2,32,34,0.000023,0.001727,0,19119,52,0.00001,18,0.201752,0.229927,3563.175618,0.120321,0.000509
112222,112222,,2,31,33,2,31,33,0.000352,0.002468,0,19106,52,0.00001,16,0.186411,0.206991,363.509173,0.151515,0.000724
112224,112224,,4,8,12,4,8,12,0.000422,0.001448,0,20627,25,0.000013,13,0.184453,0.203547,2948.541078,0.272727,0.000936
112228,112228,,2,29,31,2,29,31,0.000044,0.000705,0,20629,3,0.000011,18,0.183431,0.207212,4146.638861,0.098925,0.000451
9711045,9711045,,1,5,6,1,5,6,0.000008,0.000052,0,20628,3,0.00001,10,0.179473,0.221885,65.734804,0.233333,0.000232
112229,112229,,2,7,9,2,7,9,0.000475,0.00323,0,19385,1,0.000011,15,0.205041,0.238966,212.86567,0.277778,0.000468
110205,110205,,4,0,4,4,0,4,0.000658,0,0,19384,1,0.000012,0,0,0,0,0.083333,0.000938
112230,112230,,2,17,19,2,17,19,0.000001,0.000032,0,20630,23,0.000012,18,0.155815,0.173195,2121.372258,0.128655,0.000438
112233,112233,,4,23,27,4,23,27,0.000045,0.00298,0,20633,0,0.000012,13,0.180783,0.211259,673.972841,0.192308,0.000922
9801029,9801029,,3,7,10,3,7,10,0.000082,0.001385,0,9440,0,0.000012,14,0.201262,0.230944,174.614435,0.288889,0.000738
9809118,9809118,,3,12,15,3,12,15,0.000243,0.004405,0,20631,2,0.000011,16,0.169554,0.200455,194.624037,0.152381,0.000751
9907011,9907011,,5,22,27,5,22,27,0.000077,0.002963,0,20632,0,0.000013,12,0.192572,0.222129,4823.743413,0.176638,0.001162
112234,112234,,0,1,1,0,1,1,0,0,0,20634,13,0.00001,12,0.165799,0.17675,0,0,0
112235,112235,,4,18,22,4,18,22,0.000058,0.000634,0,19041,10,0.000012,15,0.186943,0.206869,24779.472733,0.140693,0.001129
9308054,9308054,,3,0,3,3,0,3,0,0,0,2086,25,0.000023,0,0,0,0,0,0.000688
112236,112236,,29,21,50,29,21,50,0.003837,0.004015,0,18971,1,0.000023,14,0.205691,0.231931,12258.254438,0.144082,0.007652
112238,112238,,0,11,11,0,11,11,0,0.001581,0,20635,30,0.00001,14,0.208839,0.231336,0,0.345455,0
112239,112239,,1,4,5,1,4,5,0,0.000004,0,20636,25,0.000012,15,0.148178,0.157775,2,0.3,0.000219
112240,112240,,0,4,4,0,4,4,0,0.000338,0,20637,8,0.00001,18,0.162564,0.176649,0,0.166667,0
112241,112241,,0,3,3,0,3,3,0,0,0,20638,26,0.00001,12,0.123131,0.135733,0,0.5,0
112242,112242,,0,6,6,0,6,6,0,0,0,20639,26,0.00001,11,0.139672,0.15636,0,0.3,0
112243,112243,,2,1,3,2,1,3,0,0,0,20640,22,0.000012,17,0.138815,0.146279,962.115651,0.333333,0.000458
112244,112244,,5,20,25,5,20,25,0.000116,0.001438,0,20641,25,0.000013,16,0.19842,0.220222,3131.272241,0.253333,0.001149
112245,112245,,0,2,2,0,2,2,0,0.000003,0,20644,8,0.00001,1,1,1,0,0.5,0
9611236,9611236,,4,0,4,4,0,4,0.000265,0,0,20642,8,0.000031,0,0,0,0,0.166667,0.001004
9906066,9906066,,2,1,3,2,1,3,0.000005,0.000003,0,20643,8,0.000016,1,1,1,0,0.333333,0.000438
112246,112246,,4,8,12,4,8,12,0.00018,0.001699,0,20645,30,0.000012,14,0.201359,0.221079,116.792324,0.257576,0.000909
112247,112247,,14,4,18,14,4,18,0.000491,0.000847,0,18864,0,0.000015,13,0.190997,0.209383,19.333598,0.382353,0.005252
112248,112248,,12,25,37,12,25,37,0.000248,0.002401,0,20646,30,0.000015,13,0.215945,0.238698,17007.456617,0.175676,0.002844
112250,112250,,0,2,2,0,2,2,0,0.000101,0,20647,52,0.00001,16,0.157445,0.169829,0,0,0
112251,112251,,11,32,43,11,32,43,0.002055,0.00244,0,18543,1,0.000014,16,0.185148,0.207429,14560.867499,0.196013,0.0035
112252,112252,,0,12,12,0,12,12,0,0.001067,0,20648,15,0.00001,14,0.201397,0.221188,0,0.113636,0
112254,112254,,2,20,22,2,20,22,0.000247,0.015034,0,20649,1,0.000012,14,0.222624,0.255411,4688.272561,0.194805,0.000445
112255,112255,,2,7,9,2,7,9,0.00002,0.000015,0,20650,0,0.000011,14,0.16197,0.176035,1080.356747,0.333333,0.000438
112256,112256,,2,2,4,2,2,4,0,0.000005,0,20651,30,0.000018,15,0.143919,0.154825,1263.073698,0.333333,0.000451
112257,112257,,0,9,9,0,9,9,0,0,0,20656,21,0.00001,8,0.204607,0.275418,0,0.097222,0
9609148,9609148,,1,3,4,1,3,4,0,0,0,20655,21,0.000011,2,0.8,0.875,4,0,0.000219
9609149,9609149,,1,3,4,1,3,4,0,0,0,20652,21,0.000011,7,0.2257,0.270629,26.660714,0.25,0.000219
9404145,9404145,,2,0,2,2,0,2,0,0,0,20654,21,0.000016,0,0,0,0,0,0.000445
9411139,9411139,,2,0,2,2,0,2,0,0,0,20653,21,0.000016,0,0,0,0,0,0.000445
112259,112259,,2,12,14,2,12,14,0.000102,0.00149,0,20005,0,0.00001,18,0.187226,0.21118,5.062295,0.307692,0.000664
112260,112260,,4,12,16,4,12,16,0.000012,0.000003,0,20657,23,0.000012,14,0.162102,0.174139,2.196825,0.366667,0.000923
112261,112261,,7,5,12,7,5,12,0.00037,0.000031,0,20658,1,0.000017,14,0.173001,0.186941,5150.642343,0.045455,0.001554
112262,112262,,2,6,8,2,6,8,0.000036,0.000005,0,20659,30,0.000011,19,0.147786,0.160634,37.201832,0.196429,0.000451
112263,112263,,2,7,9,2,7,9,0,0,0,20660,9,0.000014,12,0.142266,0.160815,912,0.277778,0.000438
201001,201001,,0,3,3,0,3,3,0,0.000004,0,20663,22,0.00001,2,0.666667,0.75,0,0,0
106130,106130,,1,0,1,1,0,1,0,0,0,20662,22,0.000013,0,0,0,0,0,0.000219
9310158,9310158,,4,2,6,4,2,6,0,0,0,20661,6,0.000021,1,1,1,11.666667,0,0.000896
201002,201002,,0,18,18,0,18,18,0,0.002472,0,20665,30,0.00001,14,0.194701,0.214185,0,0.104575,0
9506082,9506082,,1,0,1,1,0,1,0.000029,0,0,20664,30,0.00001,0,0,0,0,0,0.000219
201003,201003,,0,2,2,0,2,2,0,0,0,20667,22,0.00001,2,0.75,0.833333,0,0.5,0
9903097,9903097,,1,1,2,1,1,2,0,0,0,20666,22,0.000014,2,0.666667,0.75,0,0.5,0.000219
201005,201005,,1,10,11,1,10,11,0,0.000008,0,20668,23,0.00001,16,0.135082,0.15588,90.634512,0.1,0.000219
201006,201006,,1,5,6,1,5,6,0.000001,0.001138,0,20670,4,0.000011,15,0.153679,0.167629,29.274155,0.233333,0.000219
9911130,9911130,,2,6,8,2,6,8,0.000014,0.000141,0,20669,4,0.000013,14,0.179285,0.198986,9536.411254,0.125,0.000445
201007,201007,,11,16,27,11,16,27,0.000191,0.000065,0,19507,30,0.000024,15,0.17365,0.188236,18468.741116,0.143875,0.002728
201008,201008,,2,19,21,2,19,21,0,0.000007,0,20671,6,0.000011,16,0.138626,0.159566,10899.678107,0.088095,0.000451
201009,201009,,1,8,9,1,8,9,0.000006,0.000028,0,20673,0,0.00001,15,0.14183,0.153935,48.51843,0.25,0.000219
9805164,9805164,,1,5,6,1,5,6,0,0.000019,0,20672,0,0.000011,3,0.571429,0.680556,3.166667,0.433333,0.000226
201010,201010,,1,20,21,1,20,21,0.000035,0.00135,0,20674,3,0.00001,16,0.191892,0.215499,479.443092,0.230952,0.000219
201011,201011,,1,8,9,1,8,9,0,0.000003,0,20675,23,0.000011,18,0.122102,0.135176,2338.520662,0.263889,0.000226
201012,201012,,1,21,22,1,21,22,0.000035,0.00285,0,20676,25,0.00001,15,0.1896,0.212857,0,0.300866,0.000219
201013,201013,,4,7,11,4,7,11,0.000001,0.00006,0,20677,23,0.000014,15,0.148884,0.159242,319.863661,0.172727,0.000896
201014,201014,,0,2,2,0,2,2,0,0.000167,0,20678,3,0.00001,14,0.204485,0.227875,0,0,0
201015,201015,,41,28,69,41,28,69,0.000498,0.000408,0,18836,3,0.000032,15,0.18403,0.202747,7290.644076,0.224851,0.011963
201016,201016,,15,25,40,15,25,40,0.000794,0.001264,0,20679,30,0.000023,13,0.219031,0.242513,55376.303329,0.116026,0.003786
201018,201018,,2,12,14,2,12,14,0.000193,0.002868,0,20680,15,0.000011,13,0.202712,0.222661,1838.59348,0.120879,0.000452
201019,201019,,17,14,31,17,14,31,0.002398,0.015559,0,18521,1,0.000021,15,0.189839,0.211674,17071.068335,0.176344,0.004945
201022,201022,,0,8,8,0,8,8,0,0.000548,0,20681,4,0.00001,17,0.128567,0.144734,0,0.446429,0
201023,201023,,2,14,16,2,14,16,0.000206,0.000331,0,18511,23,0.000011,13,0.180393,0.198894,49152.76834,0.120833,0.000591
201025,201025,,3,30,33,3,30,33,0.000113,0.003917,0,20682,30,0.00001,15,0.211009,0.233976,6295.853371,0.151515,0.000717
201026,201026,,0,5,5,0,5,5,0,0.001189,0,20683,25,0.00001,15,0.187652,0.208569,0,0.1,0
201027,201027,,2,13,15,2,13,15,0.000254,0.000425,0,20684,2,0.00001,12,0.189513,0.207913,250.731962,0.247619,0.000471
201030,201030,,3,2,5,3,2,5,0.000368,0.000053,0,20685,1,0.000015,16,0.172604,0.190984,156.179958,0.35,0.000677
201031,201031,,3,9,12,3,9,12,0.000034,0.002026,0,20686,30,0.000013,15,0.187893,0.208148,10065.515495,0.318182,0.000664
201032,201032,,7,86,93,7,86,93,0.000683,0.007271,0,20687,0,0.000012,15,0.19219,0.224821,13392.990412,0.087658,0.001717
201033,201033,,0,9,9,0,9,9,0,0.002745,0,20688,30,0.00001,14,0.190072,0.20948,0,0.125,0
201034,201034,,0,11,11,0,11,11,0,0.000223,0,20689,30,0.00001,17,0.174716,0.191724,0,0.1,0
201035,201035,,3,35,38,3,35,38,0.000032,0.00153,0,20690,3,0.000011,13,0.210438,0.235858,6666.599349,0.16643,0.000684
201036,201036,,3,15,18,3,15,18,0.000352,0.013913,0,20691,1,0.000012,11,0.226859,0.257357,11897.728135,0.104575,0.000677
9610051,9610051,,6,3,9,6,3,9,0.000013,0.000519,0,4999,6,0.000036,7,0.218954,0.251688,11320.520344,0.069444,0.00137
9709162,9709162,,2,1,3,2,1,3,0.000001,0,0,11869,6,0.000016,8,0.180723,0.200282,0,0.5,0.000459
9710040,9710040,,1,2,3,1,2,3,0.000001,0,0,11870,6,0.000011,8,0.181818,0.206162,0,0.5,0.000233
201037,201037,,25,46,71,25,46,71,0.001124,0.005151,0,18871,0,0.000017,15,0.202342,0.230862,8508.966114,0.208451,0.008907
201038,201038,,2,9,11,2,9,11,0.000047,0.001982,0,20692,4,0.000011,17,0.208592,0.241602,928.705689,0.3,0.000459
201040,201040,,2,25,27,2,25,27,0.000048,0.00291,0,19196,0,0.000011,12,0.20062,0.223258,4655.121051,0.193732,0.000461
201041,201041,,4,26,30,4,26,30,0.00008,0.002694,0,20693,25,0.000012,15,0.193243,0.218236,7699.445147,0.132184,0.00093
201042,201042,,1,12,13,1,12,13,0.000113,0.001526,0,20694,3,0.00001,13,0.196158,0.218412,6840.30393,0.102564,0.000361
201043,201043,,0,2,2,0,2,2,0,0.000001,0,20695,8,0.00001,14,0.14346,0.151342,0,0,0
201044,201044,,0,1,1,0,1,1,0,0,0,20696,28,0.00001,1,1,1,0,0,0
9606155,9606155,,6,0,6,6,0,6,0,0,0,9491,28,0.000076,0,0,0,0,0.2,0.001378
201045,201045,,8,1,9,8,1,9,0,0.000001,0,20697,6,0.000033,9,0.159091,0.188558,139.624772,0.097222,0.001786
201047,201047,,2,25,27,2,25,27,0.000095,0.002634,0,20698,6,0.000012,16,0.229657,0.26238,10157.315372,0.108262,0.000438
201048,201048,,4,6,10,4,6,10,0.000075,0.000151,0,20699,2,0.000013,15,0.154052,0.171866,11603.235209,0.233333,0.000923
201049,201049,,0,4,4,0,4,4,0,0.00002,0,20702,52,0.00001,15,0.158284,0.171182,0,0.25,0
9701003,9701003,,1,3,4,1,3,4,0,0.00002,0,20701,52,0.000012,2,0.615385,0.6875,8,0.083333,0.000219
9604132,9604132,,1,0,1,1,0,1,0,0,0,20700,52,0.000013,0,0,0,0,0,0.000226
201050,201050,,0,6,6,0,6,6,0,0.000003,0,20703,23,0.00001,17,0.159462,0.176228,0,0.033333,0
201051,201051,,2,18,20,2,18,20,0.000054,0.002173,0,20704,25,0.000011,13,0.218831,0.245209,7404.207273,0.168421,0.000452
201130,201130,,2,14,16,2,14,16,0.000059,0.001985,0,20705,25,0.00001,14,0.198289,0.219741,3288.704407,0.233333,0.000458
201052,201052,,2,5,7,2,5,7,0,0,0,20706,6,0.000013,16,0.137507,0.146782,5525.91697,0.309524,0.000445
201053,201053,,0,1,1,0,1,1,0,0,0,20708,6,0.00001,1,1,1,0,0,0
110197,110197,,2,0,2,2,0,2,0,0,0,20707,6,0.00002,0,0,0,0,0,0.000438
201054,201054,,9,25,34,9,25,34,0.000121,0.001015,0,19356,3,0.000013,15,0.188494,0.209456,5107.406809,0.213012,0.002383
201055,201055,,2,11,13,2,11,13,0.000033,0.001472,0,20709,25,0.000012,14,0.1829,0.202811,1006.936226,0.326923,0.000445
201056,201056,,4,11,15,4,11,15,0.000001,0.00002,0,20710,22,0.000016,16,0.150431,0.163858,17403.271634,0.138095,0.000883
201057,201057,,2,12,14,2,12,14,0,0.000013,0,20711,23,0.000011,15,0.135082,0.150871,825.853569,0.225275,0.000445
201058,201058,,2,6,8,2,6,8,0.000013,0.000581,0,20712,1,0.000012,9,0.182385,0.210915,102.849423,0.339286,0.000438
201059,201059,,3,40,43,3,40,43,0.000002,0.00009,0,20715,23,0.000011,14,0.18004,0.201799,8548.451432,0.07309,0.000678
9303154,9303154,,7,3,10,7,3,10,0.000002,0,0,2579,23,0.000027,1,1,1,193.286596,0.155556,0.001642
9304094,9304094,,2,2,4,2,2,4,0.000001,0.000004,0,20714,5,0.000011,1,1,1,5.566667,0.083333,0.000472
9710100,9710100,,2,3,5,2,3,5,0.000001,0.000004,0,20713,5,0.000011,2,0.8,0.875,24.316667,0.1,0.000472
201060,201060,,14,22,36,14,22,36,0.000201,0.001141,0,18837,3,0.000016,16,0.186355,0.206237,2009.41482,0.262698,0.004045
201061,201061,,3,30,33,3,30,33,0.000215,0.002984,0,20249,3,0.000011,15,0.20187,0.230507,5114.706142,0.139205,0.000754
201062,201062,,6,55,61,6,55,61,0.000189,0.007489,0,19049,10,0.000015,16,0.205858,0.235688,21266.140626,0.079781,0.001389
201063,201063,,8,13,21,8,13,21,0.000178,0.003111,0,20716,25,0.000016,17,0.178252,0.200799,2301.726457,0.095238,0.001866
201064,201064,,1,3,4,1,3,4,0,0,0,20718,23,0.000013,2,0.8,0.875,2,0.25,0.000219
9805061,9805061,,3,1,4,3,1,4,0,0,0,20717,23,0.00002,1,1,1,4,0.083333,0.00067
9704188,9704188,,2,0,2,2,0,2,0,0,0,7770,23,0.000039,0,0,0,0,0,0.000473
201065,201065,,0,1,1,0,1,1,0,0,0,20719,28,0.00001,11,0.160979,0.182642,0,0,0
201066,201066,,2,19,21,2,19,21,0.000053,0.00328,0,17747,25,0.000011,12,0.203731,0.223683,3690.95313,0.207143,0.000537
201067,201067,,5,10,15,5,10,15,0.000156,0.000287,0,20720,2,0.000013,14,0.179218,0.199179,1733.486932,0.147619,0.001168
201068,201068,,0,2,2,0,2,2,0,0,0,20723,22,0.00001,4,0.4375,0.559524,0,0,0
9503051,9503051,,2,1,3,2,1,3,0,0,0,20722,22,0.000023,1,1,1,2,0,0.000438
9307061,9307061,,1,0,1,1,0,1,0,0,0,20721,22,0.000031,0,0,0,0,0,0.000232
201069,201069,,0,7,7,0,7,7,0,0,0,20724,26,0.00001,11,0.140126,0.158406,0,0.285714,0
201071,201071,,0,10,10,0,10,10,0,0.000028,0,20727,9,0.00001,16,0.165184,0.188777,0,0.044444,0
9403151,9403151,,1,3,4,1,3,4,0,0.000312,0,20726,9,0.000011,2,0.714286,0.8,3.833333,0,0.000219
9802086,9802086,,1,5,6,1,5,6,0,0.000148,0,20725,4,0.000011,11,0.170616,0.189857,8.319444,0.1,0.000219
201072,201072,,1,16,17,1,16,17,0,0.000959,0,20728,0,0.000016,16,0.189626,0.212684,37205.500291,0.238971,0.000239
201073,201073,,0,21,21,0,21,21,0,0.000061,0,20729,23,0.00001,14,0.169607,0.190498,0,0.152381,0
201074,201074,,0,1,1,0,1,1,0,0,0,20730,23,0.00001,3,0.5,0.611111,0,0,0
9403138,9403138,,2,1,3,2,1,3,0,0,0,5996,23,0.000022,2,0.666667,0.75,5777.245047,0,0.000446
201075,201075,,8,41,49,8,41,49,0.001069,0.003116,0,20731,4,0.000012,13,0.203818,0.228044,11384.765538,0.139881,0.002168
201076,201076,,2,43,45,2,43,45,0.000587,0.004354,0,18548,1,0.00001,16,0.212741,0.247827,5908.197954,0.136869,0.000493
201078,201078,,0,5,5,0,5,5,0,0.000001,0,20732,26,0.00001,16,0.144515,0.154997,0,0.4,0
201079,201079,,4,33,37,4,33,37,0.000083,0.002614,0,16306,8,0.000011,15,0.18701,0.212624,14788.920444,0.126126,0.000905
9407115,9407115,,1,1,2,1,1,2,0.000001,0.000038,0,7802,23,0.000011,1,1,1,0,0.5,0.000247
9409137,9409137,,3,5,8,3,5,8,0.000003,0.000044,0,4473,23,0.000013,2,0.857143,0.916667,3238.577702,0.267857,0.000721
201084,201084,,4,9,13,4,9,13,0.000011,0.000682,0,20733,5,0.000013,14,0.154137,0.165724,1139.994037,0.237179,0.001023
201085,201085,,0,1,1,0,1,1,0,0,26,20735,48,0.00001,1,1,1,0,0,0
104053,104053,,2,0,2,2,0,2,0,0,26,20734,48,0.000028,0,0,0,0,0,0.000438
201086,201086,,0,7,7,0,7,7,0,0.000002,0,20736,22,0.00001,5,0.409091,0.491481,0,0.261905,0
201088,201088,,0,3,3,0,3,3,0,0,0,20737,23,0.00001,10,0.15255,0.169356,0,0.333333,0
201089,201089,,6,15,21,6,15,21,0.000393,0.000935,0,19105,52,0.000011,14,0.19859,0.220906,5731.741962,0.269048,0.001668
201090,201090,,1,1,2,1,1,2,0,0,0,20738,15,0.000015,17,0.110498,0.114916,0,0.5,0.000226
201091,201091,,7,22,29,7,22,29,0.00004,0.000354,0,20739,9,0.000012,14,0.187132,0.211752,1824.982974,0.243842,0.0016
9209065,9209065,,5,0,5,5,0,5,0.000001,0,0,459,9,0.000018,0,0,0,0,0.05,0.001241
9301099,9301099,,18,7,25,18,7,25,0.000003,0.000021,0,448,9,0.000061,2,0.888889,0.9375,5902.316669,0.155,0.004823
9302114,9302114,,9,0,9,9,0,9,0.000001,0,0,438,9,0.000039,0,0,0,0,0.152778,0.002315
9303051,9303051,,9,2,11,9,2,11,0.000002,0,0,1034,9,0.00002,2,0.75,0.833333,8.487475,0.136364,0.002269
9303058,9303058,,1,0,1,1,0,1,0.000001,0,0,3663,9,0.00001,0,0,0,0,0,0.000261
9304115,9304115,,15,7,22,15,7,22,0.000072,0.000021,0,451,9,0.00003,2,0.769231,0.85,961.12677,0.125541,0.003626
9306019,9306019,,7,4,11,7,4,11,0.000001,0,0,3200,9,0.000018,3,0.6,0.703704,66.752622,0.118182,0.001661
9306079,9306079,,4,2,6,4,2,6,0.000001,0.000011,0,3172,9,0.000016,1,1,1,139.919394,0.2,0.00104
9306129,9306129,,1,0,1,1,0,1,0.000001,0,0,3662,9,0.00001,0,0,0,0,0,0.000261
9307046,9307046,,9,6,15,9,6,15,0.000072,0.000001,0,1039,9,0.000016,2,0.75,0.833333,522.546087,0.061905,0.002083
9308114,9308114,,8,6,14,8,6,14,0.000001,0.000002,0,456,9,0.000026,3,0.592593,0.677083,11332.213598,0.203297,0.002036
9309029,9309029,,1,0,1,1,0,1,0.000001,0,0,3661,9,0.00001,0,0,0,0,0,0.000261
9311084,9311084,,9,13,22,9,13,22,0.000028,0.000024,0,1335,9,0.000028,4,0.421569,0.556202,7760.037434,0.138528,0.002297
9402133,9402133,,5,2,7,5,2,7,0.000001,0,0,3199,9,0.000015,3,0.472222,0.519608,3.416667,0.238095,0.001205
9403185,9403185,,2,13,15,2,13,15,0.000001,0.000004,0,3203,9,0.000011,5,0.418919,0.519355,26635.392609,0.119048,0.000533
201093,201093,,8,29,37,8,29,37,0.000236,0.005596,0,20043,52,0.000013,16,0.212737,0.242061,24595.719269,0.153904,0.002467
201094,201094,,3,8,11,3,8,11,0.000146,0.000011,0,20740,1,0.000013,14,0.139486,0.150425,7.95,0.272727,0.000658
201095,201095,,21,31,52,21,31,52,0.000468,0.000769,0,18840,3,0.000016,14,0.1998,0.220682,30177.151652,0.266214,0.005857
201096,201096,,3,20,23,3,20,23,0.000003,0.000247,0,20741,1,0.000013,18,0.180035,0.20078,22071.98145,0.130435,0.000725
201097,201097,,0,7,7,0,7,7,0,0.000056,0,20742,3,0.00001,14,0.171987,0.185578,0,0.357143,0
201098,201098,,0,6,6,0,6,6,0,0.001715,0,20743,0,0.00001,17,0.152242,0.168386,0,0.233333,0
201099,201099,,5,28,33,5,28,33,0.000027,0.002462,0,20744,9,0.000011,15,0.193139,0.231481,15858.661023,0.234848,0.001162
201101,201101,,1,1,2,1,1,2,0.000001,0,0,20745,23,0.000011,15,0.11789,0.125215,0,0.5,0.000219
201102,201102,,0,14,14,0,14,14,0,0.008585,0,20746,1,0.00001,16,0.20151,0.226168,0,0.203297,0
201103,201103,,11,7,18,11,7,18,0.000533,0.00101,0,20747,30,0.000018,15,0.184568,0.202495,914.785542,0.238562,0.002617
201104,201104,,3,7,10,3,7,10,0.000388,0.000048,0,20748,17,0.000011,15,0.133346,0.145947,3.900433,0.455556,0.000677
201105,201105,,0,5,5,0,5,5,0,0.000003,0,20749,5,0.00001,4,0.4375,0.514881,0,0.1,0
201106,201106,,3,17,20,3,17,20,0.000129,0.000652,0,20750,2,0.00001,15,0.192699,0.213574,469.309286,0.25,0.000684
201107,201107,,0,16,16,0,16,16,0,0.001874,0,20751,2,0.00001,18,0.203279,0.229903,0,0.241667,0
201108,201108,,0,20,20,0,20,20,0,0.000012,0,20752,6,0.00001,16,0.167894,0.184891,0,0.163158,0
201109,201109,,4,18,22,4,18,22,0.000012,0.000174,0,20753,10,0.000013,15,0.179718,0.197645,1908.15859,0.119048,0.000935
9206019,9206019,,5,0,5,5,0,5,0.000017,0,0,2849,10,0.000015,0,0,0,0,0.35,0.001277
9609207,9609207,,2,9,11,2,9,11,0.000004,0.000031,0,2854,9,0.000012,9,0.200728,0.242593,14592.649132,0.209091,0.000517
201110,201110,,0,6,6,0,6,6,0,0.000001,0,20754,23,0.00001,19,0.16199,0.173193,0,0.333333,0
201111,201111,,4,13,17,4,13,17,0.000137,0.000565,0,20755,1,0.000011,14,0.18616,0.207477,3695.028871,0.136029,0.001165
201113,201113,,4,36,40,4,36,40,0.00007,0.002914,0,19096,3,0.000011,14,0.197436,0.223676,1641.327224,0.123718,0.000955
201114,201114,,5,12,17,5,12,17,0.000606,0.000774,0,19047,10,0.000011,16,0.192267,0.215825,1259.90753,0.1875,0.00201
201116,201116,,2,1,3,2,1,3,0.000419,0,0,20759,1,0.000012,3,0.5,0.583333,127,0.166667,0.000532
9809016,9809016,,1,2,3,1,2,3,0,0,0,20758,23,0.000021,2,0.75,0.833333,98,0.166667,0.000233
9710090,9710090,,1,2,3,1,2,3,0,0,0,20757,23,0.000019,1,1,1,34,0.166667,0.000226
201118,201118,,0,8,8,0,8,8,0,0.003023,0,20760,2,0.00001,14,0.194035,0.213663,0,0.178571,0
201119,201119,,0,1,1,0,1,1,0,0,0,20761,5,0.00001,1,1,1,0,0,0
201120,201120,,1,6,7,1,6,7,0.000026,0.000009,0,20762,23,0.00001,15,0.155101,0.189924,130.719832,0.047619,0.000219
201121,201121,,4,22,26,4,22,26,0.000084,0.002572,0,20763,25,0.000012,12,0.214736,0.24232,2336.946439,0.104615,0.000936
201122,201122,,2,5,7,2,5,7,0,0.000006,0,20764,23,0.000012,18,0.137504,0.157883,11.224777,0.142857,0.000445
201123,201123,,0,2,2,0,2,2,0,0,0,20766,6,0.00001,7,0.218121,0.246612,0,0.5,0
9906212,9906212,,2,1,3,2,1,3,0,0,0,20765,6,0.000023,7,0.216807,0.240772,129,0.166667,0.000438
201124,201124,,4,5,9,4,5,9,0.000027,0.00001,0,20767,23,0.000013,18,0.137551,0.1579,1842.706178,0.055556,0.00091
201125,201125,,1,17,18,1,17,18,0,0.000016,0,20769,23,0.00001,15,0.135966,0.165418,495.63269,0.133987,0.000219
9912269,9912269,,2,12,14,2,12,14,0,0.000016,0,20768,23,0.000011,16,0.130454,0.158115,1306.658536,0.186813,0.000445
201126,201126,,2,14,16,2,14,16,0.000026,0.001752,0,20772,13,0.000011,13,0.205315,0.234677,8066.720805,0.1875,0.000438
9702152,9702152,,2,6,8,2,6,8,0.000041,0.000656,0,20771,13,0.000011,12,0.189303,0.216086,21.030739,0.267857,0.000451
9612139,9612139,,2,10,12,2,10,12,0.000014,0.000931,0,20770,13,0.000013,11,0.212273,0.248483,1353.021366,0.219697,0.000451
201127,201127,,14,36,50,14,36,50,0.001235,0.003233,0,20773,25,0.000015,15,0.191911,0.217211,24996.17254,0.130612,0.003508
201129,201129,,1,20,21,1,20,21,0.00004,0.00775,0,20774,2,0.00001,13,0.210706,0.23942,461.855849,0.121429,0.000245
201131,201131,,1,2,3,1,2,3,0,0,0,20775,23,0.000015,15,0.13931,0.145721,0,0.5,0.000246
201132,201132,,7,15,22,7,15,22,0.000208,0.000425,0,18979,3,0.000012,15,0.194022,0.217426,1919.284054,0.285714,0.002285
201133,201133,,3,13,16,3,13,16,0.000231,0.000074,0,16314,5,0.000011,12,0.20413,0.226246,1024.03316,0.175,0.000797
201134,201134,,1,1,2,1,1,2,0,0,0,20776,6,0.000012,10,0.138662,0.162764,0,0.5,0.000219
201135,201135,,2,34,36,2,34,36,0.000026,0.00202,0,20777,30,0.000011,13,0.215791,0.239053,593.01305,0.237302,0.000527
201136,201136,,35,30,65,35,30,65,0.000365,0.000419,0,18841,3,0.000027,15,0.184079,0.202935,8390.523374,0.241106,0.010032
201137,201137,,0,4,4,0,4,4,0,0.000074,0,20778,30,0.00001,14,0.171307,0.184677,0,0.416667,0
201138,201138,,3,21,24,3,21,24,0.000745,0.002236,0,20779,2,0.00001,15,0.206158,0.232575,441.546039,0.108696,0.000671
201139,201139,,4,11,15,4,11,15,0.000022,0.000819,0,20780,23,0.000012,14,0.188209,0.20643,1226.917579,0.185714,0.000929
201140,201140,,4,66,70,4,66,70,0.000493,0.007325,0,19286,30,0.000011,13,0.226009,0.255496,49284.428887,0.110559,0.001196
201141,201141,,1,6,7,1,6,7,0.000002,0.000023,0,20781,23,0.000011,17,0.171583,0.188382,3202.985716,0.238095,0.000219
201142,201142,,7,25,32,7,25,32,0.000002,0.000005,0,20782,6,0.000015,13,0.166614,0.184607,44131.843133,0.111895,0.00158
201144,201144,,15,37,52,15,37,52,0.000382,0.003877,0,19379,30,0.000023,15,0.218977,0.243561,51251.350727,0.153469,0.003771
201145,201145,,7,59,66,7,59,66,0.001705,0.020502,0,18552,1,0.000012,16,0.202868,0.231486,30795.298301,0.149184,0.002182
201146,201146,,3,14,17,3,14,17,0.000033,0.000202,0,20783,52,0.000011,15,0.174744,0.192199,4111.145753,0.132353,0.000658
201147,201147,,0,8,8,0,8,8,0,0.000121,0,20785,5,0.00001,6,0.296943,0.388235,0,0.089286,0
9812223,9812223,,1,1,2,1,1,2,0.000001,0.000003,0,20784,5,0.000011,2,0.6,0.666667,0,0.5,0.000219
201148,201148,,9,19,28,9,19,28,0.000028,0.000035,0,20786,5,0.00002,17,0.139944,0.154162,11198.56038,0.140212,0.002097
201149,201149,,17,14,31,17,14,31,0.000192,0.000263,0,19345,3,0.000016,16,0.175268,0.192466,256.682276,0.350538,0.004673
201150,201150,,0,1,1,0,1,1,0,0.000001,0,20787,25,0.00001,2,0.666667,0.75,0,0,0
201151,201151,,10,18,28,10,18,28,0.000448,0.004908,0,20362,2,0.000015,17,0.173557,0.196111,14995.370336,0.123016,0.002388
201152,201152,,0,11,11,0,11,11,0,0.000032,0,20788,5,0.00001,13,0.172327,0.187507,0,0.172727,0
201153,201153,,0,9,9,0,9,9,0,0.003453,0,20789,3,0.00001,17,0.171807,0.188925,0,0.111111,0
201154,201154,,1,26,27,1,26,27,0.000003,0.000061,0,20790,23,0.00001,13,0.179053,0.198825,358.964803,0.149573,0.000259
201155,201155,,3,19,22,3,19,22,0.000137,0.003052,0,20791,10,0.00001,16,0.190809,0.214203,224.973608,0.155844,0.000677
201156,201156,,2,11,13,2,11,13,0,0,0,20793,6,0.000012,14,0.12863,0.150898,856.754384,0.153846,0.000438
9301039,9301039,,2,1,3,2,1,3,0,0,0,2057,6,0.000011,1,1,1,0.5,0.166667,0.000478
9805160,9805160,,5,5,10,5,5,10,0.000001,0.000011,0,20792,9,0.000015,11,0.187873,0.211843,1172.106681,0.144444,0.001109
201157,201157,,4,3,7,4,3,7,0.000059,0.00003,0,20794,22,0.000011,18,0.123822,0.132408,0,0.380952,0.00091
9904176,9904176,,6,1,7,6,1,7,0.00006,0.000003,0,18801,8,0.000017,14,0.152307,0.163358,587.791255,0.214286,0.002168
9904075,9904075,,17,3,20,17,3,20,0.000234,0.00008,0,18800,3,0.000041,13,0.179646,0.19843,10941.718141,0.15,0.006374
201159,201159,,13,36,49,13,36,49,0.000244,0.001053,0,18842,3,0.000015,15,0.19105,0.210981,109052.539228,0.214711,0.004673
201160,201160,,0,1,1,0,1,1,0,0,0,20796,21,0.00001,8,0.186577,0.213823,0,0,0
9609143,9609143,,1,5,6,1,5,6,0,0,0,20795,21,0.000019,7,0.227723,0.280745,138,0.233333,0.000219
201161,201161,,1,12,13,1,12,13,0.000029,0.000409,0,20797,30,0.00001,14,0.194074,0.211628,82.117553,0.269231,0.000226
201162,201162,,0,7,7,0,7,7,0,0.0067,0,20798,1,0.00001,15,0.211556,0.242072,0,0.380952,0
201163,201163,,0,5,5,0,5,5,0,0.000029,0,20799,4,0.00001,15,0.174973,0.191648,0,0.2,0
201164,201164,,3,5,8,3,5,8,0.000004,0.00002,0,20800,5,0.000012,15,0.140189,0.160453,286.728274,0.196429,0.000671
201165,201165,,3,21,24,3,21,24,0.000001,0.000047,0,20801,17,0.000012,12,0.167778,0.216496,508.064697,0.182971,0.00071
9409066,9409066,,2,6,8,2,6,8,0,0.000035,0,4236,4,0.000017,3,0.575758,0.649123,182.392771,0.107143,0.000597
201166,201166,,0,10,10,0,10,10,0,0.006324,0,20802,2,0.00001,16,0.191193,0.21985,0,0.144444,0
201167,201167,,1,5,6,1,5,6,0,0.000002,0,20803,17,0.000011,13,0.146398,0.169686,10.5,0.3,0.000252
201168,201168,,3,1,4,3,1,4,0,0.000311,0,20804,23,0.00002,7,0.217778,0.24406,413.56319,0.083333,0.000664
201169,201169,,0,1,1,0,1,1,0,0.000005,0,20805,23,0.00001,3,0.473684,0.518519,0,0,0
201170,201170,,2,6,8,2,6,8,0.000205,0.002568,0,20806,1,0.000015,11,0.226464,0.255595,6877.352777,0.232143,0.000445
201171,201171,,2,23,25,2,23,25,0.000078,0.004637,0,20364,30,0.000011,16,0.210645,0.237422,8191.198504,0.165,0.000485
201173,201173,,8,42,50,8,42,50,0.000511,0.001171,0,19107,52,0.000014,14,0.20181,0.22748,52063.750207,0.133878,0.002224
201175,201175,,6,41,47,6,41,47,0.000434,0.00166,0,19127,52,0.000011,13,0.210997,0.234996,62630.402926,0.149399,0.001639
201177,201177,,19,17,36,19,17,36,0.000354,0.000259,0,19350,3,0.000016,16,0.180842,0.19748,295.683784,0.328571,0.005093
201178,201178,,1,57,58,1,57,58,0.000059,0.009931,0,20807,30,0.00001,14,0.222718,0.250861,334.274423,0.170599,0.000219
201179,201179,,7,20,27,7,20,27,0.000249,0.000027,0,20808,23,0.000015,18,0.143147,0.161267,7880.970391,0.173789,0.001567
201180,201180,,0,17,17,0,17,17,0,0.000056,0,20809,41,0.00001,13,0.17732,0.195366,0,0.216912,0
201181,201181,,0,14,14,0,14,14,0,0.000194,0,20810,2,0.00001,14,0.184086,0.201099,0,0.269231,0
201182,201182,,5,38,43,5,38,43,0.000358,0.005675,0,20363,2,0.000012,19,0.20448,0.236323,9912.128197,0.094684,0.001322
201183,201183,,5,23,28,5,23,28,0.00082,0.005026,0,20811,2,0.000011,14,0.2122,0.238661,4856.087724,0.107143,0.001161
205213,205213,,34,44,78,34,44,78,0.002967,0.006587,0,20814,41,0.000023,17,0.213939,0.241028,82070.354471,0.156011,0.010784
202021,202021,,328,34,362,328,34,362,0.035826,0.024965,0,18540,41,0.000204,14,0.216131,0.251448,501436.706587,0.05068,0.115221
202109,202109,,204,25,229,204,25,229,0.021402,0.007829,0,18923,41,0.000132,14,0.192611,0.218088,156268.134332,0.074695,0.075847
202153,202153,,81,21,102,81,21,102,0.009939,0.02032,0,18927,41,0.00006,14,0.187055,0.213128,15051.299949,0.189381,0.039266
202179,202179,,99,37,136,99,37,136,0.010206,0.003198,0,19227,41,0.00006,15,0.196439,0.226076,89915.244567,0.111275,0.039688
203028,203028,,65,27,92,65,27,92,0.006829,0.009182,0,19231,41,0.000043,15,0.188479,0.215582,41836.086718,0.177735,0.027671
203093,203093,,54,26,80,54,26,80,0.007068,0.021654,0,19232,41,0.000037,14,0.203823,0.23696,20348.733548,0.254272,0.025349
203124,203124,,63,80,143,63,80,143,0.007349,0.0061,0,19242,41,0.000042,14,0.223357,0.256031,526294.332174,0.085837,0.027596
203134,203134,,49,40,89,49,40,89,0.006358,0.014992,0,19233,41,0.000037,14,0.203227,0.240456,70749.810477,0.162028,0.023339
203140,203140,,56,49,105,56,49,105,0.005502,0.004077,0,19250,41,0.000034,14,0.213834,0.24286,103159.825677,0.134432,0.022009
203164,203164,,59,25,84,59,25,84,0.007986,0.020267,0,19234,41,0.000038,14,0.190733,0.21685,6272.647523,0.194492,0.024955
203186,203186,,50,35,85,50,35,85,0.006004,0.01189,0,19243,41,0.000034,14,0.211203,0.238781,52993.582494,0.19944,0.021691
203229,203229,,63,32,95,63,32,95,0.006323,0.006297,0,19244,41,0.000038,14,0.207922,0.23485,38790.089547,0.156887,0.024318
203249,203249,,59,24,83,59,24,83,0.006957,0.00359,0,19248,41,0.000036,14,0.203894,0.228073,34311.142318,0.211872,0.023554
203255,203255,,45,25,70,45,25,70,0.004295,0.003105,0,19253,41,0.000029,14,0.202334,0.226699,30236.40499,0.22029,0.017081
203257,203257,,54,33,87,54,33,87,0.005998,0.019724,0,19252,41,0.000032,14,0.219981,0.251519,71834.258773,0.206897,0.020982
204001,204001,,24,34,58,24,34,58,0.002582,0.003945,0,19257,41,0.000021,14,0.207874,0.234222,10322.169918,0.256806,0.010288
204004,204004,,61,56,117,61,56,117,0.00734,0.015426,0,19246,41,0.000036,13,0.219061,0.252299,262812.836632,0.116121,0.023355
204051,204051,,76,24,100,76,24,100,0.012004,0.021716,0,18544,41,0.000043,14,0.210471,0.241723,104695.989355,0.09404,0.023905
204054,204054,,81,73,154,81,73,154,0.008237,0.025691,0,19273,41,0.000041,13,0.230522,0.266,307162.987161,0.101435,0.026111
204147,204147,,35,39,74,35,39,74,0.003957,0.024267,0,19289,41,0.000023,15,0.205855,0.23397,103699.840398,0.146797,0.01252
204174,204174,,29,42,71,29,42,71,0.003206,0.004341,0,19290,41,0.00002,13,0.214581,0.239495,33518.154663,0.281087,0.011152
204196,204196,,34,41,75,34,41,75,0.003421,0.020696,0,19277,41,0.000022,13,0.217292,0.244483,59303.413664,0.193333,0.012131
205006,205006,,18,25,43,18,25,43,0.00163,0.001774,0,19306,41,0.000015,15,0.185355,0.210718,74170.427978,0.140642,0.006863
205033,205033,,96,14,110,96,14,110,0.010998,0.001782,0,19281,41,0.000057,14,0.191283,0.212439,25180.752035,0.137781,0.033037
205048,205048,,78,48,126,78,48,126,0.009292,0.007428,0,19310,41,0.000047,13,0.206746,0.233401,79108.700788,0.108635,0.026664
205066,205066,,78,37,115,78,37,115,0.008819,0.018322,0,19308,41,0.00005,13,0.208939,0.234129,67825.972646,0.140275,0.026841
205067,205067,,23,77,100,23,77,100,0.00302,0.02351,0,19307,41,0.000016,16,0.221746,0.251654,48961.274578,0.179091,0.008436
205089,205089,,93,46,139,93,46,139,0.010478,0.00445,0,19311,41,0.000054,16,0.218946,0.247211,262240.231022,0.135909,0.030186
205174,205174,,32,20,52,32,20,52,0.003372,0.004226,0,19312,41,0.000025,17,0.196734,0.219045,16837.305217,0.196456,0.011981
205183,205183,,51,11,62,51,11,62,0.005132,0.001784,0,20813,41,0.00003,14,0.192505,0.212646,3677.743758,0.138022,0.014947
205185,205185,,45,23,68,45,23,68,0.003374,0.005839,0,20812,41,0.000033,18,0.206994,0.235954,77975.939981,0.148595,0.013988
201184,201184,,0,1,1,0,1,1,0,0.000252,0,20815,3,0.00001,15,0.175529,0.189903,0,0,0
201185,201185,,9,34,43,9,34,43,0.00044,0.004236,0,19148,3,0.000013,14,0.199707,0.227769,14683.3247,0.1268,0.003224
201186,201186,,0,6,6,0,6,6,0,0.000002,0,20816,23,0.00001,19,0.115489,0.127512,0,0.366667,0
201188,201188,,1,12,13,1,12,13,0.000025,0.001919,0,20817,0,0.000011,16,0.186268,0.209884,2242.246537,0.115385,0.000266
201189,201189,,15,8,23,15,8,23,0.000527,0.000064,0,20818,8,0.000022,16,0.179467,0.195598,2480.819297,0.280632,0.004197
201190,201190,,0,7,7,0,7,7,0,0.000124,0,20819,52,0.00001,17,0.154446,0.173064,0,0.238095,0
201191,201191,,5,24,29,5,24,29,0.000187,0.00171,0,20821,25,0.000012,16,0.193502,0.216331,2611.99906,0.176108,0.001196
9510112,9510112,,3,0,3,3,0,3,0.000021,0,0,20820,25,0.000015,0,0,0,0,0,0.000704
201192,201192,,0,12,12,0,12,12,0,0.000008,0,20823,26,0.00001,13,0.157734,0.170844,0,0.037879,0
9301132,9301132,,5,0,5,5,0,5,0.000002,0,0,5486,22,0.00006,0,0,0,0,0.15,0.001183
9903148,9903148,,1,2,3,1,2,3,0,0,0,20822,26,0.000011,2,0.666667,0.75,2.333333,0.166667,0.000219
201193,201193,,0,7,7,0,7,7,0,0.000004,0,20825,26,0.00001,13,0.160546,0.174578,0,0.071429,0
9906060,9906060,,2,13,15,2,13,15,0.000042,0.00211,0,20824,26,0.000012,15,0.174914,0.200772,1411.040759,0.190476,0.000438
201194,201194,,3,7,10,3,7,10,0.000259,0.001237,0,20826,0,0.000015,13,0.190583,0.21039,18782.67389,0.077778,0.000767
201195,201195,,0,1,1,0,1,1,0,0,0,20827,9,0.00001,3,0.5,0.611111,0,0,0
201196,201196,,9,19,28,9,19,28,0.000378,0.002573,0,20828,30,0.000013,13,0.214878,0.237346,1530.894582,0.301587,0.002186
201197,201197,,12,54,66,12,54,66,0.000129,0.001467,0,19351,3,0.000014,14,0.204225,0.228298,5744.266904,0.231469,0.003264
203227,203227,,5,53,58,5,53,58,0.000044,0.000758,0,19366,3,0.000012,14,0.201721,0.224016,1529.929963,0.253176,0.001321
201229,201229,,9,17,26,9,17,26,0.000102,0.000292,0,19359,3,0.000013,14,0.198769,0.218562,6496.274441,0.375385,0.002533
202030,202030,,18,29,47,18,29,47,0.000139,0.000398,0,19343,3,0.000018,15,0.206999,0.22923,11663.720981,0.258557,0.004982
202045,202045,,14,29,43,14,29,43,0.000232,0.000418,0,19357,3,0.000015,14,0.203422,0.225533,10981.404063,0.218162,0.003648
202087,202087,,35,16,51,35,16,51,0.000419,0.000471,0,19344,3,0.000026,16,0.205313,0.229289,45928.1013,0.160784,0.009352
202139,202139,,13,22,35,13,22,35,0.000422,0.000488,0,19358,3,0.000013,15,0.184411,0.200998,2741.106182,0.266387,0.003461
202151,202151,,22,44,66,22,44,66,0.000437,0.000862,0,19360,3,0.000018,15,0.192621,0.213434,11086.59012,0.23683,0.005599
202176,202176,,17,21,38,17,21,38,0.000436,0.000334,0,19346,3,0.000019,16,0.183572,0.201627,3934.277391,0.268848,0.004595
203089,203089,,8,13,21,8,13,21,0.000271,0.000101,0,19365,3,0.000012,14,0.197274,0.216983,1439.350765,0.252381,0.002014
208009,208009,,4,41,45,4,41,45,0.000031,0.00061,0,20830,3,0.000011,14,0.18531,0.20428,683.571946,0.218687,0.000904
203071,203071,,6,18,24,6,18,24,0.000065,0.001267,0,19349,3,0.000012,16,0.182591,0.20319,653.131023,0.318841,0.001622
204012,204012,,20,46,66,20,46,66,0.000335,0.001039,0,19363,3,0.000017,15,0.193518,0.214697,13075.606439,0.17972,0.005162
204138,204138,,6,36,42,6,36,42,0.000036,0.000508,0,19367,3,0.000012,14,0.198487,0.219795,1761.858923,0.260743,0.001508
204155,204155,,8,31,39,8,31,39,0.000116,0.000939,0,20829,3,0.000012,14,0.209561,0.234087,16525.921128,0.143725,0.001986
204172,204172,,4,27,31,4,27,31,0.00003,0.00079,0,19369,3,0.000011,16,0.187507,0.207663,397.022191,0.269892,0.001106
206208,206208,,7,24,31,7,24,31,0.000054,0.000279,0,19372,3,0.000012,14,0.186434,0.203291,4544.547356,0.34086,0.001683
201198,201198,,5,13,18,5,13,18,0.000403,0.000087,0,19051,10,0.000011,16,0.180442,0.198638,2275.351523,0.251634,0.001486
201199,201199,,0,12,12,0,12,12,0,0.000072,0,20831,26,0.00001,13,0.158469,0.171642,0,0.037879,0
201200,201200,,9,8,17,9,8,17,0.000213,0.000049,0,20832,25,0.000015,14,0.158264,0.170884,5083.454278,0.099265,0.002092
201201,201201,,2,6,8,2,6,8,0.000003,0.000106,0,20833,25,0.000012,16,0.183217,0.203597,19.976797,0.410714,0.000458
201202,201202,,0,9,9,0,9,9,0,0.002693,0,20834,3,0.00001,16,0.191188,0.210711,0,0.194444,0
201203,201203,,1,4,5,1,4,5,0.000019,0.00001,0,20835,30,0.00001,15,0.164274,0.175892,179.929998,0.1,0.000232
201204,201204,,2,7,9,2,7,9,0,0,0,20837,23,0.000027,16,0.12493,0.132417,19596,0.069444,0.000445
9804048,9804048,,1,5,6,1,5,6,0,0,0,20836,23,0.000013,10,0.156798,0.18513,5.5,0.4,0.000232
9401012,9401012,,2,2,4,2,2,4,0,0,0,4758,23,0.000018,1,1,1,23404.965485,0.166667,0.000546
201206,201206,,4,26,30,4,26,30,0.000094,0.003658,0,20017,13,0.000011,14,0.204796,0.241591,8616.615509,0.172414,0.001217
201207,201207,,1,3,4,1,3,4,0,0,0,20838,23,0.000012,15,0.134106,0.144157,304.957542,0.083333,0.000219
201208,201208,,0,1,1,0,1,1,0,0.00002,0,20839,22,0.00001,2,0.538462,0.571429,0,0,0
201209,201209,,0,39,39,0,39,39,0,0.020402,0,20840,2,0.00001,16,0.20527,0.242609,0,0.116059,0
201212,201212,,0,2,2,0,2,2,0,0.000015,0,20842,23,0.00001,23,0.110069,0.156106,0,0,0
9212092,9212092,,2,0,2,2,0,2,0.000023,0,0,20841,23,0.000015,0,0,0,0,0,0.000438
201213,201213,,0,12,12,0,12,12,0,0.000004,0,20843,5,0.00001,17,0.111117,0.120597,0,0.257576,0
201214,201214,,0,3,3,0,3,3,0,0.000006,0,20845,13,0.00001,5,0.336364,0.398198,0,0,0
9411152,9411152,,4,4,8,4,4,8,0.000007,0.000034,0,20844,13,0.000019,2,0.833333,0.9,7,0.232143,0.000883
201215,201215,,5,37,42,5,37,42,0.000439,0.021498,0,19205,8,0.000011,12,0.219433,0.246305,27188.188275,0.137631,0.001305
201216,201216,,2,8,10,2,8,10,0.000008,0.000425,0,20846,3,0.000011,17,0.153842,0.169258,406.169141,0.155556,0.000438
201218,201218,,2,35,37,2,35,37,0.000117,0.005228,0,20847,30,0.000011,16,0.206181,0.233295,1167.585827,0.195195,0.000484
201219,201219,,0,5,5,0,5,5,0,0.000052,0,20848,5,0.00001,16,0.162929,0.179071,0,0.25,0
201220,201220,,1,2,3,1,2,3,0,0,0,20850,20,0.000013,6,0.305556,0.370202,1,0.166667,0.000219
7084,7084,,1,0,1,1,0,1,0,0,0,20849,20,0.000016,0,0,0,0,0,0.000226
201221,201221,,13,45,58,13,45,58,0.000485,0.003787,0,18988,0,0.000013,15,0.209186,0.243662,29201.911196,0.120085,0.004033
201222,201222,,25,5,30,25,5,30,0.000604,0.000365,0,20851,30,0.000027,16,0.1867,0.202343,17387.750001,0.087356,0.006023
201223,201223,,1,10,11,1,10,11,0,0.001754,0,20852,30,0.000012,13,0.212139,0.233359,7505.079675,0.154545,0.000219
201224,201224,,12,28,40,12,28,40,0.002451,0.02221,0,18972,1,0.000013,15,0.211386,0.245078,26471.024842,0.182051,0.003115
201225,201225,,0,12,12,0,12,12,0,0.006617,0,20853,15,0.00001,13,0.201615,0.221877,0,0.143939,0
201227,201227,,11,55,66,11,55,66,0.000532,0.001572,0,19029,10,0.000014,14,0.215268,0.243883,66999.370027,0.147552,0.003647
201228,201228,,7,21,28,7,21,28,0.000063,0.001801,0,20854,30,0.000015,13,0.209247,0.229964,22358.211891,0.125661,0.001619
201231,201231,,0,7,7,0,7,7,0,0.00008,0,20855,52,0.00001,14,0.179041,0.197957,0,0.166667,0
201232,201232,,1,33,34,1,33,34,0.000286,0.021851,0,20246,30,0.00001,15,0.216847,0.252702,1342.535982,0.156863,0.000268
9903142,9903142,,1,18,19,1,18,19,0.000257,0.018138,0,20245,1,0.00001,14,0.192114,0.216637,15.279042,0.304094,0.000226
201233,201233,,1,15,16,1,15,16,0.000347,0.001078,0,20856,2,0.00001,15,0.190821,0.22103,223.648131,0.1,0.000219
201234,201234,,1,3,4,1,3,4,0,0.000013,0,20857,0,0.000012,16,0.143422,0.158862,0,0.333333,0.000219
201235,201235,,0,4,4,0,4,4,0,0.000008,0,20858,26,0.00001,16,0.158747,0.176008,0,0,0
9506100,9506100,,2,3,5,2,3,5,0.000001,0.000003,0,14278,26,0.000014,6,0.233607,0.295614,144.85341,0.1,0.000478
201236,201236,,1,16,17,1,16,17,0.000039,0.006574,0,20859,1,0.00001,15,0.205813,0.229785,267.531091,0.275735,0.000226
201237,201237,,4,11,15,4,11,15,0.000047,0.000034,0,20860,20,0.000014,13,0.169719,0.184013,105.303069,0.247619,0.000883
201238,201238,,0,4,4,0,4,4,0,0.000018,0,20861,22,0.00001,14,0.167308,0.17909,0,0.25,0
201239,201239,,6,5,11,6,5,11,0.000186,0.000053,0,19093,52,0.000013,17,0.146703,0.16243,4194.372795,0.190909,0.001602
201240,201240,,0,5,5,0,5,5,0,0.000007,0,20862,6,0.00001,17,0.136071,0.152441,0,0.3,0
201241,201241,,12,16,28,12,16,28,0.001013,0.002549,0,19151,25,0.000016,19,0.189451,0.216467,7529.208274,0.177249,0.003157
201242,201242,,1,2,3,1,2,3,0.000001,0.00002,0,20864,22,0.00001,4,0.428571,0.505556,0,0.333333,0.000252
9701058,9701058,,2,3,5,2,3,5,0.000001,0.000001,0,20863,23,0.000015,3,0.5,0.642857,50.446547,0.05,0.000478
201243,201243,,2,37,39,2,37,39,0.000075,0.003468,0,20865,2,0.00001,13,0.202187,0.228449,8.78685,0.147099,0.000445
201244,201244,,1,17,18,1,17,18,0.000012,0.001742,0,20866,0,0.000011,12,0.210818,0.234071,7057.967302,0.114379,0.000219
201245,201245,,8,9,17,8,9,17,0.00006,0.000021,0,20867,15,0.000021,15,0.167245,0.179155,9058.014142,0.238971,0.002145
201246,201246,,1,4,5,1,4,5,0.000001,0.00007,0,20868,17,0.000011,6,0.305556,0.432576,0,0.4,0.000219
201248,201248,,1,31,32,1,31,32,0.000043,0.009048,0,20869,2,0.00001,16,0.212807,0.243463,3734.395853,0.21875,0.000219
201249,201249,,3,18,21,3,18,21,0.00027,0.001011,0,20870,3,0.000011,14,0.201055,0.221946,370.657637,0.192857,0.000703
201250,201250,,0,4,4,0,4,4,0,0.000009,0,20871,26,0.00001,12,0.163355,0.185759,0,0.166667,0
201252,201252,,1,9,10,1,9,10,0.000367,0.006805,0,20872,26,0.00001,19,0.178757,0.204141,236.034411,0.233333,0.000219
9905186,9905186,,1,7,8,1,7,8,0.000531,0.01647,0,18546,1,0.00001,14,0.183955,0.207543,4.020948,0.321429,0.000493
201254,201254,,3,17,20,3,17,20,0.000024,0.001594,0,20873,52,0.000011,15,0.19256,0.216986,1908.077053,0.115789,0.000685
201255,201255,,3,7,10,3,7,10,0.000628,0.001214,0,18950,5,0.000012,14,0.195648,0.218685,2410.412722,0.155556,0.00096
201256,201256,,3,23,26,3,23,26,0.000072,0.002733,0,20011,0,0.000011,13,0.197695,0.222635,6139.180493,0.107692,0.000844
201257,201257,,7,36,43,7,36,43,0.000133,0.005231,0,20365,30,0.000015,17,0.204985,0.232392,39689.92404,0.093577,0.001627
201259,201259,,2,14,16,2,14,16,0.000042,0.002213,0,20874,30,0.000011,13,0.21173,0.232994,420.82251,0.1375,0.000445
201260,201260,,3,6,9,3,6,9,0.00007,0.001988,0,20875,13,0.000011,13,0.212362,0.236692,1527.486174,0.125,0.000677
201261,201261,,1,4,5,1,4,5,0.000003,0.000153,0,20061,25,0.000011,13,0.184386,0.200832,412.24777,0.45,0.000293
201263,201263,,0,6,6,0,6,6,0,0.000163,0,20876,23,0.00001,12,0.195862,0.215236,0,0.066667,0
201265,201265,,3,10,13,3,10,13,0.000706,0.006878,0,20877,1,0.000011,14,0.196221,0.218873,1401.731897,0.326923,0.000691
201266,201266,,0,21,21,0,21,21,0,0.000559,0,20878,2,0.00001,16,0.162787,0.180997,0,0.17619,0
201267,201267,,5,25,30,5,25,30,0.000248,0.002374,0,20879,4,0.000011,16,0.161038,0.182232,437.81899,0.170115,0.0016
201269,201269,,0,2,2,0,2,2,0,0.000156,0,20880,2,0.00001,13,0.172333,0.191045,0,0,0
201270,201270,,5,29,34,5,29,34,0.000614,0.008508,0,20881,25,0.000012,14,0.208091,0.233293,8667.745721,0.164884,0.001175
201271,201271,,1,22,23,1,22,23,0.00002,0.00369,0,19050,10,0.00001,15,0.198271,0.222329,1819.188196,0.199605,0.00025
201272,201272,,4,31,35,4,31,35,0.000636,0.003344,0,20882,25,0.000011,14,0.203051,0.229344,1065.844618,0.184874,0.000909
202001,202001,,1,2,3,1,2,3,0,0.000016,0,20883,4,0.000011,13,0.153476,0.169722,75.458675,0,0.000219
202002,202002,,5,26,31,5,26,31,0.000284,0.018496,0,20884,4,0.000016,13,0.204931,0.229519,11974.065693,0.164516,0.001506
202003,202003,,10,35,45,10,35,45,0.001237,0.006091,0,18562,1,0.000014,13,0.215627,0.246961,15616.378707,0.131818,0.00244
202004,202004,,0,1,1,0,1,1,0,0.000001,0,20885,20,0.00001,1,1,1,0,0,0
202005,202005,,1,27,28,1,27,28,0.000213,0.001344,0,16315,5,0.00001,14,0.188854,0.212692,4993.174159,0.108466,0.000344
9306041,9306041,,4,30,34,4,30,34,0.000024,0.000159,0,430,5,0.000018,5,0.497512,0.607333,30666.777865,0.120321,0.001293
202006,202006,,0,10,10,0,10,10,0,0.000426,0,20887,13,0.00001,14,0.177881,0.203375,0,0.355556,0
9809137,9809137,,1,8,9,1,8,9,0.000005,0.00055,0,20886,13,0.000011,11,0.22503,0.262526,238.730692,0.319444,0.000219
202007,202007,,2,13,15,2,13,15,0.000163,0.001332,0,20888,4,0.00001,15,0.180659,0.202631,492.147353,0.228571,0.000768
202009,202009,,3,9,12,3,9,12,0.000048,0.001214,0,20889,25,0.000012,15,0.193227,0.216215,2643.412483,0.212121,0.000711
202010,202010,,1,15,16,1,15,16,0.000213,0.000275,0,16307,1,0.00001,16,0.168637,0.190325,7489.228493,0.1375,0.000344
202011,202011,,9,34,43,9,34,43,0.000184,0.001207,0,20890,30,0.000014,14,0.215253,0.238636,19045.278139,0.208749,0.002146
202012,202012,,10,23,33,10,23,33,0.000209,0.000491,0,20891,25,0.000016,14,0.203616,0.22713,37517.442316,0.08428,0.002337
202013,202013,,0,1,1,0,1,1,0,0,27,20893,49,0.00001,1,1,1,0,0,0
201217,201217,,1,0,1,1,0,1,0,0,27,20892,49,0.000019,0,0,0,0,0,0.000219
202014,202014,,2,58,60,2,58,60,0.000082,0.007827,0,20894,30,0.000011,14,0.218997,0.249806,20607.583925,0.09096,0.00048
202015,202015,,1,2,3,1,2,3,0.000003,0.000001,0,20895,4,0.00001,14,0.184827,0.197804,1565.054572,0.333333,0.000219
202016,202016,,0,7,7,0,7,7,0,0.001104,0,20896,25,0.00001,17,0.173832,0.195613,0,0.452381,0
202017,202017,,18,22,40,18,22,40,0.000683,0.000486,0,18862,0,0.000041,13,0.191731,0.212843,93982.625395,0.074359,0.0047
202018,202018,,2,5,7,2,5,7,0.000001,0.000031,0,20897,17,0.000011,13,0.143893,0.157427,8.193643,0.333333,0.000451
202019,202019,,0,3,3,0,3,3,0,0.000936,0,20898,25,0.00001,17,0.175216,0.194641,0,0.333333,0
202022,202022,,2,37,39,2,37,39,0.000254,0.000861,0,18918,3,0.000011,13,0.213502,0.24043,18433.09865,0.197706,0.00076
202023,202023,,4,9,13,4,9,13,0.000029,0.000025,0,20899,22,0.000013,15,0.157635,0.168488,9648.047495,0.102564,0.000884
202025,202025,,3,17,20,3,17,20,0.000055,0.003495,0,20900,30,0.000011,15,0.219759,0.249022,4929.88857,0.207895,0.000738
202027,202027,,4,16,20,4,16,20,0.000308,0.002649,0,20901,2,0.000013,16,0.162517,0.19519,3467.543234,0.128947,0.000903
202029,202029,,1,6,7,1,6,7,0.000032,0.001055,0,20902,25,0.00001,15,0.186565,0.205116,6.209332,0.333333,0.000226
204260,204260,,19,44,63,19,44,63,0.000242,0.000531,0,19370,3,0.000017,14,0.21256,0.236823,47246.160478,0.168715,0.004653
204164,204164,,19,13,32,19,13,32,0.0002,0.000485,0,19348,3,0.000019,14,0.200908,0.221467,33433.185357,0.199597,0.004966
204239,204239,,12,22,34,12,22,34,0.0001,0.000391,0,19368,3,0.000015,14,0.201183,0.222159,6403.343918,0.259358,0.003068
202031,202031,,0,7,7,0,7,7,0,0.000015,0,20903,9,0.00001,14,0.159821,0.169448,0,0.071429,0
202032,202032,,4,13,17,4,13,17,0.00015,0.000152,0,19118,52,0.000011,18,0.188795,0.208629,6910.007985,0.246324,0.001036
9202089,9202089,,3,0,3,3,0,3,0.000003,0,0,956,5,0.000024,0,0,0,0,0.166667,0.000697
202033,202033,,0,12,12,0,12,12,0,0.000022,0,20904,52,0.00001,16,0.173985,0.190416,0,0.075758,0
202034,202034,,1,10,11,1,10,11,0,0.00001,0,20905,22,0.000011,16,0.1403,0.154466,116.448424,0.3,0.000219
202035,202035,,1,1,2,1,1,2,0,0,0,20906,6,0.000014,13,0.150564,0.16406,1203,0,0.000219
202036,202036,,2,8,10,2,8,10,0.000214,0.000069,0,16128,5,0.000012,15,0.146679,0.163403,1286.844299,0.288889,0.000563
202037,202037,,4,22,26,4,22,26,0.000089,0.001639,0,20907,25,0.000013,16,0.192867,0.218675,19362.834492,0.156923,0.00091
202038,202038,,1,3,4,1,3,4,0.000015,0,0,20910,9,0.000011,2,0.8,0.875,4,0.083333,0.000219
9408009,9408009,,1,0,1,1,0,1,0,0,0,20909,9,0.000013,0,0,0,0,0,0.000226
9410107,9410107,,1,1,2,1,1,2,0,0,0,20908,9,0.000013,2,0.666667,0.75,0,0.5,0.000226
202039,202039,,3,24,27,3,24,27,0.000009,0.001592,0,20911,30,0.000012,15,0.21666,0.241218,4076.199524,0.136752,0.00067
202040,202040,,5,18,23,5,18,23,0.00038,0.000584,0,20912,30,0.000012,14,0.216992,0.239877,7377.647463,0.167984,0.001185
202041,202041,,4,11,15,4,11,15,0.000001,0.000011,0,20913,6,0.000013,17,0.155487,0.171644,7131.963332,0.128571,0.000916
202042,202042,,1,9,10,1,9,10,0,0.001166,0,20914,25,0.000012,14,0.194032,0.213654,8241.081728,0.144444,0.000226
202043,202043,,3,15,18,3,15,18,0.000147,0.000104,0,19117,52,0.00001,18,0.18744,0.208123,21211.095507,0.140523,0.000726
202044,202044,,1,27,28,1,27,28,0.000003,0.004633,0,20915,25,0.00001,13,0.199431,0.224467,261.25726,0.190476,0.000219
202047,202047,,3,5,8,3,5,8,0.000002,0.001142,0,20916,4,0.000022,17,0.1534,0.175266,7096.593483,0.214286,0.000664
202049,202049,,0,12,12,0,12,12,0,0.000222,0,20917,2,0.00001,17,0.175637,0.198297,0,0.098485,0
202050,202050,,2,6,8,2,6,8,0.00002,0.000056,0,20918,30,0.000011,15,0.186357,0.200205,354.202077,0.410714,0.000451
202051,202051,,1,16,17,1,16,17,0.000002,0.000077,0,20919,52,0.000011,15,0.166165,0.181416,283.879016,0.139706,0.000219
9503198,9503198,,5,7,12,5,7,12,0.000007,0.000012,0,4226,52,0.000016,5,0.375,0.51875,3355.778387,0.257576,0.001199
9604131,9604131,,4,10,14,4,10,14,0.000009,0.000014,0,4227,52,0.000014,4,0.509804,0.637821,3928.441519,0.208791,0.000953
202053,202053,,0,23,23,0,23,23,0,0.002996,0,20920,4,0.00001,14,0.179135,0.206572,0,0.134387,0
202054,202054,,3,7,10,3,7,10,0,0.000002,0,20921,23,0.000013,22,0.15763,0.182164,14012.150024,0.277778,0.000664
202055,202055,,2,17,19,2,17,19,0.000454,0.016314,0,20922,1,0.000011,13,0.190818,0.212291,2017.700803,0.187135,0.000445
202056,202056,,20,23,43,20,23,43,0.003632,0.01864,0,18589,1,0.00002,13,0.204434,0.23079,92291.13869,0.17608,0.00618
202057,202057,,5,31,36,5,31,36,0.00016,0.001351,0,18986,3,0.000011,14,0.196543,0.223242,18143.28416,0.071429,0.001576
9508098,9508098,,1,3,4,1,3,4,0.000016,0,0,18978,3,0.00001,2,0.8,0.875,2322.656612,0.166667,0.000258
9206042,9206042,,4,0,4,4,0,4,0,0,0,630,3,0.000031,0,0,0,0,0.166667,0.000906
9310178,9310178,,1,2,3,1,2,3,0,0,0,18977,3,0.000013,1,1,1,37.442049,0.166667,0.000226
9312066,9312066,,1,2,3,1,2,3,0,0,0,18976,3,0.000013,1,1,1,37.442049,0.166667,0.000226
202058,202058,,7,3,10,7,3,10,0.000066,0.000312,0,20099,0,0.000014,16,0.161449,0.180594,10.336067,0.377778,0.00164
202059,202059,,1,4,5,1,4,5,0,0,0,20923,30,0.000012,6,0.276316,0.402381,5.666667,0.4,0.000219
202062,202062,,2,10,12,2,10,12,0.000043,0.000035,0,19506,30,0.000011,14,0.186383,0.201222,715.831263,0.128788,0.000511
202063,202063,,0,14,14,0,14,14,0,0.000287,0,20924,8,0.00001,19,0.181371,0.203301,0,0.104396,0
202064,202064,,4,28,32,4,28,32,0.000001,0.000615,0,20925,10,0.000016,15,0.194996,0.218389,29394.457133,0.142137,0.000936
202066,202066,,0,10,10,0,10,10,0,0.001116,0,20926,13,0.00001,17,0.177539,0.20139,0,0.111111,0
202067,202067,,7,12,19,7,12,19,0.000225,0.000158,0,19094,52,0.000012,18,0.144498,0.16458,2349.692924,0.163743,0.001806
202068,202068,,1,6,7,1,6,7,0,0.000007,0,20927,5,0.000011,17,0.158114,0.171758,0,0.333333,0.000219
202069,202069,,9,8,17,9,8,17,0.000125,0.000429,0,20928,52,0.000017,18,0.18956,0.210183,26391.612304,0.117647,0.002085
202070,202070,,1,1,2,1,1,2,0.000015,0.000002,0,20929,26,0.000011,2,0.666667,0.75,2,0,0.000219
202071,202071,,0,18,18,0,18,18,0,0.000273,0,20930,26,0.00001,19,0.177874,0.200175,0,0.323529,0
202072,202072,,3,10,13,3,10,13,0.000301,0.007678,0,20931,13,0.000011,14,0.194739,0.217062,192.751199,0.224359,0.000705
202074,202074,,3,19,22,3,19,22,0.000595,0.00312,0,20932,52,0.00001,14,0.194017,0.216137,1300.049469,0.112554,0.000665
202075,202075,,3,25,28,3,25,28,0.000253,0.002673,0,19255,1,0.000011,14,0.201339,0.227718,2506.881843,0.142857,0.000917
202076,202076,,4,4,8,4,4,8,0.000003,0.000014,0,20933,5,0.000013,14,0.15716,0.171656,47.010479,0.303571,0.000903
204224,204224,,1,5,6,1,5,6,0,0,0,20934,22,0.000011,5,0.337838,0.454,1.5,0.2,0.000219
9602013,9602013,,1,6,7,1,6,7,0,0.000002,0,20586,22,0.000012,3,0.586207,0.666667,9.683333,0.214286,0.000226
202078,202078,,0,19,19,0,19,19,0,0.002728,0,20935,30,0.00001,15,0.185232,0.205543,0,0.190058,0
202079,202079,,10,30,40,10,30,40,0.000601,0.001681,0,18992,3,0.000012,16,0.193225,0.216188,5942.756883,0.273077,0.002822
202080,202080,,0,13,13,0,13,13,0,0.000074,0,20936,22,0.00001,15,0.157113,0.178685,0,0.173077,0
202081,202081,,0,7,7,0,7,7,0,0.000001,0,20937,6,0.00001,13,0.150263,0.161862,0,0.190476,0
202082,202082,,5,11,16,5,11,16,0.000001,0.000109,0,20938,22,0.00002,14,0.181587,0.198803,68688.443401,0.0625,0.001142
9302085,9302085,,4,0,4,4,0,4,0.000002,0,0,4350,22,0.000032,0,0,0,0,0,0.000987
202083,202083,,1,47,48,1,47,48,0.000027,0.023947,0,20939,8,0.00001,13,0.223402,0.255633,3511.68646,0.132535,0.000234
202084,202084,,4,49,53,4,49,53,0.000088,0.004092,0,20940,0,0.000012,14,0.196455,0.224602,5714.307537,0.151669,0.000969
202085,202085,,2,11,13,2,11,13,0.000009,0.000961,0,20941,1,0.000015,16,0.185844,0.204748,20385.569393,0.083333,0.000438
202086,202086,,0,1,1,0,1,1,0,0,28,20943,50,0.00001,1,1,1,0,0,0
110095,110095,,1,0,1,1,0,1,0,0,28,20942,50,0.000019,0,0,0,0,0,0.000219
202088,202088,,2,11,13,2,11,13,0.000437,0.018605,0,20944,1,0.000011,11,0.226494,0.256227,1148.65151,0.307692,0.000452
202089,202089,,1,4,5,1,4,5,0,0.000005,0,20945,5,0.00001,17,0.134331,0.145447,9393.576105,0.15,0.000232
202090,202090,,1,44,45,1,44,45,0.000047,0.00639,0,20946,4,0.00001,18,0.194591,0.228313,460.267583,0.125758,0.000233
202091,202091,,3,16,19,3,16,19,0.000135,0.003718,0,19339,25,0.000011,13,0.208785,0.240103,6638.245069,0.073099,0.000845
9311186,9311186,,2,3,5,2,3,5,0.000053,0.00026,0,19338,0,0.000012,2,0.666667,0.75,16.337746,0,0.00046
202092,202092,,1,15,16,1,15,16,0.000012,0.001101,0,20947,30,0.000011,14,0.188876,0.2059,190.029961,0.2375,0.000219
202093,202093,,5,6,11,5,6,11,0.000064,0.000353,0,19332,30,0.000013,14,0.168755,0.182084,1760.765407,0.145455,0.001138
202095,202095,,2,1,3,2,1,3,0.000029,0,0,20948,26,0.000014,17,0.131192,0.142395,256.844181,0.166667,0.000458
202097,202097,,6,17,23,6,17,23,0.000206,0.000577,0,19147,3,0.000011,15,0.194256,0.218138,659.742877,0.227273,0.001992
202099,202099,,2,4,6,2,4,6,0.000013,0.000099,0,20949,30,0.000012,15,0.207108,0.225957,0,0.4,0.000511
202100,202100,,1,17,18,1,17,18,0.000022,0.001734,0,20950,25,0.00001,16,0.180986,0.202269,23.947049,0.388889,0.000219
202101,202101,,1,12,13,1,12,13,0,0.000046,0,20951,22,0.00001,15,0.175482,0.193995,1663.346582,0.179487,0.000219
202102,202102,,1,3,4,1,3,4,0.000028,0.000001,0,20952,23,0.00001,15,0.140013,0.152499,1635.678159,0.25,0.000242
202103,202103,,0,13,13,0,13,13,0,0.007788,0,20953,0,0.00001,16,0.205608,0.229919,0,0.179487,0
202104,202104,,4,39,43,4,39,43,0.000128,0.010763,0,20954,30,0.000012,12,0.22511,0.257924,23393.407523,0.080842,0.000909
202106,202106,,1,15,16,1,15,16,0.000006,0.000351,0,20955,30,0.00001,13,0.210775,0.231057,631.961713,0.091667,0.000233
9603056,9603056,,4,6,10,4,6,10,0.000003,0,0,4383,22,0.000015,3,0.590909,0.705128,4385.656361,0.233333,0.000952
202108,202108,,1,5,6,1,5,6,0.000001,0.000022,0,20956,26,0.000011,16,0.143539,0.156001,0.333333,0.366667,0.000219
202110,202110,,1,22,23,1,22,23,0,0.00015,0,20957,22,0.00001,13,0.20998,0.230181,10468.51683,0.219368,0.000226
202111,202111,,118,27,145,118,27,145,0.011824,0.004035,0,18922,41,0.000074,14,0.188785,0.21407,30194.754898,0.092768,0.046009
202113,202113,,0,6,6,0,6,6,0,0.000003,0,20958,20,0.00001,13,0.151568,0.163003,0,0.2,0
202114,202114,,0,10,10,0,10,10,0,0.000021,0,20959,23,0.00001,14,0.179025,0.197557,0,0.266667,0
202116,202116,,13,22,35,13,22,35,0.000393,0.000897,0,19162,0,0.000016,16,0.194275,0.221178,11461.78625,0.159664,0.003509
9411096,9411096,,10,0,10,10,0,10,0.000288,0,0,19161,0,0.000014,0,0,0,0,0.311111,0.002674
202117,202117,,1,8,9,1,8,9,0.000008,0.000063,0,20960,1,0.000011,19,0.165079,0.188627,2880.168554,0.111111,0.000219
202118,202118,,10,26,36,10,26,36,0.000662,0.0054,0,20961,2,0.000014,15,0.215808,0.245196,19494.310971,0.095238,0.002531
202121,202121,,2,8,10,2,8,10,0,0.000206,0,20962,15,0.000012,14,0.173785,0.189167,44428.900697,0.1,0.000451
9408097,9408097,,4,5,9,4,5,9,0.000004,0.00002,0,6449,15,0.000015,2,0.727273,0.8125,9609.995342,0.055556,0.000924
9305170,9305170,,1,1,2,1,1,2,0.000006,0.000005,0,8394,22,0.000018,1,1,1,0,0.5,0.000273
9207026,9207026,,1,0,1,1,0,1,0,0,0,6451,15,0.000013,0,0,0,0,0,0.000278
9302084,9302084,,1,0,1,1,0,1,0,0,0,6450,15,0.000013,0,0,0,0,0,0.000278
202122,202122,,0,3,3,0,3,3,0,0.000001,0,20963,25,0.00001,2,0.8,0.875,0,0.166667,0
202123,202123,,10,10,20,10,10,20,0.000092,0.000132,0,20964,2,0.000015,13,0.164817,0.177972,1366.8763,0.3,0.002419
202125,202125,,7,8,15,7,8,15,0.00051,0.000645,0,19240,10,0.000012,15,0.188769,0.209561,531.713173,0.147619,0.0022
202126,202126,,17,58,75,17,58,75,0.001358,0.01936,0,19236,10,0.000015,15,0.206394,0.236562,41629.936018,0.091712,0.004807
202128,202128,,1,2,3,1,2,3,0.000042,0.000025,0,20965,52,0.00001,16,0.16344,0.175668,4.949959,0,0.000226
202129,202129,,5,37,42,5,37,42,0.000754,0.002251,0,18939,1,0.000011,17,0.206912,0.235855,11165.540293,0.136469,0.001297
202130,202130,,0,9,9,0,9,9,0,0.001626,0,20966,25,0.00001,13,0.203741,0.228858,0,0.138889,0
202131,202131,,7,36,43,7,36,43,0.00076,0.024343,0,20248,30,0.000012,19,0.211916,0.248806,5619.438156,0.165006,0.001754
9904141,9904141,,1,17,18,1,17,18,0.000286,0.000182,0,20244,52,0.00001,13,0.188489,0.215494,852.136841,0.130719,0.000268
202132,202132,,3,8,11,3,8,11,0.000006,0.000199,0,20969,13,0.000013,16,0.182297,0.223261,2953.71666,0.181818,0.000699
101012,101012,,4,0,4,4,0,4,0.000008,0,0,20968,13,0.000015,0,0,0,0,0.333333,0.000938
9509076,9509076,,6,9,15,6,9,15,0.000015,0.000933,0,5537,13,0.000019,5,0.350975,0.393188,1578.407946,0.061905,0.00143
9904169,9904169,,4,7,11,4,7,11,0.000006,0.000309,0,20967,13,0.000018,18,0.210785,0.252514,778.227315,0.109091,0.00091
9310174,9310174,,5,2,7,5,2,7,0.000025,0.0002,0,5357,13,0.000017,1,1,1,20.219212,0.095238,0.001207
9206018,9206018,,2,0,2,2,0,2,0.000005,0,0,2975,23,0.000015,0,0,0,0,0,0.000545
9306140,9306140,,2,2,4,2,2,4,0.000005,0,0,1818,5,0.000015,1,1,1,28972,0,0.000532
202133,202133,,11,15,26,11,15,26,0.000101,0.000506,0,19364,3,0.000014,15,0.179549,0.196383,259.088125,0.255385,0.002765
202134,202134,,2,8,10,2,8,10,0.000015,0.000037,0,20971,23,0.000012,17,0.173712,0.187298,6263.844399,0.222222,0.000438
9609029,9609029,,2,1,3,2,1,3,0,0,0,20970,23,0.000016,3,0.5,0.566667,0,0.333333,0.000451
202135,202135,,18,57,75,18,57,75,0.00155,0.00214,0,19046,10,0.000016,14,0.213043,0.243475,57391.858207,0.155856,0.005049
202136,202136,,2,19,21,2,19,21,0.000092,0.001757,0,20972,25,0.00001,16,0.183157,0.20755,98.953932,0.2,0.000478
202137,202137,,9,14,23,9,14,23,0.000248,0.001593,0,20973,30,0.000016,15,0.193667,0.210437,12721.338419,0.152174,0.002104
203038,203038,,11,20,31,11,20,31,0.000223,0.000986,0,20974,30,0.000017,15,0.21021,0.232544,24890.21497,0.136559,0.002537
204117,204117,,7,19,26,7,19,26,0.000367,0.001495,0,20975,30,0.000014,15,0.196283,0.219117,14393.182857,0.14,0.001586
202138,202138,,2,16,18,2,16,18,0.000322,0.00703,0,20976,2,0.00001,13,0.210505,0.238403,417.570295,0.160131,0.000471
202141,202141,,1,2,3,1,2,3,0.000011,0.000015,0,20977,23,0.000012,14,0.159509,0.175507,58.678728,0.333333,0.000219
202142,202142,,21,11,32,21,11,32,0.001299,0.000107,0,20978,8,0.000024,16,0.17962,0.196944,5225.774437,0.243952,0.005891
202144,202144,,14,2,16,14,2,16,0.000119,0.000003,0,19068,0,0.000025,14,0.139759,0.147904,155.968807,0.2875,0.003431
202145,202145,,0,16,16,0,16,16,0,0.000007,0,20979,26,0.00001,20,0.148961,0.165721,0,0.104167,0
202146,202146,,0,11,11,0,11,11,0,0.000007,0,20980,23,0.00001,15,0.143081,0.155618,0,0.245455,0
202147,202147,,4,15,19,4,15,19,0.000379,0.001525,0,20982,25,0.000012,13,0.18287,0.203064,1957.57625,0.169591,0.000991
9303059,9303059,,2,9,11,2,9,11,0.00006,0.000559,0,20981,13,0.000011,3,0.681818,0.788889,81.989927,0.090909,0.000466
202148,202148,,13,57,70,13,57,70,0.000617,0.008344,0,18898,3,0.000014,13,0.22489,0.256489,53967.223838,0.083851,0.00358
202149,202149,,1,8,9,1,8,9,0.000006,0.000085,0,20983,0,0.000011,16,0.184797,0.205669,174.526441,0.152778,0.000226
202150,202150,,18,20,38,18,20,38,0.00205,0.017571,0,18925,41,0.000021,13,0.197104,0.222772,14256.315059,0.164296,0.008577
202152,202152,,1,20,21,1,20,21,0.000021,0.001793,0,19140,0,0.00001,14,0.193313,0.221326,9593.472513,0.071429,0.000485
202154,202154,,0,2,2,0,2,2,0,0.000003,0,20984,2,0.00001,14,0.158859,0.178559,0,0,0
9205005,9205005,,1,0,1,1,0,1,0,0,0,822,23,0.000063,0,0,0,0,0,0.000453
202155,202155,,2,10,12,2,10,12,0.00008,0.011456,0,20985,1,0.000011,11,0.215181,0.235618,4401.688423,0.204545,0.000458
202156,202156,,5,48,53,5,48,53,0.001042,0.023316,0,18572,1,0.000012,13,0.229273,0.262277,72763.354893,0.173077,0.001323
202157,202157,,91,21,112,91,21,112,0.011866,0.02127,0,18924,41,0.000063,15,0.199003,0.232377,41024.880391,0.174228,0.041427
202158,202158,,1,6,7,1,6,7,0,0.001017,0,20986,13,0.000013,14,0.164148,0.180445,771.079641,0.190476,0.000227
202159,202159,,0,1,1,0,1,1,0,0,0,20987,15,0.00001,1,1,1,0,0,0
9304070,9304070,,2,0,2,2,0,2,0.00002,0,0,5477,15,0.000019,0,0,0,0,0,0.000466
202160,202160,,0,14,14,0,14,14,0,0.006245,0,20988,25,0.00001,17,0.188068,0.215208,0,0.076923,0
202162,202162,,0,3,3,0,3,3,0,0,0,20990,20,0.00001,7,0.226389,0.262942,0,0.166667,0
9908074,9908074,,1,4,5,1,4,5,0,0.002049,0,20989,4,0.000013,6,0.265432,0.307364,128,0.2,0.000219
202164,202164,,1,2,3,1,2,3,0.000014,0,0,20991,25,0.000011,3,0.571429,0.708333,6,0.166667,0.000226
9407095,9407095,,2,1,3,2,1,3,0,0,0,14028,21,0.00007,1,1,1,5.5,0.166667,0.00059
202165,202165,,1,21,22,1,21,22,0.000068,0.00349,0,20992,3,0.00001,17,0.202788,0.227872,235.68898,0.183983,0.000232
202166,202166,,1,10,11,1,10,11,0.000194,0.016444,0,20993,25,0.000011,14,0.180464,0.203935,0,0.290909,0.000259
202168,202168,,24,30,54,24,30,54,0.001247,0.00101,0,20018,0,0.000019,14,0.201644,0.229326,69365.23523,0.122991,0.007077
202169,202169,,1,1,2,1,1,2,0,0.000003,0,20994,23,0.000013,1,1,1,0,0.5,0.000219
202170,202170,,1,15,16,1,15,16,0.000002,0.000184,0,20995,26,0.00001,11,0.176405,0.222034,0,0.266667,0.000219
202171,202171,,6,39,45,6,39,45,0.000129,0.002745,0,20996,30,0.000012,14,0.219994,0.245001,9166.135622,0.220202,0.00144
202174,202174,,17,28,45,17,28,45,0.000636,0.000555,0,20073,25,0.000031,16,0.196921,0.225332,75228.02029,0.075253,0.003951
202175,202175,,2,25,27,2,25,27,0.00006,0.016456,0,19256,1,0.000011,16,0.193772,0.219475,521.140915,0.198006,0.000681
202177,202177,,0,22,22,0,22,22,0,0.000812,0,20997,2,0.00001,17,0.193754,0.220165,0,0.203463,0
202178,202178,,4,21,25,4,21,25,0.000013,0.001297,0,20998,23,0.000013,14,0.203286,0.228006,55166.23573,0.161667,0.00095
202180,202180,,2,25,27,2,25,27,0.000078,0.002264,0,20999,8,0.000011,13,0.197466,0.2193,2022.043118,0.189459,0.000597
202181,202181,,0,18,18,0,18,18,0,0.000774,0,21000,13,0.00001,15,0.15395,0.179952,0,0.264706,0
202182,202182,,1,6,7,1,6,7,0.000001,0.000018,0,21001,4,0.000011,18,0.161029,0.175058,788.963485,0.357143,0.000232
202183,202183,,5,28,33,5,28,33,0.000763,0.005565,0,21002,8,0.000011,13,0.210761,0.241017,5160.449051,0.150568,0.001244
202184,202184,,12,30,42,12,30,42,0.00135,0.002314,0,19239,10,0.000013,14,0.199456,0.225743,14371.818534,0.245064,0.003521
202185,202185,,0,4,4,0,4,4,0,0.00002,0,21003,22,0.00001,4,0.472222,0.563725,0,0.416667,0
202186,202186,,85,26,111,85,26,111,0.011129,0.019674,0,18928,41,0.000057,14,0.194729,0.220764,76942.743384,0.161753,0.037743
9306090,9306090,,2,0,2,2,0,2,0.000037,0,0,18803,3,0.000011,0,0,0,0,0.5,0.000856
203005,203005,,4,29,33,4,29,33,0.000001,0.000026,0,21004,20,0.000011,14,0.174557,0.193242,7227.599124,0.133523,0.000903
203006,203006,,5,28,33,5,28,33,0.000001,0.000015,0,21005,20,0.000013,13,0.165061,0.181415,3429.454031,0.201705,0.001122
202189,202189,,8,22,30,8,22,30,0.000542,0.018913,0,19154,25,0.000014,13,0.203996,0.235365,16951.754311,0.18046,0.002253
202190,202190,,45,16,61,45,16,61,0.004971,0.002676,0,19228,41,0.000035,14,0.186431,0.209194,10611.7361,0.238798,0.01955
202191,202191,,1,39,40,1,39,40,0.000011,0.023679,0,21006,2,0.00001,14,0.227514,0.261681,3062.598908,0.142949,0.000219
202192,202192,,0,15,15,0,15,15,0,0,0,21007,23,0.00001,13,0.170573,0.215661,0,0.133333,0
202194,202194,,2,3,5,2,3,5,0,0.000001,0,21008,20,0.000012,2,0.565217,0.615385,104.00119,0.2,0.000479
202195,202195,,10,16,26,10,16,26,0.001303,0.002396,0,20036,1,0.000015,14,0.195405,0.21981,4724.560634,0.266154,0.002682
202196,202196,,0,14,14,0,14,14,0,0.000021,0,21011,4,0.00001,14,0.156128,0.170793,0,0.049451,0
9807053,9807053,,1,5,6,1,5,6,0,0.000004,0,21010,23,0.00001,9,0.208443,0.291697,42.166667,0.1,0.000219
9806207,9806207,,1,1,2,1,1,2,0,0,0,21009,23,0.000012,1,1,1,0,0.5,0.000226
202197,202197,,6,25,31,6,25,31,0.000896,0.001932,0,21012,4,0.000012,14,0.20462,0.228091,12396.540812,0.13871,0.001645
202199,202199,,2,18,20,2,18,20,0.000068,0.00004,0,21013,20,0.00001,13,0.17113,0.186996,109.961077,0.25,0.000438
202200,202200,,0,56,56,0,56,56,0,0.006455,0,21014,3,0.00001,14,0.206147,0.232016,0,0.094805,0
202201,202201,,2,24,26,2,24,26,0.000051,0.017359,0,21015,2,0.00001,15,0.203713,0.23985,951.693073,0.152308,0.000451
202203,202203,,4,12,16,4,12,16,0.000011,0.000242,0,21016,2,0.000013,15,0.176978,0.195068,1907.221437,0.220833,0.000883
202202,202202,,4,12,16,4,12,16,0.000055,0.001784,0,19376,30,0.000012,12,0.215392,0.236607,218.253065,0.325,0.000903
202204,202204,,2,3,5,2,3,5,0,0.000003,0,21017,28,0.000015,15,0.1425,0.152659,10090.289707,0.1,0.000445
202205,202205,,3,10,13,3,10,13,0.000271,0.000275,0,21018,4,0.000012,13,0.196239,0.215282,914.134092,0.314103,0.001043
202206,202206,,0,15,15,0,15,15,0,0.002176,0,21019,0,0.00001,17,0.169962,0.195922,0,0.171429,0
202207,202207,,3,33,36,3,33,36,0,0.000037,0,21020,20,0.000011,20,0.167933,0.187624,17806.212884,0.110317,0.000671
202208,202208,,18,25,43,18,25,43,0.000906,0.001611,0,20025,4,0.000016,15,0.196222,0.222018,27811.163336,0.14175,0.006117
202209,202209,,1,8,9,1,8,9,0.000027,0.002817,0,21021,30,0.00001,12,0.187164,0.206658,476.134826,0.111111,0.000239
203001,203001,,0,9,9,0,9,9,0,0.000529,0,21022,13,0.00001,14,0.201063,0.230317,0,0.319444,0
203002,203002,,0,21,21,0,21,21,0,0.000755,0,21023,13,0.00001,11,0.213435,0.253223,0,0.17381,0
203004,203004,,11,13,24,11,13,24,0.001972,0.007904,0,21024,1,0.000019,17,0.196365,0.22257,37185.238175,0.105072,0.002654
208216,208216,,0,27,27,0,27,27,0,0.000004,0,21025,20,0.00001,21,0.152881,0.171392,0,0.173789,0
203007,203007,,3,11,14,3,11,14,0.000038,0.001904,0,21026,2,0.000017,15,0.18114,0.197806,12040.917452,0.186813,0.000677
203008,203008,,0,3,3,0,3,3,0,0.000005,0,21027,1,0.00001,16,0.170851,0.186616,0,0.333333,0
203009,203009,,0,13,13,0,13,13,0,0.000817,0,21028,0,0.00001,14,0.194547,0.214889,0,0.153846,0
203012,203012,,4,5,9,4,5,9,0.000001,0.000001,0,21029,23,0.000017,19,0.148399,0.161538,4843.458273,0.111111,0.000877
205116,205116,,1,5,6,1,5,6,0,0.000022,0,21030,4,0.000011,15,0.149848,0.163881,0,0.366667,0.000219
203275,203275,,4,1,5,4,1,5,0.000005,0,0,19373,5,0.000023,5,0.310345,0.383333,170.435657,0.15,0.000953
205180,205180,,15,24,39,15,24,39,0.001153,0.019756,0,19220,8,0.000016,14,0.193884,0.218225,18172.771631,0.165317,0.003772
205037,205037,,8,56,64,8,56,64,0.001077,0.023798,0,19219,8,0.000012,13,0.208223,0.235263,54530.19294,0.119048,0.002229
203014,203014,,11,11,22,11,11,22,0.000074,0.000247,0,20069,25,0.000019,16,0.178112,0.197861,31276.681586,0.162338,0.002629
203015,203015,,1,1,2,1,1,2,0.000001,0.000033,0,21031,28,0.000012,15,0.149379,0.162399,0,0.5,0.000226
203016,203016,,2,12,14,2,12,14,0.000015,0.000874,0,21032,0,0.000011,14,0.183544,0.202227,6701.002681,0.252747,0.00046
203017,203017,,1,14,15,1,14,15,0.000028,0.001653,0,21033,30,0.000011,15,0.1844,0.201001,416.856988,0.2,0.000233
203018,203018,,56,25,81,56,25,81,0.007032,0.021044,0,19226,41,0.00004,14,0.195114,0.229053,15718.258937,0.204475,0.026107
210081,210081,,3,15,18,3,15,18,0.000001,0.000023,0,21036,5,0.000013,14,0.172123,0.186927,27350.773579,0.081699,0.000658
207120,207120,,6,11,17,6,11,17,0.000002,0.000002,0,21034,5,0.000016,15,0.133995,0.142042,7590.012657,0.172794,0.001361
207205,207205,,3,8,11,3,8,11,0,0.000002,0,21035,5,0.000013,16,0.121524,0.128825,97.168849,0.272727,0.000677
203021,203021,,1,44,45,1,44,45,0.000067,0.023507,0,21037,1,0.00001,15,0.207049,0.242143,7548.648784,0.138384,0.000219
203022,203022,,0,4,4,0,4,4,0,0.000004,0,21039,25,0.00001,15,0.148194,0.15782,0,0.25,0
104151,104151,,1,0,1,1,0,1,0,0,0,21038,25,0.000012,0,0,0,0,0,0.000219
203023,203023,,0,31,31,0,31,31,0,0.019148,0,21040,0,0.00001,17,0.185719,0.213489,0,0.150538,0
203024,203024,,3,13,16,3,13,16,0.000207,0.000143,0,21041,15,0.000012,15,0.168889,0.186576,3568.574163,0.1375,0.000671
203025,203025,,7,16,23,7,16,23,0.000452,0.002258,0,21042,0,0.000013,16,0.169088,0.192762,2644.270691,0.187747,0.001594
203026,203026,,3,7,10,3,7,10,0.000008,0.000146,0,21044,8,0.000017,14,0.177191,0.193884,6311.626002,0.133333,0.000679
3274,3274,,1,0,1,1,0,1,0.000002,0,0,21043,8,0.000012,0,0,0,0,0,0.000239
9508167,9508167,,1,3,4,1,3,4,0,0.000014,0,5643,5,0.000017,9,0.171636,0.194589,281.75521,0.083333,0.000262
203027,203027,,0,6,6,0,6,6,0,0.000004,0,21046,23,0.00001,16,0.128309,0.139157,0,0.1,0
9812174,9812174,,1,4,5,1,4,5,0,0.000004,0,21045,23,0.000011,10,0.175285,0.197705,107.277079,0.15,0.000219
203029,203029,,0,14,14,0,14,14,0,0.000005,0,21047,5,0.00001,18,0.100795,0.109844,0,0.131868,0
203030,203030,,3,30,33,3,30,33,0.000492,0.000637,0,19128,52,0.000011,14,0.205914,0.228555,38316.431401,0.180871,0.000927
203032,203032,,0,29,29,0,29,29,0,0.002608,0,21048,25,0.00001,14,0.204449,0.230247,0,0.091133,0
203033,203033,,0,3,3,0,3,3,0,0,0,21049,5,0.00001,18,0.109243,0.119619,0,0.333333,0
203034,203034,,1,2,3,1,2,3,0,0.000001,0,21050,20,0.000013,1,1,1,0,0.5,0.000219
203035,203035,,2,14,16,2,14,16,0.000167,0.001213,0,21051,25,0.00001,13,0.192797,0.212356,540.010686,0.316667,0.000591
203036,203036,,6,11,17,6,11,17,0.000254,0.001745,0,21052,25,0.000012,15,0.189621,0.210808,2064.436324,0.272059,0.001522
203037,203037,,1,1,2,1,1,2,0,0.000002,0,21053,4,0.000019,1,1,1,1,0,0.000219
203039,203039,,12,15,27,12,15,27,0.000112,0.000536,0,19069,0,0.000021,13,0.191449,0.213114,34779.902125,0.14245,0.002864
203040,203040,,21,8,29,21,8,29,0.000421,0.00002,0,21054,15,0.00003,15,0.154018,0.163368,2850.486863,0.184729,0.005156
203042,203042,,1,8,9,1,8,9,0,0.000001,0,21056,28,0.000011,3,0.6875,0.833333,20.583333,0.069444,0.000226
9609150,9609150,,1,1,2,1,1,2,0,0,0,21055,28,0.000011,1,1,1,0,0.5,0.000226
203043,203043,,1,24,25,1,24,25,0.000001,0.00021,0,21057,5,0.00001,19,0.171343,0.190388,1068.269938,0.116667,0.000226
203044,203044,,0,3,3,0,3,3,0,0,0,21061,9,0.00001,13,0.128613,0.144635,0,0,0
9903220,9903220,,2,1,3,2,1,3,0,0,0,14900,9,0.000017,13,0.124434,0.134455,0.333333,0.166667,0.000445
9904062,9904062,,1,4,5,1,4,5,0,0.000022,0,21060,9,0.000013,13,0.129259,0.148191,64.333333,0,0.000219
9811026,9811026,,1,7,8,1,7,8,0,0.000032,0,21059,4,0.000013,5,0.345238,0.421264,111.5,0.017857,0.000226
203046,203046,,1,26,27,1,26,27,0.000031,0.00228,0,21062,13,0.00001,17,0.205524,0.237052,217.508581,0.18661,0.000219
203047,203047,,4,20,24,4,20,24,0.00022,0.002719,0,21063,30,0.000011,14,0.200316,0.223267,3252.7277,0.217391,0.000987
203048,203048,,14,142,156,14,142,156,0.001373,0.039122,0,18946,13,0.000016,15,0.230195,0.279067,191304.256673,0.052192,0.004385
9908004,9908004,,1,134,135,1,134,135,0.00046,0.045517,0,18921,13,0.00001,13,0.23757,0.290179,454.776394,0.088723,0.000328
203049,203049,,4,33,37,4,33,37,0.000445,0.015379,0,19172,8,0.000012,13,0.210411,0.240346,5593.001407,0.245495,0.001049
203050,203050,,0,26,26,0,26,26,0,0.006167,0,21064,25,0.00001,17,0.185621,0.215433,0,0.2,0
203051,203051,,6,13,19,6,13,19,0.00009,0.000948,0,21065,30,0.000012,13,0.22037,0.243318,15898.735212,0.149123,0.001606
203052,203052,,4,56,60,4,56,60,0.00031,0.001723,0,19052,10,0.000013,14,0.211871,0.243989,29805.342128,0.153107,0.001218
203053,203053,,4,12,16,4,12,16,0.0002,0.000463,0,21066,23,0.000012,15,0.193022,0.21598,30501.288126,0.225,0.00093
203054,203054,,1,2,3,1,2,3,0,0,0,21067,22,0.00001,7,0.234483,0.290476,4,0.166667,0.000232
203055,203055,,7,6,13,7,6,13,0.000052,0.000047,0,21068,0,0.000017,13,0.172679,0.188627,2498.923433,0.25641,0.001692
203056,203056,,4,10,14,4,10,14,0.000021,0.00007,0,21069,52,0.000013,16,0.153522,0.168286,916.649139,0.335165,0.000916
203057,203057,,5,32,37,5,32,37,0.000369,0.006617,0,21070,1,0.000013,14,0.207043,0.233998,11124.197817,0.117117,0.001408
203058,203058,,1,14,15,1,14,15,0.000282,0.0029,0,21071,2,0.00001,14,0.191961,0.212839,489.824114,0.166667,0.000226
203059,203059,,0,8,8,0,8,8,0,0.000593,0,21072,26,0.00001,18,0.141599,0.158099,0,0.196429,0
9201069,9201069,,2,0,2,2,0,2,0.000001,0,0,3869,23,0.000031,0,0,0,0,0,0.00048
9204051,9204051,,2,0,2,2,0,2,0.000001,0,0,3867,5,0.000023,0,0,0,0,0.5,0.00048
9210159,9210159,,1,1,2,1,1,2,0.000001,0,0,3868,5,0.000012,1,1,1,0,0.5,0.000254
203060,203060,,4,18,22,4,18,22,0.000233,0.000542,0,21073,10,0.000013,14,0.194227,0.217317,3843.511151,0.279221,0.000958
203061,203061,,12,16,28,12,16,28,0.000251,0.000971,0,19296,0,0.000014,15,0.187938,0.210299,2396.083017,0.126984,0.003285
203062,203062,,0,3,3,0,3,3,0,0.000001,0,21074,23,0.00001,8,0.204545,0.233038,0,0,0
203063,203063,,3,6,9,3,6,9,0.000002,0.000001,0,21075,6,0.000012,12,0.168252,0.204564,60.844105,0.208333,0.00067
203064,203064,,1,51,52,1,51,52,0.000028,0.021323,0,21076,1,0.00001,14,0.214476,0.249823,2971.753928,0.146682,0.000219
203065,203065,,19,13,32,19,13,32,0.000017,0.000043,0,21077,15,0.00003,15,0.163191,0.174904,6055.727863,0.134073,0.004595
9310117,9310117,,7,1,8,7,1,8,0.000034,0.000004,0,6192,15,0.00002,1,1,1,17.831374,0.035714,0.001771
9411115,9411115,,4,1,5,4,1,5,0.000002,0.000003,0,14522,15,0.000014,2,0.6,0.666667,6.823341,0.15,0.001072
203066,203066,,14,14,28,14,14,28,0.00002,0.000037,0,21078,5,0.000021,14,0.17963,0.194357,68680.62216,0.183862,0.003245
203068,203068,,2,12,14,2,12,14,0.000232,0.010248,0,21079,1,0.00001,13,0.195225,0.215767,5351.987215,0.17033,0.000478
203069,203069,,0,13,13,0,13,13,0,0.0167,0,21080,1,0.00001,14,0.1948,0.219216,0,0.288462,0
9502092,9502092,,10,4,14,10,4,14,0.000374,0.000055,0,3912,26,0.000027,7,0.25724,0.313576,817.790114,0.28022,0.00317
9512166,9512166,,5,8,13,5,8,13,0.000307,0.000077,0,5744,26,0.000017,6,0.27933,0.331167,5473.25296,0.358974,0.001875
203070,203070,,8,13,21,8,13,21,0.000177,0.000394,0,21081,13,0.000015,14,0.191042,0.217648,4155.808453,0.12619,0.001851
203072,203072,,1,2,3,1,2,3,0,0,0,21082,23,0.000012,9,0.157571,0.179632,18.313004,0,0.000219
203073,203073,,2,23,25,2,23,25,0,0.000008,0,21083,6,0.000011,12,0.191951,0.210555,7733.861923,0.15,0.000445
203075,203075,,0,4,4,0,4,4,0,0,0,21084,6,0.00001,13,0.14034,0.153494,0,0.25,0
203076,203076,,0,53,53,0,53,53,0,0.010141,0,21085,13,0.00001,13,0.196387,0.229619,0,0.136067,0
203077,203077,,1,17,18,1,17,18,0.000015,0.001925,0,21086,30,0.000011,14,0.193248,0.213114,1205.920693,0.199346,0.000219
203078,203078,,0,7,7,0,7,7,0,0.000297,0,21087,30,0.00001,13,0.208293,0.227341,0,0.238095,0
203079,203079,,6,3,9,6,3,9,0.000002,0.000004,0,21089,15,0.000028,14,0.180968,0.193816,38438.216198,0.138889,0.001375
9812130,9812130,,3,2,5,3,2,5,0,0,0,21088,15,0.000024,5,0.308411,0.362121,128.683203,0.25,0.000723
203080,203080,,55,15,70,55,15,70,0.007468,0.004082,0,19229,41,0.00004,15,0.187529,0.211938,9265.426093,0.269358,0.026031
203081,203081,,4,18,22,4,18,22,0.00002,0.000039,0,21090,10,0.000015,16,0.171435,0.188063,17479.338573,0.158009,0.000929
203082,203082,,70,26,96,70,26,96,0.007757,0.003236,0,19238,41,0.000042,14,0.193529,0.220038,27050.069638,0.158224,0.028503
203084,203084,,2,25,27,2,25,27,0.000041,0.002609,0,21091,25,0.000011,12,0.209336,0.232194,698.201229,0.135328,0.000445
203085,203085,,2,29,31,2,29,31,0,0.001979,0,21094,6,0.000011,16,0.154162,0.178353,4778.847274,0.089247,0.000438
9810202,9810202,,1,4,5,1,4,5,0.000023,0.000001,0,21093,6,0.00001,11,0.173998,0.213467,35.557572,0.15,0.000232
9802014,9802014,,1,0,1,1,0,1,0,0,0,21092,6,0.000012,0,0,0,0,0,0.000226
203086,203086,,0,1,1,0,1,1,0,0.000001,0,21095,21,0.00001,2,0.6,0.666667,0,0,0
9707020,9707020,,2,2,4,2,2,4,0.000043,0,0,6181,21,0.000019,1,1,1,18041.279247,0,0.000473
9603202,9603202,,1,0,1,1,0,1,0,0,0,6179,21,0.000019,0,0,0,0,0,0.000233
203087,203087,,1,4,5,1,4,5,0,0.000023,0,21096,25,0.000015,15,0.166285,0.178323,2331.126874,0.15,0.000226
203088,203088,,2,2,4,2,2,4,0.000067,0.000009,0,21097,26,0.000011,4,0.340909,0.427778,28.9,0.166667,0.000445
203090,203090,,1,1,2,1,1,2,0.000011,0.000927,0,21098,25,0.000013,12,0.187088,0.202299,0,0.5,0.000219
203091,203091,,0,23,23,0,23,23,0,0.001748,0,21099,13,0.00001,18,0.201365,0.231596,0,0.090909,0
203092,203092,,5,13,18,5,13,18,0.000657,0.002266,0,19237,10,0.000011,16,0.197257,0.223623,11199.807752,0.124183,0.001762
203094,203094,,4,10,14,4,10,14,0.000072,0.001525,0,21100,8,0.000012,17,0.158923,0.175653,358.041283,0.186813,0.000909
203095,203095,,11,14,25,11,14,25,0.00049,0.001946,0,21101,30,0.000018,14,0.206797,0.228687,10790.322676,0.16,0.002643
203097,203097,,1,4,5,1,4,5,0.000202,0.003673,0,21102,2,0.00001,11,0.184458,0.206611,33.257888,0.1,0.000219
203098,203098,,2,8,10,2,8,10,0.00062,0.001317,0,19115,0,0.00001,18,0.176219,0.198717,1704.021573,0.2,0.000673
203099,203099,,16,27,43,16,27,43,0.000538,0.002599,0,21103,8,0.000021,16,0.215912,0.24214,97718.082821,0.122924,0.004296
203100,203100,,0,20,20,0,20,20,0,0.001172,0,21104,2,0.00001,15,0.192481,0.217447,0,0.113158,0
9503120,9503120,,1,2,3,1,2,3,0.000367,0.000018,0,18948,5,0.00001,8,0.247006,0.27443,49.570223,0.166667,0.000447
9310157,9310157,,2,11,13,2,11,13,0.000022,0.000398,0,1005,5,0.000012,3,0.547619,0.608696,31120.439747,0.115385,0.000564
9404172,9404172,,5,7,12,5,7,12,0.000277,0.000482,0,1007,5,0.000014,4,0.435897,0.501634,15479.941197,0.106061,0.001208
203102,203102,,1,20,21,1,20,21,0.000261,0.023136,0,21105,1,0.00001,13,0.214615,0.247482,336.700977,0.135714,0.000219
203103,203103,,1,11,12,1,11,12,0,0.000003,0,21106,22,0.00001,6,0.267735,0.343732,9.4,0.348485,0.000219
203104,203104,,1,12,13,1,12,13,0.000003,0.000059,0,21107,28,0.00001,13,0.167305,0.181907,10.461025,0.307692,0.000219
203105,203105,,4,8,12,4,8,12,0.000025,0.000117,0,21108,9,0.000011,14,0.174037,0.191176,68.005143,0.409091,0.000916
203106,203106,,0,9,9,0,9,9,0,0.000314,0,21109,2,0.00001,13,0.179407,0.195995,0,0.208333,0
203107,203107,,3,36,39,3,36,39,0.000103,0.004674,0,21110,25,0.000011,14,0.206673,0.234802,5128.329634,0.116734,0.000725
203108,203108,,3,88,91,3,88,91,0.000056,0.003972,0,21111,3,0.000011,14,0.205033,0.230712,3781.472757,0.146032,0.000703
203109,203109,,9,23,32,9,23,32,0.000482,0.003523,0,21112,30,0.000012,13,0.216969,0.240389,3466.362891,0.129032,0.002153
203110,203110,,0,28,28,0,28,28,0,0.00108,0,21113,52,0.00001,13,0.221619,0.246491,0,0.097884,0
203111,203111,,3,22,25,3,22,25,0.000095,0.001923,0,21114,52,0.000011,17,0.191485,0.215969,6237.680105,0.181667,0.00071
203113,203113,,11,10,21,11,10,21,0.000622,0.000132,0,21115,8,0.000017,16,0.18068,0.198625,1045.007381,0.288095,0.003122
203116,203116,,2,24,26,2,24,26,0.000054,0.003136,0,21117,2,0.000011,14,0.196224,0.225171,664.520152,0.155385,0.000445
9705167,9705167,,2,15,17,2,15,17,0.000062,0.011718,0,21116,2,0.000011,11,0.221473,0.257078,483.931799,0.1875,0.000451
203117,203117,,1,2,3,1,2,3,0,0,0,21118,23,0.000012,17,0.131426,0.143321,3980.984418,0.166667,0.000219
203118,203118,,3,5,8,3,5,8,0.000001,0.000034,0,21119,20,0.000016,15,0.15415,0.164889,5440.124251,0.267857,0.000677
203119,203119,,13,23,36,13,23,36,0.000477,0.001224,0,21120,8,0.00002,16,0.207749,0.231674,31013.524944,0.137302,0.003461
203120,203120,,3,11,14,3,11,14,0.00006,0.000414,0,21121,25,0.000011,14,0.181051,0.198488,3890.867328,0.142857,0.000709
203121,203121,,1,10,11,1,10,11,0.000026,0.000056,0,21122,30,0.00001,14,0.177356,0.190955,178.30597,0.4,0.000252
203122,203122,,1,1,2,1,1,2,0,0,29,21124,51,0.000014,1,1,1,0,0.5,0.000219
203114,203114,,2,0,2,2,0,2,0,0,29,21123,51,0.000027,0,0,0,0,0.5,0.000445
203123,203123,,3,13,16,3,13,16,0.000001,0.000024,0,21125,6,0.000012,19,0.16951,0.188016,26915.313484,0.175,0.000677
203125,203125,,9,18,27,9,18,27,0.000155,0.00228,0,21126,30,0.000014,13,0.216721,0.239807,2442.198267,0.226496,0.002152
203126,203126,,0,5,5,0,5,5,0,0.000003,0,21127,5,0.00001,13,0.110831,0.138221,0,0.4,0
203127,203127,,0,3,3,0,3,3,0,0.000008,0,21128,22,0.00001,18,0.1447,0.159729,0,0,0
203129,203129,,12,32,44,12,32,44,0.000755,0.001581,0,18990,0,0.000013,14,0.19842,0.226603,14632.044359,0.124736,0.004442
203130,203130,,2,9,11,2,9,11,0,0.000003,0,21130,6,0.000011,14,0.154056,0.168399,18182.604267,0.154545,0.000471
9812179,9812179,,2,1,3,2,1,3,0,0.000002,0,21129,6,0.000015,1,1,1,10,0.166667,0.000452
203131,203131,,1,18,19,1,18,19,0,0.000014,0,21131,6,0.00001,13,0.154866,0.169265,51.65019,0.172515,0.000219
203132,203132,,2,1,3,2,1,3,0.000006,0.000008,0,21132,5,0.000013,3,0.461538,0.527778,10.146794,0,0.000445
203135,203135,,1,11,12,1,11,12,0,0.000003,0,21133,6,0.000011,15,0.133874,0.147506,6223.480429,0.098485,0.000219
203136,203136,,2,10,12,2,10,12,0.00001,0.000139,0,20074,25,0.000011,16,0.186529,0.207322,758.353062,0.371212,0.000465
203137,203137,,7,19,26,7,19,26,0.000014,0.000172,0,21134,5,0.000015,15,0.170009,0.185147,5594.817121,0.223077,0.001613
203138,203138,,9,21,30,9,21,30,0.000325,0.00082,0,20053,0,0.000013,16,0.184062,0.207211,4254.003857,0.175862,0.002421
9809171,9809171,,2,6,8,2,6,8,0.00003,0.00018,0,7205,2,0.000012,11,0.177412,0.19578,79.551676,0.232143,0.000503
203139,203139,,1,12,13,1,12,13,0,0.000014,0,21135,6,0.00001,15,0.149898,0.17238,82.783903,0.173077,0.000219
203141,203141,,1,18,19,1,18,19,0.000013,0.000401,0,21136,30,0.00001,14,0.195743,0.214558,790.284156,0.140351,0.000232
203142,203142,,2,26,28,2,26,28,0.000047,0.001392,0,21137,25,0.00001,17,0.199466,0.221313,568.612797,0.170635,0.000478
203143,203143,,2,7,9,2,7,9,0.000048,0.000876,0,21138,22,0.000011,13,0.208325,0.227635,86.848579,0.263889,0.000451
203144,203144,,1,26,27,1,26,27,0.000016,0.001325,0,21140,13,0.00001,15,0.177648,0.212417,0,0.168091,0.000219
9709017,9709017,,2,45,47,2,45,47,0.000031,0.012419,0,21139,13,0.00001,13,0.208274,0.254911,499.195915,0.099907,0.000445
9608185,9608185,,2,16,18,2,16,18,0.000169,0.002517,0,5784,4,0.000011,12,0.186736,0.225183,127.569945,0.218954,0.000481
203145,203145,,2,5,7,2,5,7,0.000001,0.000319,0,21141,25,0.000012,14,0.186883,0.20518,3620.370483,0.119048,0.000445
203146,203146,,7,11,18,7,11,18,0.000459,0.001604,0,21142,13,0.000013,15,0.179177,0.202649,590.896693,0.25817,0.001744
203202,203202,,7,29,36,7,29,36,0.000452,0.008653,0,21143,13,0.000013,13,0.195175,0.22152,9858.025802,0.118254,0.001703
203147,203147,,8,38,46,8,38,46,0.001076,0.004914,0,20239,1,0.000013,16,0.207232,0.237853,43388.013497,0.083575,0.002102
203148,203148,,0,5,5,0,5,5,0,0.000001,0,21144,23,0.00001,18,0.122432,0.134321,0,0.1,0
203149,203149,,5,23,28,5,23,28,0.000037,0.000465,0,21145,2,0.000015,14,0.190662,0.214271,23335.481486,0.083333,0.001115
203150,203150,,0,1,1,0,1,1,0,0.000009,0,21146,1,0.00001,2,0.666667,0.75,0,0,0
203151,203151,,8,32,40,8,32,40,0.000199,0.003232,0,21147,30,0.000013,15,0.213601,0.238725,5220.329059,0.180128,0.001859
203155,203155,,1,15,16,1,15,16,0.000004,0.002379,0,21148,30,0.000011,16,0.197917,0.220444,2070.863728,0.241667,0.000226
203166,203166,,7,48,55,7,48,55,0.000229,0.003158,0,21149,30,0.000012,15,0.22146,0.248493,8208.40033,0.120202,0.001639
205210,205210,,5,21,26,5,21,26,0.000153,0.002606,0,21150,30,0.000011,16,0.196365,0.21777,511.772121,0.198462,0.001162
203152,203152,,0,8,8,0,8,8,0,0.000162,0,21151,1,0.00001,17,0.16263,0.180559,0,0.196429,0
203153,203153,,15,13,28,15,13,28,0.001523,0.002703,0,19235,41,0.000016,15,0.183881,0.206504,4107.899613,0.291005,0.006991
203154,203154,,4,17,21,4,17,21,0.000098,0.001897,0,21152,2,0.000012,14,0.173304,0.198988,682.679706,0.15,0.000909
203156,203156,,0,3,3,0,3,3,0,0.000024,0,21156,2,0.00001,14,0.156881,0.170604,0,0.166667,0
9511165,9511165,,2,1,3,2,1,3,0.000003,0,0,21154,2,0.000015,1,1,1,2,0.166667,0.000445
9805203,9805203,,1,6,7,1,6,7,0,0.000263,0,21155,2,0.000013,13,0.185874,0.209438,5487,0.047619,0.000219
9511094,9511094,,1,0,1,1,0,1,0,0,0,21153,2,0.000023,0,0,0,0,0,0.000232
203157,203157,,1,120,121,1,120,121,0.000338,0.033121,0,19112,0,0.00001,13,0.235752,0.277543,7349.653905,0.084848,0.000447
203158,203158,,0,6,6,0,6,6,0,0.000004,0,21157,22,0.00001,13,0.163818,0.189006,0,0.066667,0
203159,203159,,0,1,1,0,1,1,0,0,0,21158,4,0.00001,2,0.666667,0.75,0,0,0
203161,203161,,17,43,60,17,43,60,0.000935,0.000906,0,19110,52,0.000015,15,0.204427,0.230119,58541.25545,0.117514,0.004313
203162,203162,,3,12,15,3,12,15,0.000074,0.000203,0,21159,26,0.000012,18,0.176401,0.19338,4490.091158,0.271429,0.000684
203165,203165,,8,37,45,8,37,45,0.000209,0.002163,0,21160,30,0.000013,14,0.22318,0.247689,16296.608009,0.139394,0.001839
203167,203167,,4,5,9,4,5,9,0.000407,0.015014,0,21161,41,0.000016,15,0.168628,0.191031,377.815059,0.347222,0.00091
203169,203169,,3,4,7,3,4,7,0,0.000002,0,21162,6,0.000014,8,0.192394,0.256631,44.5,0.214286,0.000658
203170,203170,,0,4,4,0,4,4,0,0.000042,0,21163,25,0.00001,16,0.144009,0.159164,0,0,0
203171,203171,,0,1,1,0,1,1,0,0,0,21164,2,0.00001,1,1,1,0,0,0
203172,203172,,0,13,13,0,13,13,0,0.000702,0,21165,1,0.00001,20,0.161207,0.189355,0,0.064103,0
9307092,9307092,,4,3,7,4,3,7,0.000012,0.000012,0,5722,1,0.000023,1,1,1,10274.317127,0.02381,0.000936
203173,203173,,5,33,38,5,33,38,0.00028,0.002136,0,20045,52,0.000011,17,0.194295,0.223598,5313.81044,0.167141,0.001254
203175,203175,,9,14,23,9,14,23,0.000396,0.000174,0,19347,3,0.000013,15,0.183387,0.199356,4828.408848,0.247036,0.002466
203176,203176,,0,24,24,0,24,24,0,0.002437,0,21166,30,0.00001,13,0.218259,0.244868,0,0.177536,0
203178,203178,,0,1,1,0,1,1,0,0,0,21168,23,0.00001,7,0.2112,0.231512,0,0,0
9910240,9910240,,1,2,3,1,2,3,0,0.001029,0,21167,23,0.000019,6,0.26572,0.301399,131,0,0.000219
203179,203179,,3,10,13,3,10,13,0.000024,0.000443,0,21169,0,0.000011,17,0.179454,0.199315,8.868809,0.320513,0.000671
203181,203181,,3,10,13,3,10,13,0.000668,0.000121,0,21170,25,0.00001,15,0.182377,0.202278,843.426358,0.237179,0.000723
203182,203182,,6,4,10,6,4,10,0.000002,0.000011,0,21171,15,0.000017,3,0.615385,0.729167,22.970238,0.122222,0.001394
203183,203183,,0,4,4,0,4,4,0,0.000036,0,21172,52,0.00001,16,0.166943,0.180421,0,0.083333,0
203184,203184,,1,8,9,1,8,9,0.000007,0.000471,0,21173,4,0.00001,16,0.186339,0.20877,96.258982,0.305556,0.000232
203185,203185,,1,16,17,1,16,17,0.000041,0.000709,0,18802,3,0.000011,15,0.183815,0.202444,787.452965,0.264706,0.001122
205147,205147,,29,34,63,29,34,63,0.000766,0.002713,0,20007,0,0.00002,15,0.196998,0.225497,13274.21148,0.220686,0.008441
205074,205074,,30,55,85,30,55,85,0.000827,0.004225,0,20006,0,0.000019,14,0.205365,0.235889,14912.964233,0.169608,0.008843
203188,203188,,11,35,46,11,35,46,0.000197,0.001403,0,19361,3,0.000013,15,0.192129,0.213062,4345.489979,0.245894,0.002876
203204,203204,,7,24,31,7,24,31,0.000121,0.00036,0,19362,3,0.000012,16,0.184087,0.202825,187.477787,0.290323,0.001866
203190,203190,,8,30,38,8,30,38,0.000405,0.003158,0,19085,0,0.000014,15,0.201997,0.229114,72155.582659,0.110953,0.00206
203192,203192,,0,3,3,0,3,3,0,0.000029,0,21174,4,0.00001,14,0.152796,0.164051,0,0.166667,0
203193,203193,,8,10,18,8,10,18,0.000348,0.000143,0,21175,0,0.000013,14,0.179763,0.199117,2669.401195,0.326797,0.002026
203194,203194,,4,5,9,4,5,9,0.000002,0.000004,0,21176,15,0.000012,17,0.166705,0.185513,1443.295345,0.305556,0.000916
203195,203195,,0,3,3,0,3,3,0,0,0,21181,26,0.00001,4,0.5,0.608333,0,0.166667,0
9804091,9804091,,6,1,7,6,1,7,0.000012,0.000001,0,8268,26,0.000027,2,0.666667,0.75,5.583333,0.119048,0.001389
9906184,9906184,,1,1,2,1,1,2,0,0,0,21180,26,0.000013,3,0.5,0.611111,3,0,0.000219
9810003,9810003,,1,1,2,1,1,2,0,0,0,21179,26,0.000021,2,0.666667,0.75,4,0,0.000226
203196,203196,,0,2,2,0,2,2,0,0.000065,0,21182,1,0.00001,18,0.170898,0.185795,0,0,0
203197,203197,,1,5,6,1,5,6,0,0,0,21184,23,0.00001,14,0.145775,0.155105,125.440368,0.133333,0.000219
9802115,9802115,,3,2,5,3,2,5,0,0,0,21183,23,0.000016,2,0.75,0.833333,9,0.1,0.000664
203198,203198,,21,11,32,21,11,32,0.001085,0.000139,0,21185,8,0.000023,16,0.191633,0.208733,8086.873926,0.272177,0.005501
203199,203199,,2,14,16,2,14,16,0.000048,0.001658,0,21186,30,0.000011,16,0.203744,0.224707,1953.832995,0.191667,0.000451
203200,203200,,1,8,9,1,8,9,0,0.00001,0,21187,23,0.000011,18,0.137839,0.158804,29.907576,0.097222,0.000219
203203,203203,,8,46,54,8,46,54,0.001628,0.022749,0,21188,1,0.000012,13,0.207536,0.237102,9092.176853,0.150594,0.001913
203205,203205,,5,13,18,5,13,18,0.000117,0.001719,0,21189,25,0.000013,16,0.181486,0.20399,9463.334475,0.183007,0.001209
203207,203207,,2,11,13,2,11,13,0.00001,0.000219,0,21190,9,0.00001,15,0.168364,0.188112,4289.962911,0.269231,0.000445
203209,203209,,0,7,7,0,7,7,0,0.000023,0,21191,17,0.00001,8,0.202723,0.231461,0,0.309524,0
203210,203210,,0,4,4,0,4,4,0,0.000411,0,21192,8,0.00001,18,0.164487,0.179485,0,0.416667,0
203212,203212,,1,14,15,1,14,15,0,0,0,21193,22,0.000011,9,0.180505,0.231312,26.890873,0.247619,0.000219
203213,203213,,3,14,17,3,14,17,0.00002,0.000463,0,21194,0,0.000014,15,0.196194,0.221777,26289.53823,0.121324,0.000664
203215,203215,,1,14,15,1,14,15,0,0.006561,0,21197,23,0.000011,14,0.18609,0.208504,5827.18312,0.147619,0.000219
9309126,9309126,,1,0,1,1,0,1,0.000077,0,0,21196,23,0.000011,0,0,0,0,0,0.000226
9901074,9901074,,2,2,4,2,2,4,0.000077,0.006006,0,21195,23,0.000012,15,0.171712,0.190979,1014.924488,0.333333,0.000445
203216,203216,,0,16,16,0,16,16,0,0.002887,0,21198,2,0.00001,18,0.21052,0.237155,0,0.1125,0
203217,203217,,13,19,32,13,19,32,0.000548,0.002134,0,20014,10,0.000014,16,0.189304,0.21289,4559.897613,0.095766,0.003126
203218,203218,,3,19,22,3,19,22,0.0001,0.002412,0,21199,3,0.000011,16,0.195289,0.218721,3606.18134,0.188312,0.000671
203221,203221,,2,3,5,2,3,5,0.000244,0.000291,0,21201,25,0.000012,13,0.177559,0.192757,1522.916272,0.1,0.000438
111196,111196,,3,0,3,3,0,3,0.000005,0,0,21200,25,0.000017,0,0,0,0,0.166667,0.000677
203222,203222,,1,43,44,1,43,44,0.000033,0.003558,0,21203,2,0.00001,16,0.211484,0.239263,1388.308366,0.128964,0.000219
9611052,9611052,,2,7,9,2,7,9,0.000075,0.002806,0,21202,13,0.00001,12,0.202543,0.235957,22.322026,0.208333,0.000445
203223,203223,,1,8,9,1,8,9,0.000033,0.005672,0,21204,2,0.00001,14,0.190411,0.217238,29.974416,0.277778,0.000239
203224,203224,,0,8,8,0,8,8,0,0.001321,0,21205,25,0.00001,15,0.185314,0.204574,0,0.178571,0
203226,203226,,0,1,1,0,1,1,0,0,30,21207,53,0.00001,1,1,1,0,0,0
9612107,9612107,,1,0,1,1,0,1,0,0,30,21206,53,0.000019,0,0,0,0,0,0.000219
203228,203228,,0,12,12,0,12,12,0,0.000042,0,21211,22,0.00001,7,0.302405,0.380452,0,0.189394,0
9606059,9606059,,2,4,6,2,4,6,0.000001,0.000005,0,21209,22,0.000012,7,0.287599,0.34917,37.2,0.433333,0.000445
9705097,9705097,,1,7,8,1,7,8,0,0.000004,0,21210,22,0.000011,8,0.247191,0.319383,0.983333,0.285714,0.000219
9710071,9710071,,1,1,2,1,1,2,0,0.000025,0,21208,22,0.000011,5,0.287554,0.334328,0,0.5,0.000219
203231,203231,,71,29,100,71,29,100,0.007282,0.021558,0,19251,41,0.000043,14,0.212966,0.244004,34866.527747,0.191717,0.027146
203232,203232,,1,5,6,1,5,6,0.000183,0.00572,0,21212,41,0.000011,15,0.165584,0.186363,0.75,0.4,0.000226
203233,203233,,0,34,34,0,34,34,0,0.022497,0,21213,1,0.00001,16,0.204082,0.232168,0,0.254011,0
203234,203234,,0,10,10,0,10,10,0,0.000012,0,21214,2,0.00001,14,0.162966,0.184338,0,0.266667,0
203236,203236,,5,23,28,5,23,28,0.00048,0.017828,0,21215,4,0.000012,14,0.214856,0.249706,8135.673706,0.169312,0.001202
203237,203237,,6,40,46,6,40,46,0.000185,0.001421,0,20027,4,0.000011,16,0.193319,0.222157,1664.176212,0.184541,0.001844
203238,203238,,3,13,16,3,13,16,0.000081,0.000647,0,21216,2,0.000011,14,0.173284,0.196367,360.597117,0.158333,0.000697
203239,203239,,0,25,25,0,25,25,0,0.019687,0,21217,2,0.00001,14,0.20345,0.225792,0,0.123333,0
203240,203240,,0,4,4,0,4,4,0,0.00002,0,21218,22,0.00001,2,0.625,0.7,0,0.166667,0
203241,203241,,6,17,23,6,17,23,0.000376,0.001021,0,21219,9,0.000012,12,0.194769,0.216787,3427.67533,0.120553,0.00139
203242,203242,,1,14,15,1,14,15,0.000001,0.000059,0,21220,52,0.00001,15,0.181788,0.199571,310.461197,0.157143,0.000219
203243,203243,,7,49,56,7,49,56,0.000198,0.002978,0,19149,3,0.000012,15,0.217533,0.251938,21584.505511,0.106494,0.002307
204079,204079,,12,65,77,12,65,77,0.001289,0.003152,0,19301,3,0.000012,14,0.224496,0.257544,83581.851196,0.085099,0.003467
204061,204061,,10,35,45,10,35,45,0.000387,0.001758,0,19300,10,0.000013,15,0.205207,0.233956,27658.333178,0.123737,0.002572
203244,203244,,0,11,11,0,11,11,0,0.017465,0,21221,8,0.00001,14,0.186666,0.209971,0,0.245455,0
203245,203245,,2,21,23,2,21,23,0.00002,0.000174,0,21222,22,0.000011,15,0.182774,0.199095,1364.21602,0.126482,0.000465
203246,203246,,3,17,20,3,17,20,0.000007,0.000101,0,21223,0,0.000012,19,0.166985,0.18632,420.625659,0.160526,0.00069
203247,203247,,6,40,46,6,40,46,0.000459,0.002086,0,20023,0,0.000011,14,0.209848,0.239208,12348.377109,0.190821,0.002072
203250,203250,,0,20,20,0,20,20,0,0.000217,0,21224,5,0.00001,15,0.157897,0.172368,0,0.152632,0
203251,203251,,2,18,20,2,18,20,0.000044,0.001287,0,21225,22,0.000011,17,0.209657,0.23084,843.798633,0.097368,0.000438
203252,203252,,1,7,8,1,7,8,0,0.00002,0,21226,22,0.000011,17,0.143663,0.157028,898.12256,0.25,0.000219
203253,203253,,1,7,8,1,7,8,0,0.000002,0,21231,23,0.000013,18,0.109326,0.128952,91.990804,0.053571,0.000226
9611183,9611183,,1,1,2,1,1,2,0,0,0,21230,23,0.000011,2,0.666667,0.75,6,0,0.000226
9811238,9811238,,1,1,2,1,1,2,0,0,0,21228,23,0.000011,1,1,1,0,0.5,0.000226
9911056,9911056,,1,2,3,1,2,3,0,0,0,21227,23,0.000011,18,0.109156,0.123823,217.75,0.166667,0.000226
9601172,9601172,,1,1,2,1,1,2,0,0,0,21229,23,0.00002,1,1,1,4,0,0.000226
9403120,9403120,,1,0,1,1,0,1,0,0,0,18138,23,0.000015,0,0,0,0,0,0.000232
203254,203254,,0,3,3,0,3,3,0,0.000927,0,21232,25,0.00001,16,0.175145,0.193587,0,0.333333,0
203256,203256,,11,6,17,11,6,17,0.000508,0.000258,0,19053,10,0.000014,15,0.187227,0.208531,13269.549367,0.194853,0.003238
203248,203248,,24,0,24,24,0,24,0.002293,0,0,19249,41,0.000024,0,0,0,0,0.123188,0.008892
203259,203259,,6,23,29,6,23,29,0.00014,0.000071,0,21233,30,0.000012,13,0.196446,0.214279,3938.304536,0.139163,0.001361
203261,203261,,1,13,14,1,13,14,0,0.000017,0,21234,22,0.000012,15,0.159398,0.171832,5533.645775,0.137363,0.000219
203263,203263,,1,7,8,1,7,8,0,0.000004,0,21235,6,0.000012,15,0.157299,0.169745,10075.222869,0.25,0.000219
203264,203264,,10,8,18,10,8,18,0.000498,0.000078,0,21236,30,0.000016,14,0.188436,0.203573,6454.767673,0.140523,0.002389
203266,203266,,2,37,39,2,37,39,0.000067,0.001914,0,21237,52,0.00001,17,0.196785,0.229071,2793.335723,0.168691,0.000472
203267,203267,,10,54,64,10,54,64,0.000243,0.005391,0,20019,0,0.000013,15,0.221675,0.2521,36079.964089,0.084325,0.002733
203269,203269,,3,27,30,3,27,30,0.000185,0.001407,0,21238,30,0.00001,13,0.221195,0.245159,393.266824,0.214943,0.000684
203270,203270,,1,12,13,1,12,13,0.000061,0.004135,0,21239,4,0.00001,13,0.197077,0.223407,513.336718,0.294872,0.000219
203271,203271,,2,19,21,2,19,21,0.000012,0.000616,0,20075,25,0.000011,15,0.185335,0.20607,11872.228149,0.140476,0.000486
203272,203272,,6,62,68,6,62,68,0.000608,0.003357,0,20086,10,0.000012,15,0.210561,0.242016,12392.394861,0.088674,0.001421
203273,203273,,1,4,5,1,4,5,0,0.000022,0,21240,23,0.000011,18,0.153403,0.164775,10723.827424,0.1,0.000239
203274,203274,,7,11,18,7,11,18,0.000453,0.003144,0,19222,25,0.000013,15,0.189362,0.21242,2765.240102,0.22549,0.00185
203276,203276,,5,18,23,5,18,23,0.000223,0.00293,0,21241,25,0.000012,13,0.193246,0.214538,4379.41258,0.217391,0.001168
203277,203277,,3,25,28,3,25,28,0.000125,0.002818,0,21242,30,0.000011,16,0.189145,0.217833,11981.832272,0.112434,0.000717
204002,204002,,27,36,63,27,36,63,0.003165,0.011051,0,19279,41,0.00002,14,0.213867,0.245016,24210.832482,0.25704,0.010226
9401098,9401098,,6,12,18,6,12,18,0.000743,0.000676,0,19225,13,0.000013,4,0.369458,0.461111,641.014662,0.091503,0.002141
204005,204005,,1,9,10,1,9,10,0.000001,0.000377,0,21243,0,0.000011,19,0.184402,0.211366,897.770057,0.044444,0.000226
204006,204006,,0,1,1,0,1,1,0,0,0,21245,22,0.00001,1,1,1,0,0,0
203067,203067,,4,0,4,4,0,4,0.000001,0,0,21244,22,0.000041,0,0,0,0,0,0.000916
204009,204009,,2,28,30,2,28,30,0.000268,0.001524,0,21246,10,0.00001,16,0.200174,0.228014,1373.16455,0.133333,0.000445
204011,204011,,0,8,8,0,8,8,0,0.000068,0,21247,13,0.00001,17,0.131067,0.148511,0,0.142857,0
204013,204013,,3,20,23,3,20,23,0.00008,0.00226,0,21248,30,0.000011,14,0.192702,0.218586,190.459499,0.227273,0.000664
204015,204015,,3,13,16,3,13,16,0.000012,0.000004,0,21249,23,0.000011,14,0.162118,0.174236,2.196825,0.366667,0.000684
204016,204016,,0,3,3,0,3,3,0,0.000005,0,21250,28,0.00001,15,0.145585,0.160486,0,0.166667,0
204017,204017,,0,21,21,0,21,21,0,0.001121,0,21251,0,0.00001,14,0.186554,0.212585,0,0.116667,0
204018,204018,,0,3,3,0,3,3,0,0,0,21252,23,0.00001,3,0.55,0.621212,0,0.5,0
204019,204019,,0,1,1,0,1,1,0,0,0,21253,52,0.00001,2,0.6,0.666667,0,0,0
204020,204020,,0,11,11,0,11,11,0,0.000111,0,21254,30,0.00001,19,0.176678,0.192464,0,0.127273,0
204021,204021,,0,5,5,0,5,5,0,0.000506,0,21255,8,0.00001,12,0.187862,0.20473,0,0.15,0
204023,204023,,4,42,46,4,42,46,0.000682,0.019432,0,20041,4,0.000011,16,0.209187,0.240856,6365.610388,0.141063,0.00098
204024,204024,,1,7,8,1,7,8,0,0.000001,0,21256,28,0.000011,2,0.818182,0.888889,5.333333,0.178571,0.000226
204025,204025,,53,21,74,53,21,74,0.005903,0.003132,0,19272,41,0.000028,15,0.199274,0.223795,12425.175996,0.165309,0.019109
204026,204026,,42,27,69,42,27,69,0.005945,0.005054,0,19271,41,0.000029,13,0.214091,0.244005,21391.116953,0.264493,0.016653
204028,204028,,0,5,5,0,5,5,0,0.000009,0,21257,26,0.00001,6,0.265092,0.332013,0,0.15,0
204029,204029,,2,18,20,2,18,20,0.000043,0.00446,0,21258,1,0.000011,15,0.218554,0.25205,3770.776694,0.089474,0.000465
204031,204031,,5,19,24,5,19,24,0.00004,0.000548,0,19371,3,0.000012,15,0.178222,0.194574,27.251733,0.34058,0.001294
204032,204032,,4,23,27,4,23,27,0.000062,0.000965,0,21259,30,0.000013,15,0.212271,0.235335,16202.873442,0.297721,0.001015
204033,204033,,50,34,84,50,34,84,0.005011,0.005445,0,19270,41,0.000032,14,0.216701,0.242872,220438.615291,0.180293,0.01735
204034,204034,,1,8,9,1,8,9,0.000051,0.001089,0,21260,1,0.00001,14,0.166101,0.184641,175.664729,0.027778,0.000232
204035,204035,,0,5,5,0,5,5,0,0.000082,0,21261,23,0.00001,18,0.186892,0.218405,0,0.15,0
204036,204036,,0,2,2,0,2,2,0,0,0,21262,23,0.00001,2,0.583333,0.642857,0,0.5,0
204038,204038,,1,23,24,1,23,24,0.000136,0.01827,0,21263,8,0.00001,15,0.186001,0.211378,157.386609,0.117754,0.000219
204039,204039,,1,17,18,1,17,18,0.000001,0.000073,0,21264,4,0.000011,16,0.166761,0.191585,39.115083,0.228758,0.000219
204040,204040,,0,4,4,0,4,4,0,0,0,21265,23,0.00001,15,0.117897,0.126679,0,0.083333,0
9503171,9503171,,1,0,1,1,0,1,0,0,0,7223,23,0.000019,0,0,0,0,0,0.000233
9601157,9601157,,1,1,2,1,1,2,0,0,0,7222,23,0.000019,1,1,1,1,0,0.000233
204041,204041,,5,27,32,5,27,32,0.000068,0.001968,0,21266,0,0.000013,13,0.186797,0.206622,8891.017412,0.177419,0.001142
204042,204042,,3,8,11,3,8,11,0.000286,0.000179,0,21267,25,0.000011,16,0.166386,0.183711,11349.468213,0.118182,0.000664
204043,204043,,2,21,23,2,21,23,0.000348,0.011772,0,21268,1,0.000012,16,0.222189,0.25467,876.271633,0.152174,0.000465
204045,204045,,6,14,20,6,14,20,0.00111,0.011032,0,21269,1,0.000015,17,0.223056,0.253534,2439.071085,0.168421,0.001723
204046,204046,,1,7,8,1,7,8,0,0.000001,0,21270,26,0.000012,13,0.129715,0.144655,251.881587,0.160714,0.000219
9803237,9803237,,6,12,18,6,12,18,0.000057,0.00001,0,7593,26,0.000015,8,0.218324,0.328699,74137.719816,0.062092,0.001383
9312138,9312138,,1,0,1,1,0,1,0,0,0,7592,26,0.000011,0,0,0,0,0,0.000259
9801018,9801018,,6,4,10,6,4,10,0.000001,0,0,7590,26,0.000016,8,0.204453,0.273904,1697.206494,0.3,0.001388
9802036,9802036,,3,2,5,3,2,5,0,0,0,7584,26,0.000012,4,0.411765,0.547619,16427.094156,0.45,0.000711
204047,204047,,9,33,42,9,33,42,0.000141,0.020874,0,21271,25,0.000016,14,0.197084,0.225173,14269.265801,0.134146,0.002304
204050,204050,,1,16,17,1,16,17,0.000036,0.002398,0,21272,4,0.000011,14,0.20867,0.232766,1679.745768,0.231618,0.000219
204052,204052,,0,11,11,0,11,11,0,0.000561,0,21273,2,0.00001,16,0.168664,0.188427,0,0.2,0
204053,204053,,3,5,8,3,5,8,0,0.000008,0,21274,23,0.000016,16,0.135776,0.147996,6906.192121,0.107143,0.00067
9702057,9702057,,5,1,6,5,1,6,0.000525,0.000027,0,8121,1,0.000016,14,0.143075,0.156981,0,0.2,0.001817
204055,204055,,0,26,26,0,26,26,0,0.00097,0,21275,30,0.00001,14,0.203378,0.226189,0,0.172308,0
204056,204056,,2,5,7,2,5,7,0.000495,0.007675,0,21276,1,0.000011,17,0.212543,0.242918,341.403707,0.428571,0.000478
204057,204057,,0,16,16,0,16,16,0,0.000277,0,21277,23,0.00001,16,0.180271,0.204887,0,0.091667,0
204058,204058,,7,19,26,7,19,26,0.001344,0.004598,0,19218,8,0.000011,13,0.205911,0.236311,5712.575919,0.275385,0.001807
204059,204059,,0,4,4,0,4,4,0,0.001798,0,21278,41,0.00001,13,0.218535,0.249899,0,0.166667,0
204060,204060,,0,1,1,0,1,1,0,0.000005,0,21279,8,0.00001,13,0.148086,0.159814,0,0,0
204062,204062,,16,7,23,16,7,23,0.00046,0.000156,0,21280,2,0.000018,18,0.190414,0.209517,2434.937649,0.213439,0.004099
204063,204063,,0,9,9,0,9,9,0,0.000016,0,21282,26,0.00001,16,0.143123,0.155528,0,0.236111,0
9907159,9907159,,3,8,11,3,8,11,0.000001,0.000049,0,21281,26,0.000014,15,0.161962,0.17592,12714.969328,0.163636,0.000658
204064,204064,,6,18,24,6,18,24,0.000321,0.000536,0,20085,10,0.000012,14,0.194935,0.217383,928.867497,0.280797,0.001401
204067,204067,,0,7,7,0,7,7,0,0.000005,0,21283,28,0.00001,15,0.134728,0.155121,0,0.261905,0
204068,204068,,5,11,16,5,11,16,0.000009,0.000004,0,21284,17,0.000013,13,0.150437,0.179727,29.191735,0.2875,0.001168
204069,204069,,1,1,2,1,1,2,0.000164,0,0,21285,8,0.00001,1,1,1,1.5,0,0.000226
204072,204072,,0,7,7,0,7,7,0,0.000007,0,21286,6,0.00001,16,0.157938,0.172841,0,0.214286,0
204073,204073,,0,5,5,0,5,5,0,0.000012,0,21287,28,0.00001,15,0.146033,0.162834,0,0.25,0
204074,204074,,24,21,45,24,21,45,0.000956,0.00159,0,18900,3,0.000025,15,0.197657,0.220842,31337.9723,0.178788,0.008613
204075,204075,,0,9,9,0,9,9,0,0.000224,0,21288,4,0.00001,15,0.170406,0.190552,0,0.138889,0
204076,204076,,2,9,11,2,9,11,0,0.000003,0,21289,6,0.000012,16,0.129206,0.141127,1260.430551,0.181818,0.000451
204077,204077,,0,3,3,0,3,3,0,0.000948,0,21290,25,0.00001,18,0.182977,0.201929,0,0.166667,0
204078,204078,,3,11,14,3,11,14,0.000101,0.000669,0,21291,30,0.000011,16,0.19099,0.213929,570.246949,0.285714,0.000757
204080,204080,,7,28,35,7,28,35,0.000192,0.002831,0,21292,0,0.000013,16,0.180219,0.211958,3994.250607,0.140336,0.00158
204081,204081,,2,10,12,2,10,12,0.000256,0.01651,0,21293,1,0.00001,12,0.196938,0.217451,224.111891,0.265152,0.000502
204082,204082,,1,12,13,1,12,13,0,0,0,21294,23,0.000011,18,0.133116,0.148603,204.375623,0.147436,0.000219
204085,204085,,4,21,25,4,21,25,0.000231,0.000473,0,21295,52,0.000012,18,0.190932,0.214146,1899.24975,0.14,0.000967
204086,204086,,1,13,14,1,13,14,0,0.000004,0,21296,23,0.000011,16,0.132832,0.145679,4296.569009,0.263736,0.000233
204087,204087,,1,9,10,1,9,10,0,0.000032,0,21299,23,0.00001,16,0.125524,0.145289,284.133311,0.188889,0.000226
9905167,9905167,,1,8,9,1,8,9,0,0.000014,0,21298,23,0.000011,14,0.147452,0.185679,98.403425,0.097222,0.000226
9512033,9512033,,2,0,2,2,0,2,0,0,0,14911,23,0.000021,0,0,0,0,0.5,0.000458
9606024,9606024,,2,2,4,2,2,4,0,0,0,14913,23,0.000021,3,0.571429,0.708333,34,0.083333,0.000452
9903135,9903135,,3,5,8,3,5,8,0,0.000001,0,21297,23,0.000014,13,0.158982,0.179547,1253.633888,0.125,0.000671
204088,204088,,2,15,17,2,15,17,0,0.000003,0,21300,6,0.000011,15,0.134695,0.146019,11960.791447,0.205882,0.000451
204089,204089,,32,245,277,32,245,277,0.001549,0.028757,0,19134,0,0.000022,14,0.237319,0.284742,542141.963129,0.044904,0.008479
9511178,9511178,,1,31,32,1,31,32,0.000338,0.011859,0,19065,0,0.00001,10,0.246525,0.301069,3995.31859,0.085685,0.000447
9702098,9702098,,2,41,43,2,41,43,0.000398,0.015605,0,4651,0,0.000011,13,0.220275,0.269546,2008.777132,0.139535,0.000708
9702189,9702189,,1,29,30,1,29,30,0.000338,0.01009,0,19064,0,0.00001,11,0.22419,0.261317,29.063972,0.229885,0.000447
9711198,9711198,,1,1,2,1,1,2,0.000175,0,0,6881,0,0.00001,1,1,1,8958,0,0.000245
204090,204090,,1,20,21,1,20,21,0.000001,0.000004,0,21301,6,0.00001,14,0.167502,0.181434,292.327648,0.114286,0.000219
204119,204119,,1,9,10,1,9,10,0.000024,0.000669,0,19063,3,0.00001,13,0.198995,0.219883,372.641489,0.111111,0.0005
205209,205209,,19,39,58,19,39,58,0.001654,0.002968,0,19223,3,0.000016,14,0.214311,0.241473,80692.463798,0.087114,0.005334
205198,205198,,20,19,39,20,19,39,0.001028,0.001921,0,19144,3,0.000019,15,0.208578,0.232927,13954.407775,0.177463,0.006117
206175,206175,,12,64,76,12,64,76,0.000796,0.014578,0,19321,1,0.000015,15,0.215163,0.246667,131639.987724,0.075088,0.003412
204092,204092,,1,6,7,1,6,7,0,0.000016,0,21302,23,0.000011,16,0.142749,0.16113,385.106517,0.142857,0.000219
204093,204093,,0,29,29,0,29,29,0,0.002626,0,21303,13,0.00001,17,0.201863,0.231933,0,0.165025,0
204094,204094,,0,13,13,0,13,13,0,0.0007,0,21304,0,0.00001,17,0.172285,0.195856,0,0.185897,0
204096,204096,,2,13,15,2,13,15,0.000011,0.00021,0,21305,30,0.000011,14,0.189924,0.205556,125.840123,0.342857,0.000445
204097,204097,,2,10,12,2,10,12,0,0.000036,0,21306,6,0.000013,14,0.159393,0.180498,9233.622807,0.212121,0.000445
204099,204099,,12,4,16,12,4,16,0.000475,0.00003,0,21307,0,0.000017,13,0.181415,0.197777,2025.946003,0.254167,0.002938
204100,204100,,3,12,15,3,12,15,0.000003,0.000048,0,21308,0,0.000013,15,0.162001,0.181804,683.954625,0.209524,0.000664
204101,204101,,0,15,15,0,15,15,0,0.005006,0,21309,13,0.00001,12,0.19574,0.218133,0,0.128571,0
204102,204102,,2,17,19,2,17,19,0.00008,0.002774,0,21310,30,0.00001,13,0.219624,0.242212,1082.891627,0.207602,0.000452
204103,204103,,9,46,55,9,46,55,0.000257,0.007407,0,21311,2,0.000015,18,0.231017,0.264503,34188.612149,0.093266,0.00221
204104,204104,,0,3,3,0,3,3,0,0.000001,0,21312,1,0.00001,17,0.139339,0.148921,0,0.166667,0
204105,204105,,2,8,10,2,8,10,0.000001,0.000037,0,21314,23,0.000012,19,0.136913,0.157223,708.5221,0.177778,0.000445
106090,106090,,4,0,4,4,0,4,0.000017,0,0,21313,23,0.000015,0,0,0,0,0.25,0.000896
204106,204106,,0,4,4,0,4,4,0,0.000009,0,21315,25,0.00001,13,0.160309,0.185313,0,0.166667,0
204107,204107,,3,6,9,3,6,9,0.000242,0.000451,0,21317,8,0.000012,14,0.185782,0.202978,1086.12762,0.180556,0.000713
9907002,9907002,,1,9,10,1,9,10,0.000005,0.004103,0,21316,13,0.000012,12,0.198961,0.229923,202.778605,0.077778,0.000239
204109,204109,,2,14,16,2,14,16,0.00005,0.002392,0,21318,30,0.00001,14,0.213938,0.236679,956.881202,0.229167,0.000472
204110,204110,,14,15,29,14,15,29,0.00051,0.000164,0,21319,8,0.000018,13,0.196406,0.213088,13939.813739,0.210591,0.003614
204111,204111,,0,8,8,0,8,8,0,0.000035,0,21321,22,0.00001,18,0.161065,0.177563,0,0.125,0
9412180,9412180,,6,6,12,6,6,12,0.000001,0.000001,0,1773,22,0.00003,3,0.625,0.766667,72892.142338,0.060606,0.001389
9812103,9812103,,2,5,7,2,5,7,0.000001,0.000001,0,21320,22,0.000012,4,0.482759,0.619048,4,0.238095,0.000445
9403127,9403127,,2,1,3,2,1,3,0,0,0,1768,22,0.000017,2,0.6,0.666667,20715.330945,0.166667,0.000478
204112,204112,,7,58,65,7,58,65,0.00095,0.020288,0,19217,8,0.000012,13,0.225922,0.258048,25517.791046,0.176442,0.001815
204113,204113,,6,15,21,6,15,21,0.00032,0.016531,0,21322,25,0.000014,16,0.182125,0.20468,4786.084787,0.192857,0.001367
204114,204114,,5,9,14,5,9,14,0.000032,0.000011,0,21323,23,0.000014,14,0.17203,0.186561,625.869897,0.263736,0.001135
204115,204115,,0,16,16,0,16,16,0,0.000986,0,21324,9,0.00001,12,0.194567,0.216366,0,0.179167,0
204116,204116,,1,4,5,1,4,5,0,0,0,21325,26,0.000014,3,0.615385,0.729167,4.266667,0.3,0.000219
204118,204118,,0,1,1,0,1,1,0,0,0,21326,22,0.00001,17,0.138815,0.146279,0,0,0
204120,204120,,6,26,32,6,26,32,0.000378,0.002598,0,19221,3,0.000012,13,0.210029,0.235307,9772.193364,0.139113,0.001596
204121,204121,,9,7,16,9,7,16,0.000286,0.00007,0,21327,2,0.000014,19,0.154325,0.168041,10503.656313,0.266667,0.002147
204122,204122,,3,21,24,3,21,24,0.00014,0.007476,0,21329,25,0.000012,15,0.189901,0.210071,4388.176301,0.141304,0.000678
9707024,9707024,,2,2,4,2,2,4,0.000088,0.000001,0,21328,22,0.000019,1,1,1,36.401429,0.083333,0.000471
204123,204123,,1,12,13,1,12,13,0.000001,0.010859,0,21330,1,0.000012,16,0.170657,0.196438,11512.615546,0.237179,0.000239
204124,204124,,4,14,18,4,14,18,0.000504,0.000173,0,21331,4,0.000011,15,0.162415,0.179557,1333.626924,0.19281,0.000943
9402010,9402010,,7,3,10,7,3,10,0.000046,0.000021,0,14856,1,0.00003,2,0.8,0.875,456.821014,0.1,0.00164
9604162,9604162,,1,6,7,1,6,7,0.000045,0.000068,0,14855,4,0.00001,10,0.182463,0.207034,10.867658,0.261905,0.000273
204125,204125,,1,3,4,1,3,4,0.000001,0.000092,0,21332,4,0.000012,17,0.151968,0.166718,0,0.333333,0.000219
204127,204127,,0,24,24,0,24,24,0,0.005186,0,21333,4,0.00001,14,0.192082,0.222208,0,0.20471,0
204128,204128,,0,21,21,0,21,21,0,0.000151,0,21334,0,0.00001,14,0.193894,0.214119,0,0.147619,0
204129,204129,,15,13,28,15,13,28,0.000948,0.000212,0,21335,8,0.000017,14,0.192076,0.209679,12901.829222,0.277778,0.003896
204130,204130,,0,3,3,0,3,3,0,0,0,21336,22,0.00001,7,0.217868,0.249829,0,0.166667,0
204132,204132,,5,5,10,5,5,10,0.00003,0.000007,0,21337,0,0.000015,14,0.162195,0.174956,105.050642,0.377778,0.001188
204133,204133,,1,1,2,1,1,2,0,0.000001,0,21339,41,0.000011,4,0.368421,0.416667,0,0.5,0.000219
9811075,9811075,,3,4,7,3,4,7,0.000047,0.000006,0,21338,41,0.000021,3,0.541667,0.628205,94.527723,0.119048,0.000697
204136,204136,,2,21,23,2,21,23,0.000041,0.002562,0,21340,25,0.000011,14,0.20741,0.232085,12137.121818,0.199605,0.000524
204137,204137,,6,17,23,6,17,23,0.000094,0.001754,0,21341,8,0.000013,16,0.179317,0.199766,13971.827126,0.118577,0.001393
204139,204139,,0,3,3,0,3,3,0,0.000002,0,21344,22,0.00001,15,0.118608,0.128961,0,0.333333,0
9403020,9403020,,2,0,2,2,0,2,0,0,0,21342,22,0.000019,0,0,0,0,0.5,0.000445
9911133,9911133,,1,2,3,1,2,3,0,0.000002,0,21343,22,0.000013,15,0.118576,0.128694,0,0.333333,0.000219
204141,204141,,3,7,10,3,7,10,0.000077,0.000301,0,21345,8,0.000012,14,0.177286,0.194132,345.879129,0.255556,0.000777
204142,204142,,0,3,3,0,3,3,0,0.000044,0,21346,52,0.00001,4,0.444444,0.526042,0,0.166667,0
204145,204145,,16,23,39,16,23,39,0.000746,0.001001,0,21347,0,0.000016,16,0.192458,0.216471,9107.815424,0.161943,0.004006
204146,204146,,79,36,115,79,36,115,0.008101,0.009665,0,19280,41,0.000054,13,0.21233,0.237074,97195.319212,0.191609,0.029192
204200,204200,,17,20,37,17,20,37,0.002457,0.017381,0,19295,41,0.000015,13,0.197781,0.220259,2022.992815,0.376877,0.006757
204226,204226,,50,23,73,50,23,73,0.007457,0.004597,0,19292,41,0.000029,15,0.184914,0.207806,12918.529563,0.116819,0.016124
204234,204234,,22,72,94,22,72,94,0.00229,0.005339,0,19302,41,0.000016,15,0.221957,0.250865,179917.068866,0.136239,0.008157
204148,204148,,8,48,56,8,48,56,0.000386,0.001277,0,21349,52,0.000016,15,0.200774,0.229614,82730.50146,0.05487,0.00188
9508041,9508041,,1,2,3,1,2,3,0.000015,0.000001,0,21348,52,0.00001,1,1,1,0,0.333333,0.000273
204151,204151,,2,8,10,2,8,10,0,0.000011,0,21350,23,0.000011,14,0.172048,0.186573,1,0.388889,0.000445
204152,204152,,1,14,15,1,14,15,0.00001,0.001189,0,21351,30,0.00001,16,0.186195,0.203997,2350.722857,0.142857,0.000253
204153,204153,,3,18,21,3,18,21,0.000074,0.001066,0,21352,0,0.000011,16,0.180357,0.205572,1288.62565,0.159524,0.000691
204154,204154,,4,21,25,4,21,25,0.000026,0.000357,0,21353,9,0.000011,14,0.185639,0.207765,1020.636199,0.298333,0.000903
204157,204157,,1,37,38,1,37,38,0.000026,0.002567,0,21354,52,0.00001,15,0.199819,0.227178,9901.669638,0.084637,0.000239
204159,204159,,0,10,10,0,10,10,0,0.000188,0,21356,30,0.00001,13,0.219415,0.240646,0,0.122222,0
9606081,9606081,,1,2,3,1,2,3,0.000002,0.000001,0,21355,26,0.000011,2,0.75,0.833333,2.333333,0,0.000219
204160,204160,,9,9,18,9,9,18,0.000915,0.015507,0,21357,25,0.000017,13,0.192914,0.213123,4320.630726,0.30719,0.002118
204161,204161,,7,13,20,7,13,20,0.000196,0.0001,0,21358,2,0.000012,18,0.200167,0.219421,5239.740668,0.265789,0.001708
204162,204162,,1,8,9,1,8,9,0.000037,0.000588,0,21360,30,0.000011,12,0.211461,0.231097,2691.489498,0.097222,0.000219
9907136,9907136,,1,1,2,1,1,2,0.000007,0,0,21359,6,0.000011,3,0.5,0.547619,14,0,0.000226
204163,204163,,2,53,55,2,53,55,0.000095,0.004597,0,21364,30,0.00001,14,0.227927,0.256299,8887.416811,0.075758,0.000458
9704090,9704090,,1,5,6,1,5,6,0.000054,0.00001,0,21363,4,0.00001,7,0.260181,0.326149,155.809406,0.266667,0.000232
9610039,9610039,,2,9,11,2,9,11,0.000001,0.000012,0,21362,4,0.000012,6,0.302387,0.381871,172.034647,0.163636,0.000458
204165,204165,,0,13,13,0,13,13,0,0.002669,0,21365,30,0.00001,14,0.195439,0.21791,0,0.25,0
204166,204166,,2,6,8,2,6,8,0.000157,0.000021,0,21366,23,0.000011,16,0.170995,0.190573,12691.361981,0.107143,0.00052
204167,204167,,4,36,40,4,36,40,0.000453,0.002004,0,21367,1,0.000012,13,0.199629,0.225403,8117.443824,0.104487,0.000945
204169,204169,,4,38,42,4,38,42,0.00016,0.000565,0,21368,9,0.000011,14,0.203605,0.225881,8409.896031,0.182346,0.00089
204170,204170,,1,16,17,1,16,17,0.000002,0.000078,0,21369,30,0.00001,14,0.179417,0.194247,20.432196,0.253676,0.000219
204171,204171,,2,9,11,2,9,11,0.000018,0.000009,0,21370,26,0.000016,15,0.150779,0.161981,14465.583628,0.154545,0.000458
9411007,9411007,,2,2,4,2,2,4,0.000001,0.000009,0,6258,26,0.000026,2,0.625,0.7,0.333333,0.333333,0.000634
204173,204173,,0,7,7,0,7,7,0,0.000104,0,21371,30,0.00001,15,0.204161,0.223846,0,0.357143,0
204175,204175,,3,2,5,3,2,5,0.000003,0.00002,0,21372,25,0.000011,15,0.142532,0.150194,226.037355,0.4,0.000704
204176,204176,,1,2,3,1,2,3,0,0,0,21374,28,0.000013,3,0.571429,0.708333,1,0.166667,0.000219
9811099,9811099,,2,1,3,2,1,3,0,0,0,21373,28,0.000019,2,0.666667,0.75,4,0.166667,0.000445
204177,204177,,0,1,1,0,1,1,0,0,31,21376,54,0.00001,1,1,1,0,0,0
9911074,9911074,,1,0,1,1,0,1,0,0,31,21375,54,0.000019,0,0,0,0,0,0.000219
204178,204178,,0,17,17,0,17,17,0,0.00024,0,21379,4,0.00001,15,0.177727,0.194156,0,0.110294,0
9605067,9605067,,7,2,9,7,2,9,0.000005,0.000021,0,5561,2,0.000023,2,0.666667,0.75,8827.518204,0.194444,0.001636
9703019,9703019,,4,7,11,4,7,11,0.000005,0.000024,0,21378,2,0.000014,11,0.175477,0.21704,168.510262,0.181818,0.000883
9612186,9612186,,2,5,7,2,5,7,0.000001,0.000068,0,21377,2,0.000013,11,0.188697,0.253961,144.939579,0.261905,0.000464
204179,204179,,3,30,33,3,30,33,0.000039,0.002457,0,21380,1,0.000012,15,0.181714,0.205612,13425.383618,0.096591,0.00069
204180,204180,,0,11,11,0,11,11,0,0.011161,0,21381,1,0.00001,11,0.22587,0.255893,0,0.372727,0
204181,204181,,2,10,12,2,10,12,0.000002,0.000005,0,21382,6,0.000011,17,0.126986,0.1392,36.255675,0.204545,0.000438
204182,204182,,1,27,28,1,27,28,0,0.01636,0,21383,15,0.00001,14,0.208573,0.230891,15879.42635,0.07672,0.000246
204183,204183,,8,50,58,8,50,58,0.000928,0.020067,0,21389,4,0.000013,13,0.204972,0.23625,44352.645211,0.079855,0.001874
9902031,9902031,,1,6,7,1,6,7,0.000236,0.000034,0,21388,1,0.00001,14,0.129157,0.140786,115.5,0.142857,0.000273
9902147,9902147,,1,7,8,1,7,8,0.000236,0.000037,0,21387,1,0.00001,14,0.129301,0.141592,144.623857,0.107143,0.000273
9403082,9403082,,6,1,7,6,1,7,0.000001,0.000019,0,21384,1,0.00003,1,1,1,3.5,0.119048,0.001382
9404158,9404158,,3,2,5,3,2,5,0.000001,0.000001,0,21386,1,0.000014,3,0.545455,0.638889,4.5,0.15,0.000672
9407085,9407085,,3,2,5,3,2,5,0.000001,0.000001,0,21385,1,0.000014,3,0.545455,0.638889,4.5,0.15,0.000672
204184,204184,,1,4,5,1,4,5,0,0,0,21391,5,0.000012,1,1,1,1,0.35,0.000219
9902124,9902124,,1,1,2,1,1,2,0,0,0,21390,5,0.000013,1,1,1,0,0.5,0.000226
204185,204185,,7,33,40,7,33,40,0.000235,0.001762,0,21392,30,0.000012,15,0.213705,0.238867,3441.962319,0.224359,0.00166
204186,204186,,6,32,38,6,32,38,0.00009,0.002482,0,21394,4,0.000016,17,0.192316,0.223409,65545.534805,0.055477,0.001361
9603155,9603155,,2,1,3,2,1,3,0.000036,0,0,21393,22,0.000011,2,0.666667,0.75,9.083333,0.166667,0.000484
9209110,9209110,,3,0,3,3,0,3,0.000003,0,0,1765,22,0.000044,0,0,0,0,0,0.000813
9409145,9409145,,2,2,4,2,2,4,0.000003,0,0,4386,22,0.000016,2,0.75,0.833333,2,0.25,0.000479
204188,204188,,3,18,21,3,18,21,0.000008,0.000005,0,21395,23,0.000013,16,0.140768,0.155055,274.311826,0.128571,0.00067
9201009,9201009,,3,0,3,3,0,3,0.000033,0,0,494,13,0.000017,0,0,0,0,0.166667,0.001082
204191,204191,,7,35,42,7,35,42,0.000145,0.002486,0,19136,3,0.000012,16,0.192495,0.218337,9718.120977,0.151568,0.002258
204192,204192,,4,21,25,4,21,25,0.000121,0.001529,0,19378,30,0.000011,14,0.217883,0.240311,7087.051495,0.233333,0.000899
204193,204193,,0,17,17,0,17,17,0,0.017171,0,21397,1,0.00001,14,0.199487,0.223301,0,0.261029,0
203096,203096,,1,0,1,1,0,1,0.000202,0,0,21396,1,0.00001,0,0,0,0,0,0.000219
204194,204194,,0,6,6,0,6,6,0,0.000001,0,21398,23,0.00001,18,0.150455,0.164207,0,0.333333,0
204195,204195,,5,17,22,5,17,22,0.00031,0.002821,0,20038,0,0.000012,15,0.191925,0.216126,49966.700678,0.170996,0.001209
204197,204197,,1,31,32,1,31,32,0.000004,0.003488,0,21399,30,0.000011,15,0.215544,0.240075,782.73959,0.199597,0.000219
204199,204199,,2,6,8,2,6,8,0.00002,0.000176,0,21400,3,0.000012,16,0.178699,0.195043,3854.70737,0.375,0.000452
204201,204201,,1,38,39,1,38,39,0.000015,0.01288,0,21401,1,0.000011,12,0.214283,0.244405,2959.19357,0.070175,0.000219
204202,204202,,1,5,6,1,5,6,0.000001,0.000035,0,21403,10,0.000011,16,0.174155,0.190047,8,0.3,0.000239
9206110,9206110,,1,0,1,1,0,1,0,0,0,21402,10,0.000012,0,0,0,0,0,0.000226
204205,204205,,1,14,15,1,14,15,0.000042,0.001583,0,21404,25,0.00001,20,0.18066,0.203495,203.744718,0.214286,0.000239
204206,204206,,2,75,77,2,75,77,0.00002,0.004306,0,21405,3,0.000011,15,0.21779,0.250358,9433.71712,0.061517,0.000445
204207,204207,,2,8,10,2,8,10,0.000045,0.002797,0,21406,13,0.00001,15,0.16543,0.184029,190.930966,0.177778,0.000478
204208,204208,,0,2,2,0,2,2,0,0.000021,0,21407,22,0.00001,18,0.123819,0.132306,0,0.5,0
204209,204209,,2,12,14,2,12,14,0.000047,0.001185,0,21408,1,0.000011,14,0.196033,0.216946,105.486363,0.175824,0.000451
204210,204210,,2,11,13,2,11,13,0.000378,0.000044,0,21410,17,0.00001,15,0.134298,0.148457,11.58681,0.25641,0.000438
9203007,9203007,,1,0,1,1,0,1,0.000001,0,0,21409,17,0.000011,0,0,0,0,0,0.000232
204211,204211,,2,3,5,2,3,5,0,0,0,21411,23,0.000012,16,0.132869,0.14313,30,0.3,0.000505
204212,204212,,2,9,11,2,9,11,0.000104,0.006231,0,21412,0,0.00001,13,0.188957,0.210798,1228.391876,0.109091,0.000451
204213,204213,,3,13,16,3,13,16,0.000284,0.000093,0,21413,10,0.000011,16,0.182505,0.202635,393.053306,0.308333,0.000677
204214,204214,,2,5,7,2,5,7,0.000065,0.000011,0,21414,25,0.00001,17,0.169297,0.182939,224.020961,0.285714,0.000478
204215,204215,,1,14,15,1,14,15,0,0.000046,0,21415,15,0.00001,14,0.179483,0.193679,523.995792,0.161905,0.000232
204216,204216,,3,14,17,3,14,17,0.000001,0.000009,0,21416,23,0.000012,15,0.150244,0.16533,1057.051147,0.213235,0.000745
204219,204219,,2,11,13,2,11,13,0.000026,0.000263,0,21417,30,0.00001,13,0.183412,0.197223,33.935544,0.24359,0.000465
204220,204220,,1,5,6,1,5,6,0.000002,0.000004,0,21418,22,0.00001,15,0.160819,0.171458,746.560786,0.166667,0.000232
204221,204221,,10,16,26,10,16,26,0.000595,0.002285,0,21419,30,0.000013,15,0.190293,0.21115,8420.92027,0.144615,0.002556
204222,204222,,8,13,21,8,13,21,0.000371,0.000179,0,21420,0,0.000013,15,0.183917,0.204733,807.684188,0.295238,0.002048
204223,204223,,5,7,12,5,7,12,0.000046,0.000151,0,20058,0,0.000015,14,0.165868,0.181738,12025.589989,0.090909,0.001142
204225,204225,,4,31,35,4,31,35,0.000081,0.001315,0,21421,2,0.000011,15,0.198323,0.223768,8385.383323,0.157983,0.001016
204227,204227,,4,16,20,4,16,20,0.000279,0.001349,0,21422,0,0.000011,16,0.182702,0.205273,308.550258,0.276316,0.001068
204228,204228,,1,34,35,1,34,35,0.000106,0.003936,0,21423,0,0.00001,16,0.170114,0.196516,113.612129,0.137815,0.000232
204229,204229,,0,10,10,0,10,10,0,0.000064,0,21426,28,0.00001,16,0.168107,0.18307,0,0.177778,0
9801044,9801044,,3,6,9,3,6,9,0.000001,0.000004,0,21424,28,0.000014,14,0.134419,0.145199,11,0.194444,0.00067
9809046,9809046,,2,7,9,2,7,9,0.000001,0.000012,0,21425,28,0.000012,14,0.134807,0.146889,17.385714,0.222222,0.000438
9608064,9608064,,8,3,11,8,3,11,0.000035,0.00008,0,5754,28,0.000057,12,0.157863,0.173202,1054.19735,0.109091,0.002005
9610196,9610196,,3,1,4,3,1,4,0,0,0,9538,28,0.000021,1,1,1,5884,0.166667,0.000718
204231,204231,,0,21,21,0,21,21,0,0.000522,0,21427,10,0.00001,14,0.199162,0.222924,0,0.259524,0
204232,204232,,3,12,15,3,12,15,0,0.000001,0,21428,22,0.000015,18,0.141589,0.152282,3787.21962,0.195238,0.000677
204233,204233,,7,30,37,7,30,37,0.000105,0.000575,0,21429,3,0.000012,15,0.19199,0.211652,1899.471165,0.275526,0.001828
205218,205218,,17,35,52,17,35,52,0.0014,0.002283,0,21430,3,0.000015,14,0.209799,0.233672,117132.997732,0.100302,0.00486
205043,205043,,13,12,25,13,12,25,0.0015,0.001952,0,19278,41,0.000015,14,0.188717,0.208843,7308.044832,0.185,0.004665
9407004,9407004,,1,17,18,1,17,18,0.000063,0.000691,0,19294,13,0.00001,5,0.340304,0.412849,863.312713,0.04902,0.000407
204235,204235,,3,10,13,3,10,13,0.000093,0.001015,0,21431,25,0.000011,14,0.183924,0.204728,387.219695,0.24359,0.000704
204237,204237,,6,3,9,6,3,9,0,0,0,21432,23,0.000028,16,0.122611,0.12918,6853,0.361111,0.001374
204238,204238,,0,2,2,0,2,2,0,0.000031,0,21433,30,0.00001,12,0.140228,0.149235,0,0.5,0
204241,204241,,0,4,4,0,4,4,0,0.000004,0,21434,23,0.00001,19,0.135488,0.147756,0,0.5,0
204242,204242,,2,4,6,2,4,6,0.000022,0.000928,0,21435,23,0.000017,12,0.187194,0.20267,7.333333,0.133333,0.000445
204243,204243,,1,18,19,1,18,19,0.000025,0.002473,0,21436,2,0.000011,14,0.195148,0.220835,265.964664,0.154971,0.000219
204244,204244,,1,5,6,1,5,6,0.000003,0.000041,0,21437,13,0.00001,16,0.146133,0.166822,0.75,0.4,0.000232
204245,204245,,14,13,27,14,13,27,0.000005,0.000131,0,21438,15,0.000023,15,0.205729,0.224879,98159.123049,0.163818,0.003286
204246,204246,,5,17,22,5,17,22,0.000009,0.000008,0,21439,17,0.000013,16,0.163525,0.202936,2014.263434,0.225108,0.001155
204247,204247,,4,12,16,4,12,16,0.000098,0.000757,0,19327,3,0.000011,16,0.189679,0.215556,2642.91043,0.1125,0.00124
204248,204248,,3,15,18,3,15,18,0.000021,0.001661,0,21440,30,0.000013,13,0.206135,0.228688,15482.722632,0.245098,0.000677
204249,204249,,11,20,31,11,20,31,0.001169,0.001284,0,20013,10,0.000014,16,0.193559,0.217121,5297.313336,0.134409,0.002734
9701112,9701112,,2,1,3,2,1,3,0,0,0,7417,10,0.00002,1,1,1,8535,0.166667,0.000462
204250,204250,,0,15,15,0,15,15,0,0.009367,0,21441,1,0.00001,17,0.216007,0.247408,0,0.22381,0
204251,204251,,2,15,17,2,15,17,0.000047,0.005796,0,21442,23,0.000011,16,0.15944,0.178628,270.904352,0.165441,0.000438
9502078,9502078,,2,9,11,2,9,11,0.00029,0.000043,0,11612,5,0.000011,4,0.386792,0.504065,290.205873,0.109091,0.000605
9503074,9503074,,3,0,3,3,0,3,0.000214,0,0,15396,23,0.000016,0,0,0,0,0,0.000782
9504011,9504011,,3,4,7,3,4,7,0.000214,0.000011,0,5038,5,0.000013,4,0.402597,0.450269,1883.432738,0.071429,0.000795
9510147,9510147,,6,3,9,6,3,9,0.000238,0.000008,0,2551,23,0.000019,2,0.8,0.875,1529.27679,0.111111,0.001483
9602023,9602023,,2,3,5,2,3,5,0.000221,0.000026,0,15395,13,0.000011,4,0.418605,0.50463,48.855983,0.15,0.000563
9611031,9611031,,1,2,3,1,2,3,0.000213,0.00001,0,15394,5,0.00001,7,0.233883,0.252722,0,0.5,0.000344
9703044,9703044,,2,11,13,2,11,13,0.000215,0.000605,0,15393,5,0.00001,12,0.200379,0.234764,281.542672,0.076923,0.000569
9303049,9303049,,5,0,5,5,0,5,0.000006,0,0,994,5,0.000027,0,0,0,0,0.1,0.001357
9407100,9407100,,3,2,5,3,2,5,0.000007,0,0,5539,5,0.000015,5,0.341176,0.397126,98.917798,0.3,0.00072
9504021,9504021,,1,5,6,1,5,6,0.000001,0.000024,0,5540,5,0.000012,7,0.289703,0.33646,58.564051,0.2,0.000261
9406053,9406053,,2,3,5,2,3,5,0.000058,0.000015,0,8219,13,0.000014,6,0.34,0.417647,6975.453531,0.15,0.000461
9401155,9401155,,2,0,2,2,0,2,0.000014,0,0,6922,41,0.000015,0,0,0,0,0,0.00047
9712194,9712194,,2,19,21,2,19,21,0.000001,0.000155,0,8213,5,0.000013,19,0.153416,0.20303,10240.349939,0.066667,0.000461
9407002,9407002,,4,5,9,4,5,9,0.000084,0.000027,0,6250,5,0.000013,2,0.692308,0.777778,9484.709524,0.194444,0.000953
204254,204254,,23,33,56,23,33,56,0.00076,0.001183,0,20022,0,0.000017,15,0.214886,0.243403,62106.49332,0.13539,0.006144
204255,204255,,0,1,1,0,1,1,0,0,11,21443,33,0.00001,1,1,1,0,0,0
204256,204256,,11,28,39,11,28,39,0.000557,0.004455,0,21444,30,0.000015,14,0.212216,0.237226,11699.432533,0.149798,0.002555
204257,204257,,2,26,28,2,26,28,0.000578,0.021945,0,21445,1,0.00001,13,0.208898,0.241374,412.68826,0.284392,0.000451
204258,204258,,0,6,6,0,6,6,0,0.000001,0,21446,26,0.00001,12,0.147745,0.176195,0,0.2,0
204259,204259,,0,4,4,0,4,4,0,0,0,21447,23,0.00001,16,0.131925,0.142092,0,0,0
9704078,9704078,,1,0,1,1,0,1,0,0,0,14965,23,0.000012,0,0,0,0,0,0.000232
205001,205001,,1,6,7,1,6,7,0.000081,0.015579,0,21448,1,0.00001,15,0.172836,0.193318,5.556953,0.357143,0.000283
205002,205002,,2,25,27,2,25,27,0.000005,0.006953,0,21451,4,0.000017,12,0.226611,0.273452,3002.946925,0.115385,0.000471
9703122,9703122,,1,10,11,1,10,11,0.000082,0.002471,0,21450,4,0.00001,12,0.199096,0.230629,15.212962,0.263636,0.000233
9905203,9905203,,3,3,6,3,3,6,0.000082,0,0,21449,22,0.000014,2,0.714286,0.8,67.479304,0.2,0.000671
9605226,9605226,,5,0,5,5,0,5,0,0,0,8390,22,0.000022,0,0,0,0,0.05,0.001136
205004,205004,,2,15,17,2,15,17,0,0.000022,0,21452,28,0.000012,15,0.160632,0.175614,1418.549787,0.198529,0.000445
205005,205005,,1,5,6,1,5,6,0,0.000001,0,21453,28,0.000011,15,0.15646,0.168919,55.37841,0.2,0.000226
205007,205007,,1,5,6,1,5,6,0.000165,0.001368,0,21454,4,0.00001,14,0.169668,0.204651,107.657997,0.166667,0.000261
205008,205008,,14,49,63,14,49,63,0.001624,0.004304,0,19303,41,0.000014,16,0.213521,0.239535,3210.046557,0.284946,0.005073
205009,205009,,3,15,18,3,15,18,0.000097,0.002082,0,21455,25,0.000011,17,0.180272,0.20383,3247.587741,0.160131,0.000691
205010,205010,,8,41,49,8,41,49,0.000326,0.005208,0,21456,30,0.000012,13,0.216368,0.243369,3935.678755,0.142857,0.001934
206001,206001,,5,36,41,5,36,41,0.000214,0.004839,0,21459,30,0.000011,13,0.211627,0.237219,1921.147379,0.165244,0.001189
205283,205283,,4,32,36,4,32,36,0.000239,0.00207,0,21458,30,0.000011,13,0.213609,0.237988,1896.342327,0.173016,0.000983
205011,205011,,8,9,17,8,9,17,0.000223,0.000031,0,21460,52,0.000012,18,0.177506,0.195788,462.28537,0.1875,0.001892
205012,205012,,10,12,22,10,12,22,0.000195,0.001057,0,21461,0,0.000017,14,0.176213,0.194015,3793.127341,0.214286,0.00227
205013,205013,,1,5,6,1,5,6,0.000004,0.000011,0,21462,23,0.000011,13,0.158626,0.173403,328.053188,0.166667,0.000219
205014,205014,,3,22,25,3,22,25,0.000007,0.001088,0,21463,3,0.000011,13,0.196932,0.218669,24157.065588,0.048333,0.000782
205015,205015,,22,33,55,22,33,55,0.002938,0.019852,0,19293,41,0.000015,14,0.210998,0.236965,24249.416826,0.16936,0.007241
205016,205016,,3,13,16,3,13,16,0.000024,0.008387,0,21464,9,0.00001,15,0.212621,0.246702,1654.768531,0.2375,0.000684
205017,205017,,5,39,44,5,39,44,0.000021,0.000073,0,21468,22,0.000013,12,0.206389,0.227643,62544.578017,0.03277,0.001148
204022,204022,,1,0,1,1,0,1,0.000001,0,0,21467,22,0.00001,0,0,0,0,0,0.000252
9611087,9611087,,1,1,2,1,1,2,0.000001,0.00002,0,21466,22,0.00001,2,0.538462,0.571429,0,0.5,0.000252
9611187,9611187,,1,0,1,1,0,1,0.000001,0,0,21465,22,0.00001,0,0,0,0,0,0.000252
205018,205018,,3,7,10,3,7,10,0.000001,0.000001,0,21472,23,0.000013,19,0.142222,0.156208,4920.872543,0.2,0.00067
9602127,9602127,,1,6,7,1,6,7,0,0,0,21471,23,0.000011,2,0.75,0.833333,32.583333,0.02381,0.000239
9408045,9408045,,1,0,1,1,0,1,0,0,0,21470,23,0.000012,0,0,0,0,0,0.000226
9503177,9503177,,1,0,1,1,0,1,0,0,0,21469,23,0.000012,0,0,0,0,0,0.000226
205019,205019,,4,20,24,4,20,24,0.000129,0.002335,0,21473,0,0.000011,15,0.179072,0.202857,3238.766832,0.175725,0.001106
205020,205020,,24,27,51,24,27,51,0.002874,0.005034,0,19291,41,0.000016,14,0.211404,0.241443,9773.277661,0.300392,0.007528
205021,205021,,1,8,9,1,8,9,0,0.000006,0,21476,15,0.000011,15,0.148207,0.15784,26936,0.041667,0.000226
9310054,9310054,,1,0,1,1,0,1,0,0,0,21475,15,0.000011,0,0,0,0,0,0.000226
9804130,9804130,,3,1,4,3,1,4,0.000001,0,0,21474,22,0.000014,1,1,1,3,0.166667,0.000677
205022,205022,,1,4,5,1,4,5,0,0,0,21480,28,0.000012,16,0.125076,0.132555,29.876908,0.1,0.000219
204048,204048,,1,0,1,1,0,1,0,0,0,21479,28,0.000013,0,0,0,0,0,0.000226
9906181,9906181,,3,3,6,3,3,6,0,0.000013,0,21478,28,0.00002,10,0.172881,0.195353,108.048947,0.133333,0.00067
9706030,9706030,,2,1,3,2,1,3,0,0,0,21477,28,0.000019,9,0.204312,0.224992,292.048947,0.333333,0.000464
205023,205023,,0,4,4,0,4,4,0,0.000013,0,21481,15,0.00001,14,0.147157,0.157344,0,0,0
205024,205024,,11,23,34,11,23,34,0.000158,0.001654,0,21482,30,0.000016,17,0.202656,0.225412,25919.142969,0.180036,0.002522
205026,205026,,6,24,30,6,24,30,0.000001,0.000212,0,21483,23,0.000018,14,0.192718,0.216965,37014.84015,0.078161,0.001341
205027,205027,,1,1,2,1,1,2,0.000017,0.000087,0,21484,0,0.000011,17,0.177304,0.19372,0,0.5,0.000303
205028,205028,,1,17,18,1,17,18,0,0.000041,0,21486,15,0.00001,16,0.190182,0.21088,1523.960796,0.081699,0.000239
9511096,9511096,,1,0,1,1,0,1,0,0,0,21485,15,0.00001,0,0,0,0,0,0.000226
205029,205029,,0,2,2,0,2,2,0,0.000062,0,21487,8,0.00001,15,0.162729,0.179155,0,0.5,0
205030,205030,,0,2,2,0,2,2,0,0.000023,0,21488,28,0.00001,13,0.173379,0.191758,0,0,0
205031,205031,,3,18,21,3,18,21,0.000009,0.000528,0,21489,0,0.000012,20,0.188684,0.213601,1163.256642,0.135714,0.000684
205032,205032,,2,19,21,2,19,21,0.000001,0.000014,0,21490,20,0.000011,14,0.156065,0.170701,1283.884878,0.185714,0.000505
205034,205034,,2,57,59,2,57,59,0.000062,0.005678,0,21491,4,0.00001,14,0.207861,0.240846,1908.054304,0.116014,0.000458
205035,205035,,0,2,2,0,2,2,0,0,0,21493,22,0.00001,8,0.217391,0.269898,0,0,0
9902135,9902135,,1,0,1,1,0,1,0,0,0,21492,22,0.000014,0,0,0,0,0,0.000219
205036,205036,,3,7,10,3,7,10,0.000001,0.000004,0,21494,10,0.000015,16,0.167719,0.182422,6410.961031,0.244444,0.00067
205038,205038,,3,4,7,3,4,7,0.000001,0.000001,0,21495,22,0.000014,17,0.141235,0.149162,1254.799597,0.261905,0.000677
205039,205039,,3,9,12,3,9,12,0.000011,0.000864,0,21496,1,0.000013,18,0.156804,0.176068,7651.836065,0.325758,0.000684
205041,205041,,4,37,41,4,37,41,0.000113,0.002705,0,21497,25,0.000011,15,0.196145,0.220573,8001.727024,0.136585,0.000936
205042,205042,,1,10,11,1,10,11,0.000008,0.00009,0,21498,0,0.00001,12,0.194946,0.215734,25.054913,0.163636,0.000226
205044,205044,,1,8,9,1,8,9,0.000023,0.000928,0,21499,2,0.000011,16,0.153461,0.17773,323.735545,0.25,0.000232
205045,205045,,1,10,11,1,10,11,0,0.000001,0,21500,23,0.000011,18,0.114413,0.123433,1654.204012,0.354545,0.000219
205047,205047,,2,15,17,2,15,17,0.000042,0.001165,0,21501,30,0.000011,14,0.190772,0.209107,571.941891,0.194853,0.000465
205050,205050,,19,19,38,19,19,38,0.001106,0.001016,0,21502,10,0.000019,14,0.201871,0.224277,17818.807155,0.123044,0.004766
205051,205051,,14,22,36,14,22,36,0.001948,0.018374,0,21504,1,0.000019,16,0.179924,0.208752,6942.706756,0.149206,0.003288
9909186,9909186,,3,24,27,3,24,27,0.000642,0.018812,0,21503,1,0.000012,12,0.20616,0.231363,960.346338,0.235043,0.000823
205052,205052,,9,13,22,9,13,22,0.001443,0.01838,0,21505,1,0.000016,14,0.200377,0.231496,40962.453411,0.183983,0.002112
205053,205053,,0,8,8,0,8,8,0,0.000722,0,21506,25,0.00001,13,0.169821,0.184042,0,0.321429,0
205054,205054,,0,6,6,0,6,6,0,0.002678,0,21507,30,0.00001,14,0.175671,0.192707,0,0.3,0
205056,205056,,1,7,8,1,7,8,0.000022,0.001723,0,21509,8,0.00001,14,0.181648,0.204271,78.334515,0.107143,0.000226
9712242,9712242,,1,6,7,1,6,7,0.00002,0.000153,0,21508,0,0.000011,7,0.244762,0.27456,55.25868,0.238095,0.000226
205057,205057,,5,21,26,5,21,26,0.000002,0.000012,0,21510,23,0.000012,14,0.157441,0.174347,6721.919543,0.121538,0.001168
205058,205058,,2,17,19,2,17,19,0.000038,0.000416,0,21511,30,0.000011,15,0.213259,0.235406,1633.48487,0.30117,0.000471
205059,205059,,0,1,1,0,1,1,0,0,0,21512,23,0.00001,4,0.346154,0.407407,0,0,0
205060,205060,,0,106,106,0,106,106,0,0.032596,0,21513,4,0.00001,13,0.23567,0.27947,0,0.06451,0
9703014,9703014,,1,9,10,1,9,10,0.000095,0.000048,0,4813,15,0.00001,11,0.177089,0.217611,136647.353679,0.077778,0.000285
9410012,9410012,,1,7,8,1,7,8,0.000078,0.000016,0,8117,5,0.00001,5,0.318681,0.396839,1729.03264,0.053571,0.00024
205062,205062,,1,34,35,1,34,35,0,0.000035,0,21514,20,0.000011,13,0.172322,0.192826,3785.244807,0.138655,0.000245
205063,205063,,4,13,17,4,13,17,0.000001,0.000069,0,21516,2,0.000016,15,0.185614,0.201732,19850.757141,0.113971,0.00089
203225,203225,,4,0,4,4,0,4,0.00001,0,0,21515,2,0.000018,0,0,0,0,0.25,0.000916
205064,205064,,1,24,25,1,24,25,0.000222,0.017827,0,21517,1,0.00001,17,0.198134,0.228657,681.148075,0.153333,0.000219
205065,205065,,4,19,23,4,19,23,0.000002,0.000035,0,21518,15,0.000012,15,0.182934,0.200123,10484.21373,0.12253,0.000916
205068,205068,,6,5,11,6,5,11,0.000102,0.001505,0,21519,13,0.000014,15,0.160899,0.175961,240.943482,0.245455,0.001361
205069,205069,,7,15,22,7,15,22,0.00018,0.000406,0,21520,25,0.000015,15,0.18532,0.205283,3503.359614,0.251082,0.001817
205070,205070,,11,26,37,11,26,37,0.001106,0.00158,0,20015,10,0.000014,15,0.197483,0.22417,11775.356039,0.144895,0.002739
205071,205071,,0,3,3,0,3,3,0,0,0,21521,6,0.00001,10,0.173549,0.209796,0,0.333333,0
205072,205072,,2,10,12,2,10,12,0.000024,0.000203,0,21522,23,0.000011,16,0.169593,0.191917,18356.807639,0.159091,0.000451
205073,205073,,0,29,29,0,29,29,0,0.005426,0,21523,0,0.00001,13,0.203458,0.233129,0,0.141626,0
205075,205075,,4,35,39,4,35,39,0.000679,0.025792,0,21524,1,0.000012,12,0.208159,0.239923,7242.328541,0.149798,0.00089
205076,205076,,3,19,22,3,19,22,0.000002,0.000024,0,21526,6,0.000011,15,0.177155,0.195308,13965.112819,0.11039,0.000658
9311073,9311073,,3,0,3,3,0,3,0,0,0,21525,6,0.000015,0,0,0,0,0.166667,0.000677
205077,205077,,4,24,28,4,24,28,0.000028,0.016684,0,21527,25,0.000017,12,0.199314,0.222781,11942.957849,0.140212,0.00096
205078,205078,,3,50,53,3,50,53,0.000203,0.007126,0,19380,30,0.000011,13,0.213266,0.239377,16982.571766,0.125907,0.000887
205079,205079,,8,22,30,8,22,30,0.000147,0.000236,0,21528,4,0.000016,14,0.183392,0.203941,22278.201793,0.124138,0.002808
205081,205081,,1,6,7,1,6,7,0.000018,0.000004,0,21529,5,0.00001,19,0.095642,0.111492,17.528571,0.142857,0.000219
205082,205082,,2,27,29,2,27,29,0.000247,0.018679,0,21530,1,0.00001,15,0.208961,0.235092,1472.850776,0.261084,0.000507
205083,205083,,4,49,53,4,49,53,0.000427,0.003347,0,21531,25,0.000011,15,0.204656,0.234752,16948.531735,0.095065,0.000916
205084,205084,,4,36,40,4,36,40,0.000141,0.002344,0,21532,25,0.000014,16,0.182512,0.209447,29001.553923,0.178205,0.000964
205087,205087,,0,34,34,0,34,34,0,0.002213,0,21533,25,0.00001,14,0.204989,0.229026,0,0.163102,0
205088,205088,,1,7,8,1,7,8,0.000002,0.000072,0,21534,25,0.00001,17,0.161307,0.176052,0,0.357143,0.000232
205090,205090,,4,20,24,4,20,24,0.000804,0.020183,0,21535,1,0.000011,17,0.210955,0.245638,5172.589053,0.197464,0.000931
205091,205091,,1,11,12,1,11,12,0.000007,0.000037,0,21536,52,0.000012,16,0.179287,0.196848,4950.914635,0.05303,0.000219
205092,205092,,6,25,31,6,25,31,0.000557,0.013341,0,21537,41,0.000012,15,0.184579,0.208752,10816.013072,0.170968,0.001406
205093,205093,,1,17,18,1,17,18,0.000019,0.004579,0,21538,30,0.00001,14,0.189717,0.208194,58.162318,0.25817,0.000219
205095,205095,,1,3,4,1,3,4,0.000041,0.000001,0,21539,4,0.00001,12,0.161331,0.177246,90.011502,0.166667,0.000226
205096,205096,,2,35,37,2,35,37,0.00002,0.000924,0,21540,3,0.00001,14,0.209776,0.238322,2811.853411,0.195946,0.000458
205097,205097,,6,21,27,6,21,27,0.000225,0.000387,0,21541,52,0.000012,15,0.201394,0.225639,2433.711367,0.166667,0.001434
205099,205099,,9,27,36,9,27,36,0.001059,0.001932,0,21542,10,0.000012,15,0.201605,0.226715,4038.711049,0.351587,0.002297
205100,205100,,11,70,81,11,70,81,0.002122,0.030577,0,20037,1,0.000013,13,0.222622,0.259793,46561.824163,0.116358,0.002832
205102,205102,,0,1,1,0,1,1,0,0,0,21543,23,0.00001,23,0.121973,0.133541,0,0,0
205103,205103,,9,33,42,9,33,42,0.00101,0.006914,0,21544,8,0.000012,15,0.208808,0.235393,38926.517702,0.095819,0.002367
207104,207104,,13,51,64,13,51,64,0.001098,0.004026,0,19340,3,0.000014,15,0.218591,0.248928,34329.230499,0.086806,0.003513
206202,206202,,13,18,31,13,18,31,0.00059,0.009143,0,19337,25,0.000023,16,0.203298,0.232198,93609.806836,0.107527,0.003284
207235,207235,,20,17,37,20,17,37,0.000676,0.000689,0,19341,3,0.000015,14,0.208084,0.23325,18946.726577,0.217718,0.005847
207107,207107,,33,50,83,33,50,83,0.000664,0.00173,0,19143,3,0.000022,13,0.209982,0.233767,49965.441948,0.130032,0.009332
207245,207245,,17,79,96,17,79,96,0.002333,0.022139,0,21545,8,0.000016,14,0.221659,0.252248,141786.226062,0.075768,0.004033
211025,211025,,2,34,36,2,34,36,0.000246,0.013759,0,21549,8,0.00001,14,0.209001,0.238788,2331.497064,0.143651,0.000512
208013,208013,,20,15,35,20,15,35,0.002036,0.008319,0,21548,8,0.00002,13,0.194022,0.21343,32481.498506,0.130252,0.004932
210160,210160,,7,7,14,7,7,14,0.001015,0.000608,0,21547,8,0.000012,14,0.186066,0.205376,994.671367,0.225275,0.001682
211031,211031,,4,11,15,4,11,15,0.000107,0.000226,0,21580,3,0.000011,14,0.209299,0.233195,7939.770392,0.190476,0.001094
209261,209261,,11,79,90,11,79,90,0.000761,0.006083,0,21562,25,0.000015,17,0.20344,0.236003,37770.365423,0.110737,0.002609
210217,210217,,3,64,67,3,64,67,0.000357,0.028659,0,21579,25,0.000011,14,0.22655,0.264536,11344.865925,0.092718,0.0007
210292,210292,,14,180,194,14,180,194,0.000309,0.02101,0,21578,0,0.000015,13,0.244072,0.287503,146482.066817,0.043587,0.003412
211090,211090,,12,34,46,12,34,46,0.000335,0.001346,0,21583,3,0.000015,14,0.206879,0.232007,21824.180446,0.13913,0.002873
207004,207004,,19,27,46,19,27,46,0.000476,0.000584,0,19150,3,0.000014,13,0.21177,0.236711,8135.098448,0.226087,0.005742
207089,207089,,11,24,35,11,24,35,0.000316,0.002118,0,19146,3,0.000013,13,0.214308,0.240204,13976.398574,0.12437,0.003202
208101,208101,,10,26,36,10,26,36,0.000248,0.017627,0,21582,3,0.000015,15,0.199617,0.224355,5349.489968,0.143651,0.002592
208196,208196,,27,36,63,27,36,63,0.000576,0.000886,0,19382,3,0.000018,14,0.20516,0.228405,14875.109591,0.222478,0.007483
209090,209090,,27,19,46,27,19,46,0.000999,0.000876,0,21563,3,0.000018,14,0.205282,0.229435,20399.827665,0.158937,0.007209
209222,209222,,14,41,55,14,41,55,0.000556,0.002331,0,21581,3,0.000013,14,0.210719,0.235986,9854.790827,0.216835,0.003564
205104,205104,,6,42,48,6,42,48,0.000255,0.01826,0,21584,1,0.000012,14,0.216937,0.24976,24246.325496,0.083777,0.001354
205106,205106,,32,42,74,32,42,74,0.003666,0.021816,0,19315,41,0.00002,14,0.214772,0.248412,42815.43694,0.147353,0.009356
205107,205107,,13,17,30,13,17,30,0.000133,0.00038,0,21585,3,0.000015,14,0.207387,0.229332,6605.020018,0.277011,0.003164
205108,205108,,6,20,26,6,20,26,0.000214,0.001977,0,19326,0,0.000011,15,0.197261,0.224672,9814.734194,0.083077,0.001861
205109,205109,,12,56,68,12,56,68,0.001413,0.004861,0,19314,41,0.000013,16,0.217551,0.243974,3565.629393,0.287313,0.004184
205110,205110,,5,15,20,5,15,20,0.000185,0.001736,0,21457,30,0.000012,13,0.220386,0.243491,1515.38668,0.276316,0.001163
205111,205111,,2,3,5,2,3,5,0.000118,0.000032,0,21575,0,0.00001,13,0.159919,0.1713,23.910179,0.3,0.000594
205112,205112,,0,1,1,0,1,1,0,0,0,21586,5,0.00001,1,1,1,0,0,0
205113,205113,,1,25,26,1,25,26,0,0.000023,0,21587,22,0.000011,13,0.177907,0.196475,4369.779594,0.170769,0.000219
205114,205114,,1,7,8,1,7,8,0,0.000001,0,21588,22,0.000013,16,0.129241,0.135805,13485.5,0.160714,0.000219
9311162,9311162,,4,4,8,4,4,8,0,0.000001,0,9976,22,0.000017,2,0.833333,0.9,2.25,0.303571,0.000924
205115,205115,,2,15,17,2,15,17,0.000098,0.008993,0,21589,52,0.000011,17,0.221287,0.251409,2683.174776,0.147059,0.000477
205117,205117,,1,1,2,1,1,2,0,0,0,21590,22,0.000013,1,1,1,0.5,0,0.000219
205122,205122,,0,2,2,0,2,2,0,0.000006,0,21591,0,0.00001,14,0.15096,0.161216,0,0.5,0
205123,205123,,7,48,55,7,48,55,0.000195,0.003153,0,21592,52,0.000012,16,0.207877,0.237576,7473.219697,0.154545,0.00168
205124,205124,,0,10,10,0,10,10,0,0.002543,0,21593,2,0.00001,13,0.172771,0.189695,0,0.033333,0
205125,205125,,2,6,8,2,6,8,0,0.000004,0,21594,15,0.000012,15,0.138682,0.145467,0,0.464286,0.000445
205126,205126,,0,3,3,0,3,3,0,0,0,21595,26,0.00001,15,0.145904,0.154149,0,0,0
9404046,9404046,,2,0,2,2,0,2,0,0,0,7023,26,0.000017,0,0,0,0,0,0.000468
205127,205127,,0,3,3,0,3,3,0,0.000112,0,21596,13,0.00001,14,0.151947,0.165689,0,0.5,0
205128,205128,,1,9,10,1,9,10,0.000009,0.000083,0,21597,30,0.000011,13,0.191725,0.208823,4348.806034,0.033333,0.000219
205129,205129,,9,41,50,9,41,50,0.000965,0.017,0,21598,8,0.000013,13,0.211198,0.24175,35599.827216,0.185306,0.002127
205132,205132,,9,17,26,9,17,26,0.00065,0.000638,0,21599,1,0.000016,15,0.190272,0.209742,3252.403965,0.196923,0.002372
205133,205133,,3,11,14,3,11,14,0,0.000007,0,21600,20,0.000015,14,0.163437,0.173776,26554,0.17033,0.00067
205134,205134,,33,58,91,33,58,91,0.00372,0.005679,0,19316,41,0.000018,16,0.220204,0.248231,27173.74716,0.200122,0.00941
205135,205135,,2,21,23,2,21,23,0.00001,0.00021,0,21601,23,0.000011,14,0.182799,0.205294,4521.371831,0.221344,0.000451
205136,205136,,10,8,18,10,8,18,0.001116,0.001336,0,19313,41,0.000013,15,0.173763,0.193889,835.540558,0.212418,0.003691
205137,205137,,1,10,11,1,10,11,0.000008,0.000025,0,21602,5,0.00001,15,0.15954,0.170819,95.391159,0.190909,0.000219
9401167,9401167,,11,1,12,11,1,12,0.000002,0.00001,0,1912,6,0.00007,1,1,1,115.772616,0.090909,0.002594
205138,205138,,0,21,21,0,21,21,0,0.004483,0,21603,13,0.00001,16,0.178023,0.202863,0,0.164286,0
205139,205139,,4,20,24,4,20,24,0.000127,0.001538,0,21604,25,0.000011,14,0.186767,0.207971,821.334563,0.231884,0.00091
205141,205141,,0,10,10,0,10,10,0,0.017564,0,21605,1,0.00001,18,0.196994,0.232605,0,0.288889,0
205142,205142,,7,7,14,7,7,14,0.000744,0.005811,0,21606,1,0.000014,16,0.174067,0.197414,146.683803,0.263736,0.001627
205143,205143,,3,8,11,3,8,11,0.00002,0.000051,0,21607,52,0.000012,16,0.150422,0.164113,0,0.481818,0.000677
205144,205144,,11,25,36,11,25,36,0.000487,0.001102,0,20044,52,0.000015,16,0.201427,0.227267,26020.993375,0.175397,0.003188
205145,205145,,1,1,2,1,1,2,0,0.000013,0,21608,1,0.000013,14,0.163037,0.173135,0,0.5,0.000232
206108,206108,,18,46,64,18,46,64,0.000498,0.002061,0,20032,0,0.000015,15,0.205433,0.233833,7735.600607,0.202877,0.00493
207234,207234,,22,48,70,22,48,70,0.000595,0.002775,0,20033,0,0.000016,16,0.20858,0.237662,13466.002573,0.178675,0.005768
206087,206087,,13,32,45,13,32,45,0.000356,0.001681,0,20009,0,0.000013,14,0.20621,0.231929,13042.943993,0.247475,0.003667
205148,205148,,1,13,14,1,13,14,0.000043,0.001082,0,21609,25,0.00001,14,0.188021,0.209039,519.04407,0.142857,0.000226
205149,205149,,3,17,20,3,17,20,0.000151,0.001465,0,21610,0,0.000011,16,0.181265,0.2027,8293.284329,0.178947,0.000684
205150,205150,,8,13,21,8,13,21,0.000191,0.001538,0,20096,2,0.000015,16,0.187435,0.207775,4126.970734,0.261905,0.001928
205151,205151,,5,17,22,5,17,22,0.000507,0.00388,0,21611,4,0.000017,13,0.205887,0.232305,11440.705282,0.199134,0.003194
205152,205152,,2,1,3,2,1,3,0,0,0,21612,22,0.000017,3,0.444444,0.541667,4,0.166667,0.000438
205153,205153,,4,24,28,4,24,28,0.000073,0.001469,0,21613,30,0.000012,13,0.215214,0.237665,5770.547884,0.165344,0.000982
205154,205154,,7,18,25,7,18,25,0.000413,0.000855,0,21614,2,0.000012,16,0.18999,0.211034,8668.026545,0.131667,0.00162
205155,205155,,9,47,56,9,47,56,0.000636,0.008959,0,20042,1,0.000012,16,0.214554,0.25087,67910.180688,0.11039,0.002641
205156,205156,,0,8,8,0,8,8,0,0.000032,0,21615,20,0.00001,13,0.169486,0.183334,0,0.392857,0
205157,205157,,2,3,5,2,3,5,0,0,0,21616,23,0.000014,14,0.14253,0.15155,9.833333,0.15,0.000445
205158,205158,,0,4,4,0,4,4,0,0,0,21617,23,0.00001,10,0.156964,0.191102,0,0.166667,0
205159,205159,,2,4,6,2,4,6,0.000008,0.000002,0,21618,5,0.000012,10,0.183713,0.20787,329.257144,0.066667,0.000451
205160,205160,,3,44,47,3,44,47,0.000123,0.023754,0,21619,1,0.000011,13,0.220503,0.25092,20272.556062,0.173451,0.000717
205161,205161,,9,20,29,9,20,29,0.000181,0.000404,0,21620,52,0.000013,14,0.197852,0.217245,12085.301936,0.147783,0.002125
9209068,9209068,,1,2,3,1,2,3,0.000001,0.000022,0,248,13,0.000011,1,1,1,8.724825,0,0.000314
205162,205162,,2,47,49,2,47,49,0.000127,0.004013,0,21621,0,0.000011,14,0.20945,0.241806,9689.637586,0.051446,0.000522
205163,205163,,3,29,32,3,29,32,0.000021,0.001624,0,21622,3,0.000011,13,0.208959,0.233654,9650.566805,0.176411,0.000664
205164,205164,,6,14,20,6,14,20,0.000507,0.018764,0,21623,1,0.000012,16,0.209206,0.242403,2835.409258,0.176316,0.00138
205165,205165,,5,25,30,5,25,30,0.000109,0.003695,0,21624,2,0.000012,15,0.200953,0.22559,7051.67793,0.196552,0.001182
205166,205166,,6,9,15,6,9,15,0.000095,0.000678,0,21625,0,0.000013,14,0.163135,0.178246,176.950105,0.314286,0.001361
205167,205167,,0,2,2,0,2,2,0,0.000001,0,21626,22,0.00001,15,0.132408,0.146499,0,0.5,0
205168,205168,,0,4,4,0,4,4,0,0.000004,0,21628,15,0.00001,16,0.160589,0.173181,0,0.083333,0
9806135,9806135,,1,7,8,1,7,8,0,0.000005,0,21627,15,0.000012,15,0.182345,0.204079,887.581443,0.285714,0.000219
205169,205169,,1,1,2,1,1,2,0,0,0,21629,6,0.000019,6,0.29932,0.337121,44,0,0.000219
205170,205170,,3,61,64,3,61,64,0.000025,0.000629,0,21630,9,0.00001,16,0.184971,0.216365,206.632919,0.200397,0.00067
205171,205171,,3,20,23,3,20,23,0.00009,0.019028,0,21631,4,0.000012,14,0.19281,0.218951,10452.563937,0.195652,0.001453
205172,205172,,3,10,13,3,10,13,0.000304,0.000357,0,21632,4,0.000011,16,0.17564,0.196613,10898.349691,0.262821,0.00069
205173,205173,,0,6,6,0,6,6,0,0.000002,0,21633,25,0.00001,14,0.166669,0.180922,0,0.3,0
205175,205175,,2,17,19,2,17,19,0.000001,0.000036,0,21635,22,0.000011,13,0.174061,0.187315,7783.4222,0.070175,0.000445
9308157,9308157,,1,0,1,1,0,1,0,0,0,21634,22,0.00001,0,0,0,0,0,0.000232
9512120,9512120,,2,0,2,2,0,2,0.000001,0,0,4006,22,0.000012,0,0,0,0,0,0.000476
9410213,9410213,,1,0,1,1,0,1,0,0,0,15452,22,0.000022,0,0,0,0,0,0.000233
205176,205176,,0,5,5,0,5,5,0,0.001111,0,21636,25,0.00001,15,0.184557,0.204088,0,0.1,0
205178,205178,,3,4,7,3,4,7,0,0.000002,0,21637,2,0.000017,13,0.186208,0.201783,18124,0.285714,0.000664
206100,206100,,13,12,25,13,12,25,0.000235,0.000173,0,19324,3,0.000013,14,0.18541,0.201547,6540.329617,0.34,0.003794
205187,205187,,18,93,111,18,93,111,0.002025,0.005444,0,21638,8,0.000021,16,0.21055,0.240502,74062.937489,0.106306,0.004129
205181,205181,,0,3,3,0,3,3,0,0,0,21639,6,0.00001,15,0.142941,0.152532,0,0.333333,0
205182,205182,,2,17,19,2,17,19,0.000004,0.000082,0,21640,28,0.000011,16,0.171018,0.187598,1496.922435,0.254386,0.000438
205184,205184,,11,25,36,11,25,36,0.000475,0.004678,0,20016,10,0.000013,16,0.196557,0.22496,4278.339184,0.146032,0.00304
205186,205186,,0,21,21,0,21,21,0,0.002261,0,21641,30,0.00001,14,0.192715,0.218653,0,0.228571,0
205188,205188,,10,38,48,10,38,48,0.0005,0.009876,0,21642,25,0.000013,15,0.187577,0.21481,9177.047468,0.164007,0.002371
207029,207029,,7,32,39,7,32,39,0.000254,0.0024,0,21644,25,0.000012,15,0.182825,0.207552,1463.820218,0.211876,0.00166
206155,206155,,10,38,48,10,38,48,0.000882,0.022384,0,21643,25,0.000013,15,0.208627,0.243894,33225.917399,0.12367,0.002451
205189,205189,,0,4,4,0,4,4,0,0.000527,0,21645,2,0.00001,14,0.186931,0.205601,0,0.166667,0
205190,205190,,3,38,41,3,38,41,0.000066,0.001421,0,21646,0,0.000011,14,0.195065,0.221119,3333.071491,0.161585,0.00069
205191,205191,,3,12,15,3,12,15,0.000079,0.000101,0,21647,8,0.000014,17,0.151447,0.164181,15395.872558,0.228571,0.000684
205192,205192,,1,12,13,1,12,13,0.000009,0.000639,0,21649,5,0.000011,14,0.193177,0.214223,5112.084456,0.108974,0.000219
9601042,9601042,,2,9,11,2,9,11,0.000017,0.000132,0,21648,5,0.000011,6,0.33463,0.38792,155.384175,0.109091,0.000445
205193,205193,,8,11,19,8,11,19,0.000184,0.001114,0,21650,30,0.000014,16,0.189176,0.206577,2224.637113,0.175439,0.001912
205194,205194,,2,10,12,2,10,12,0.000082,0.00052,0,21651,0,0.00001,14,0.186745,0.206822,595.150711,0.310606,0.000505
208012,208012,,2,23,25,2,23,25,0.00003,0.006344,0,21652,0,0.00001,14,0.187649,0.208208,755.805405,0.28,0.000511
205195,205195,,2,25,27,2,25,27,0.000009,0.000141,0,21653,25,0.000011,13,0.184528,0.201911,7217.789094,0.119658,0.000438
207051,207051,,3,18,21,3,18,21,0.000002,0.000104,0,21656,5,0.000012,15,0.170315,0.185012,9699.900681,0.22619,0.000677
205312,205312,,1,3,4,1,3,4,0.000001,0,0,21655,23,0.00001,10,0.173989,0.194563,139.849623,0.166667,0.000239
206229,206229,,3,16,19,3,16,19,0.000003,0.000069,0,21654,5,0.000012,15,0.170378,0.184989,2681.977761,0.25731,0.00069
205199,205199,,2,7,9,2,7,9,0,0.000005,0,21657,5,0.000011,17,0.159724,0.174023,10926.315381,0.041667,0.000438
205200,205200,,29,93,122,29,93,122,0.003267,0.015852,0,19317,41,0.000019,16,0.226947,0.260701,130693.829382,0.136431,0.008791
205201,205201,,0,15,15,0,15,15,0,0.021778,0,21658,1,0.00001,13,0.196389,0.217788,0,0.228571,0
205202,205202,,0,33,33,0,33,33,0,0.002593,0,21659,4,0.00001,16,0.178135,0.208817,0,0.161932,0
205203,205203,,3,10,13,3,10,13,0.000036,0.001549,0,21660,25,0.000012,13,0.193536,0.211813,929.518079,0.217949,0.000677
205204,205204,,29,50,79,29,50,79,0.003161,0.012858,0,20238,1,0.000024,15,0.216455,0.247884,89496.822745,0.117494,0.007068
205216,205216,,9,12,21,9,12,21,0.001121,0.001373,0,21661,1,0.000014,16,0.190929,0.213894,1405.618408,0.25,0.002167
205205,205205,,3,4,7,3,4,7,0.000019,0.00008,0,21662,5,0.000013,18,0.16533,0.181811,3333.04706,0.047619,0.000755
205206,205206,,0,11,11,0,11,11,0,0.000025,0,21663,0,0.00001,15,0.159391,0.177782,0,0.254545,0
205208,205208,,0,12,12,0,12,12,0,0.001361,0,21664,25,0.00001,16,0.17976,0.200498,0,0.44697,0
205211,205211,,6,17,23,6,17,23,0.000968,0.001228,0,21665,8,0.000012,14,0.188495,0.208188,1027.522425,0.15415,0.001381
205214,205214,,6,24,30,6,24,30,0.000071,0.001906,0,21666,30,0.000013,15,0.196721,0.216694,8042.50066,0.12069,0.001374
205215,205215,,2,14,16,2,14,16,0.000008,0.000002,0,21667,17,0.000011,17,0.147734,0.181635,9.32274,0.170833,0.000445
205217,205217,,3,10,13,3,10,13,0.000048,0.00014,0,21668,2,0.000011,20,0.152179,0.168758,68.02833,0.288462,0.000697
205219,205219,,0,14,14,0,14,14,0,0.015229,0,21670,41,0.00001,12,0.198774,0.219214,0,0.159341,0
9902194,9902194,,1,7,8,1,7,8,0.000179,0.015014,0,21669,1,0.00001,15,0.178051,0.202142,0,0.267857,0.000219
205220,205220,,6,35,41,6,35,41,0.000255,0.001846,0,21561,25,0.000012,16,0.186988,0.211291,1507.980741,0.179268,0.001441
205221,205221,,5,37,42,5,37,42,0.000738,0.019609,0,21671,1,0.000011,17,0.217537,0.25031,31328.223648,0.106852,0.001239
205222,205222,,4,29,33,4,29,33,0.000127,0.001905,0,21672,25,0.000011,15,0.194881,0.217261,6753.181195,0.204545,0.00091
205223,205223,,1,3,4,1,3,4,0,0.000008,0,21673,8,0.000019,14,0.16611,0.182356,5124,0.166667,0.000219
205226,205226,,0,1,1,0,1,1,0,0,0,21674,22,0.00001,2,0.666667,0.75,0,0,0
9312079,9312079,,3,1,4,3,1,4,0.000002,0,0,7849,22,0.000022,1,1,1,4852.17838,0.083333,0.00069
205227,205227,,17,52,69,17,52,69,0.001442,0.018181,0,21553,8,0.000019,13,0.219509,0.245081,52735.250528,0.152813,0.004303
205228,205228,,0,22,22,0,22,22,0,0.008115,0,21675,6,0.00001,17,0.217243,0.250231,0,0.108225,0
205229,205229,,1,7,8,1,7,8,0.000012,0.000005,0,21676,15,0.00001,15,0.153452,0.16321,3.5,0.267857,0.000219
205230,205230,,6,50,56,6,50,56,0.000198,0.006037,0,21677,25,0.000014,13,0.212177,0.246525,36458.426177,0.082468,0.001367
205231,205231,,0,17,17,0,17,17,0,0.001879,0,21678,25,0.00001,16,0.178757,0.199397,0,0.323529,0
205232,205232,,1,3,4,1,3,4,0,0.000001,0,21679,23,0.000019,19,0.120851,0.130342,4315,0.083333,0.000219
205233,205233,,7,20,27,7,20,27,0.000228,0.000466,0,21680,52,0.000013,14,0.184935,0.205802,5642.588271,0.068376,0.0016
205234,205234,,9,34,43,9,34,43,0.000228,0.000842,0,20081,4,0.000014,16,0.191043,0.217653,3196.745327,0.225914,0.003302
205235,205235,,0,9,9,0,9,9,0,0.001742,0,21681,13,0.00001,14,0.179083,0.199627,0,0.166667,0
205236,205236,,9,37,46,9,37,46,0.001472,0.018751,0,21682,1,0.000014,15,0.209483,0.24304,21810.289414,0.074396,0.002206
205237,205237,,0,14,14,0,14,14,0,0.000087,0,21683,30,0.00001,17,0.176002,0.19119,0,0.115385,0
205238,205238,,2,16,18,2,16,18,0,0.000004,0,21684,6,0.00001,15,0.122529,0.145338,327.430097,0.160131,0.000438
9203003,9203003,,3,0,3,3,0,3,0,0,0,5877,6,0.000022,0,0,0,0,0.5,0.000797
205239,205239,,0,2,2,0,2,2,0,0,0,21685,23,0.00001,3,0.545455,0.638889,0,0.5,0
205240,205240,,1,5,6,1,5,6,0.000005,0.000007,0,21686,4,0.00001,17,0.147892,0.165336,0,0.233333,0.000226
205242,205242,,4,10,14,4,10,14,0.000041,0.002098,0,21687,30,0.000012,14,0.214814,0.23802,14578.369864,0.131868,0.000896
205243,205243,,2,2,4,2,2,4,0,0,0,21689,23,0.000013,9,0.204233,0.221943,5,0.25,0.000451
9805024,9805024,,2,0,2,2,0,2,0.000005,0,0,21688,23,0.000016,0,0,0,0,0,0.000471
205244,205244,,25,28,53,25,28,53,0.004018,0.018174,0,21690,41,0.000019,17,0.19782,0.221736,15953.838196,0.240929,0.007117
205245,205245,,2,27,29,2,27,29,0.000003,0.000221,0,21691,13,0.000011,14,0.162671,0.181139,8809.43912,0.258621,0.000445
205247,205247,,2,19,21,2,19,21,0.000147,0.002037,0,21692,25,0.00001,13,0.192811,0.217546,1663.188343,0.121429,0.000471
205248,205248,,0,7,7,0,7,7,0,0.000804,0,21694,5,0.00001,13,0.184367,0.200202,0,0.142857,0
9810242,9810242,,1,3,4,1,3,4,0.000009,0.000009,0,21693,5,0.000011,4,0.423077,0.545455,0,0.5,0.000219
205249,205249,,3,4,7,3,4,7,0,0,0,21695,23,0.000014,16,0.122627,0.129307,0,0.47619,0.000677
205250,205250,,0,5,5,0,5,5,0,0.000005,0,21696,26,0.00001,16,0.152004,0.161238,0,0.15,0
205251,205251,,5,66,71,5,66,71,0.0006,0.025188,0,21697,8,0.000011,15,0.215699,0.245202,21073.765738,0.124346,0.001181
205252,205252,,0,7,7,0,7,7,0,0.000001,0,21698,26,0.00001,6,0.240741,0.342949,0,0.119048,0
205253,205253,,3,14,17,3,14,17,0.000133,0.000511,0,21699,30,0.000011,14,0.189884,0.211664,1076.434022,0.238971,0.00069
205254,205254,,7,43,50,7,43,50,0.000429,0.004937,0,21700,2,0.000012,18,0.206168,0.238133,20493.208572,0.11102,0.001804
205255,205255,,0,16,16,0,16,16,0,0.001574,0,21701,25,0.00001,16,0.180225,0.201952,0,0.375,0
205256,205256,,1,3,4,1,3,4,0,0.000001,0,21702,9,0.000011,14,0.173286,0.189587,12037.666667,0.166667,0.000219
205257,205257,,0,19,19,0,19,19,0,0.000048,0,21703,23,0.00001,14,0.161531,0.176498,0,0.105263,0
205258,205258,,27,26,53,27,26,53,0.00353,0.005905,0,21704,41,0.000018,14,0.197617,0.223972,15214.315022,0.134978,0.008109
205259,205259,,8,42,50,8,42,50,0.000339,0.001885,0,21577,0,0.000016,17,0.197831,0.224549,35068.863474,0.120816,0.001925
205261,205261,,0,9,9,0,9,9,0,0.000077,0,21705,4,0.00001,9,0.204247,0.241973,0,0.138889,0
205263,205263,,1,1,2,1,1,2,0,0,0,21706,0,0.000014,15,0.131749,0.140652,0,0.5,0.000219
205264,205264,,0,6,6,0,6,6,0,0.000045,0,21707,4,0.00001,15,0.175286,0.1907,0,0.2,0
205265,205265,,4,31,35,4,31,35,0.000088,0.005973,0,21708,2,0.000012,18,0.204095,0.227532,2390.032027,0.118487,0.000971
206185,206185,,2,20,22,2,20,22,0.000067,0.000155,0,21711,2,0.00001,18,0.197796,0.21797,776.893701,0.222944,0.000525
205274,205274,,1,18,19,1,18,19,0.000002,0.00041,0,21710,4,0.00001,14,0.181386,0.200267,705.070752,0.187135,0.000233
206041,206041,,4,11,15,4,11,15,0.000111,0.000528,0,21709,2,0.000012,18,0.188503,0.207213,262.647268,0.290476,0.001024
205266,205266,,15,61,76,15,61,76,0.001458,0.016163,0,21712,41,0.000014,16,0.219239,0.247118,12685.023643,0.258246,0.004573
205267,205267,,0,6,6,0,6,6,0,0.000098,0,21713,1,0.00001,15,0.169188,0.186773,0,0.433333,0
205268,205268,,1,2,3,1,2,3,0,0.000009,0,21714,15,0.000013,3,0.403509,0.449275,19.25,0,0.000219
205269,205269,,10,11,21,10,11,21,0.000237,0.002548,0,21715,30,0.000016,16,0.184578,0.202134,9366.997357,0.216667,0.002317
205270,205270,,18,13,31,18,13,31,0.002207,0.00392,0,21716,41,0.000016,17,0.199943,0.228587,15331.677397,0.292473,0.005905
205271,205271,,2,19,21,2,19,21,0.000023,0.000109,0,21718,8,0.000011,14,0.197002,0.217047,7438.581376,0.164286,0.000438
9608182,9608182,,3,3,6,3,3,6,0.000026,0.00074,0,21717,13,0.000014,5,0.336283,0.39386,131.213158,0.1,0.000677
205272,205272,,1,6,7,1,6,7,0,0.000076,0,21719,28,0.000011,11,0.174517,0.214237,9.15619,0.261905,0.000219
205273,205273,,1,18,19,1,18,19,0.000001,0.000041,0,21720,5,0.00001,14,0.187507,0.204236,1826.305229,0.152047,0.000226
205275,205275,,7,20,27,7,20,27,0.000062,0.000607,0,21721,3,0.000012,15,0.181373,0.199234,370.242458,0.304843,0.001661
205276,205276,,0,10,10,0,10,10,0,0.000986,0,21723,13,0.00001,15,0.188666,0.211911,0,0.055556,0
9703035,9703035,,1,2,3,1,2,3,0.000012,0.000045,0,21722,5,0.000011,1,1,1,2,0,0.000219
205277,205277,,10,11,21,10,11,21,0.000386,0.00129,0,21724,25,0.000015,14,0.184365,0.203634,3081.632969,0.211905,0.002349
205278,205278,,2,4,6,2,4,6,0.000112,0.00087,0,21725,8,0.000013,14,0.181853,0.200235,11611.017577,0.066667,0.000465
205279,205279,,46,54,100,46,54,100,0.005384,0.005404,0,21726,41,0.000034,16,0.218052,0.244385,57805.727857,0.196364,0.015901
205280,205280,,21,18,39,21,18,39,0.002896,0.019568,0,21727,41,0.000016,18,0.190487,0.221814,5077.218354,0.184211,0.005653
205281,205281,,5,28,33,5,28,33,0.000094,0.003827,0,21728,0,0.000013,16,0.200607,0.229148,10199.830494,0.083333,0.001135
205282,205282,,0,5,5,0,5,5,0,0.000187,0,21729,26,0.00001,17,0.176331,0.192888,0,0.2,0
205284,205284,,0,6,6,0,6,6,0,0.000003,0,21731,9,0.00001,13,0.159812,0.170904,0,0.133333,0
9912061,9912061,,1,6,7,1,6,7,0,0.000002,0,21730,9,0.000011,17,0.127653,0.13658,34.145303,0.238095,0.000219
205285,205285,,1,6,7,1,6,7,0.000039,0.000557,0,21732,2,0.00001,16,0.175753,0.195784,55.517494,0.380952,0.00024
205286,205286,,1,21,22,1,21,22,0.000011,0.001444,0,21733,30,0.000011,17,0.213,0.236739,4086.31151,0.227273,0.000246
205287,205287,,2,9,11,2,9,11,0.000004,0.000434,0,21734,30,0.000011,16,0.212627,0.23892,1502.636699,0.2,0.000438
9307068,9307068,,1,0,1,1,0,1,0.000013,0,0,19177,3,0.000011,0,0,0,0,0,0.000424
205289,205289,,0,3,3,0,3,3,0,0.000001,0,21735,23,0.00001,24,0.111708,0.123546,0,0.166667,0
9502008,9502008,,4,0,4,4,0,4,0.000002,0,0,11416,23,0.00002,0,0,0,0,0.166667,0.000903
205291,205291,,15,30,45,15,30,45,0.001427,0.004491,0,21736,41,0.000014,17,0.200225,0.224506,8033.748525,0.145455,0.00446
205292,205292,,1,11,12,1,11,12,0.000029,0.002005,0,19333,30,0.00001,15,0.179737,0.200786,1266.421743,0.280303,0.000327
205293,205293,,2,18,20,2,18,20,0.000013,0.001282,0,21737,10,0.000011,17,0.194871,0.219793,2464.523656,0.063158,0.000445
205294,205294,,3,31,34,3,31,34,0.000038,0.000973,0,21739,3,0.00001,15,0.20766,0.23309,9573.892239,0.109626,0.00074
9911038,9911038,,1,6,7,1,6,7,0.000011,0.00173,0,21738,3,0.00001,15,0.167091,0.186809,826.91604,0.166667,0.00024
205295,205295,,4,29,33,4,29,33,0.000105,0.001059,0,21740,0,0.000011,16,0.204147,0.23091,2311.506754,0.127841,0.001109
205296,205296,,9,23,32,9,23,32,0.00127,0.0031,0,21741,41,0.000012,17,0.201423,0.224799,39698.883365,0.183468,0.002411
205297,205297,,30,29,59,30,29,59,0.001519,0.002144,0,20079,4,0.000031,15,0.196905,0.222802,17721.898456,0.111338,0.011269
205298,205298,,3,21,24,3,21,24,0.00035,0.000802,0,21742,9,0.000012,12,0.202422,0.225524,3024.593082,0.130435,0.000672
205299,205299,,5,60,65,5,60,65,0.000081,0.008733,0,21743,25,0.000014,12,0.2185,0.248858,24427.857729,0.09976,0.001214
205300,205300,,9,20,29,9,20,29,0.000277,0.002267,0,20012,0,0.000013,15,0.192718,0.218535,8791.815162,0.14532,0.002597
205301,205301,,16,56,72,16,56,72,0.000506,0.021023,0,20080,4,0.000017,17,0.203584,0.237434,57157.272729,0.111502,0.00679
205302,205302,,8,32,40,8,32,40,0.000823,0.005223,0,21744,41,0.000012,13,0.21067,0.241735,1782.594348,0.264744,0.002173
205303,205303,,13,61,74,13,61,74,0.001334,0.006188,0,21745,41,0.000012,17,0.21607,0.244364,6076.540077,0.235468,0.003585
205304,205304,,3,10,13,3,10,13,0,0.000005,0,21746,5,0.000013,14,0.156642,0.170508,3135.85885,0.102564,0.00067
205305,205305,,1,15,16,1,15,16,0.000008,0.007267,0,21747,25,0.00001,15,0.195186,0.219663,583.858078,0.133333,0.000232
205306,205306,,1,95,96,1,95,96,0.000048,0.023982,0,21748,2,0.00001,14,0.232351,0.272589,19837.089853,0.045833,0.000259
205307,205307,,4,4,8,4,4,8,0.000026,0.000036,0,21749,4,0.000015,18,0.161585,0.179029,37698.83089,0.071429,0.000896
205308,205308,,3,9,12,3,9,12,0.000189,0.002145,0,21750,4,0.00001,16,0.156179,0.172542,23.817793,0.310606,0.001036
205309,205309,,1,10,11,1,10,11,0.000017,0.000201,0,21751,2,0.00001,18,0.194398,0.213426,683.687678,0.072727,0.000219
205310,205310,,1,19,20,1,19,20,0.000018,0.000185,0,21754,5,0.000011,15,0.199801,0.223473,1328.536657,0.039474,0.000219
9603014,9603014,,3,1,4,3,1,4,0.000042,0,0,7396,5,0.000015,1,1,1,1.5,0.166667,0.000677
9906074,9906074,,3,2,5,3,2,5,0.000003,0.000005,0,21753,5,0.000012,16,0.149963,0.162547,967.282243,0,0.000684
9811187,9811187,,1,0,1,1,0,1,0,0,0,21752,5,0.000015,0,0,0,0,0,0.000239
205311,205311,,44,69,113,44,69,113,0.004785,0.020444,0,21755,41,0.000036,16,0.222772,0.250284,102452.796896,0.191846,0.015294
205314,205314,,33,20,53,33,20,53,0.003633,0.00332,0,21756,41,0.000021,14,0.192923,0.21755,10789.046132,0.154572,0.009454
206033,206033,,34,25,59,34,25,59,0.003732,0.020902,0,21757,41,0.000022,14,0.208263,0.240331,45580.397376,0.156634,0.009323
206045,206045,,34,55,89,34,55,89,0.003605,0.023231,0,21758,41,0.000021,18,0.207317,0.240231,59099.504732,0.11121,0.009046
205317,205317,,2,35,37,2,35,37,0.000049,0.004591,0,21759,25,0.00001,11,0.243477,0.278896,2709.859529,0.083333,0.000458
205318,205318,,3,2,5,3,2,5,0.00024,0.000335,0,21760,8,0.000013,13,0.186393,0.202373,333.835927,0.3,0.000677
205319,205319,,1,2,3,1,2,3,0.000203,0.000227,0,21761,1,0.00001,12,0.18976,0.207132,47.827771,0.166667,0.000219
205320,205320,,4,19,23,4,19,23,0.000124,0.003522,0,21762,25,0.000012,17,0.176856,0.200161,9398.541093,0.20751,0.000936
205321,205321,,21,88,109,21,88,109,0.002195,0.01163,0,21763,1,0.000017,17,0.218757,0.253248,67850.103365,0.101342,0.006291
205322,205322,,1,14,15,1,14,15,0,0.00001,0,21764,9,0.000011,14,0.164291,0.183799,63.020421,0.138095,0.000219
206002,206002,,1,18,19,1,18,19,0.000021,0.008565,0,21765,25,0.00001,15,0.19641,0.218318,116.273068,0.201754,0.000226
206003,206003,,4,14,18,4,14,18,0.000047,0.000897,0,21766,30,0.000011,18,0.193175,0.213281,3717.528775,0.176471,0.000916
206004,206004,,4,5,9,4,5,9,0.000066,0.000007,0,21768,8,0.000021,14,0.141111,0.153574,14954.71145,0.152778,0.000903
205046,205046,,7,0,7,7,0,7,0.000066,0,0,21767,8,0.000039,0,0,0,0,0.190476,0.001586
206005,206005,,43,25,68,43,25,68,0.004005,0.019915,0,21769,41,0.000035,17,0.215848,0.245458,79689.600884,0.245391,0.014511
206006,206006,,1,54,55,1,54,55,0.000001,0.002436,0,21771,30,0.000011,14,0.212565,0.239903,5631.171433,0.061616,0.000239
9912170,9912170,,2,4,6,2,4,6,0.000029,0.000025,0,21770,22,0.000011,18,0.124469,0.133994,12.269235,0.366667,0.000445
9605072,9605072,,2,3,5,2,3,5,0.000001,0.000001,0,8664,30,0.000012,3,0.555556,0.633333,13.008785,0.15,0.000478
9607094,9607094,,3,6,9,3,6,9,0.000001,0.000012,0,8663,30,0.000014,3,0.560976,0.623188,75.14437,0.236111,0.000704
206007,206007,,2,33,35,2,33,35,0.00001,0.002404,0,21772,30,0.000012,17,0.210902,0.236793,6645.593162,0.097479,0.000458
206009,206009,,2,20,22,2,20,22,0.000341,0.002748,0,21773,30,0.00001,14,0.215531,0.238922,4553.995703,0.214286,0.000486
206010,206010,,19,86,105,19,86,105,0.001708,0.007149,0,21774,41,0.000017,16,0.226184,0.254772,52845.514147,0.1663,0.004728
206011,206011,,6,24,30,6,24,30,0.000064,0.003314,0,21775,30,0.000015,17,0.191929,0.213389,8302.476417,0.202299,0.001361
206012,206012,,2,9,11,2,9,11,0.00005,0.001253,0,20047,52,0.00001,17,0.176825,0.194029,1521.186995,0.3,0.000506
206014,206014,,4,9,13,4,9,13,0.000062,0.000988,0,21777,30,0.000012,13,0.192141,0.209341,892.702876,0.147436,0.000922
106119,106119,,1,0,1,1,0,1,0.000012,0,0,21776,30,0.000011,0,0,0,0,0,0.000246
206015,206015,,0,5,5,0,5,5,0,0,0,21778,6,0.00001,3,0.578947,0.69697,0,0.15,0
206016,206016,,3,32,35,3,32,35,0.000086,0.003568,0,21779,25,0.000011,18,0.172999,0.198798,2075.323278,0.182353,0.000684
206017,206017,,53,11,64,53,11,64,0.001838,0.001937,0,20078,4,0.000034,15,0.186535,0.211268,35888.595761,0.182044,0.020068
206018,206018,,5,21,26,5,21,26,0.000062,0.00145,0,21780,30,0.000014,17,0.189187,0.208223,5763.899102,0.150769,0.001142
206019,206019,,0,9,9,0,9,9,0,0.000231,0,21781,30,0.00001,14,0.182455,0.197082,0,0.291667,0
206020,206020,,7,37,44,7,37,44,0.00059,0.019647,0,21782,1,0.000012,18,0.203433,0.236081,10244.73046,0.19926,0.002168
206021,206021,,0,3,3,0,3,3,0,0,4,21783,16,0.00001,2,0.636364,0.714286,0,0.333333,0
206022,206022,,0,2,2,0,2,2,0,0,0,21784,20,0.00001,19,0.151519,0.16275,0,0,0
206023,206023,,0,13,13,0,13,13,0,0.001058,0,21785,30,0.00001,14,0.189149,0.206562,0,0.262821,0
206024,206024,,4,15,19,4,15,19,0.000064,0.001461,0,21786,25,0.000012,13,0.19627,0.217482,3773.983884,0.22807,0.000928
206025,206025,,0,16,16,0,16,16,0,0.000651,0,21787,3,0.00001,16,0.187995,0.207689,0,0.245833,0
206026,206026,,5,7,12,5,7,12,0.00021,0.000041,0,21788,1,0.000012,15,0.168468,0.1823,732.267452,0.19697,0.001209
206027,206027,,0,3,3,0,3,3,0,0.000024,0,21789,1,0.00001,13,0.170397,0.182268,0,0,0
206028,206028,,2,2,4,2,2,4,0.000016,0.000003,0,21790,1,0.000011,2,0.666667,0.75,5,0.25,0.000465
206029,206029,,5,89,94,5,89,94,0.000506,0.005742,0,21791,41,0.000011,16,0.228139,0.257557,20514.994234,0.182338,0.001444
206031,206031,,2,24,26,2,24,26,0.000013,0.000658,0,21792,25,0.000011,17,0.176039,0.198927,1508.654717,0.144615,0.000438
206032,206032,,1,16,17,1,16,17,0.000608,0.003811,0,21793,13,0.00001,15,0.189183,0.212444,174.167916,0.051471,0.000245
206034,206034,,3,5,8,3,5,8,0,0,0,21794,23,0.000014,16,0.122653,0.129442,3,0.357143,0.000677
206035,206035,,3,17,20,3,17,20,0.000035,0.001,0,21795,30,0.000015,16,0.190066,0.208618,12338.819869,0.15,0.000684
206036,206036,,0,3,3,0,3,3,0,0,0,21796,6,0.00001,16,0.135917,0.143714,0,0.5,0
206037,206037,,0,2,2,0,2,2,0,0.000002,0,21797,22,0.00001,13,0.165821,0.177062,0,0.5,0
206039,206039,,0,4,4,0,4,4,0,0.000004,0,21798,23,0.00001,14,0.167678,0.178814,0,0.166667,0
206040,206040,,0,1,1,0,1,1,0,0,0,21803,30,0.00001,3,0.5,0.583333,0,0,0
9812243,9812243,,1,2,3,1,2,3,0,0,0,21802,30,0.000019,2,0.75,0.833333,3,0.166667,0.000219
9212102,9212102,,2,0,2,2,0,2,0,0,0,21799,30,0.000026,0,0,0,0,0.5,0.000451
9310052,9310052,,1,2,3,1,2,3,0,0,0,21801,30,0.000018,1,1,1,2,0.166667,0.000226
206042,206042,,4,28,32,4,28,32,0.000007,0.001582,0,21804,25,0.000017,13,0.202093,0.222211,25482.197048,0.118952,0.000903
206044,206044,,2,13,15,2,13,15,0.000004,0.001267,0,21805,25,0.000013,13,0.190369,0.208847,4324.015993,0.180952,0.000445
206043,206043,,0,18,18,0,18,18,0,0.000833,0,21806,2,0.00001,16,0.14939,0.171872,0,0.22549,0
206046,206046,,2,11,13,2,11,13,0.000015,0.001531,0,21807,25,0.000014,17,0.179071,0.20194,6331.567246,0.134615,0.000451
206047,206047,,2,10,12,2,10,12,0.000008,0.00003,0,21808,5,0.000013,15,0.161264,0.172756,5988.280124,0.143939,0.000438
206048,206048,,0,2,2,0,2,2,0,0,0,21809,30,0.00001,15,0.140818,0.14913,0,0,0
206049,206049,,9,6,15,9,6,15,0.000337,0.00049,0,19336,13,0.000019,19,0.165289,0.181828,12964.104615,0.104762,0.002389
106219,106219,,1,0,1,1,0,1,0.000006,0,0,19335,13,0.000013,0,0,0,0,0,0.000283
206050,206050,,1,18,19,1,18,19,0.000128,0.002711,0,21810,25,0.00001,14,0.200791,0.22376,1516.1323,0.084795,0.000226
206051,206051,,4,23,27,4,23,27,0.000133,0.00662,0,21811,4,0.000013,13,0.205615,0.235646,5107.399536,0.131054,0.001317
206052,206052,,3,24,27,3,24,27,0.000156,0.00235,0,21813,41,0.00001,16,0.198845,0.224867,10776.790941,0.109687,0.000873
205040,205040,,6,0,6,6,0,6,0.000123,0,0,21812,41,0.000015,0,0,0,0,0.1,0.001557
206053,206053,,5,3,8,5,3,8,0,0.000001,0,21814,23,0.000014,19,0.155746,0.164921,19245.175033,0.142857,0.001143
206054,206054,,2,7,9,2,7,9,0.000048,0.001415,0,21815,4,0.000011,15,0.165047,0.188094,741.83585,0.305556,0.000445
206055,206055,,0,6,6,0,6,6,0,0.000007,0,21816,23,0.00001,15,0.154401,0.170683,0,0.233333,0
206056,206056,,0,1,1,0,1,1,0,0,0,21817,23,0.00001,8,0.178336,0.19739,0,0,0
206058,206058,,1,28,29,1,28,29,0.000008,0.001554,0,21818,30,0.00001,17,0.213134,0.236866,5149.552425,0.232759,0.000219
206059,206059,,51,24,75,51,24,75,0.004605,0.003873,0,21819,41,0.000034,17,0.201037,0.222913,29284.537776,0.195315,0.016287
9707048,9707048,,9,6,15,9,6,15,0.000466,0.000093,0,6178,26,0.000019,4,0.423529,0.497685,5647.295777,0.080952,0.002765
206060,206060,,0,33,33,0,33,33,0,0.000607,0,21820,30,0.00001,13,0.213255,0.235399,0,0.160038,0
206061,206061,,0,1,1,0,1,1,0,0,32,21822,55,0.00001,1,1,1,0,0,0
9805057,9805057,,1,0,1,1,0,1,0,0,32,21821,55,0.000019,0,0,0,0,0,0.000219
206062,206062,,10,88,98,10,88,98,0.001098,0.013288,0,21823,41,0.000013,16,0.233387,0.265938,49972.717932,0.192615,0.002741
206063,206063,,16,146,162,16,146,162,0.001582,0.034184,0,21824,4,0.000018,14,0.249344,0.2902,205587.586235,0.0513,0.004193
206064,206064,,2,34,36,2,34,36,0.000033,0.000743,0,21825,0,0.000011,16,0.188202,0.214502,9758.076141,0.107143,0.000451
206065,206065,,31,20,51,31,20,51,0.003241,0.018074,0,21826,41,0.000024,17,0.199673,0.220926,2311.644871,0.280392,0.010155
206073,206073,,50,15,65,50,15,65,0.005216,0.001887,0,21827,41,0.000034,17,0.19648,0.215846,4414.803613,0.261538,0.015619
206194,206194,,3,21,24,3,21,24,0.000158,0.002207,0,21828,41,0.00001,17,0.204363,0.2315,1806.779397,0.153986,0.00084
206221,206221,,27,25,52,27,25,52,0.002587,0.003353,0,21830,41,0.000023,17,0.198899,0.220321,6926.392581,0.245475,0.008527
206079,206079,,58,11,69,58,11,69,0.006854,0.001554,0,21829,41,0.000035,17,0.188165,0.207665,6436.502447,0.148977,0.017061
206066,206066,,5,13,18,5,13,18,0.000085,0.001714,0,21831,30,0.000013,13,0.208438,0.228712,5648.677176,0.202614,0.001129
206067,206067,,0,2,2,0,2,2,0,0,4,21832,16,0.00001,3,0.466667,0.571429,0,0.5,0
206069,206069,,0,13,13,0,13,13,0,0.000741,0,21833,2,0.00001,14,0.178465,0.199458,0,0.358974,0
206070,206070,,23,27,50,23,27,50,0.001493,0.013228,0,21834,41,0.000019,19,0.204487,0.241681,30653.228582,0.173469,0.006307
206071,206071,,1,53,54,1,53,54,0.000267,0.021903,0,21835,1,0.00001,13,0.212344,0.246305,2900.245187,0.116352,0.000248
206072,206072,,1,46,47,1,46,47,0.000018,0.004605,0,21836,52,0.00001,18,0.198299,0.23411,2037.958562,0.122572,0.000226
208178,208178,,50,29,79,50,29,79,0.005388,0.002426,0,21843,41,0.000029,17,0.199737,0.220746,25149.830196,0.214378,0.014374
206167,206167,,19,32,51,19,32,51,0.001562,0.004041,0,21840,41,0.000018,17,0.210084,0.233771,43356.555001,0.256863,0.006228
206248,206248,,14,34,48,14,34,48,0.00089,0.019524,0,21841,41,0.000017,17,0.2106,0.235249,26383.845484,0.249557,0.0051
207067,207067,,7,23,30,7,23,30,0.000535,0.002829,0,21837,41,0.000013,17,0.20078,0.222339,11260.649843,0.255172,0.002338
208010,208010,,14,25,39,14,25,39,0.001512,0.019152,0,21842,41,0.000015,17,0.214508,0.243544,13600.33842,0.264507,0.004374
208041,208041,,29,19,48,29,19,48,0.002677,0.002935,0,21838,41,0.000022,17,0.195103,0.214882,1641.719719,0.293883,0.008989
208148,208148,,30,22,52,30,22,52,0.002498,0.017458,0,21839,41,0.000022,17,0.195903,0.217054,3271.630354,0.265083,0.009067
206074,206074,,0,7,7,0,7,7,0,0.000023,0,21844,23,0.00001,15,0.13596,0.149972,0,0.357143,0
206075,206075,,4,24,28,4,24,28,0.000166,0.003956,0,21845,30,0.000011,15,0.193887,0.216704,926.5128,0.185185,0.000944
206076,206076,,0,10,10,0,10,10,0,0.000003,0,21848,6,0.00001,14,0.143096,0.154626,0,0.077778,0
9208061,9208061,,2,0,2,2,0,2,0,0,0,21847,6,0.00002,0,0,0,0,0,0.000438
9303118,9303118,,2,0,2,2,0,2,0,0,0,21846,6,0.000012,0,0,0,0,0,0.000458
206077,206077,,1,23,24,1,23,24,0.000011,0.002363,0,21849,30,0.000011,16,0.208899,0.231238,2660.318734,0.199275,0.000219
206078,206078,,3,9,12,3,9,12,0,0.000448,0,21850,6,0.000031,16,0.209642,0.236521,45959.521625,0.05303,0.00069
206080,206080,,1,22,23,1,22,23,0.000005,0.011967,0,21851,1,0.000011,16,0.191694,0.219034,1941.444198,0.118577,0.000251
206081,206081,,0,25,25,0,25,25,0,0.024261,0,21852,1,0.00001,16,0.2037,0.240016,0,0.21,0
206082,206082,,1,6,7,1,6,7,0,0.000009,0,21853,23,0.000012,15,0.14762,0.174646,1576.009295,0.142857,0.000219
206083,206083,,0,4,4,0,4,4,0,0.000041,0,21854,30,0.00001,14,0.157199,0.166637,0,0.083333,0
206084,206084,,1,14,15,1,14,15,0.000057,0.014313,0,21855,1,0.000011,15,0.207585,0.239445,1864.916594,0.261905,0.000226
206085,206085,,0,14,14,0,14,14,0,0.000614,0,21856,1,0.00001,15,0.153429,0.167516,0,0.230769,0
206086,206086,,3,18,21,3,18,21,0.000008,0.000024,0,21857,17,0.000012,13,0.165563,0.180741,15439.852279,0.216667,0.000684
206088,206088,,4,2,6,4,2,6,0.000001,0.00001,0,21858,0,0.00004,14,0.1609,0.172606,43685.834799,0.066667,0.00091
206089,206089,,10,24,34,10,24,34,0.000206,0.002178,0,21859,25,0.000017,13,0.199972,0.22137,22177.351746,0.143494,0.002263
206090,206090,,24,27,51,24,27,51,0.001527,0.005969,0,21860,41,0.000019,18,0.207834,0.234768,32201.750183,0.20549,0.006544
206091,206091,,2,28,30,2,28,30,0.000017,0.001094,0,21861,41,0.00001,18,0.19173,0.215964,10555.275582,0.131034,0.000451
206092,206092,,0,32,32,0,32,32,0,0.002988,0,21862,3,0.00001,14,0.205634,0.232778,0,0.100806,0
206093,206093,,0,7,7,0,7,7,0,0.000001,0,21863,6,0.00001,16,0.120009,0.131214,0,0.095238,0
206094,206094,,4,66,70,4,66,70,0.000506,0.022702,0,21864,41,0.000011,16,0.222376,0.249737,9449.914546,0.202484,0.001094
206095,206095,,0,24,24,0,24,24,0,0.00014,0,21865,30,0.00001,14,0.190307,0.207918,0,0.152174,0
206096,206096,,2,5,7,2,5,7,0.000235,0.001058,0,21546,8,0.000012,14,0.185374,0.204367,522.771196,0.285714,0.000525
206097,206097,,1,18,19,1,18,19,0.000009,0.002139,0,21867,30,0.00001,15,0.19415,0.216948,135.978915,0.157895,0.000219
9705126,9705126,,1,11,12,1,11,12,0.000025,0.004201,0,21866,2,0.00001,14,0.175501,0.215206,241.417236,0.083333,0.000226
206098,206098,,4,25,29,4,25,29,0.000995,0.021855,0,21868,1,0.000011,14,0.201715,0.235917,732.813814,0.240148,0.000949
206101,206101,,2,15,17,2,15,17,0.000074,0.000433,0,21869,3,0.000011,15,0.19048,0.210283,1677.18934,0.102941,0.000458
206103,206103,,16,41,57,16,41,57,0.002567,0.021453,0,21870,41,0.000015,17,0.207543,0.232793,24582.881377,0.188283,0.004191
206104,206104,,9,44,53,9,44,53,0.000131,0.00075,0,21874,2,0.000017,16,0.190458,0.217066,68188.646629,0.112119,0.002236
9504160,9504160,,2,16,18,2,16,18,0.000009,0.000124,0,21872,9,0.000011,6,0.295409,0.3375,1209.678535,0.147059,0.000508
9512201,9512201,,1,10,11,1,10,11,0.000009,0.000031,0,21873,9,0.00001,13,0.192384,0.231822,455.987853,0.1,0.000281
9411150,9411150,,4,3,7,4,3,7,0.00001,0.000018,0,21871,9,0.000013,5,0.342105,0.387949,25,0.261905,0.000898
9307176,9307176,,6,6,12,6,6,12,0.000002,0.000074,0,6594,9,0.000018,4,0.338583,0.430233,685.479965,0.143939,0.00142
206105,206105,,0,6,6,0,6,6,0,0.000443,0,21875,8,0.00001,14,0.185238,0.201165,0,0.1,0
206106,206106,,6,10,16,6,10,16,0.000079,0.001355,0,21876,25,0.000013,15,0.181968,0.201718,12005.019994,0.2625,0.001542
206107,206107,,13,30,43,13,30,43,0.001307,0.019363,0,19320,41,0.000014,17,0.198633,0.224962,68489.472017,0.152824,0.003397
206109,206109,,2,20,22,2,20,22,0.00003,0.001782,0,21877,52,0.00001,16,0.197434,0.224242,93.215436,0.175325,0.000445
206110,206110,,0,12,12,0,12,12,0,0.001298,0,21878,2,0.00001,16,0.163167,0.183993,0,0.159091,0
206111,206111,,4,9,13,4,9,13,0,0.000002,0,21879,23,0.000015,16,0.133018,0.14404,345.968578,0.224359,0.000996
206112,206112,,1,21,22,1,21,22,0.000006,0.000253,0,21880,0,0.00001,18,0.179998,0.203187,96.987825,0.225108,0.000265
206113,206113,,0,15,15,0,15,15,0,0.001957,0,21881,8,0.00001,13,0.190325,0.207795,0,0.138095,0
206114,206114,,2,5,7,2,5,7,0,0.000003,0,21882,5,0.000013,10,0.152605,0.178816,8.333333,0.261905,0.000438
206115,206115,,20,27,47,20,27,47,0.000477,0.000934,0,20008,0,0.000017,16,0.192371,0.221601,5451.387207,0.19519,0.005142
206116,206116,,1,26,27,1,26,27,0,0.007248,0,21883,2,0.000011,18,0.208194,0.238447,3696.369567,0.143875,0.000219
206117,206117,,1,3,4,1,3,4,0.000007,0.000219,0,21884,8,0.000011,14,0.168503,0.182818,2087.517456,0.25,0.000252
206118,206118,,6,41,47,6,41,47,0.000533,0.004932,0,21885,1,0.000012,14,0.203016,0.230152,12664.198889,0.116096,0.001457
206119,206119,,2,2,4,2,2,4,0.000017,0.000008,0,21886,2,0.000011,17,0.15757,0.169799,108.06582,0.25,0.000451
206121,206121,,0,3,3,0,3,3,0,0,0,21887,26,0.00001,3,0.583333,0.690476,0,0.5,0
206122,206122,,0,5,5,0,5,5,0,0.000002,0,21888,2,0.00001,13,0.186225,0.201871,0,0.35,0
206123,206123,,1,20,21,1,20,21,0.000005,0.000626,0,21889,3,0.00001,14,0.18625,0.20505,273.732011,0.233333,0.000219
206124,206124,,0,5,5,0,5,5,0,0.000002,0,21890,23,0.00001,15,0.137555,0.156376,0,0.3,0
206125,206125,,3,8,11,3,8,11,0.000071,0.000279,0,21891,13,0.000011,12,0.186867,0.20813,149.094115,0.254545,0.000704
206126,206126,,10,26,36,10,26,36,0.00097,0.018497,0,21892,2,0.000016,16,0.210942,0.245068,43540.534388,0.116667,0.002349
206127,206127,,2,11,13,2,11,13,0.000034,0.001872,0,21893,23,0.000011,18,0.131303,0.146154,1,0.282051,0.000445
206128,206128,,3,16,19,3,16,19,0.000052,0.018525,0,21894,25,0.000012,16,0.182729,0.205532,995.314834,0.190058,0.00069
206129,206129,,3,19,22,3,19,22,0.000007,0.000408,0,21895,4,0.000012,16,0.175151,0.196645,1938.421753,0.077922,0.000658
206130,206130,,3,2,5,3,2,5,0.000008,0,0,21896,15,0.000015,17,0.161221,0.175923,28332.175428,0,0.000677
206131,206131,,20,19,39,20,19,39,0.001946,0.002257,0,21897,41,0.000014,16,0.207054,0.22805,10307.837404,0.288799,0.00522
206132,206132,,17,14,31,17,14,31,0.001282,0.00383,0,21898,41,0.000017,19,0.191568,0.216829,1251.926579,0.297849,0.004617
206133,206133,,3,4,7,3,4,7,0.000001,0,0,21899,22,0.000016,8,0.201835,0.270563,59.224359,0.214286,0.00067
206134,206134,,1,13,14,1,13,14,0,0.000008,0,21900,6,0.00001,17,0.12682,0.146179,227.572591,0.120879,0.000226
206135,206135,,0,2,2,0,2,2,0,0.000043,0,21902,41,0.00001,1,1,1,0,0,0
204131,204131,,4,0,4,4,0,4,0.000411,0,0,21901,41,0.000024,0,0,0,0,0,0.00091
206136,206136,,5,3,8,5,3,8,0.000076,0.000223,0,21903,13,0.000013,20,0.143948,0.156832,151.685125,0.178571,0.001239
206137,206137,,2,23,25,2,23,25,0.000024,0.003029,0,21904,30,0.000011,14,0.212929,0.236069,5758.799452,0.218333,0.000438
206138,206138,,5,26,31,5,26,31,0.000051,0.000575,0,21905,0,0.000012,15,0.203817,0.229857,6777.367553,0.191398,0.00123
206139,206139,,2,8,10,2,8,10,0.000063,0.000266,0,21906,26,0.00001,15,0.173582,0.188983,53.48419,0.166667,0.000465
206141,206141,,7,68,75,7,68,75,0.00087,0.012642,0,21907,1,0.000011,19,0.204932,0.241135,22805.08614,0.123423,0.001727
206142,206142,,0,3,3,0,3,3,0,0.000046,0,21908,30,0.00001,11,0.162737,0.17559,0,0.5,0
206143,206143,,0,8,8,0,8,8,0,0.000003,0,21909,5,0.00001,10,0.157063,0.192102,0,0.285714,0
206144,206144,,1,21,22,1,21,22,0.000002,0.002193,0,21910,2,0.000012,16,0.195665,0.222552,675.86684,0.106061,0.000219
206145,206145,,1,26,27,1,26,27,0,0.000017,0,21911,20,0.000011,15,0.169626,0.18998,3024.873469,0.176638,0.000219
206146,206146,,7,7,14,7,7,14,0.000648,0.001681,0,21560,25,0.000014,17,0.175874,0.198215,444.483737,0.269231,0.001687
206147,206147,,5,28,33,5,28,33,0.000067,0.003951,0,21912,25,0.000012,14,0.210284,0.243861,11613.217125,0.116477,0.001136
206148,206148,,4,30,34,4,30,34,0.000125,0.001142,0,21913,2,0.000012,16,0.193246,0.22031,5510.941362,0.118538,0.00093
206149,206149,,5,15,20,5,15,20,0.000249,0.000163,0,21557,8,0.000012,14,0.196054,0.215024,664.206798,0.334211,0.001241
206151,206151,,3,23,26,3,23,26,0.000033,0.000485,0,20087,10,0.000011,15,0.199976,0.224116,3682.996982,0.203077,0.000713
206152,206152,,8,38,46,8,38,46,0.000481,0.002615,0,20048,52,0.000013,14,0.203897,0.231575,8604.819363,0.133333,0.001989
206153,206153,,2,15,17,2,15,17,0.000016,0.001943,0,21914,1,0.000014,16,0.196284,0.221205,12426.593161,0.099265,0.000438
206154,206154,,5,65,70,5,65,70,0.000223,0.018684,0,21915,10,0.000013,13,0.216771,0.247902,51425.980712,0.114907,0.001149
206156,206156,,0,2,2,0,2,2,0,0,29,21916,51,0.00001,1,1,1,0,0.5,0
206157,206157,,0,12,12,0,12,12,0,0.002139,0,21917,30,0.00001,17,0.185452,0.205666,0,0.272727,0
206158,206158,,2,36,38,2,36,38,0.000075,0.004575,0,21918,3,0.000011,15,0.198914,0.227324,6151.068317,0.190612,0.000445
206159,206159,,3,1,4,3,1,4,0.000265,0.000033,0,21919,13,0.000012,15,0.156814,0.169434,13.615071,0.25,0.000727
206160,206160,,0,9,9,0,9,9,0,0.000008,0,21920,23,0.00001,14,0.133948,0.147247,0,0.152778,0
206161,206161,,17,50,67,17,50,67,0.001406,0.00702,0,21921,4,0.000017,15,0.215287,0.24538,81635.714717,0.083673,0.006687
206162,206162,,0,3,3,0,3,3,0,0.00002,0,21922,13,0.00001,17,0.128405,0.145027,0,0.166667,0
206163,206163,,9,36,45,9,36,45,0.000527,0.000851,0,20083,4,0.000015,16,0.191036,0.217655,4343.245195,0.214141,0.003841
206164,206164,,16,49,65,16,49,65,0.001255,0.002689,0,20082,4,0.000018,16,0.195785,0.227677,43806.331199,0.130288,0.006213
206165,206165,,3,15,18,3,15,18,0.000103,0.000304,0,21923,0,0.000011,15,0.19663,0.22246,6435.491312,0.176471,0.000677
206166,206166,,14,20,34,14,20,34,0.001227,0.003945,0,21924,41,0.000014,17,0.196655,0.220217,33578.128081,0.168449,0.003512
206168,206168,,0,3,3,0,3,3,0,0.000002,0,21925,26,0.00001,17,0.126431,0.134563,0,0,0
206169,206169,,0,16,16,0,16,16,0,0.000234,0,21926,2,0.00001,12,0.191111,0.210537,0,0.120833,0
206170,206170,,0,12,12,0,12,12,0,0.001131,0,21927,30,0.00001,14,0.209474,0.230516,0,0.242424,0
206171,206171,,0,22,22,0,22,22,0,0.000849,0,21928,3,0.00001,14,0.196923,0.222278,0,0.142857,0
206172,206172,,0,7,7,0,7,7,0,0.000043,0,21929,4,0.00001,16,0.166465,0.190004,0,0.5,0
206173,206173,,7,52,59,7,52,59,0.000002,0.000579,0,21933,23,0.000014,15,0.183605,0.206261,93203.334547,0.097312,0.001647
9903251,9903251,,1,10,11,1,10,11,0.000007,0.000074,0,21932,23,0.00001,13,0.166586,0.189438,71.212024,0.127273,0.000266
9902027,9902027,,2,4,6,2,4,6,0.000001,0.000008,0,21930,23,0.00002,14,0.148259,0.169597,1529,0.233333,0.000452
9903060,9903060,,1,1,2,1,1,2,0.000001,0,0,21931,23,0.000011,15,0.12919,0.142166,0,0.5,0.000226
206174,206174,,0,15,15,0,15,15,0,0.003097,0,21934,3,0.00001,16,0.176295,0.199193,0,0.285714,0
206176,206176,,0,24,24,0,24,24,0,0.00177,0,21935,41,0.00001,17,0.20196,0.223503,0,0.172101,0
206178,206178,,1,10,11,1,10,11,0.000002,0.0001,0,21936,2,0.000012,13,0.174294,0.192641,2097.279779,0.218182,0.000226
206179,206179,,0,9,9,0,9,9,0,0.000108,0,21938,13,0.00001,16,0.130586,0.155245,0,0.152778,0
9607009,9607009,,2,2,4,2,2,4,0.000002,0.000012,0,21937,13,0.000013,6,0.274123,0.307667,69.209524,0.25,0.000438
206180,206180,,1,25,26,1,25,26,0.000233,0.01728,0,21939,1,0.00001,14,0.196551,0.222484,1199.974804,0.196923,0.000226
206181,206181,,3,20,23,3,20,23,0.000002,0.00004,0,21940,15,0.000012,14,0.188241,0.204876,8119.373261,0.118577,0.000677
206183,206183,,1,45,46,1,45,46,0.000025,0.003245,0,21941,3,0.00001,15,0.212453,0.246298,5696.270156,0.101932,0.000219
206184,206184,,2,2,4,2,2,4,0.000037,0.000027,0,21942,2,0.000012,16,0.159089,0.171125,0,0.5,0.000445
206186,206186,,2,22,24,2,22,24,0.000004,0.000032,0,21944,23,0.000011,15,0.157221,0.174641,652.823061,0.068841,0.000478
9601174,9601174,,1,4,5,1,4,5,0,0.000013,0,21943,5,0.00001,3,0.666667,0.805556,7.35,0.15,0.000233
206187,206187,,0,14,14,0,14,14,0,0.006714,0,21946,25,0.00001,17,0.19094,0.213807,0,0.076923,0
9911079,9911079,,1,5,6,1,5,6,0.000079,0.000009,0,21945,5,0.00001,17,0.125885,0.136194,9.406711,0.3,0.000219
206188,206188,,5,36,41,5,36,41,0.000259,0.016251,0,21947,25,0.000013,14,0.199159,0.226362,19203.735971,0.09878,0.001115
206189,206189,,0,3,3,0,3,3,0,0.000513,0,21948,1,0.00001,18,0.19089,0.211334,0,0.333333,0
206190,206190,,2,2,4,2,2,4,0.00002,0,0,21949,30,0.000013,16,0.130594,0.139606,9.142507,0.25,0.000438
206191,206191,,0,18,18,0,18,18,0,0.004463,0,21950,2,0.00001,14,0.213726,0.239159,0,0.186275,0
206192,206192,,3,24,27,3,24,27,0.000121,0.003337,0,21951,2,0.000013,19,0.181452,0.203956,1323.018184,0.07265,0.000779
9512001,9512001,,2,2,4,2,2,4,0.000039,0.000007,0,7513,23,0.000012,3,0.545455,0.638889,14.857814,0.416667,0.000473
9612036,9612036,,2,5,7,2,5,7,0.000041,0.00001,0,7515,23,0.000011,4,0.555556,0.708333,16854.350903,0.190476,0.000467
206193,206193,,3,16,19,3,16,19,0.000085,0.009469,0,21952,25,0.000011,14,0.199024,0.231823,1132.670406,0.190058,0.000684
206195,206195,,22,24,46,22,24,46,0.001403,0.002765,0,21954,41,0.000017,19,0.189748,0.218322,14522.347481,0.129952,0.005828
206150,206150,,1,0,1,1,0,1,0.000032,0,0,21953,41,0.000011,0,0,0,0,0,0.000376
206197,206197,,3,19,22,3,19,22,0.000072,0.000233,0,21955,26,0.000012,19,0.179544,0.203133,871.729786,0.281385,0.000664
206198,206198,,0,9,9,0,9,9,0,0.003141,0,21956,25,0.00001,16,0.178682,0.200786,0,0.277778,0
206199,206199,,1,5,6,1,5,6,0.000001,0.000027,0,21957,5,0.000011,15,0.153323,0.162478,422.535124,0.333333,0.000219
206200,206200,,4,48,52,4,48,52,0.000227,0.004125,0,21958,41,0.000012,19,0.203706,0.233893,21672.71863,0.122549,0.001034
206201,206201,,0,5,5,0,5,5,0,0.000036,0,21959,26,0.00001,14,0.163862,0.178435,0,0.15,0
206203,206203,,3,41,44,3,41,44,0.000054,0.001667,0,21960,0,0.000011,14,0.195227,0.221609,3596.230574,0.152748,0.000678
206204,206204,,17,22,39,17,22,39,0.001026,0.00176,0,21961,41,0.000015,19,0.192441,0.216575,18677.131159,0.17274,0.004504
206205,206205,,2,6,8,2,6,8,0.000273,0.005731,0,21962,41,0.000012,15,0.165588,0.18646,13.791667,0.196429,0.000452
206206,206206,,3,21,24,3,21,24,0.000104,0.000573,0,21963,0,0.000011,17,0.173059,0.197095,565.596487,0.228261,0.001112
206207,206207,,0,24,24,0,24,24,0,0.017874,0,21964,1,0.00001,12,0.200847,0.222324,0,0.15942,0
206209,206209,,1,15,16,1,15,16,0.000001,0.000048,0,21966,0,0.00001,16,0.173232,0.191042,1248.131384,0.066667,0.000219
9709148,9709148,,2,4,6,2,4,6,0.000002,0.00007,0,9907,2,0.000014,11,0.177138,0.195565,8472.592194,0.233333,0.000467
9912080,9912080,,1,9,10,1,9,10,0.000001,0.000209,0,21965,2,0.00001,14,0.176502,0.200289,658.121506,0.111111,0.000226
206210,206210,,1,4,5,1,4,5,0,0.000009,0,21967,52,0.000012,15,0.107239,0.122431,123.844271,0.2,0.000219
206211,206211,,0,6,6,0,6,6,0,0.000007,0,21968,23,0.00001,16,0.11899,0.132531,0,0.233333,0
206213,206213,,5,9,14,5,9,14,0.000083,0.000605,0,21969,10,0.000013,15,0.185399,0.208355,1463.735269,0.10989,0.001274
206214,206214,,4,50,54,4,50,54,0.000144,0.00482,0,21971,41,0.000011,13,0.208686,0.237888,21288.744225,0.066038,0.001072
9901067,9901067,,1,5,6,1,5,6,0.000057,0.001301,0,21970,41,0.00001,11,0.211486,0.238186,299.629397,0.066667,0.000248
206215,206215,,0,7,7,0,7,7,0,0.006031,0,21973,30,0.00001,14,0.184284,0.200415,0,0.119048,0
9806035,9806035,,1,1,2,1,1,2,0.000071,0.000002,0,21972,30,0.000011,1,1,1,0,0.5,0.000219
206216,206216,,8,21,29,8,21,29,0.000081,0.000183,0,21974,2,0.000014,17,0.168977,0.189463,7272.081434,0.178571,0.001865
206217,206217,,0,9,9,0,9,9,0,0.00142,0,21975,25,0.00001,16,0.178851,0.199526,0,0.138889,0
206218,206218,,3,17,20,3,17,20,0.000181,0.002155,0,21976,41,0.000011,18,0.190035,0.213652,5839.605501,0.144737,0.000698
206219,206219,,1,2,3,1,2,3,0.000001,0.000001,0,21977,25,0.000012,16,0.17385,0.191636,527.596372,0,0.000219
206220,206220,,13,27,40,13,27,40,0.000151,0.00175,0,21978,25,0.00002,17,0.189971,0.215068,33176.017904,0.114103,0.003077
206222,206222,,0,11,11,0,11,11,0,0.001168,0,21979,8,0.00001,13,0.180197,0.19895,0,0.2,0
206224,206224,,0,12,12,0,12,12,0,0.000004,0,21980,6,0.00001,14,0.121144,0.137014,0,0.151515,0
206225,206225,,0,6,6,0,6,6,0,0.000118,0,21981,25,0.00001,17,0.203927,0.23349,0,0.066667,0
206226,206226,,0,51,51,0,51,51,0,0.002767,0,21982,30,0.00001,14,0.194923,0.22136,0,0.112941,0
9211038,9211038,,2,0,2,2,0,2,0.000033,0,0,21800,30,0.000018,0,0,0,0,0,0.000445
9512211,9512211,,3,15,18,3,15,18,0.000001,0.000022,0,6391,4,0.000013,5,0.364198,0.445763,57961.245483,0.117647,0.00069
206227,206227,,0,1,1,0,1,1,0,0,0,21983,23,0.00001,19,0.122442,0.132313,0,0,0
206230,206230,,0,2,2,0,2,2,0,0,0,21984,5,0.00001,18,0.109156,0.123823,0,0,0
206231,206231,,1,20,21,1,20,21,0.000015,0.000891,0,21985,30,0.00001,15,0.189765,0.210129,1425.57344,0.133333,0.000232
206232,206232,,0,9,9,0,9,9,0,0.000005,0,21987,52,0.00001,7,0.219048,0.288785,0,0.236111,0
9707229,9707229,,1,3,4,1,3,4,0,0.000044,0,21986,52,0.000011,4,0.444444,0.526042,7,0.083333,0.000219
206233,206233,,2,6,8,2,6,8,0.000205,0.010543,0,21988,1,0.00001,14,0.189341,0.208779,77.468467,0.285714,0.000485
206234,206234,,3,14,17,3,14,17,0.000185,0.006594,0,21989,2,0.000011,17,0.191718,0.216826,943.047453,0.198529,0.000677
206236,206236,,2,5,7,2,5,7,0,0.000001,0,21992,17,0.000014,5,0.364706,0.45914,22.5,0.166667,0.000451
112237,112237,,4,0,4,4,0,4,0.000001,0,0,21991,17,0.000019,0,0,0,0,0.166667,0.000903
9602121,9602121,,3,0,3,3,0,3,0,0,0,21990,17,0.000018,0,0,0,0,0.166667,0.000677
206237,206237,,14,30,44,14,30,44,0.001438,0.017846,0,21993,41,0.000015,17,0.210781,0.235021,21140.766886,0.233087,0.003714
206238,206238,,3,16,19,3,16,19,0.000145,0.000724,0,21994,52,0.000011,14,0.193815,0.215238,3779.76497,0.280702,0.00073
206239,206239,,4,18,22,4,18,22,0.000334,0.005049,0,21995,41,0.000012,19,0.210406,0.240508,23260.048547,0.15368,0.001065
206240,206240,,0,6,6,0,6,6,0,0.000116,0,21996,26,0.00001,15,0.169877,0.182413,0,0.3,0
206241,206241,,19,36,55,19,36,55,0.000641,0.000832,0,21997,0,0.000017,15,0.203444,0.229496,14980.99597,0.147138,0.004889
206242,206242,,5,16,21,5,16,21,0.000152,0.000204,0,21998,52,0.000013,16,0.190496,0.21079,3465.966241,0.230952,0.001148
206243,206243,,1,30,31,1,30,31,0.000608,0.003004,0,21999,2,0.00001,16,0.201023,0.228437,970.655729,0.102151,0.000245
206244,206244,,2,7,9,2,7,9,0,0,0,22000,23,0.000012,16,0.122687,0.12972,2,0.375,0.000445
206245,206245,,0,4,4,0,4,4,0,0,0,22001,5,0.00001,14,0.160201,0.170971,0,0.083333,0
206246,206246,,1,4,5,1,4,5,0,0.000002,0,22002,26,0.000011,17,0.154685,0.170244,6536.425305,0.2,0.000219
206247,206247,,5,40,45,5,40,45,0.000574,0.017168,0,22003,1,0.000012,15,0.198269,0.229261,17468.208369,0.101515,0.001162
206249,206249,,1,13,14,1,13,14,0,0.000236,0,22004,0,0.000011,12,0.192294,0.213979,2589.261921,0.17033,0.000219
206250,206250,,0,1,1,0,1,1,0,0.000002,0,22005,30,0.00001,16,0.147967,0.156476,0,0,0
206251,206251,,10,10,20,10,10,20,0.000002,0.000001,0,22006,23,0.000018,15,0.144843,0.158769,1846.112453,0.255263,0.002398
206252,206252,,1,8,9,1,8,9,0,0.000002,0,22007,23,0.000011,22,0.157644,0.182254,5030.761792,0.277778,0.000219
206253,206253,,0,16,16,0,16,16,0,0.00022,0,22008,25,0.00001,14,0.19911,0.22448,0,0.2375,0
206254,206254,,3,12,15,3,12,15,0.000059,0.001283,0,22009,25,0.000012,13,0.194305,0.213504,3161.414352,0.2,0.000664
206255,206255,,97,26,123,97,26,123,0.003719,0.004202,0,22010,4,0.000059,17,0.196993,0.235956,142258.272965,0.131414,0.035199
207001,207001,,3,34,37,3,34,37,0.000019,0.000803,0,22011,3,0.000012,14,0.193022,0.212757,1721.179654,0.273273,0.000745
207002,207002,,15,9,24,15,9,24,0.000707,0.00021,0,22012,1,0.000018,14,0.186353,0.204435,31732.547664,0.144928,0.003558
207003,207003,,5,16,21,5,16,21,0.000247,0.016421,0,22013,25,0.000012,13,0.198588,0.218731,3818.756822,0.183333,0.001163
207005,207005,,0,15,15,0,15,15,0,0.003335,0,22014,25,0.00001,12,0.194619,0.215029,0,0.190476,0
207006,207006,,6,27,33,6,27,33,0.000162,0.00403,0,20049,52,0.000012,14,0.191583,0.218789,1146.912053,0.193182,0.001483
207007,207007,,3,10,13,3,10,13,0.000003,0.000056,0,22015,30,0.000013,15,0.196347,0.218757,9062.866658,0.134615,0.000658
207008,207008,,0,2,2,0,2,2,0,0.000001,0,22017,5,0.00001,15,0.171807,0.192968,0,0,0
112123,112123,,1,0,1,1,0,1,0,0,0,22016,5,0.000014,0,0,0,0,0,0.000219
207009,207009,,6,27,33,6,27,33,0.000595,0.016647,0,22018,8,0.000012,16,0.205281,0.23737,15843.716801,0.135417,0.001341
207010,207010,,0,1,1,0,1,1,0,0,0,22019,4,0.00001,16,0.141096,0.156966,0,0,0
9511142,9511142,,2,4,6,2,4,6,0.000038,0.000079,0,6071,4,0.000019,15,0.164149,0.190847,1307.875,0.133333,0.000446
207011,207011,,0,2,2,0,2,2,0,0,0,22020,20,0.00001,1,1,1,0,0,0
207012,207012,,1,15,16,1,15,16,0,0.00002,0,22021,6,0.000011,19,0.157654,0.171919,3456.498384,0.154167,0.000226
207013,207013,,0,1,1,0,1,1,0,0.000003,0,22022,23,0.00001,2,0.666667,0.75,0,0,0
207014,207014,,2,37,39,2,37,39,0.000025,0.00189,0,22023,0,0.000011,13,0.191385,0.213564,3404.473512,0.118758,0.000452
207015,207015,,4,12,16,4,12,16,0.000313,0.000421,0,22024,2,0.000011,16,0.177577,0.196046,65.169123,0.308333,0.000943
207016,207016,,4,16,20,4,16,20,0.000698,0.001823,0,22025,13,0.000011,16,0.204656,0.23122,1559.908966,0.071053,0.000909
9202051,9202051,,2,0,2,2,0,2,0,0,0,781,0,0.000032,0,0,0,0,0,0.000488
207017,207017,,2,19,21,2,19,21,0,0.000655,0,22026,23,0.000014,16,0.197619,0.223165,19710.155912,0.069048,0.000445
207020,207020,,6,12,18,6,12,18,0.000152,0.000095,0,22027,10,0.000013,14,0.184173,0.203374,23845.594327,0.166667,0.001348
207021,207021,,0,1,1,0,1,1,0,0,0,22028,5,0.00001,6,0.25641,0.335,0,0,0
207022,207022,,7,12,19,7,12,19,0.000003,0.000837,0,22029,15,0.000016,13,0.204379,0.223386,42857.23332,0.166667,0.001646
207023,207023,,1,13,14,1,13,14,0.000035,0.000309,0,22030,0,0.00001,16,0.181595,0.200903,653.480548,0.159341,0.000226
9412071,9412071,,2,3,5,2,3,5,0.000023,0.000033,0,1705,0,0.000011,6,0.257322,0.300678,10.804803,0.15,0.000659
207024,207024,,1,15,16,1,15,16,0.000287,0.01664,0,22031,1,0.00001,15,0.188022,0.21121,238.32523,0.233333,0.000219
207025,207025,,2,4,6,2,4,6,0.000018,0.000375,0,22032,30,0.000012,16,0.177636,0.190753,8499.791547,0.3,0.000451
207026,207026,,7,13,20,7,13,20,0.000125,0.002972,0,20098,0,0.000014,16,0.206485,0.2364,4556.200517,0.123684,0.001674
9502046,9502046,,1,0,1,1,0,1,0.000017,0,0,2266,0,0.000011,0,0,0,0,0,0.000355
207027,207027,,10,43,53,10,43,53,0.000375,0.00379,0,20046,52,0.000015,17,0.201545,0.235155,26579.755284,0.101597,0.003297
207028,207028,,3,12,15,3,12,15,0.000002,0.000067,0,22033,20,0.000011,13,0.152914,0.170026,1140.681238,0.119048,0.000664
207031,207031,,5,6,11,5,6,11,0.000002,0.000012,0,22034,15,0.000014,15,0.174993,0.186498,7865.215987,0.290909,0.001195
207032,207032,,1,15,16,1,15,16,0.000061,0.002702,0,22037,13,0.00001,14,0.170242,0.190285,21.857338,0.1,0.000232
9705144,9705144,,3,4,7,3,4,7,0.000036,0.000161,0,22036,13,0.000013,11,0.190625,0.217653,517.480578,0.190476,0.000758
9703084,9703084,,3,9,12,3,9,12,0.000019,0.000933,0,22035,13,0.000014,11,0.206536,0.241836,815.048415,0.143939,0.000678
207033,207033,,4,8,12,4,8,12,0.000002,0.000008,0,22038,20,0.000012,14,0.162087,0.177618,3337.105159,0.257576,0.000883
207034,207034,,21,12,33,21,12,33,0.001288,0.004012,0,22039,41,0.000018,18,0.192658,0.213649,4122.375334,0.243371,0.005756
207061,207061,,19,17,36,19,17,36,0.001065,0.002614,0,22041,41,0.000016,19,0.191806,0.213446,6690.153987,0.218254,0.004889
207050,207050,,20,12,32,20,12,32,0.001042,0.001096,0,22040,41,0.000017,19,0.197743,0.219087,25382.042637,0.275202,0.005256
207035,207035,,0,1,1,0,1,1,0,0,33,22043,56,0.00001,1,1,1,0,0,0
203011,203011,,1,0,1,1,0,1,0,0,33,22042,56,0.000019,0,0,0,0,0,0.000219
207036,207036,,0,8,8,0,8,8,0,0.000001,0,22045,6,0.00001,14,0.136074,0.147282,0,0.285714,0
9810220,9810220,,3,5,8,3,5,8,0,0.000002,0,22044,6,0.000013,5,0.318937,0.371007,150.714827,0.142857,0.000664
207037,207037,,17,66,83,17,66,83,0.001274,0.004661,0,22046,41,0.000014,14,0.224958,0.252391,48796.806267,0.194681,0.004355
207038,207038,,2,20,22,2,20,22,0,0.000017,0,22047,5,0.000011,18,0.136282,0.155138,10990.844055,0.088745,0.000438
207039,207039,,10,8,18,10,8,18,0.001122,0.000861,0,22048,1,0.000014,16,0.183436,0.203483,352.459092,0.254902,0.00245
207040,207040,,4,11,15,4,11,15,0.000014,0.00003,0,22049,8,0.000013,17,0.163772,0.180907,2394.163315,0.157143,0.00089
207041,207041,,1,9,10,1,9,10,0.000001,0.000052,0,22050,6,0.000011,15,0.16555,0.177682,9931.125266,0.088889,0.000219
207042,207042,,0,2,2,0,2,2,0,0.000927,0,22051,21,0.00001,12,0.187167,0.20251,0,0,0
207043,207043,,0,5,5,0,5,5,0,0.000022,0,22052,2,0.00001,15,0.139347,0.152992,0,0.25,0
207044,207044,,4,25,29,4,25,29,0.000077,0.001286,0,22053,3,0.000011,15,0.192311,0.213198,12048.876982,0.246305,0.000903
207045,207045,,0,1,1,0,1,1,0,0.000001,0,22054,8,0.00001,1,1,1,0,0,0
207046,207046,,0,9,9,0,9,9,0,0.000002,0,22055,22,0.00001,15,0.138,0.147922,0,0.111111,0
207047,207047,,4,3,7,4,3,7,0.000002,0,0,22056,15,0.000013,15,0.153274,0.160982,14.354961,0.238095,0.000896
207048,207048,,0,7,7,0,7,7,0,0.000012,0,22059,22,0.00001,17,0.150169,0.161355,0,0.142857,0
9912220,9912220,,1,3,4,1,3,4,0,0.000012,0,22058,22,0.000011,1,1,1,0.533333,0.333333,0.000219
9912221,9912221,,1,8,9,1,8,9,0,0.000016,0,22057,22,0.000011,17,0.142021,0.155976,251.517485,0.263889,0.000219
207049,207049,,2,14,16,2,14,16,0,0.000013,0,22060,23,0.000012,16,0.170647,0.187975,3523.841736,0.1875,0.000438
207052,207052,,0,38,38,0,38,38,0,0.004493,0,22061,2,0.00001,14,0.211951,0.240478,0,0.108108,0
207053,207053,,0,19,19,0,19,19,0,0.016808,0,22062,8,0.00001,16,0.192013,0.212934,0,0.181287,0
207054,207054,,1,12,13,1,12,13,0.000001,0.003085,0,22063,2,0.000011,15,0.180306,0.196398,2816.546763,0.230769,0.000219
207055,207055,,0,18,18,0,18,18,0,0.003662,0,22064,13,0.00001,15,0.187688,0.207427,0,0.094771,0
207057,207057,,0,4,4,0,4,4,0,0.000022,0,22065,1,0.00001,16,0.153214,0.166139,0,0.083333,0
207058,207058,,0,7,7,0,7,7,0,0.000943,0,22066,30,0.00001,15,0.170959,0.186475,0,0.071429,0
207059,207059,,0,14,14,0,14,14,0,0.001082,0,22067,0,0.00001,14,0.181353,0.204777,0,0.120879,0
9510013,9510013,,5,6,11,5,6,11,0.000154,0.000063,0,4442,26,0.000021,6,0.264085,0.352889,16960.301429,0.209091,0.001376
207060,207060,,4,19,23,4,19,23,0.000565,0.003992,0,22068,25,0.000012,17,0.177711,0.203216,5866.855014,0.124506,0.000922
207062,207062,,2,4,6,2,4,6,0,0,0,22070,22,0.000014,20,0.104716,0.12032,20.2,0.166667,0.000438
9911121,9911121,,1,0,1,1,0,1,0,0,0,22069,22,0.000013,0,0,0,0,0,0.000232
207064,207064,,1,12,13,1,12,13,0.000008,0.000023,0,22071,25,0.00001,14,0.175007,0.188851,1944.711173,0.083333,0.000219
207065,207065,,1,2,3,1,2,3,0,0.000927,0,22072,23,0.000011,12,0.187191,0.202546,666.120001,0.166667,0.000219
207066,207066,,0,3,3,0,3,3,0,0.000848,0,22073,4,0.00001,14,0.170169,0.183462,0,0.333333,0
207068,207068,,1,23,24,1,23,24,0.000003,0.00252,0,22074,4,0.00001,17,0.188672,0.21462,832.532683,0.121377,0.000219
207070,207070,,1,17,18,1,17,18,0.00025,0.000651,0,22075,0,0.00001,15,0.17189,0.194881,232.962075,0.179739,0.000226
207071,207071,,4,21,25,4,21,25,0.000926,0.022628,0,22076,1,0.000012,17,0.200767,0.237128,1982.602259,0.216667,0.000923
207072,207072,,4,23,27,4,23,27,0.000437,0.00168,0,22077,8,0.000011,17,0.174978,0.200257,1875.621476,0.105413,0.000903
9608162,9608162,,3,4,7,3,4,7,0.000051,0.001325,0,5192,13,0.000012,10,0.205394,0.232238,165.378238,0.142857,0.000717
207073,207073,,1,8,9,1,8,9,0,0.000004,0,22079,5,0.000011,17,0.110496,0.118499,8.25,0.222222,0.000219
9303062,9303062,,1,0,1,1,0,1,0,0,0,22078,5,0.000011,0,0,0,0,0,0.000226
207074,207074,,1,20,21,1,20,21,0.000029,0.001644,0,22080,4,0.000011,16,0.190504,0.213608,9612.392927,0.247619,0.000219
207075,207075,,1,10,11,1,10,11,0.000019,0.000046,0,22081,30,0.00001,18,0.174051,0.188415,671.87093,0.145455,0.000232
207076,207076,,4,33,37,4,33,37,0.000798,0.020141,0,22082,1,0.000011,14,0.20071,0.229597,547.125827,0.271772,0.000929
207077,207077,,2,8,10,2,8,10,0.000143,0.00021,0,22083,52,0.00001,14,0.172511,0.188324,0.725367,0.433333,0.000497
207078,207078,,0,4,4,0,4,4,0,0.000012,0,22084,30,0.00001,16,0.174598,0.190564,0,0.5,0
207079,207079,,1,10,11,1,10,11,0,0.000003,0,22085,6,0.000011,16,0.119844,0.131245,49.793096,0.354545,0.000226
207080,207080,,0,8,8,0,8,8,0,0.000338,0,22086,13,0.00001,14,0.181634,0.203259,0,0.321429,0
207081,207081,,1,20,21,1,20,21,0.000001,0.009209,0,22091,0,0.000011,15,0.201543,0.227551,6184.907088,0.030952,0.000219
105152,105152,,1,0,1,1,0,1,0.000108,0,0,22090,0,0.00001,0,0,0,0,0,0.000226
9902001,9902001,,1,15,16,1,15,16,0.000108,0.00168,0,22089,17,0.00001,15,0.166767,0.19266,253.092914,0.170833,0.000226
9407058,9407058,,7,4,11,7,4,11,0.000048,0.000031,0,8072,17,0.000015,2,0.75,0.833333,9.644444,0.272727,0.0016
9411232,9411232,,4,10,14,4,10,14,0.00007,0.000096,0,22087,17,0.000013,8,0.226891,0.300963,313.899832,0.197802,0.000896
9708033,9708033,,1,14,15,1,14,15,0.00002,0.002009,0,22088,17,0.00001,15,0.166725,0.192417,0.666667,0.185714,0.000226
207082,207082,,1,4,5,1,4,5,0,0.000788,0,22092,30,0.000013,15,0.173385,0.19101,2997.49708,0.15,0.000219
207083,207083,,1,28,29,1,28,29,0.00011,0.02081,0,22093,1,0.00001,14,0.191064,0.222478,612.507261,0.158867,0.000219
207084,207084,,3,7,10,3,7,10,0.00058,0.001369,0,22094,25,0.000011,15,0.176513,0.196392,292.901102,0.155556,0.00069
207086,207086,,1,39,40,1,39,40,0.000021,0.001907,0,22095,30,0.00001,14,0.220556,0.246323,81.422949,0.208974,0.000219
207090,207090,,0,9,9,0,9,9,0,0.011371,0,22096,2,0.00001,13,0.213524,0.248675,0,0.194444,0
207091,207091,,7,49,56,7,49,56,0.000634,0.020306,0,22097,10,0.000012,20,0.197017,0.233306,30836.279813,0.174026,0.00168
207092,207092,,0,12,12,0,12,12,0,0.000012,0,22098,23,0.00001,15,0.171887,0.187333,0,0.128788,0
207093,207093,,0,10,10,0,10,10,0,0.000489,0,22099,3,0.00001,15,0.180468,0.199321,0,0.244444,0
207094,207094,,3,21,24,3,21,24,0.000059,0.008058,0,22100,52,0.000012,18,0.216797,0.248528,28063.878688,0.166667,0.001141
207096,207096,,6,16,22,6,16,22,0.000149,0.000458,0,22101,4,0.000014,18,0.172956,0.201908,17673.771033,0.103896,0.002636
207097,207097,,1,28,29,1,28,29,0.000007,0.003535,0,22102,30,0.00001,17,0.202546,0.22791,1447.71485,0.158867,0.000226
207098,207098,,0,19,19,0,19,19,0,0.000598,0,22103,3,0.00001,17,0.170969,0.189473,0,0.154971,0
207099,207099,,1,24,25,1,24,25,0,0.000025,0,22104,6,0.000011,16,0.161379,0.176929,10248.111501,0.121667,0.000226
207100,207100,,1,9,10,1,9,10,0,0.000006,0,22105,23,0.000011,19,0.134963,0.152836,1101.592433,0.166667,0.000226
207101,207101,,11,16,27,11,16,27,0.001124,0.000974,0,22106,1,0.000014,14,0.191955,0.21313,7740.662797,0.163818,0.002655
207102,207102,,4,18,22,4,18,22,0.000147,0.001865,0,22107,25,0.000012,16,0.189351,0.21415,11404.429304,0.142857,0.000877
207103,207103,,1,18,19,1,18,19,0.000017,0.001917,0,22108,25,0.00001,14,0.193492,0.216853,84.367317,0.146199,0.000219
207106,207106,,87,37,124,87,37,124,0.003215,0.003875,0,22109,4,0.000052,15,0.202787,0.231826,88279.648367,0.135851,0.03172
207108,207108,,5,16,21,5,16,21,0.000232,0.000954,0,22110,30,0.000012,15,0.19381,0.213696,1617.405144,0.257143,0.001129
207109,207109,,0,19,19,0,19,19,0,0.000012,0,22111,5,0.00001,16,0.155808,0.171392,0,0.111111,0
9608089,9608089,,1,5,6,1,5,6,0,0.000023,0,5641,5,0.000011,8,0.216044,0.254731,11510.251898,0.2,0.000242
207111,207111,,6,28,34,6,28,34,0.000246,0.004058,0,22112,2,0.000012,15,0.211654,0.240748,27459.524321,0.111408,0.001361
207112,207112,,2,3,5,2,3,5,0,0.00002,0,22113,22,0.000012,9,0.176781,0.249745,0,0.4,0.000438
207113,207113,,5,10,15,5,10,15,0.000002,0.00002,0,22114,15,0.000014,13,0.175378,0.186988,5571.889397,0.266667,0.001168
207114,207114,,2,29,31,2,29,31,0.000075,0.001046,0,22115,4,0.00001,17,0.182004,0.211724,685.653301,0.190323,0.000459
207115,207115,,6,28,34,6,28,34,0.000323,0.004823,0,22116,30,0.000012,18,0.204353,0.22968,12379.03544,0.163102,0.001367
207116,207116,,0,211,211,0,211,211,0,0.029497,0,22118,1,0.00001,13,0.250654,0.291599,0,0.036651,0
9912139,9912139,,1,12,13,1,12,13,0.000347,0.018262,0,22117,1,0.00001,11,0.226829,0.256262,0.506614,0.333333,0.000219
207117,207117,,8,39,47,8,39,47,0.000767,0.001053,0,20088,10,0.000012,14,0.210299,0.239158,15193.873461,0.126735,0.002009
207118,207118,,2,13,15,2,13,15,0.000014,0.000931,0,22119,30,0.000011,13,0.209252,0.229628,5162.967387,0.166667,0.000484
207121,207121,,1,1,2,1,1,2,0.000005,0,0,22121,8,0.000012,1,1,1,0,0.5,0.000219
207110,207110,,2,0,2,2,0,2,0.000005,0,0,22120,8,0.000022,0,0,0,0,0.5,0.000445
207122,207122,,0,13,13,0,13,13,0,0.005799,0,22122,26,0.00001,19,0.181413,0.206487,0,0.294872,0
207124,207124,,8,67,75,8,67,75,0.001122,0.00521,0,22123,41,0.000012,15,0.213272,0.239724,15106.975239,0.090991,0.001952
207125,207125,,1,27,28,1,27,28,0.000225,0.006569,0,22124,1,0.00001,14,0.203955,0.23511,102.056998,0.125661,0.00024
207126,207126,,0,8,8,0,8,8,0,0.000024,0,22125,0,0.00001,14,0.166044,0.179567,0,0.232143,0
207127,207127,,6,51,57,6,51,57,0.000393,0.010277,0,22126,10,0.000012,20,0.194113,0.229668,13082.394972,0.176378,0.001381
207128,207128,,3,28,31,3,28,31,0.000491,0.01948,0,22127,1,0.000011,15,0.202705,0.236639,1290.185778,0.269892,0.000684
207129,207129,,4,12,16,4,12,16,0.000948,0.009836,0,22128,41,0.000011,14,0.193751,0.216827,4471.257482,0.2125,0.000976
207130,207130,,21,154,175,21,154,175,0.000848,0.009659,0,21576,0,0.00002,16,0.204766,0.243079,69929.50394,0.049787,0.005056
9403091,9403091,,1,0,1,1,0,1,0.000113,0,0,21574,0,0.00001,0,0,0,0,0,0.000361
9707053,9707053,,1,4,5,1,4,5,0.000113,0.000036,0,21573,0,0.00001,13,0.16076,0.191432,226.997766,0.15,0.000361
9709188,9709188,,1,13,14,1,13,14,0.000113,0.000226,0,21572,0,0.00001,12,0.168534,0.196309,2.990595,0.269231,0.000361
9911086,9911086,,2,23,25,2,23,25,0.000133,0.001552,0,21571,0,0.000011,12,0.198948,0.227324,669.442513,0.153333,0.000581
207131,207131,,3,21,24,3,21,24,0.000277,0.000739,0,22129,3,0.000011,16,0.199458,0.223175,10664.8982,0.242754,0.000678
207132,207132,,10,40,50,10,40,50,0.000579,0.001016,0,22130,3,0.000015,14,0.204468,0.227556,11237.053559,0.143265,0.00248
207133,207133,,5,19,24,5,19,24,0.000411,0.017099,0,22131,1,0.000013,15,0.176692,0.200754,9451.327663,0.179348,0.001129
207134,207134,,1,2,3,1,2,3,0,0.000002,0,22132,20,0.000014,1,1,1,1,0.166667,0.000219
207135,207135,,15,25,40,15,25,40,0.000351,0.000947,0,22133,0,0.000015,16,0.20073,0.226845,9150.911022,0.219231,0.003869
207136,207136,,7,14,21,7,14,21,0.000571,0.006698,0,22134,41,0.000012,14,0.201633,0.224966,12034.192755,0.154762,0.001732
207137,207137,,0,7,7,0,7,7,0,0.000012,0,22135,26,0.00001,16,0.143866,0.156193,0,0.166667,0
207138,207138,,5,22,27,5,22,27,0.000125,0.001877,0,22136,25,0.000013,15,0.192931,0.215912,12852.960249,0.082621,0.001168
207139,207139,,4,33,37,4,33,37,0.000127,0.00124,0,22137,2,0.000011,15,0.206722,0.230028,7508.593682,0.054054,0.000916
207140,207140,,0,37,37,0,37,37,0,0.003682,0,22138,25,0.00001,15,0.199244,0.224543,0,0.177177,0
207141,207141,,2,9,11,2,9,11,0.000156,0.000018,0,22139,4,0.000011,16,0.139515,0.15748,105.633353,0.172727,0.000451
207142,207142,,2,28,30,2,28,30,0.000375,0.022178,0,22140,2,0.000011,13,0.233411,0.271311,1798.921995,0.154023,0.000438
207143,207143,,1,23,24,1,23,24,0.000001,0.00011,0,22144,20,0.00001,15,0.166142,0.18743,480.392913,0.072464,0.000219
9402065,9402065,,2,0,2,2,0,2,0.000002,0,0,22143,20,0.000011,0,0,0,0,0.5,0.000445
9512019,9512019,,1,4,5,1,4,5,0.000001,0.000046,0,22142,13,0.00001,10,0.207965,0.243483,45.131274,0.15,0.000226
9605124,9605124,,3,9,12,3,9,12,0.000003,0.000048,0,22141,9,0.000012,7,0.227749,0.280528,75.565135,0.242424,0.000664
207144,207144,,4,12,16,4,12,16,0.000913,0.011504,0,22145,1,0.000011,14,0.193686,0.21621,7139.818089,0.2375,0.000923
207145,207145,,4,38,42,4,38,42,0.000866,0.012442,0,22146,1,0.000012,15,0.209316,0.237723,6976.647089,0.156794,0.000916
207147,207147,,0,2,2,0,2,2,0,0.000151,0,22147,13,0.00001,18,0.20975,0.249464,0,0.5,0
207148,207148,,2,17,19,2,17,19,0.000085,0.002075,0,22148,30,0.00001,13,0.19085,0.2107,1035.732128,0.27193,0.000458
207149,207149,,4,22,26,4,22,26,0.000002,0.001171,0,22149,30,0.000013,14,0.189955,0.20828,4749.91573,0.092308,0.000896
207150,207150,,0,1,1,0,1,1,0,0.000004,0,22150,0,0.00001,1,1,1,0,0,0
207151,207151,,0,23,23,0,23,23,0,0.003104,0,22152,4,0.00001,15,0.16693,0.194276,0,0.213439,0
9903199,9903199,,1,6,7,1,6,7,0.000036,0.001128,0,22151,4,0.00001,15,0.157901,0.176433,2.25,0.309524,0.000219
9712167,9712167,,2,19,21,2,19,21,0.000023,0.001916,0,16471,4,0.000012,13,0.159959,0.182676,150.628475,0.292857,0.000465
207152,207152,,0,17,17,0,17,17,0,0.000019,0,22153,6,0.00001,18,0.146838,0.163397,0,0.1875,0
207153,207153,,0,15,15,0,15,15,0,0.007609,0,22154,20,0.00001,13,0.181128,0.202278,0,0.166667,0
207154,207154,,0,6,6,0,6,6,0,0.000031,0,22155,20,0.00001,13,0.172278,0.187912,0,0.366667,0
207155,207155,,1,7,8,1,7,8,0.00001,0.000436,0,22156,25,0.00001,14,0.182038,0.1986,487.294301,0.267857,0.000226
207157,207157,,3,37,40,3,37,40,0.000468,0.003274,0,22157,41,0.000011,17,0.205838,0.228917,2103.629186,0.225641,0.000754
207158,207158,,4,7,11,4,7,11,0.000039,0.000074,0,22158,30,0.000013,14,0.199325,0.218674,3379.279995,0.145455,0.000883
207159,207159,,5,13,18,5,13,18,0.000112,0.001205,0,22159,25,0.000012,17,0.19171,0.212142,265.078538,0.222222,0.001162
207160,207160,,1,24,25,1,24,25,0.000053,0.002413,0,22160,30,0.00001,13,0.199693,0.225448,27.424587,0.158333,0.000219
207161,207161,,4,26,30,4,26,30,0.000151,0.003582,0,22161,4,0.000011,14,0.164525,0.184459,4534.876385,0.204598,0.000909
207162,207162,,2,15,17,2,15,17,0.000072,0.001786,0,20090,0,0.00001,16,0.197296,0.221567,797.671074,0.165441,0.000665
207163,207163,,5,24,29,5,24,29,0.000425,0.00768,0,22162,1,0.000012,16,0.196232,0.221583,3894.367398,0.211823,0.001196
207164,207164,,4,3,7,4,3,7,0.000088,0.000002,0,22163,8,0.000012,18,0.131694,0.140002,128.870238,0.166667,0.00089
207165,207165,,0,5,5,0,5,5,0,0.000928,0,22164,23,0.00001,12,0.187946,0.203856,0,0.2,0
207166,207166,,4,17,21,4,17,21,0.000091,0.000587,0,22165,30,0.000011,16,0.206481,0.230638,2351.998086,0.264286,0.000943
207167,207167,,0,2,2,0,2,2,0,0,0,22166,23,0.00001,1,1,1,0,0.5,0
207168,207168,,7,14,21,7,14,21,0.000143,0.002149,0,21568,0,0.000015,15,0.193547,0.218214,10928.42106,0.154762,0.00166
207169,207169,,1,12,13,1,12,13,0,0.000037,0,22167,5,0.000011,14,0.160472,0.177365,253.599603,0.121795,0.000219
207170,207170,,0,8,8,0,8,8,0,0.002821,0,22168,25,0.00001,16,0.175797,0.195677,0,0.160714,0
207171,207171,,6,27,33,6,27,33,0.001004,0.012327,0,22169,52,0.000011,13,0.214116,0.244342,14805.28815,0.154356,0.001504
207172,207172,,0,17,17,0,17,17,0,0.00045,0,22170,3,0.00001,16,0.194136,0.215888,0,0.198529,0
207173,207173,,6,54,60,6,54,60,0.000425,0.025036,0,22171,25,0.000014,14,0.197871,0.234504,24006.596266,0.14661,0.001348
207174,207174,,11,23,34,11,23,34,0.000102,0.000772,0,22172,3,0.000016,13,0.214879,0.238299,23761.774449,0.204991,0.002579
207175,207175,,2,70,72,2,70,72,0.000207,0.005758,0,22173,41,0.00001,16,0.224871,0.253639,1911.064095,0.170579,0.000485
207176,207176,,3,10,13,3,10,13,0.000001,0.000006,0,22174,6,0.000012,16,0.179427,0.199392,11547.917299,0.064103,0.00067
208111,208111,,2,8,10,2,8,10,0.000001,0.000003,0,22175,6,0.00001,17,0.154353,0.168872,178.831149,0.122222,0.000438
208202,208202,,0,41,41,0,41,41,0,0.000009,0,22176,6,0.00001,19,0.156364,0.179921,0,0.082317,0
207177,207177,,4,26,30,4,26,30,0.000153,0.000286,0,22177,52,0.000011,15,0.191174,0.211254,288.149637,0.183908,0.000962
207178,207178,,2,21,23,2,21,23,0.000284,0.000801,0,21570,0,0.00001,15,0.193151,0.217575,3309.499184,0.177866,0.000569
207180,207180,,2,18,20,2,18,20,0.000039,0.001309,0,22178,30,0.00001,16,0.20228,0.224514,2054.425016,0.236842,0.000505
207181,207181,,0,19,19,0,19,19,0,0.000179,0,22179,9,0.00001,14,0.188122,0.206949,0,0.298246,0
207182,207182,,0,1,1,0,1,1,0,0,34,22181,57,0.00001,1,1,1,0,0,0
108227,108227,,1,0,1,1,0,1,0,0,34,22180,57,0.000019,0,0,0,0,0,0.000219
207183,207183,,0,23,23,0,23,23,0,0.002341,0,22182,1,0.00001,15,0.196392,0.225608,0,0.130435,0
207184,207184,,0,13,13,0,13,13,0,0.002261,0,22183,10,0.00001,15,0.168711,0.187766,0,0.115385,0
207185,207185,,0,7,7,0,7,7,0,0.001188,0,22184,25,0.00001,16,0.176908,0.198532,0,0.285714,0
207186,207186,,0,1,1,0,1,1,0,0.000002,0,22185,5,0.00001,3,0.5,0.611111,0,0,0
207187,207187,,2,7,9,2,7,9,0.000033,0.000168,0,22186,13,0.000011,15,0.169831,0.193965,1213.099864,0.194444,0.000466
207188,207188,,2,59,61,2,59,61,0.000112,0.012469,0,22187,0,0.000011,14,0.223761,0.261819,4149.865274,0.118033,0.000451
207189,207189,,0,10,10,0,10,10,0,0.001209,0,22188,25,0.00001,16,0.179503,0.199807,0,0.3,0
207190,207190,,9,22,31,9,22,31,0.000814,0.003926,0,22189,41,0.000013,18,0.200169,0.224151,4299.512709,0.264516,0.002329
207191,207191,,1,7,8,1,7,8,0.000011,0.000034,0,22191,30,0.000011,14,0.184662,0.200557,287.896105,0.160714,0.000219
201087,201087,,2,0,2,2,0,2,0.000011,0,0,22190,30,0.000012,0,0,0,0,0.5,0.000445
207192,207192,,2,1,3,2,1,3,0,0,0,22192,6,0.000017,17,0.17332,0.187712,0,0.5,0.000458
207193,207193,,0,4,4,0,4,4,0,0.001247,0,22193,25,0.00001,16,0.177647,0.197085,0,0.5,0
207194,207194,,3,21,24,3,21,24,0.000037,0.00786,0,22194,8,0.000011,13,0.199223,0.221257,31219.158927,0.175725,0.00069
207195,207195,,0,7,7,0,7,7,0,0.001076,0,22195,0,0.00001,16,0.177446,0.199515,0,0.214286,0
207196,207196,,1,4,5,1,4,5,0.000003,0.000034,0,22196,4,0.000011,13,0.162361,0.18002,80.136125,0.2,0.000219
207197,207197,,0,20,20,0,20,20,0,0.003638,0,22197,2,0.00001,17,0.195012,0.223072,0,0.186842,0
207198,207198,,1,1,2,1,1,2,0.000034,0.000007,0,22198,25,0.00001,17,0.164533,0.180088,0,0.5,0.000252
207199,207199,,3,24,27,3,24,27,0.000114,0.002959,0,22199,2,0.000011,14,0.20068,0.227631,9195.536539,0.180912,0.000713
207200,207200,,3,7,10,3,7,10,0.0002,0.001597,0,22200,26,0.000012,17,0.140074,0.161073,11609.257526,0.088889,0.000695
207201,207201,,6,21,27,6,21,27,0.000028,0.000253,0,22201,9,0.000012,14,0.187829,0.212147,6335.846471,0.103989,0.001347
207202,207202,,1,9,10,1,9,10,0.000001,0.000001,0,22202,5,0.000011,16,0.122224,0.130925,87.275821,0.066667,0.000219
207203,207203,,1,3,4,1,3,4,0.000377,0.000046,0,22203,25,0.00001,14,0.169449,0.182952,23.313811,0.083333,0.000219
207204,207204,,0,5,5,0,5,5,0,0.001196,0,22204,25,0.00001,12,0.190456,0.207447,0,0.2,0
207206,207206,,3,16,19,3,16,19,0.000377,0.009109,0,22205,1,0.000015,16,0.192085,0.223977,15625.218918,0.160819,0.00067
207207,207207,,2,14,16,2,14,16,0.000023,0.001727,0,22206,0,0.000011,15,0.190059,0.210737,35184.933313,0.1125,0.000498
207208,207208,,2,56,58,2,56,58,0.000077,0.008982,0,22207,0,0.00001,15,0.214334,0.245835,3536.496795,0.098306,0.000445
207209,207209,,2,11,13,2,11,13,0.000085,0.004089,0,22208,2,0.000012,19,0.166007,0.185797,140.567012,0.307692,0.000445
207211,207211,,2,11,13,2,11,13,0.000037,0.001264,0,22209,30,0.000011,16,0.195599,0.216379,68.374188,0.307692,0.000451
207212,207212,,6,46,52,6,46,52,0.000385,0.016972,0,22210,1,0.000012,14,0.199071,0.223762,12617.04583,0.075038,0.001407
207213,207213,,2,11,13,2,11,13,0.000032,0.000971,0,22211,0,0.000011,17,0.180046,0.207097,340.995545,0.115385,0.000458
207215,207215,,0,12,12,0,12,12,0,0.00234,0,22213,4,0.00001,14,0.163401,0.184915,0,0.189394,0
9808092,9808092,,1,0,1,1,0,1,0.000027,0,0,22212,4,0.000011,0,0,0,0,0,0.000219
207216,207216,,0,3,3,0,3,3,0,0.000002,0,22214,2,0.00001,17,0.160308,0.175051,0,0.333333,0
207217,207217,,6,2,8,6,2,8,0.000067,0.000001,0,22215,8,0.000026,13,0.14907,0.15852,3243.319035,0.089286,0.001329
207218,207218,,0,6,6,0,6,6,0,0.00007,0,22216,17,0.00001,6,0.324324,0.479861,0,0.266667,0
207219,207219,,0,4,4,0,4,4,0,0.005017,0,22217,1,0.00001,16,0.156405,0.174594,0,0.25,0
207220,207220,,6,19,25,6,19,25,0.000123,0.000559,0,22218,30,0.000012,15,0.214069,0.237564,4516.721135,0.186667,0.001361
207221,207221,,1,21,22,1,21,22,0.000038,0.003452,0,22219,41,0.00001,18,0.193778,0.217128,498.185497,0.205628,0.000219
207222,207222,,4,18,22,4,18,22,0.000143,0.000803,0,22220,30,0.000011,13,0.20527,0.226127,5968.498624,0.220779,0.000916
207223,207223,,16,18,34,16,18,34,0.002322,0.003833,0,22221,41,0.000014,19,0.202066,0.234838,5703.832097,0.226381,0.004149
207224,207224,,1,12,13,1,12,13,0,0.000011,0,22222,23,0.000011,14,0.173295,0.188516,1002.8346,0.282051,0.000219
207225,207225,,0,5,5,0,5,5,0,0.000269,0,22223,30,0.00001,14,0.183628,0.196921,0,0,0
207226,207226,,1,13,14,1,13,14,0.000019,0.008779,0,22224,1,0.000014,14,0.210794,0.238387,11102.895352,0.142857,0.000219
207227,207227,,1,2,3,1,2,3,0,0.000001,0,22225,8,0.000013,14,0.129775,0.136067,2,0.166667,0.000219
207228,207228,,7,36,43,7,36,43,0.000124,0.000479,0,22227,0,0.000013,15,0.194873,0.221195,13111.537581,0.156146,0.001594
9711134,9711134,,2,5,7,2,5,7,0.000016,0.000123,0,22226,0,0.000011,15,0.157115,0.180641,3.863843,0.333333,0.000484
207230,207230,,0,2,2,0,2,2,0,0,0,22228,23,0.00001,15,0.1164,0.123694,0,0.5,0
207231,207231,,1,19,20,1,19,20,0.000001,0.006085,0,22230,15,0.00001,14,0.190118,0.213255,722.534157,0.081579,0.000219
9211129,9211129,,1,0,1,1,0,1,0.000071,0,0,22229,15,0.00001,0,0,0,0,0,0.000226
207232,207232,,1,7,8,1,7,8,0.000001,0.000078,0,22231,4,0.000012,17,0.152005,0.171805,30.689502,0.160714,0.000219
207233,207233,,0,6,6,0,6,6,0,0,0,22236,15,0.00001,4,0.5,0.630208,0,0.066667,0
109026,109026,,1,0,1,1,0,1,0,0,0,22235,15,0.000011,0,0,0,0,0,0.000219
9310140,9310140,,5,0,5,5,0,5,0.000011,0,0,6194,15,0.000034,0,0,0,0,0.1,0.001139
9404052,9404052,,1,1,2,1,1,2,0,0,0,22234,15,0.000011,1,1,1,0,0.5,0.000219
9406098,9406098,,2,0,2,2,0,2,0,0,0,22233,15,0.000014,0,0,0,0,0,0.000438
9412083,9412083,,2,2,4,2,2,4,0,0,0,22232,15,0.00002,2,0.666667,0.75,6,0.083333,0.000438
9312068,9312068,,4,2,6,4,2,6,0.000001,0.000005,0,3089,15,0.000023,1,1,1,1451.592054,0.066667,0.000936
207236,207236,,1,15,16,1,15,16,0.000004,0.002337,0,22237,30,0.00001,15,0.198947,0.218749,337.170057,0.225,0.000226
207237,207237,,0,7,7,0,7,7,0,0.000077,0,22238,5,0.00001,6,0.299643,0.345701,0,0.285714,0
9312017,9312017,,4,6,10,4,6,10,0.000004,0.000038,0,384,5,0.000022,4,0.472727,0.567308,200.687418,0.133333,0.000989
207238,207238,,4,10,14,4,10,14,0.000084,0.001015,0,22239,0,0.000013,15,0.194836,0.21958,10887.227312,0.181319,0.000903
207239,207239,,0,3,3,0,3,3,0,0.000003,0,22240,23,0.00001,24,0.111201,0.121803,0,0.166667,0
207240,207240,,0,3,3,0,3,3,0,0.000089,0,22241,5,0.00001,13,0.19739,0.217623,0,0,0
207241,207241,,5,18,23,5,18,23,0.000668,0.00482,0,22242,1,0.000012,14,0.20387,0.232445,6132.200821,0.264822,0.001142
207242,207242,,1,11,12,1,11,12,0.000018,0.00154,0,22243,30,0.000011,19,0.168788,0.191515,0,0.212121,0.000226
207243,207243,,0,21,21,0,21,21,0,0.000113,0,22244,1,0.00001,15,0.179907,0.19982,0,0.121429,0
207244,207244,,3,45,48,3,45,48,0.000643,0.004449,0,22245,10,0.000011,15,0.211627,0.243381,7841.49334,0.107713,0.000691
207246,207246,,6,19,25,6,19,25,0.000501,0.007868,0,22246,13,0.000013,14,0.184656,0.209907,5805.86113,0.138333,0.001374
207247,207247,,2,34,36,2,34,36,0.000019,0.019045,0,21550,8,0.000012,16,0.194124,0.218726,13188.871087,0.159524,0.00048
207248,207248,,0,6,6,0,6,6,0,0.000279,0,22247,1,0.00001,13,0.16747,0.183401,0,0.066667,0
9310088,9310088,,5,3,8,5,3,8,0.000004,0,0,12655,9,0.000034,1,1,1,2305,0.107143,0.00119
9303130,9303130,,2,0,2,2,0,2,0,0,0,12654,9,0.000021,0,0,0,0,0.5,0.000513
9306152,9306152,,2,0,2,2,0,2,0,0,0,12653,9,0.000021,0,0,0,0,0.5,0.000513
9307144,9307144,,1,0,1,1,0,1,0,0,0,12652,9,0.00002,0,0,0,0,0,0.000253
9307091,9307091,,4,7,11,4,7,11,0,0,0,7085,9,0.000014,1,1,1,22.914623,0.363636,0.001007
9307180,9307180,,2,9,11,2,9,11,0,0.000001,0,7086,9,0.000012,1,1,1,23.414623,0.290909,0.00051
9405077,9405077,,2,1,3,2,1,3,0,0,0,3789,9,0.000017,1,1,1,0,0.5,0.000496
9508097,9508097,,1,2,3,1,2,3,0,0,0,12660,9,0.00001,1,1,1,27.29656,0.333333,0.00026
9512128,9512128,,7,2,9,7,2,9,0,0,0,12656,9,0.000039,2,0.6,0.666667,57.29656,0.180556,0.001628
9606156,9606156,,1,2,3,1,2,3,0,0.000003,0,12659,9,0.00001,3,0.5,0.583333,0,0.5,0.00026
9607230,9607230,,2,0,2,2,0,2,0,0,0,12658,9,0.000013,0,0,0,0,0,0.000479
9610080,9610080,,5,2,7,5,2,7,0,0,0,12657,9,0.00002,3,0.466667,0.571429,29.29656,0.238095,0.00115
207249,207249,,0,65,65,0,65,65,0,0.031272,0,22248,13,0.00001,13,0.244821,0.288817,0,0.069471,0
207250,207250,,1,1,2,1,1,2,0,0,35,22250,58,0.000014,1,1,1,0,0.5,0.000219
9704144,9704144,,2,0,2,2,0,2,0,0,35,22249,58,0.000027,0,0,0,0,0.5,0.000445
207251,207251,,1,3,4,1,3,4,0,0.000009,0,22251,25,0.000012,16,0.164213,0.177877,0,0.333333,0.000219
207252,207252,,1,16,17,1,16,17,0.000031,0.001696,0,22252,41,0.00001,18,0.186068,0.209353,598.205654,0.139706,0.000239
207253,207253,,2,5,7,2,5,7,0,0.000018,0,22253,1,0.000016,14,0.172916,0.186737,1069.99985,0.142857,0.000438
207254,207254,,4,4,8,4,4,8,0,0.000001,0,22254,23,0.000023,14,0.161869,0.172268,4322,0.267857,0.000909
207255,207255,,0,26,26,0,26,26,0,0.004878,0,22255,13,0.00001,16,0.186376,0.215411,0,0.072308,0
207257,207257,,8,65,73,8,65,73,0.001076,0.005507,0,22256,41,0.000012,14,0.220204,0.248749,32696.810035,0.141933,0.002163
207258,207258,,0,7,7,0,7,7,0,0.00148,0,22257,25,0.00001,17,0.174947,0.197684,0,0.142857,0
207259,207259,,3,16,19,3,16,19,0.000124,0.001484,0,20077,4,0.00001,17,0.182463,0.208141,96.58264,0.236842,0.000795
207260,207260,,1,8,9,1,8,9,0.000018,0.001297,0,22258,25,0.000011,15,0.176853,0.197721,36.122748,0.472222,0.000219
207261,207261,,0,4,4,0,4,4,0,0,0,22259,26,0.00001,17,0.119751,0.129947,0,0.083333,0
207262,207262,,0,1,1,0,1,1,0,0,0,22260,4,0.00001,18,0.133015,0.146354,0,0,0
207263,207263,,4,6,10,4,6,10,0.000065,0.00125,0,22261,25,0.000012,13,0.189332,0.207306,1298.013512,0.266667,0.000929
207264,207264,,12,33,45,12,33,45,0.000627,0.00736,0,22262,41,0.000014,18,0.20728,0.234052,14028.65796,0.15303,0.003024
207265,207265,,2,12,14,2,12,14,0.000115,0.001032,0,22263,8,0.000011,13,0.19282,0.21212,369.610677,0.175824,0.000451
207266,207266,,6,8,14,6,8,14,0.000053,0.00032,0,22264,3,0.000013,15,0.177877,0.194276,452.898105,0.252747,0.001441
207267,207267,,13,12,25,13,12,25,0.000202,0.000212,0,22265,13,0.000018,15,0.172262,0.194425,5043.566371,0.146667,0.003072
207268,207268,,0,4,4,0,4,4,0,0,0,22266,5,0.00001,2,0.833333,0.9,0,0.5,0
207269,207269,,0,1,1,0,1,1,0,0.000001,0,22267,30,0.00001,15,0.155831,0.163803,0,0,0
207270,207270,,1,14,15,1,14,15,0.000002,0.000395,0,22268,3,0.000011,16,0.194776,0.216663,8827.228441,0.22381,0.000227
207271,207271,,1,7,8,1,7,8,0.000061,0.002241,0,22269,4,0.00001,13,0.183519,0.206704,5.577996,0.285714,0.000219
207272,207272,,2,6,8,2,6,8,0.000027,0.000346,0,20059,0,0.000011,15,0.158009,0.173633,338.550729,0.107143,0.000473
207273,207273,,1,42,43,1,42,43,0.000008,0.000655,0,22270,9,0.00001,19,0.185839,0.214956,1640.924765,0.231451,0.000219
207274,207274,,3,5,8,3,5,8,0.000038,0.00087,0,22271,30,0.000014,16,0.170964,0.190164,276.935111,0.267857,0.00069
207275,207275,,1,5,6,1,5,6,0,0.000003,0,22272,23,0.000011,18,0.104514,0.119508,0,0.333333,0.000219
207276,207276,,0,12,12,0,12,12,0,0.001236,0,22273,23,0.00001,18,0.180155,0.199922,0,0.143939,0
207277,207277,,0,7,7,0,7,7,0,0.000002,0,22274,23,0.00001,18,0.156844,0.168645,0,0.452381,0
207278,207278,,16,32,48,16,32,48,0.00069,0.001745,0,20051,0,0.000014,14,0.204672,0.230742,21701.493423,0.182181,0.004072
207279,207279,,8,14,22,8,14,22,0.000002,0.000049,0,22275,15,0.000017,15,0.174226,0.186523,5382.486898,0.199134,0.001806
207280,207280,,2,13,15,2,13,15,0.000236,0.000351,0,22276,0,0.00001,15,0.194063,0.21672,3652.598615,0.2,0.000484
207281,207281,,2,20,22,2,20,22,0.00003,0.002063,0,22277,0,0.000012,15,0.190955,0.212603,5426.086093,0.24026,0.000438
207282,207282,,0,2,2,0,2,2,0,0.000002,0,22278,20,0.00001,2,0.75,0.833333,0,0.5,0
207283,207283,,3,70,73,3,70,73,0.000377,0.004351,0,22279,25,0.000011,14,0.210527,0.240891,17989.09334,0.08124,0.000697
207284,207284,,40,14,54,40,14,54,0.002872,0.00146,0,22280,41,0.000028,15,0.193395,0.217505,93054.839773,0.0884,0.010728
208001,208001,,1,3,4,1,3,4,0.000007,0,0,22281,22,0.00001,19,0.139202,0.150209,30.5671,0.166667,0.000226
208002,208002,,6,17,23,6,17,23,0.000671,0.018446,0,22282,25,0.000014,14,0.209084,0.238219,29397.435193,0.252964,0.00142
208003,208003,,9,42,51,9,42,51,0.000661,0.013303,0,22283,3,0.000013,15,0.205385,0.230266,15743.927226,0.151373,0.002289
208004,208004,,0,12,12,0,12,12,0,0.00023,0,22284,5,0.00001,15,0.15608,0.174457,0,0.219697,0
208005,208005,,3,21,24,3,21,24,0.000002,0.000023,0,22285,6,0.000011,19,0.134596,0.150103,3887.695192,0.11413,0.000664
208006,208006,,2,4,6,2,4,6,0.000001,0.000004,0,22286,20,0.000013,15,0.153989,0.164514,5433.015816,0.266667,0.000445
208007,208007,,0,9,9,0,9,9,0,0.000041,0,22287,30,0.00001,14,0.17995,0.193613,0,0.194444,0
208008,208008,,2,14,16,2,14,16,0.000027,0.000829,0,22290,25,0.000011,15,0.197201,0.22046,496.471424,0.170833,0.000445
9910140,9910140,,2,2,4,2,2,4,0.000021,0,0,22289,25,0.000011,2,0.666667,0.75,12,0.083333,0.000458
9309051,9309051,,2,0,2,2,0,2,0,0,0,22288,25,0.000024,0,0,0,0,0,0.000452
208011,208011,,2,23,25,2,23,25,0.000013,0.001372,0,22291,3,0.000011,17,0.185613,0.209241,5532.444345,0.103333,0.00049
208046,208046,,0,7,7,0,7,7,0,0.00697,0,22292,8,0.00001,14,0.171224,0.187722,0,0.333333,0
208015,208015,,1,11,12,1,11,12,0.000039,0.000659,0,22293,1,0.00001,14,0.199241,0.219324,37.284298,0.25,0.000226
208016,208016,,0,12,12,0,12,12,0,0.000001,0,22294,6,0.00001,16,0.119667,0.129181,0,0.272727,0
208018,208018,,3,52,55,3,52,55,0.000272,0.004208,0,22295,8,0.000011,14,0.209828,0.23609,19544.353979,0.115825,0.000684
208021,208021,,0,19,19,0,19,19,0,0.000006,0,22296,17,0.00001,14,0.143359,0.155138,0,0.321637,0
208022,208022,,1,30,31,1,30,31,0.000045,0.003517,0,22297,4,0.00001,14,0.167138,0.191863,32.46906,0.209677,0.000219
208024,208024,,1,4,5,1,4,5,0.000192,0.005812,0,22298,1,0.000011,12,0.183378,0.201582,1533.128246,0.35,0.000219
208025,208025,,1,8,9,1,8,9,0.000016,0.001176,0,22299,25,0.000011,17,0.177599,0.203319,1885.458515,0.222222,0.000219
208026,208026,,0,10,10,0,10,10,0,0.001207,0,22300,13,0.00001,15,0.17604,0.195975,0,0.1,0
208028,208028,,8,34,42,8,34,42,0.000203,0.000396,0,19374,3,0.000012,14,0.203395,0.225928,30517.391163,0.166667,0.002553
208029,208029,,16,34,50,16,34,50,0.001488,0.005181,0,22301,41,0.000014,15,0.208019,0.231889,17959.936766,0.198367,0.004125
208030,208030,,1,28,29,1,28,29,0.000041,0.002399,0,22302,0,0.00001,13,0.203212,0.229342,1711.07829,0.103448,0.000322
208031,208031,,2,13,15,2,13,15,0.000003,0.000177,0,22303,25,0.000014,17,0.183646,0.203078,8055.896385,0.1,0.000465
208032,208032,,0,30,30,0,30,30,0,0.003423,0,22304,0,0.00001,14,0.205985,0.233854,0,0.128736,0
208033,208033,,0,33,33,0,33,33,0,0.002988,0,22305,25,0.00001,14,0.189557,0.211974,0,0.227273,0
208034,208034,,0,14,14,0,14,14,0,0.000056,0,22306,4,0.00001,14,0.176306,0.192123,0,0.175824,0
208035,208035,,0,10,10,0,10,10,0,0.000831,0,22307,8,0.00001,15,0.171649,0.189721,0,0.088889,0
208036,208036,,1,8,9,1,8,9,0.000004,0.000106,0,22309,9,0.000011,15,0.171501,0.193133,3520.873455,0.180556,0.000219
9712209,9712209,,1,13,14,1,13,14,0.000001,0.002854,0,22308,0,0.000011,11,0.207967,0.237235,885.093553,0.082418,0.000226
208037,208037,,5,13,18,5,13,18,0.000301,0.001564,0,22310,25,0.000013,16,0.185148,0.210189,2610.230887,0.160131,0.001102
208038,208038,,21,11,32,21,11,32,0.001625,0.001064,0,22311,41,0.000017,14,0.193155,0.213956,16664.229993,0.193548,0.005595
208039,208039,,6,51,57,6,51,57,0.000558,0.002022,0,20084,4,0.000011,15,0.199202,0.23135,18377.406782,0.154449,0.001677
208040,208040,,0,13,13,0,13,13,0,0.001724,0,22312,30,0.00001,13,0.208588,0.229565,0,0.173077,0
208042,208042,,15,40,55,15,40,55,0.001283,0.00467,0,22313,41,0.000015,15,0.21013,0.235243,18670.304532,0.16633,0.004062
208043,208043,,0,24,24,0,24,24,0,0.001892,0,22314,30,0.00001,15,0.194679,0.218753,0,0.110507,0
208044,208044,,6,23,29,6,23,29,0.000498,0.0043,0,22315,2,0.000012,17,0.185675,0.209543,2062.640107,0.229064,0.001407
208045,208045,,1,1,2,1,1,2,0.000009,0,0,22318,15,0.000011,2,0.555556,0.6,3,0,0.000219
9404105,9404105,,1,4,5,1,4,5,0,0.000006,0,22317,15,0.00002,1,1,1,6,0.05,0.000226
9306071,9306071,,3,0,3,3,0,3,0,0,0,22316,15,0.00002,0,0,0,0,0.166667,0.000671
208047,208047,,4,19,23,4,19,23,0.000811,0.018202,0,22319,1,0.000011,17,0.201554,0.237487,1790.153367,0.247036,0.000964
208048,208048,,104,45,149,104,45,149,0.003859,0.009018,0,22320,4,0.000071,15,0.215451,0.250621,284504.942808,0.116089,0.036653
208050,208050,,0,34,34,0,34,34,0,0.001882,0,22323,8,0.00001,16,0.210032,0.236513,0,0.073975,0
9907160,9907160,,2,13,15,2,13,15,0.000023,0.000861,0,22322,15,0.000011,15,0.176576,0.198313,3904.940869,0.152381,0.000445
9810174,9810174,,1,1,2,1,1,2,0.00001,0.000007,0,22321,15,0.000011,6,0.218884,0.253268,0.166667,0,0.000232
208051,208051,,1,16,17,1,16,17,0.000017,0.000483,0,22324,10,0.00001,14,0.191454,0.214637,1412.496291,0.165441,0.000247
208052,208052,,2,22,24,2,22,24,0.000002,0.000084,0,22327,5,0.000011,15,0.172496,0.195459,246.448691,0.097826,0.000451
7004,7004,,1,0,1,1,0,1,0.000001,0,0,22326,5,0.00001,0,0,0,0,0,0.000232
7005,7005,,1,0,1,1,0,1,0.000001,0,0,22325,5,0.00001,0,0,0,0,0,0.000232
208055,208055,,0,12,12,0,12,12,0,0.00187,0,22328,25,0.00001,14,0.188892,0.209909,0,0.128788,0
208056,208056,,4,10,14,4,10,14,0.000082,0.000327,0,22329,25,0.000012,18,0.166482,0.184888,922.154908,0.236264,0.001044
208057,208057,,0,1,1,0,1,1,0,0,0,22330,28,0.00001,17,0.142952,0.15112,0,0,0
208058,208058,,14,9,23,14,9,23,0.000089,0.000063,0,22331,23,0.00002,15,0.16836,0.18521,22348.184062,0.128458,0.003298
208059,208059,,1,15,16,1,15,16,0.000143,0.000604,0,22332,30,0.00001,18,0.193212,0.215215,160.127824,0.1375,0.000226
208060,208060,,6,12,18,6,12,18,0.000278,0.015496,0,22333,25,0.000014,15,0.182213,0.202912,3196.898178,0.245098,0.001374
208061,208061,,1,4,5,1,4,5,0,0,0,22334,28,0.000014,9,0.208122,0.238732,200,0.2,0.000219
208062,208062,,3,9,12,3,9,12,0.000002,0.000041,0,22335,15,0.000012,15,0.186346,0.206422,3727.609406,0.174242,0.000677
208063,208063,,1,15,16,1,15,16,0.000214,0.003057,0,22336,1,0.00001,16,0.166889,0.191892,63.497991,0.179167,0.000233
208064,208064,,1,5,6,1,5,6,0,0.000013,0,22337,15,0.000011,15,0.152567,0.161898,0,0.333333,0.000219
208065,208065,,4,25,29,4,25,29,0.000302,0.018317,0,22338,8,0.000011,15,0.203089,0.233924,15275.5869,0.160099,0.000909
208066,208066,,10,22,32,10,22,32,0.001322,0.019256,0,22339,41,0.000013,17,0.201428,0.223707,4807.673494,0.233871,0.002554
208067,208067,,5,18,23,5,18,23,0.000058,0.000223,0,22340,3,0.000011,14,0.177894,0.193782,74.428481,0.343874,0.001169
208068,208068,,1,29,30,1,29,30,0.000039,0.002536,0,22341,3,0.00001,15,0.197114,0.223679,2331.687177,0.133333,0.000219
208069,208069,,2,5,7,2,5,7,0.000004,0.000228,0,22342,13,0.000013,14,0.137364,0.156624,12.083333,0.238095,0.000445
208070,208070,,0,8,8,0,8,8,0,0.0012,0,22343,4,0.00001,16,0.166862,0.183658,0,0.160714,0
208071,208071,,4,13,17,4,13,17,0.000486,0.000218,0,22344,25,0.000012,15,0.180495,0.198687,888.028305,0.143382,0.000916
208072,208072,,5,7,12,5,7,12,0.000071,0.000871,0,22345,30,0.000013,16,0.171362,0.190989,1086.114647,0.189394,0.001102
208073,208073,,3,14,17,3,14,17,0.00017,0.00255,0,22346,1,0.000011,15,0.189093,0.214041,777.692462,0.183824,0.000697
208074,208074,,12,32,44,12,32,44,0.000858,0.002625,0,22347,41,0.000014,15,0.207552,0.230431,15412.433649,0.226216,0.00314
208075,208075,,0,7,7,0,7,7,0,0.000119,0,22348,0,0.00001,18,0.175034,0.194181,0,0.333333,0
208076,208076,,0,17,17,0,17,17,0,0.001578,0,22349,28,0.00001,18,0.168721,0.193053,0,0.044118,0
208077,208077,,6,10,16,6,10,16,0.000433,0.002278,0,22350,41,0.000012,19,0.192076,0.214499,219.284834,0.266667,0.00153
208078,208078,,3,12,15,3,12,15,0.000663,0.004757,0,22351,41,0.00001,18,0.19414,0.223601,158.057733,0.214286,0.000732
208079,208079,,1,39,40,1,39,40,0.000173,0.018204,0,22352,41,0.00001,16,0.212463,0.236097,253.048376,0.273718,0.000253
208080,208080,,3,32,35,3,32,35,0.000255,0.002488,0,22353,25,0.000011,13,0.198895,0.223697,5871.518159,0.117647,0.000684
208081,208081,,7,30,37,7,30,37,0.000775,0.009364,0,22354,41,0.000011,17,0.203921,0.23125,3157.122701,0.188438,0.001787
208082,208082,,0,11,11,0,11,11,0,0.00996,0,22355,25,0.00001,14,0.195155,0.227656,0,0.263636,0
208083,208083,,0,15,15,0,15,15,0,0.000946,0,22356,13,0.00001,14,0.189351,0.214465,0,0.314286,0
208084,208084,,0,9,9,0,9,9,0,0.000001,0,22357,22,0.00001,17,0.144632,0.154597,0,0.277778,0
208085,208085,,1,9,10,1,9,10,0.000031,0.000564,0,22358,52,0.00001,13,0.194155,0.214043,31.80302,0.155556,0.000226
208086,208086,,6,38,44,6,38,44,0.000725,0.019369,0,22359,8,0.000012,16,0.20171,0.227762,17520.783238,0.163319,0.001367
208087,208087,,2,14,16,2,14,16,0.000013,0.000595,0,22360,52,0.000011,18,0.168565,0.184841,15575.829881,0.295833,0.000445
208088,208088,,1,3,4,1,3,4,0,0,0,22361,23,0.000011,17,0.119776,0.128224,15.733333,0.166667,0.000219
208089,208089,,0,1,1,0,1,1,0,0,0,22365,15,0.00001,7,0.202335,0.233036,0,0,0
9411200,9411200,,1,6,7,1,6,7,0,0.000005,0,22364,15,0.000019,6,0.25122,0.314078,103,0.047619,0.000219
9304074,9304074,,2,0,2,2,0,2,0,0,0,22363,15,0.000022,0,0,0,0,0,0.000445
9308119,9308119,,4,4,8,4,4,8,0.000002,0.000002,0,5115,26,0.000022,2,0.833333,0.9,20458.789053,0.089286,0.001006
9407054,9407054,,2,0,2,2,0,2,0,0,0,16953,15,0.000024,0,0,0,0,0,0.000459
9409161,9409161,,1,1,2,1,1,2,0,0,0,22362,15,0.000013,2,0.555556,0.6,0,0.5,0.000226
208090,208090,,0,9,9,0,9,9,0,0.000003,0,22366,26,0.00001,13,0.163412,0.176163,0,0.055556,0
208091,208091,,0,10,10,0,10,10,0,0.000006,0,22367,2,0.00001,14,0.166155,0.184983,0,0.2,0
208092,208092,,16,14,30,16,14,30,0.001157,0.006514,0,22368,41,0.000017,16,0.176054,0.200351,34065.290841,0.14023,0.004486
208095,208095,,3,26,29,3,26,29,0.000066,0.005154,0,22369,4,0.000011,16,0.187883,0.212505,20091.068596,0.118227,0.000703
208096,208096,,6,15,21,6,15,21,0.000333,0.000186,0,22370,25,0.000014,16,0.18314,0.205134,10977.150443,0.180952,0.001426
208097,208097,,4,13,17,4,13,17,0.000369,0.013841,0,22371,25,0.000014,15,0.211225,0.24187,4090.855584,0.102941,0.00089
208098,208098,,0,15,15,0,15,15,0,0.000984,0,22372,30,0.00001,14,0.187735,0.204776,0,0.157143,0
208099,208099,,1,19,20,1,19,20,0.000002,0.000449,0,22374,2,0.000011,17,0.155812,0.184965,5649.306791,0.110526,0.000219
9608187,9608187,,1,2,3,1,2,3,0.000005,0.000001,0,22373,2,0.00001,2,0.75,0.833333,4.5,0,0.000226
208100,208100,,0,29,29,0,29,29,0,0.01997,0,22375,13,0.00001,16,0.201131,0.229899,0,0.130542,0
208102,208102,,2,3,5,2,3,5,0.000066,0.000465,0,22376,25,0.000012,18,0.157173,0.175309,531.128278,0.2,0.000445
208104,208104,,6,19,25,6,19,25,0.0001,0.001102,0,22377,52,0.000013,16,0.181388,0.207176,8285.677278,0.091667,0.001361
208105,208105,,0,7,7,0,7,7,0,0.006644,0,22378,1,0.00001,14,0.164206,0.188124,0,0.142857,0
208106,208106,,2,7,9,2,7,9,0,0.000001,0,22379,23,0.000012,17,0.128083,0.139908,5438.713095,0.138889,0.000451
208109,208109,,1,9,10,1,9,10,0.000001,0.000098,0,22381,25,0.000012,14,0.187038,0.20532,10542.223134,0.255556,0.000226
208093,208093,,4,0,4,4,0,4,0.000002,0,0,22380,25,0.000026,0,0,0,0,0.166667,0.000903
208110,208110,,3,37,40,3,37,40,0.000187,0.001943,0,22382,2,0.000011,14,0.198979,0.226844,9376.047332,0.087179,0.000658
208112,208112,,0,26,26,0,26,26,0,0.00393,0,22383,2,0.00001,15,0.191496,0.215896,0,0.075385,0
208113,208113,,3,8,11,3,8,11,0.00001,0.000069,0,22384,6,0.000015,17,0.149249,0.167564,3553.787725,0.063636,0.000658
208114,208114,,29,27,56,29,27,56,0.002854,0.002497,0,22385,41,0.000019,16,0.196762,0.219506,27514.987981,0.103896,0.007227
208115,208115,,0,21,21,0,21,21,0,0.001518,0,22386,30,0.00001,15,0.216592,0.239102,0,0.25,0
208116,208116,,0,3,3,0,3,3,0,0,0,22387,23,0.00001,19,0.13556,0.145312,0,0.5,0
208117,208117,,2,23,25,2,23,25,0.000001,0.000015,0,22388,20,0.000011,21,0.149354,0.165457,7547.310102,0.223333,0.000445
208118,208118,,1,3,4,1,3,4,0,0.000003,0,22389,22,0.000014,16,0.132759,0.142741,465.587771,0.083333,0.000226
208119,208119,,5,40,45,5,40,45,0.00017,0.001992,0,22390,52,0.000012,16,0.197519,0.22897,10317.494579,0.119192,0.001182
208120,208120,,4,9,13,4,9,13,0.000471,0.000129,0,22391,25,0.000012,14,0.183076,0.201578,5954.275444,0.205128,0.00089
208121,208121,,3,6,9,3,6,9,0.000064,0.000322,0,20097,2,0.000011,16,0.171337,0.185811,687.744651,0.375,0.000731
208122,208122,,2,1,3,2,1,3,0.000012,0,0,22392,0,0.000011,15,0.138609,0.14588,2987.595724,0,0.000451
208123,208123,,12,23,35,12,23,35,0.000585,0.00145,0,22393,0,0.000017,13,0.207804,0.233908,28618.49491,0.080672,0.003056
208125,208125,,2,55,57,2,55,57,0.000315,0.003232,0,22395,0,0.000011,15,0.215679,0.247284,11116.356196,0.076754,0.00046
9511093,9511093,,1,5,6,1,5,6,0.000038,0.00004,0,22394,0,0.00001,15,0.175829,0.200264,2.395221,0.133333,0.000232
208127,208127,,3,34,37,3,34,37,0.000178,0.002428,0,22396,25,0.000011,15,0.193641,0.218258,2584.371195,0.138889,0.000677
208129,208129,,0,4,4,0,4,4,0,0.000083,0,22397,0,0.00001,18,0.17282,0.191179,0,0.5,0
208130,208130,,1,7,8,1,7,8,0,0.000053,0,22398,5,0.000011,14,0.190935,0.207701,12239.364295,0.214286,0.000232
208131,208131,,1,3,4,1,3,4,0,0,0,22399,22,0.000014,17,0.141624,0.149818,124.127091,0.166667,0.000226
208132,208132,,2,16,18,2,16,18,0.000011,0.000177,0,22400,8,0.000011,17,0.175831,0.202863,6015.308619,0.120915,0.000438
9401165,9401165,,1,3,4,1,3,4,0,0.000011,0,10417,4,0.000012,2,0.6,0.666667,27.708459,0,0.000234
208135,208135,,0,8,8,0,8,8,0,0.006983,0,22401,1,0.00001,15,0.1834,0.204568,0,0.285714,0
208136,208136,,1,4,5,1,4,5,0,0,0,22402,6,0.000013,15,0.142769,0.152139,0,0.3,0.000226
208137,208137,,1,10,11,1,10,11,0.000014,0.015084,0,22403,1,0.00001,17,0.182367,0.203302,89.533232,0.354545,0.000219
208138,208138,,3,19,22,3,19,22,0.000002,0.00003,0,22404,15,0.000012,15,0.170222,0.183173,1999.005493,0.11039,0.00067
208139,208139,,0,19,19,0,19,19,0,0.000743,0,22405,10,0.00001,16,0.191444,0.215096,0,0.248538,0
208140,208140,,0,8,8,0,8,8,0,0.000102,0,22406,25,0.00001,14,0.176494,0.194508,0,0.25,0
208141,208141,,2,51,53,2,51,53,0.000052,0.002643,0,22407,52,0.00001,14,0.211912,0.240555,1667.961846,0.107402,0.000438
208020,208020,,11,0,11,11,0,11,0.000528,0,0,20055,0,0.000013,0,0,0,0,0.009091,0.002687
208143,208143,,1,4,5,1,4,5,0.000003,0.000028,0,22408,13,0.000011,16,0.168912,0.184943,4387.967078,0.2,0.000219
208144,208144,,2,32,34,2,32,34,0.000002,0.001622,0,22411,30,0.000011,14,0.203782,0.229896,6914.448123,0.125668,0.000445
9609125,9609125,,2,6,8,2,6,8,0.00002,0.000007,0,22410,9,0.000011,9,0.202899,0.230691,482.903701,0.089286,0.000451
9509045,9509045,,3,2,5,3,2,5,0,0,0,9348,9,0.00002,1,1,1,7706,0.05,0.000699
9603040,9603040,,2,4,6,2,4,6,0.000001,0.000007,0,22409,9,0.000013,4,0.450704,0.507812,54.116182,0.133333,0.000451
208145,208145,,4,20,24,4,20,24,0.000083,0.001059,0,22412,0,0.000012,16,0.195777,0.221288,4319.954166,0.139493,0.000922
208146,208146,,4,19,23,4,19,23,0.000137,0.001506,0,22413,0,0.000012,16,0.179142,0.201074,15027.400548,0.181818,0.00089
208147,208147,,1,9,10,1,9,10,0,0.000002,0,22414,6,0.000011,14,0.136043,0.147144,411.894114,0.222222,0.000219
208149,208149,,5,8,13,5,8,13,0.000248,0.000334,0,22415,3,0.000011,14,0.196394,0.215607,2002.633624,0.333333,0.001255
208150,208150,,0,5,5,0,5,5,0,0.000024,0,22416,26,0.00001,16,0.152444,0.170433,0,0.15,0
208151,208151,,0,11,11,0,11,11,0,0.00004,0,22417,10,0.00001,14,0.188929,0.208649,0,0.181818,0
208152,208152,,0,3,3,0,3,3,0,0,0,22418,2,0.00001,16,0.159088,0.16961,0,0.333333,0
208153,208153,,4,27,31,4,27,31,0.000647,0.002359,0,22419,1,0.000012,16,0.19944,0.226816,1765.732838,0.219355,0.000903
208154,208154,,2,23,25,2,23,25,0.000066,0.009964,0,22420,25,0.00001,16,0.192862,0.222938,11317.573268,0.13,0.000477
208155,208155,,10,12,22,10,12,22,0.000012,0.000053,0,22421,23,0.000018,16,0.160965,0.18032,10238.140763,0.138528,0.002303
208156,208156,,7,18,25,7,18,25,0.000652,0.000701,0,22422,0,0.000013,15,0.190682,0.213895,6019.538753,0.093333,0.001745
208157,208157,,4,8,12,4,8,12,0.00005,0.000108,0,22423,25,0.000013,16,0.182473,0.201858,12541.807566,0.121212,0.000896
208158,208158,,1,18,19,1,18,19,0.000003,0.002008,0,22424,13,0.000011,15,0.175371,0.197388,211.93659,0.087719,0.000234
208159,208159,,0,8,8,0,8,8,0,0,0,22426,21,0.00001,8,0.214383,0.28753,0,0.232143,0
110060,110060,,2,0,2,2,0,2,0,0,0,22425,28,0.000014,0,0,0,0,0,0.000438
208160,208160,,0,3,3,0,3,3,0,0,0,22427,22,0.00001,20,0.104635,0.119421,0,0.5,0
208161,208161,,11,27,38,11,27,38,0.000875,0.00425,0,22428,41,0.000013,16,0.20278,0.225824,6616.493201,0.219772,0.002652
208162,208162,,5,22,27,5,22,27,0.000058,0.002162,0,22429,30,0.000012,18,0.191356,0.211619,3129.704907,0.185185,0.001129
208163,208163,,9,62,71,9,62,71,0.001203,0.010109,0,22430,41,0.000013,14,0.226744,0.256457,47234.323829,0.076258,0.002272
208164,208164,,0,1,1,0,1,1,0,0,36,22432,59,0.00001,1,1,1,0,0,0
9602091,9602091,,1,0,1,1,0,1,0,0,36,22431,59,0.000019,0,0,0,0,0,0.000219
208166,208166,,1,21,22,1,21,22,0.000001,0.00025,0,22433,26,0.000011,19,0.167765,0.18705,331.283144,0.246753,0.000219
208167,208167,,10,10,20,10,10,20,0.000282,0.000141,0,21554,8,0.000016,14,0.188887,0.205124,931.729973,0.368421,0.002587
208168,208168,,0,5,5,0,5,5,0,0,0,22436,23,0.00001,18,0.13714,0.148599,0,0,0
9905171,9905171,,2,1,3,2,1,3,0,0,0,22435,23,0.000013,1,1,1,2,0,0.000438
9905151,9905151,,1,0,1,1,0,1,0,0,0,22434,23,0.000021,0,0,0,0,0,0.000232
208169,208169,,0,8,8,0,8,8,0,0.000127,0,22437,25,0.00001,16,0.170958,0.189339,0,0.339286,0
208170,208170,,0,3,3,0,3,3,0,0.000002,0,22438,8,0.00001,15,0.151781,0.163852,0,0.166667,0
208171,208171,,0,19,19,0,19,19,0,0.001421,0,22439,8,0.00001,15,0.195402,0.21607,0,0.19883,0
208172,208172,,1,4,5,1,4,5,0.000231,0.000003,0,22440,2,0.00001,20,0.134353,0.146711,802.213501,0.05,0.000233
208173,208173,,0,10,10,0,10,10,0,0.00087,0,22441,30,0.00001,15,0.184005,0.200761,0,0.244444,0
208174,208174,,9,29,38,9,29,38,0.000348,0.004079,0,22442,0,0.000013,13,0.193563,0.218828,1664.004829,0.089616,0.002447
208175,208175,,1,13,14,1,13,14,0.000056,0.003218,0,22443,2,0.00001,14,0.179911,0.204897,1668.022104,0.296703,0.000304
208176,208176,,7,14,21,7,14,21,0.000654,0.001477,0,22444,4,0.000011,15,0.204957,0.226773,9697.604189,0.2,0.002138
208177,208177,,1,11,12,1,11,12,0.000008,0.000438,0,22445,10,0.00001,16,0.185377,0.209237,52.902022,0.212121,0.000219
208179,208179,,20,8,28,20,8,28,0.001975,0.001264,0,22446,41,0.000018,17,0.192922,0.210774,346.557647,0.335979,0.005869
208180,208180,,0,11,11,0,11,11,0,0.00002,0,22447,22,0.00001,16,0.164249,0.17773,0,0.072727,0
208181,208181,,0,3,3,0,3,3,0,0.000004,0,22449,20,0.00001,13,0.163595,0.175989,0,0.166667,0
103134,103134,,1,0,1,1,0,1,0,0,0,22448,20,0.000013,0,0,0,0,0,0.000219
208182,208182,,0,11,11,0,11,11,0,0.00094,0,22450,30,0.00001,14,0.185001,0.201973,0,0.109091,0
208183,208183,,0,4,4,0,4,4,0,0.000006,0,22451,5,0.00001,13,0.140043,0.154859,0,0.083333,0
208184,208184,,3,30,33,3,30,33,0.000042,0.001531,0,22452,25,0.000012,16,0.189401,0.218004,11553.229675,0.10322,0.000697
208185,208185,,0,1,1,0,1,1,0,0,0,22453,1,0.00001,2,0.666667,0.75,0,0,0
208186,208186,,0,8,8,0,8,8,0,0.000007,0,22455,22,0.00001,4,0.486111,0.569048,0,0.285714,0
9706184,9706184,,3,9,12,3,9,12,0.000019,0.000005,0,22454,22,0.00002,3,0.523077,0.602941,75.35,0.128788,0.000664
208187,208187,,10,56,66,10,56,66,0.000258,0.012257,0,22456,3,0.000013,13,0.220638,0.249734,41881.401815,0.112821,0.002512
208188,208188,,6,9,15,6,9,15,0.000354,0.002653,0,21569,0,0.000013,16,0.176568,0.197014,1418.474199,0.261905,0.001482
208190,208190,,0,37,37,0,37,37,0,0.000647,0,22457,10,0.00001,14,0.198974,0.225982,0,0.119369,0
208191,208191,,0,4,4,0,4,4,0,0.001389,0,22458,4,0.00001,15,0.190493,0.215902,0,0.25,0
208192,208192,,1,12,13,1,12,13,0,0.000023,0,22459,15,0.000011,16,0.16935,0.1853,7234.897594,0.096154,0.000219
208193,208193,,1,3,4,1,3,4,0,0.000008,0,22460,15,0.000011,14,0.163013,0.174835,1199.566327,0.25,0.000219
208195,208195,,0,7,7,0,7,7,0,0.000007,0,22461,6,0.00001,18,0.155586,0.16576,0,0.047619,0
208197,208197,,15,21,36,15,21,36,0.001532,0.002844,0,22462,41,0.000016,15,0.200015,0.222607,16248.807635,0.192857,0.003864
208198,208198,,0,9,9,0,9,9,0,0.000351,0,22463,13,0.00001,15,0.163924,0.179969,0,0.152778,0
208199,208199,,2,8,10,2,8,10,0.000341,0.000153,0,22464,30,0.00001,14,0.208285,0.228454,893.601042,0.244444,0.000486
208200,208200,,1,15,16,1,15,16,0,0.00155,0,22465,30,0.000011,19,0.169161,0.192742,851.370448,0.129167,0.000219
9310113,9310113,,1,15,16,1,15,16,0,0.000109,0,3957,9,0.000012,4,0.396104,0.52459,49670.086176,0.0125,0.000315
208201,208201,,1,13,14,1,13,14,0.00001,0.000905,0,22466,30,0.00001,14,0.187046,0.208399,621.27166,0.104396,0.000219
208203,208203,,2,35,37,2,35,37,0.00004,0.001654,0,22467,30,0.000011,14,0.208861,0.233102,1028.843904,0.172673,0.000438
208204,208204,,0,19,19,0,19,19,0,0.00147,0,22468,30,0.00001,13,0.21472,0.237021,0,0.201754,0
208205,208205,,3,21,24,3,21,24,0.000249,0.002106,0,22469,25,0.000012,13,0.199577,0.22028,1575.703232,0.235507,0.000671
208207,208207,,2,27,29,2,27,29,0.000016,0.002671,0,22470,25,0.000011,15,0.189919,0.214721,5635.93892,0.151478,0.000451
209051,209051,,12,29,41,12,29,41,0.000812,0.00168,0,22471,25,0.000016,17,0.191963,0.215833,49379.964471,0.171951,0.002871
208208,208208,,0,4,4,0,4,4,0,0.000092,0,22472,4,0.00001,17,0.151978,0.166784,0,0.333333,0
208209,208209,,28,25,53,28,25,53,0.00276,0.002379,0,22473,41,0.00002,16,0.199379,0.219406,14349.92184,0.28701,0.00776
208211,208211,,0,12,12,0,12,12,0,0.00001,0,22474,20,0.00001,13,0.164532,0.177794,0,0.159091,0
208212,208212,,0,1,1,0,1,1,0,0.000013,0,22475,1,0.00001,13,0.171601,0.184741,0,0,0
208213,208213,,1,21,22,1,21,22,0.00001,0.00035,0,22476,30,0.00001,18,0.210531,0.234527,2295.434682,0.192641,0.000219
208214,208214,,1,11,12,1,11,12,0.000006,0.000612,0,22477,3,0.00001,14,0.186871,0.204595,4592.667057,0.159091,0.000219
208215,208215,,1,16,17,1,16,17,0,0.000015,0,22478,23,0.00001,18,0.148329,0.164749,1077.622452,0.169118,0.000219
208218,208218,,0,2,2,0,2,2,0,0.000009,0,22479,1,0.00001,17,0.161144,0.178608,0,0.5,0
208219,208219,,2,26,28,2,26,28,0.000038,0.002448,0,22480,0,0.000011,12,0.206562,0.231204,3904.938207,0.12963,0.000438
208220,208220,,0,6,6,0,6,6,0,0.001727,0,22481,2,0.00001,15,0.160648,0.17937,0,0.2,0
208221,208221,,0,2,2,0,2,2,0,0,0,22482,15,0.00001,18,0.138473,0.146358,0,0.5,0
208222,208222,,4,34,38,4,34,38,0.000341,0.003543,0,22483,4,0.000012,16,0.190316,0.211004,11078.825047,0.159317,0.000896
208225,208225,,1,17,18,1,17,18,0.000033,0.001024,0,22484,13,0.00001,17,0.181399,0.207638,1050.084291,0.091503,0.000226
208226,208226,,0,10,10,0,10,10,0,0.002945,0,22485,25,0.00001,14,0.184388,0.205234,0,0.166667,0
208227,208227,,0,44,44,0,44,44,0,0.001355,0,22486,3,0.00001,15,0.209227,0.240339,0,0.146934,0
208228,208228,,0,1,1,0,1,1,0,0,0,22487,23,0.00001,20,0.107843,0.114422,0,0,0
208229,208229,,1,10,11,1,10,11,0.000228,0.000926,0,22489,8,0.00001,15,0.191349,0.209885,40.913614,0.245455,0.000219
9712045,9712045,,1,2,3,1,2,3,0.000011,0.00019,0,22488,1,0.000011,17,0.143176,0.168743,25.667034,0.166667,0.000226
208230,208230,,1,1,2,1,1,2,0,0,37,22491,61,0.000019,1,1,1,1,0,0.000219
5057,5057,,1,0,1,1,0,1,0,0,37,22490,61,0.000027,0,0,0,0,0,0.000226
208231,208231,,34,18,52,34,18,52,0.003097,0.001941,0,22492,41,0.000023,17,0.196488,0.215401,6469.272282,0.297134,0.0098
208232,208232,,18,30,48,18,30,48,0.001817,0.003646,0,22493,41,0.000016,17,0.199193,0.22011,7243.302615,0.246897,0.005005
209002,209002,,40,21,61,40,21,61,0.004742,0.002488,0,22494,41,0.000023,17,0.198998,0.219368,9383.562202,0.253825,0.011032
209215,209215,,28,25,53,28,25,53,0.002708,0.00255,0,22495,41,0.00002,17,0.198785,0.219538,8882.607199,0.301161,0.00782
209001,209001,,3,4,7,3,4,7,0.000005,0.000005,0,22496,6,0.000017,17,0.173913,0.188795,7456.513101,0.190476,0.000664
209003,209003,,6,30,36,6,30,36,0.000122,0.001529,0,22497,0,0.000014,17,0.181507,0.211542,18202.881868,0.096032,0.001315
209004,209004,,14,25,39,14,25,39,0.001769,0.003273,0,22498,41,0.000013,14,0.209743,0.232846,33291.758502,0.168691,0.003478
209005,209005,,0,3,3,0,3,3,0,0.0008,0,22499,30,0.00001,14,0.178488,0.194776,0,0.166667,0
209006,209006,,0,1,1,0,1,1,0,0,0,22500,26,0.00001,1,1,1,0,0,0
9705231,9705231,,3,0,3,3,0,3,0,0,0,12563,26,0.000031,0,0,0,0,0.166667,0.000677
209007,209007,,0,3,3,0,3,3,0,0.000005,0,22501,22,0.00001,13,0.144196,0.153418,0,0.166667,0
209008,209008,,3,8,11,3,8,11,0.00005,0.001077,0,22502,30,0.000011,15,0.18198,0.201251,277.890866,0.190909,0.000677
209009,209009,,7,24,31,7,24,31,0.000712,0.005876,0,22503,41,0.000011,17,0.200671,0.223922,404.34235,0.288172,0.001667
209010,209010,,2,14,16,2,14,16,0.000143,0.000111,0,22504,4,0.000011,18,0.159476,0.177946,381.773255,0.254167,0.000445
209011,209011,,13,23,36,13,23,36,0.00147,0.002736,0,22505,41,0.000014,17,0.194805,0.214609,1801.675537,0.359524,0.003625
209013,209013,,0,23,23,0,23,23,0,0.003311,0,22506,3,0.00001,17,0.179092,0.207262,0,0.197628,0
209015,209015,,0,12,12,0,12,12,0,0.000027,0,22507,41,0.00001,16,0.140379,0.154436,0,0.151515,0
209016,209016,,0,6,6,0,6,6,0,0.000012,0,22508,41,0.00001,14,0.155309,0.169209,0,0.066667,0
209017,209017,,4,14,18,4,14,18,0.000001,0.000043,0,22509,15,0.000014,13,0.181317,0.19426,21167.167662,0.160131,0.000923
209018,209018,,0,32,32,0,32,32,0,0.00689,0,22510,3,0.00001,15,0.203462,0.231866,0,0.193548,0
209019,209019,,1,4,5,1,4,5,0,0.000001,0,22511,23,0.000011,13,0.123253,0.131338,1753.99375,0.05,0.000219
209020,209020,,0,12,12,0,12,12,0,0.000008,0,22512,9,0.00001,13,0.187062,0.211254,0,0.272727,0
209021,209021,,0,2,2,0,2,2,0,0.000001,0,22513,22,0.00001,6,0.269565,0.310753,0,0,0
209022,209022,,0,14,14,0,14,14,0,0.001629,0,22514,0,0.00001,12,0.200505,0.226535,0,0.175824,0
209023,209023,,1,12,13,1,12,13,0.000013,0.000001,0,22515,23,0.00001,12,0.154933,0.170834,102.448793,0.102564,0.000232
209024,209024,,0,7,7,0,7,7,0,0.000004,0,22516,22,0.00001,14,0.164372,0.176893,0,0.095238,0
209025,209025,,9,21,30,9,21,30,0.000001,0.000018,0,22517,23,0.000018,16,0.159212,0.175109,33805.710155,0.205747,0.002125
209026,209026,,6,11,17,6,11,17,0.000077,0.00007,0,22518,2,0.000013,17,0.166576,0.184727,1551.738427,0.323529,0.001387
209027,209027,,0,23,23,0,23,23,0,0.001114,0,22519,3,0.00001,14,0.191122,0.21247,0,0.100791,0
209028,209028,,3,9,12,3,9,12,0.000002,0.001538,0,22520,26,0.000013,16,0.140292,0.155426,5995.517209,0.113636,0.000658
209029,209029,,2,36,38,2,36,38,0.000289,0.018003,0,22522,8,0.00001,15,0.197188,0.221442,3598.020068,0.157183,0.000451
9910225,9910225,,1,4,5,1,4,5,0.000212,0.000438,0,22521,1,0.00001,13,0.170337,0.186047,197.871718,0.4,0.000232
209030,209030,,1,34,35,1,34,35,0.000003,0.002976,0,22523,0,0.00001,17,0.214778,0.242797,9917.278385,0.064706,0.000232
209031,209031,,0,4,4,0,4,4,0,0.000554,0,22524,52,0.00001,17,0.171054,0.189388,0,0,0
209032,209032,,0,10,10,0,10,10,0,0,0,22525,26,0.00001,15,0.141448,0.1536,0,0.333333,0
209033,209033,,0,5,5,0,5,5,0,0.000003,0,22526,22,0.00001,15,0.141589,0.15085,0,0.15,0
209035,209035,,0,5,5,0,5,5,0,0.000035,0,22527,0,0.00001,16,0.15591,0.177055,0,0.2,0
209036,209036,,2,2,4,2,2,4,0.000278,0.000008,0,22528,25,0.00001,13,0.160325,0.173716,630.739674,0,0.000445
209037,209037,,0,15,15,0,15,15,0,0.00004,0,22529,6,0.00001,15,0.163919,0.185611,0,0.157143,0
209038,209038,,3,12,15,3,12,15,0.000086,0.000464,0,22530,4,0.000012,17,0.164657,0.182379,12582.715436,0.185714,0.000665
209039,209039,,2,15,17,2,15,17,0.000054,0.00006,0,22531,5,0.000011,16,0.162324,0.180574,317.991375,0.069853,0.000458
209040,209040,,1,5,6,1,5,6,0.000006,0.00024,0,22532,2,0.00001,15,0.174763,0.194658,0,0.4,0.000226
209041,209041,,13,23,36,13,23,36,0.000264,0.000502,0,21564,3,0.000014,13,0.193284,0.212002,12873.60102,0.307937,0.003398
209042,209042,,1,22,23,1,22,23,0.000026,0.000066,0,22533,5,0.00001,20,0.179653,0.199384,992.654976,0.175889,0.000239
209043,209043,,7,29,36,7,29,36,0.000737,0.002993,0,22534,41,0.000012,15,0.204204,0.22694,6355.610132,0.183333,0.001663
209044,209044,,3,9,12,3,9,12,0.000066,0.000137,0,22535,13,0.000012,15,0.175761,0.195085,2743.846468,0.128788,0.000691
209045,209045,,1,1,2,1,1,2,0,0.000064,0,22536,23,0.00001,14,0.155786,0.168759,18.748201,0,0.000219
209046,209046,,2,18,20,2,18,20,0.000022,0.001957,0,22537,0,0.000011,14,0.173552,0.190918,492.768103,0.334211,0.000458
209047,209047,,13,34,47,13,34,47,0.002135,0.019696,0,22538,41,0.000014,17,0.199231,0.222207,5995.109958,0.229417,0.003272
209048,209048,,2,5,7,2,5,7,0.000001,0.000002,0,22539,52,0.000012,15,0.135309,0.144663,20.399611,0.261905,0.000445
209049,209049,,1,3,4,1,3,4,0.000247,0.000003,0,21567,0,0.00001,14,0.161359,0.173741,283.50555,0.25,0.000315
209050,209050,,1,35,36,1,35,36,0.000237,0.020326,0,22540,25,0.00001,14,0.19449,0.219828,1786.160855,0.17381,0.000219
209052,209052,,2,8,10,2,8,10,0.000001,0.000005,0,22541,6,0.000011,14,0.143484,0.155228,80.473082,0.3,0.000438
209053,209053,,0,4,4,0,4,4,0,0,0,22543,20,0.00001,2,0.7,0.785714,0,0.083333,0
104024,104024,,2,0,2,2,0,2,0,0,0,22542,20,0.000021,0,0,0,0,0,0.000438
209054,209054,,7,34,41,7,34,41,0.001018,0.021038,0,22544,41,0.000012,15,0.20935,0.239552,2927.204557,0.193293,0.001654
209055,209055,,0,10,10,0,10,10,0,0.000015,0,22545,9,0.00001,14,0.158048,0.186457,0,0.344444,0
209056,209056,,4,34,38,4,34,38,0.000809,0.00195,0,22546,1,0.000011,18,0.191765,0.212925,12818.854152,0.154339,0.000916
209057,209057,,4,31,35,4,31,35,0.000529,0.003386,0,22547,30,0.000011,14,0.207269,0.23016,12452.419985,0.160504,0.000883
209058,209058,,1,2,3,1,2,3,0.00007,0,0,22548,23,0.000012,4,0.421053,0.484375,16,0.166667,0.000219
209059,209059,,5,41,46,5,41,46,0.000421,0.001218,0,22549,2,0.000012,15,0.19887,0.221278,28796.891907,0.109179,0.001137
209060,209060,,0,18,18,0,18,18,0,0.000778,0,22550,0,0.00001,13,0.190434,0.211093,0,0.186275,0
209061,209061,,0,15,15,0,15,15,0,0.000021,0,22551,22,0.00001,16,0.155463,0.168936,0,0.147619,0
209062,209062,,0,7,7,0,7,7,0,0.00002,0,22552,22,0.00001,17,0.13573,0.146876,0,0.285714,0
209063,209063,,0,8,8,0,8,8,0,0.002283,0,22553,0,0.00001,18,0.171464,0.195423,0,0.142857,0
209065,209065,,0,20,20,0,20,20,0,0.001394,0,22554,30,0.00001,15,0.187144,0.20644,0,0.171053,0
9307182,9307182,,9,0,9,9,0,9,0.000024,0,0,5718,13,0.000051,0,0,0,0,0.222222,0.002131
9401134,9401134,,2,1,3,2,1,3,0.000004,0.000019,0,5724,1,0.000017,1,1,1,8.009346,0.166667,0.000498
209066,209066,,3,21,24,3,21,24,0.000063,0.002423,0,22555,25,0.000012,16,0.185826,0.210826,9463.596238,0.137681,0.000664
209067,209067,,9,70,79,9,70,79,0.001629,0.026863,0,22556,1,0.000015,12,0.228337,0.260428,49709.156298,0.118306,0.002032
209068,209068,,10,57,67,10,57,67,0.000283,0.002669,0,21565,3,0.000012,15,0.207268,0.234681,8782.925226,0.162144,0.00265
209069,209069,,2,9,11,2,9,11,0.00015,0.000228,0,22557,13,0.000011,20,0.173299,0.193367,448.347181,0.2,0.000587
209070,209070,,0,8,8,0,8,8,0,0.000002,0,22558,26,0.00001,18,0.146704,0.164898,0,0.142857,0
209071,209071,,4,2,6,4,2,6,0.000086,0.000041,0,22559,4,0.000015,15,0.162535,0.187693,162.277585,0.133333,0.000897
9210089,9210089,,1,0,1,1,0,1,0,0,0,2480,4,0.000016,0,0,0,0,0,0.000234
209072,209072,,0,3,3,0,3,3,0,0.000138,0,22560,10,0.00001,15,0.184476,0.203454,0,0.166667,0
209073,209073,,0,10,10,0,10,10,0,0.000001,0,22561,23,0.00001,18,0.109657,0.116827,0,0.322222,0
209074,209074,,1,2,3,1,2,3,0,0,0,22562,22,0.000011,14,0.158032,0.171173,0,0.5,0.000219
209075,209075,,1,4,5,1,4,5,0.000197,0.000007,0,22564,0,0.000011,15,0.176474,0.192594,55.250244,0.15,0.000219
9404177,9404177,,2,0,2,2,0,2,0,0,0,22563,0,0.000029,0,0,0,0,0,0.000451
209076,209076,,2,22,24,2,22,24,0.000301,0.001086,0,22565,25,0.00001,13,0.199468,0.220334,476.551751,0.210145,0.000445
209077,209077,,12,33,45,12,33,45,0.000307,0.002407,0,22566,0,0.000014,13,0.201094,0.228787,8682.051276,0.126768,0.003257
209078,209078,,0,1,1,0,1,1,0,0,0,22567,23,0.00001,16,0.12662,0.136609,0,0,0
209079,209079,,3,51,54,3,51,54,0.000811,0.000855,0,22568,41,0.00001,14,0.196006,0.219595,3562.861356,0.06499,0.000677
209080,209080,,1,16,17,1,16,17,0.000232,0.021151,0,22569,1,0.00001,17,0.199505,0.235004,23.573503,0.323529,0.000219
209081,209081,,6,29,35,6,29,35,0.000763,0.004483,0,22570,41,0.000012,16,0.2018,0.225417,3396.271368,0.264706,0.001401
209082,209082,,1,15,16,1,15,16,0.000036,0.003693,0,22571,30,0.00001,19,0.195585,0.221329,1163.200355,0.166667,0.000226
209084,209084,,2,16,18,2,16,18,0.000038,0.000241,0,22572,52,0.00001,18,0.199406,0.222136,139.740189,0.294118,0.000438
209085,209085,,41,21,62,41,21,62,0.001284,0.002478,0,22573,4,0.000028,16,0.188772,0.21525,14448.35736,0.226335,0.015986
209086,209086,,0,1,1,0,1,1,0,0,0,22575,0,0.00001,2,0.666667,0.75,0,0,0
9712065,9712065,,1,1,2,1,1,2,0,0,0,22574,0,0.000019,1,1,1,1,0,0.000219
209088,209088,,0,10,10,0,10,10,0,0.016807,0,22576,0,0.00001,14,0.209392,0.24244,0,0.333333,0
209089,209089,,53,17,70,53,17,70,0.001594,0.001513,0,22577,4,0.000039,16,0.185902,0.209785,5945.823596,0.221946,0.020863
209091,209091,,1,2,3,1,2,3,0.000005,0,0,22578,22,0.00001,1,1,1,59.391667,0,0.000281
209093,209093,,0,3,3,0,3,3,0,0.000033,0,22579,23,0.00001,14,0.187844,0.208737,0,0,0
209094,209094,,0,8,8,0,8,8,0,0.000002,0,22580,23,0.00001,23,0.136897,0.153655,0,0.285714,0
209095,209095,,5,19,24,5,19,24,0.00054,0.004995,0,22581,1,0.000012,17,0.209007,0.238837,4852.763108,0.217391,0.001162
209096,209096,,0,2,2,0,2,2,0,0.000066,0,22582,0,0.00001,16,0.160306,0.171254,0,0.5,0
209097,209097,,0,4,4,0,4,4,0,0.000066,0,22583,2,0.00001,15,0.168266,0.183226,0,0.166667,0
209098,209098,,10,14,24,10,14,24,0.000138,0.000242,0,22586,52,0.000018,14,0.179668,0.200674,41202.964758,0.105072,0.002323
9905141,9905141,,2,10,12,2,10,12,0.000003,0.000104,0,22585,28,0.000013,18,0.160785,0.193861,5035.063628,0.113636,0.000533
9801080,9801080,,1,7,8,1,7,8,0.000001,0.000049,0,22584,28,0.000011,11,0.175229,0.192783,122.083281,0.196429,0.000233
209099,209099,,49,11,60,49,11,60,0.001497,0.000358,0,22587,4,0.000035,16,0.185423,0.208394,3776.544432,0.271751,0.019505
209100,209100,,1,4,5,1,4,5,0.000018,0.000411,0,22588,0,0.00001,16,0.153419,0.168355,263.716198,0.15,0.000219
209101,209101,,1,17,18,1,17,18,0.000015,0.000964,0,22589,25,0.00001,15,0.197331,0.220804,498.638091,0.143791,0.000219
209102,209102,,1,13,14,1,13,14,0.000089,0.015608,0,22591,41,0.000011,15,0.185017,0.205707,711.173816,0.197802,0.000226
207179,207179,,1,0,1,1,0,1,0.000183,0,0,22590,41,0.000011,0,0,0,0,0,0.000226
209103,209103,,0,18,18,0,18,18,0,0.007,0,22592,1,0.00001,19,0.179719,0.202257,0,0.222222,0
209104,209104,,5,7,12,5,7,12,0.00006,0.015171,0,22593,30,0.000016,14,0.18836,0.205277,1357.45875,0.159091,0.001128
209105,209105,,2,10,12,2,10,12,0.000051,0.005207,0,22594,30,0.000011,14,0.21396,0.240299,3897.940003,0.143939,0.000445
209106,209106,,1,38,39,1,38,39,0.000261,0.0226,0,22596,0,0.00001,15,0.191316,0.224624,1315.34059,0.060729,0.000219
9701052,9701052,,2,5,7,2,5,7,0.000274,0.000002,0,22595,22,0.00001,8,0.19237,0.214928,49.098402,0.238095,0.000445
209107,209107,,1,4,5,1,4,5,0.000058,0.000007,0,22597,4,0.00001,13,0.168046,0.185024,197.490567,0.15,0.000219
9311102,9311102,,2,5,7,2,5,7,0.000032,0.000079,0,4272,26,0.000015,2,0.777778,0.857143,656.307589,0.095238,0.000519
9512038,9512038,,3,7,10,3,7,10,0.000029,0.00003,0,14861,22,0.000015,4,0.515152,0.651961,120.495939,0.188889,0.000687
209108,209108,,0,2,2,0,2,2,0,0.000001,0,22598,26,0.00001,10,0.20233,0.228396,0,0.5,0
209109,209109,,1,9,10,1,9,10,0.000003,0.000012,0,22599,23,0.00001,19,0.113827,0.136311,177.472758,0.111111,0.000259
209110,209110,,0,16,16,0,16,16,0,0.000017,0,22601,22,0.00001,16,0.163538,0.178328,0,0.15,0
9311028,9311028,,1,5,6,1,5,6,0,0.000013,0,22600,22,0.00001,1,1,1,0.5,0.266667,0.000219
209111,209111,,2,17,19,2,17,19,0.000046,0.000542,0,22602,30,0.00001,13,0.220425,0.243057,2105.698558,0.169591,0.000471
209113,209113,,12,1,13,12,1,13,0.000806,0.000101,0,21552,8,0.000016,13,0.180577,0.193284,225.50104,0.294872,0.003002
209114,209114,,16,35,51,16,35,51,0.001443,0.002402,0,22603,13,0.00002,16,0.196676,0.221167,56423.269994,0.064706,0.003858
209115,209115,,2,17,19,2,17,19,0.000008,0.00024,0,22608,10,0.000011,15,0.177665,0.198794,4091.687555,0.131579,0.000445
9504144,9504144,,1,5,6,1,5,6,0.000003,0.00007,0,22607,4,0.00001,2,0.727273,0.8125,11.216667,0.033333,0.000232
9606002,9606002,,1,7,8,1,7,8,0.000003,0.000344,0,22605,0,0.00001,6,0.278237,0.334983,13.605659,0.214286,0.000232
9607206,9607206,,1,5,6,1,5,6,0.000003,0.000018,0,22604,0,0.00001,8,0.203969,0.250206,28.887375,0.3,0.000232
9207115,9207115,,1,1,2,1,1,2,0.000001,0,0,22606,15,0.000012,1,1,1,4,0,0.000226
9506164,9506164,,2,6,8,2,6,8,0.000077,0.000344,0,7624,0,0.000012,6,0.276243,0.328333,3456.111098,0.196429,0.000452
209116,209116,,16,45,61,16,45,61,0.002285,0.01427,0,22609,41,0.000016,17,0.209187,0.240127,15477.282662,0.14235,0.003863
209117,209117,,1,25,26,1,25,26,0.000006,0.003138,0,22610,30,0.00001,14,0.211757,0.236169,2144.29649,0.173846,0.000219
209119,209119,,0,9,9,0,9,9,0,0.00002,0,22612,8,0.00001,15,0.179559,0.194146,0,0.208333,0
9308025,9308025,,1,0,1,1,0,1,0,0,0,22611,8,0.000011,0,0,0,0,0,0.000219
209120,209120,,6,17,23,6,17,23,0.00062,0.001553,0,21551,8,0.000012,15,0.196358,0.218087,17273.557385,0.158103,0.001518
209121,209121,,0,9,9,0,9,9,0,0.006562,0,22613,1,0.00001,13,0.186913,0.206131,0,0.444444,0
209122,209122,,31,68,99,31,68,99,0.000829,0.002558,0,21566,3,0.000019,14,0.212377,0.238784,33867.315173,0.172748,0.008022
209124,209124,,0,7,7,0,7,7,0,0.000053,0,22614,1,0.00001,14,0.177271,0.193604,0,0.190476,0
209125,209125,,0,10,10,0,10,10,0,0.000323,0,22615,5,0.00001,15,0.181488,0.206564,0,0.077778,0
209126,209126,,0,3,3,0,3,3,0,0.00013,0,22616,13,0.00001,16,0.125132,0.132977,0,0.5,0
209127,209127,,1,38,39,1,38,39,0.000058,0.019979,0,22617,4,0.00001,16,0.199094,0.229925,2991.168547,0.105938,0.000219
209128,209128,,0,15,15,0,15,15,0,0.001171,0,22618,1,0.00001,21,0.175024,0.200722,0,0.114286,0
209129,209129,,2,21,23,2,21,23,0.000001,0.000036,0,22619,15,0.000011,14,0.183665,0.198544,5608.88585,0.142292,0.000438
209130,209130,,0,13,13,0,13,13,0,0.001899,0,22620,20,0.00001,13,0.170733,0.186916,0,0.147436,0
209131,209131,,2,10,12,2,10,12,0.000004,0.000375,0,22621,30,0.000011,18,0.204609,0.225309,1837.452461,0.189394,0.000445
209132,209132,,1,5,6,1,5,6,0,0.000019,0,22623,23,0.000014,15,0.123653,0.135421,4303.566667,0.033333,0.000219
9303144,9303144,,1,0,1,1,0,1,0,0,0,22622,23,0.000012,0,0,0,0,0,0.000226
209133,209133,,2,17,19,2,17,19,0.000058,0.002724,0,22624,25,0.000011,15,0.187621,0.209106,5266.348838,0.175439,0.000471
209134,209134,,0,3,3,0,3,3,0,0.000006,0,22625,15,0.00001,15,0.14445,0.155237,0,0.166667,0
209135,209135,,0,5,5,0,5,5,0,0.005997,0,22626,23,0.00001,12,0.178144,0.195198,0,0.05,0
209136,209136,,1,27,28,1,27,28,0,0.000829,0,22627,23,0.00001,13,0.195027,0.216055,4456.038132,0.130952,0.000226
209137,209137,,5,29,34,5,29,34,0.000149,0.002173,0,22628,30,0.000011,16,0.195495,0.218715,3663.261114,0.138146,0.001148
209223,209223,,3,33,36,3,33,36,0.000052,0.006228,0,22629,30,0.000011,16,0.202057,0.228135,5313.374903,0.142857,0.000677
209138,209138,,18,12,30,18,12,30,0.000792,0.000516,0,22630,4,0.000017,16,0.183787,0.207087,1329.27931,0.270115,0.006948
209139,209139,,4,26,30,4,26,30,0.000192,0.002604,0,22631,30,0.000011,13,0.218927,0.242298,875.08232,0.285057,0.000929
209140,209140,,0,13,13,0,13,13,0,0.002158,0,22632,2,0.00001,13,0.205591,0.23258,0,0.166667,0
209141,209141,,1,17,18,1,17,18,0.000608,0.002233,0,22634,10,0.00001,16,0.187185,0.211426,22.956312,0.143791,0.000245
9905029,9905029,,1,26,27,1,26,27,0.000026,0.009657,0,22633,4,0.00001,14,0.201633,0.237056,424.179901,0.096866,0.000226
209142,209142,,1,7,8,1,7,8,0.000019,0.000269,0,22635,25,0.00001,17,0.169302,0.188544,47.444228,0.25,0.000219
209144,209144,,0,6,6,0,6,6,0,0.000004,0,22636,22,0.00001,14,0.151143,0.162224,0,0.5,0
209145,209145,,12,76,88,12,76,88,0.001138,0.014074,0,22637,41,0.000014,15,0.219456,0.248342,35871.307744,0.109848,0.002978
209146,209146,,0,16,16,0,16,16,0,0.000253,0,22639,9,0.00001,14,0.174105,0.192215,0,0.3125,0
9209112,9209112,,4,0,4,4,0,4,0.000005,0,0,22638,5,0.000013,0,0,0,0,0.083333,0.000896
209147,209147,,0,6,6,0,6,6,0,0.000017,0,22642,22,0.00001,14,0.180823,0.193428,0,0.066667,0
9508061,9508061,,4,6,10,4,6,10,0,0.000021,0,22641,22,0.000018,2,0.636364,0.714286,63.333333,0.088889,0.00089
9506153,9506153,,2,2,4,2,2,4,0,0,0,22640,22,0.000016,1,1,1,0.333333,0.416667,0.000471
209148,209148,,3,31,34,3,31,34,0.000083,0.002178,0,22643,30,0.000012,14,0.199377,0.226022,19772.793783,0.121212,0.00067
209149,209149,,0,7,7,0,7,7,0,0.000473,0,22644,1,0.00001,15,0.147304,0.161448,0,0.285714,0
209150,209150,,8,57,65,8,57,65,0.001226,0.019825,0,22645,10,0.000012,18,0.217335,0.25099,37310.112441,0.136058,0.001859
209152,209152,,2,17,19,2,17,19,0.000092,0.002077,0,22646,25,0.00001,17,0.193709,0.217415,462.064443,0.178363,0.000478
209153,209153,,5,53,58,5,53,58,0.000228,0.001835,0,22647,30,0.000011,15,0.217413,0.244542,3135.120283,0.165759,0.001162
209154,209154,,2,14,16,2,14,16,0.000001,0.000072,0,22648,9,0.000011,14,0.176453,0.194674,11848.091982,0.141667,0.000438
209155,209155,,5,31,36,5,31,36,0.000199,0.016893,0,22649,41,0.000012,17,0.197275,0.21945,16034.187688,0.181746,0.001453
209156,209156,,0,11,11,0,11,11,0,0.001357,0,22650,8,0.00001,14,0.186299,0.205583,0,0.336364,0
209157,209157,,5,39,44,5,39,44,0.000151,0.001465,0,22651,52,0.000012,15,0.206784,0.234324,7721.707089,0.159619,0.001181
209158,209158,,5,32,37,5,32,37,0.000181,0.002069,0,22652,25,0.000011,15,0.197703,0.221727,20483.113557,0.113363,0.001181
209159,209159,,12,20,32,12,20,32,0.001003,0.001381,0,21555,8,0.000015,15,0.19829,0.218935,29814.034301,0.193548,0.00292
209160,209160,,8,63,71,8,63,71,0.000616,0.005276,0,22653,41,0.000013,15,0.219812,0.2481,32296.247816,0.141449,0.002005
209161,209161,,2,32,34,2,32,34,0.000041,0.003582,0,22654,52,0.000012,18,0.185289,0.213195,3950.416498,0.138146,0.000445
209162,209162,,1,17,18,1,17,18,0,0.002028,0,22655,20,0.000011,13,0.179962,0.199753,1692.679834,0.147059,0.000219
209163,209163,,4,26,30,4,26,30,0.000988,0.020392,0,22656,1,0.000011,13,0.201457,0.225815,1286.981414,0.244828,0.000897
209164,209164,,0,43,43,0,43,43,0,0.004004,0,22657,2,0.00001,16,0.1984,0.224751,0,0.059247,0
209165,209165,,1,3,4,1,3,4,0,0,0,22658,2,0.000012,14,0.157001,0.166102,0,0.5,0.000219
209166,209166,,3,14,17,3,14,17,0.000001,0.000046,0,22659,30,0.000013,18,0.18242,0.198483,12730.022784,0.172794,0.000658
209167,209167,,0,2,2,0,2,2,0,0.000008,0,22660,20,0.00001,6,0.318966,0.384234,0,0,0
209168,209168,,0,1,1,0,1,1,0,0.000003,0,22661,10,0.00001,14,0.130465,0.138036,0,0,0
209169,209169,,1,96,97,1,96,97,0.000001,0.005658,0,22663,2,0.000011,15,0.206904,0.246724,6512.994182,0.040056,0.000219
9905073,9905073,,3,24,27,3,24,27,0.000131,0.004552,0,22662,13,0.000011,14,0.196577,0.226163,1331.300055,0.123932,0.000703
209170,209170,,1,3,4,1,3,4,0.000001,0.00004,0,22664,13,0.000011,13,0.161881,0.176259,0.665909,0.416667,0.000232
209171,209171,,0,6,6,0,6,6,0,0.000316,0,22665,5,0.00001,15,0.180137,0.198034,0,0.1,0
209172,209172,,0,9,9,0,9,9,0,0.000001,0,22667,22,0.00001,11,0.173413,0.206267,0,0.152778,0
9409172,9409172,,1,5,6,1,5,6,0,0,0,22666,15,0.000011,3,0.611111,0.712121,2.5,0.133333,0.000219
9209060,9209060,,2,0,2,2,0,2,0,0,0,3082,15,0.000013,0,0,0,0,0.5,0.000471
9211032,9211032,,5,0,5,5,0,5,0,0,0,3081,15,0.000026,0,0,0,0,0.05,0.001162
9309036,9309036,,3,4,7,3,4,7,0,0.000005,0,3080,15,0.000014,1,1,1,480.367342,0.261905,0.000704
209174,209174,,0,15,15,0,15,15,0,0.000896,0,22668,30,0.00001,14,0.201956,0.22204,0,0.095238,0
209175,209175,,2,11,13,2,11,13,0.000188,0.000462,0,22669,0,0.000011,19,0.188242,0.210266,61.319173,0.262821,0.000458
209176,209176,,5,44,49,5,44,49,0.00009,0.003168,0,22670,0,0.000011,15,0.210985,0.240016,17613.766559,0.122874,0.001279
209177,209177,,0,1,1,0,1,1,0,0,38,22672,60,0.00001,1,1,1,0,0,0
9811181,9811181,,1,0,1,1,0,1,0,0,38,22671,60,0.000019,0,0,0,0,0,0.000219
209178,209178,,0,7,7,0,7,7,0,0.00015,0,22673,25,0.00001,13,0.17705,0.193303,0,0.142857,0
209179,209179,,2,24,26,2,24,26,0.000207,0.019634,0,22674,41,0.00001,15,0.207654,0.237146,1930.820945,0.14,0.000485
209180,209180,,2,4,6,2,4,6,0.000002,0,0,22675,23,0.000013,14,0.13722,0.151836,283.323911,0.066667,0.000451
209181,209181,,1,20,21,1,20,21,0.000036,0.007796,0,22676,25,0.00001,18,0.178341,0.202515,63.146243,0.230952,0.000226
209182,209182,,3,11,14,3,11,14,0.00015,0.00179,0,22677,30,0.000011,14,0.192823,0.209995,261.007175,0.263736,0.000664
209183,209183,,0,11,11,0,11,11,0,0.000002,0,22678,20,0.00001,20,0.152045,0.164215,0,0.136364,0
209184,209184,,0,10,10,0,10,10,0,0.015358,0,22679,1,0.00001,17,0.173873,0.197299,0,0.388889,0
209185,209185,,0,8,8,0,8,8,0,0.000036,0,22680,8,0.00001,17,0.170192,0.18812,0,0.375,0
209186,209186,,4,20,24,4,20,24,0.000061,0.000501,0,22681,3,0.000011,14,0.198004,0.21924,2939.323501,0.179348,0.000976
209187,209187,,2,14,16,2,14,16,0.000212,0.001969,0,22682,2,0.000011,16,0.155714,0.183563,1025.206247,0.1125,0.000464
209188,209188,,0,49,49,0,49,49,0,0.022234,0,22683,1,0.00001,14,0.206685,0.237984,0,0.127976,0
209189,209189,,0,13,13,0,13,13,0,0.019759,0,22684,1,0.00001,17,0.199566,0.234661,0,0.352564,0
209190,209190,,5,29,34,5,29,34,0.0001,0.002395,0,20054,0,0.000012,15,0.191969,0.21885,2107.570955,0.095365,0.001352
209191,209191,,2,36,38,2,36,38,0.000257,0.00983,0,22685,1,0.000013,13,0.209572,0.236333,3236.520661,0.162873,0.000438
209192,209192,,0,8,8,0,8,8,0,0.001279,0,22686,3,0.00001,17,0.173574,0.193533,0,0.160714,0
209193,209193,,17,13,30,17,13,30,0.001428,0.001687,0,22687,41,0.000015,16,0.18795,0.20826,2296.466108,0.185057,0.004236
209194,209194,,1,44,45,1,44,45,0.000027,0.010883,0,22688,1,0.000011,17,0.205612,0.235254,5077.854912,0.105051,0.000219
209195,209195,,3,41,44,3,41,44,0.00005,0.004994,0,22689,1,0.00001,15,0.209019,0.236648,6968.419987,0.121036,0.000759
209196,209196,,1,1,2,1,1,2,0,0,0,22690,22,0.000014,1,1,1,1,0,0.000219
209197,209197,,3,26,29,3,26,29,0.000028,0.000862,0,22691,3,0.000011,14,0.204283,0.22655,789.424094,0.190887,0.000691
209198,209198,,2,4,6,2,4,6,0.000039,0.002015,0,22692,30,0.000011,13,0.184974,0.200829,13.097289,0.166667,0.000438
209199,209199,,0,5,5,0,5,5,0,0.001149,0,22693,30,0.00001,13,0.198013,0.214051,0,0.05,0
209200,209200,,2,25,27,2,25,27,0.000085,0.003006,0,22694,0,0.00001,14,0.203719,0.234072,814.705758,0.098291,0.000452
209201,209201,,11,55,66,11,55,66,0.001313,0.009941,0,22695,41,0.000013,16,0.211837,0.237986,23249.125902,0.150816,0.002697
209203,209203,,2,37,39,2,37,39,0.000243,0.002962,0,22696,8,0.00001,16,0.19667,0.220217,1161.319581,0.222672,0.000451
209204,209204,,0,1,1,0,1,1,0,0.00002,0,22697,22,0.00001,2,0.538462,0.571429,0,0,0
209205,209205,,6,28,34,6,28,34,0.00032,0.003997,0,22698,13,0.000013,14,0.201542,0.227346,20142.771877,0.120321,0.001341
209206,209206,,5,28,33,5,28,33,0.000142,0.000776,0,20076,0,0.000011,15,0.196596,0.223302,16331.26276,0.097538,0.001255
209207,209207,,1,12,13,1,12,13,0.000027,0.000462,0,22699,0,0.00001,15,0.185417,0.207972,88.220662,0.288462,0.000279
209208,209208,,1,17,18,1,17,18,0.000022,0.001045,0,22700,23,0.00001,18,0.141385,0.158547,1,0.245098,0.000219
209209,209209,,0,12,12,0,12,12,0,0.000061,0,22702,5,0.00001,15,0.172014,0.193848,0,0.234848,0
209014,209014,,5,0,5,5,0,5,0.000017,0,0,22701,15,0.000013,0,0,0,0,0.05,0.001109
209210,209210,,1,30,31,1,30,31,0.00005,0.001593,0,22703,3,0.00001,14,0.209055,0.234031,89.827051,0.202151,0.000232
209211,209211,,5,18,23,5,18,23,0.000887,0.016775,0,22704,1,0.000012,15,0.191865,0.215765,7333.143078,0.1917,0.001185
209212,209212,,0,24,24,0,24,24,0,0.019438,0,22705,25,0.00001,14,0.202969,0.234718,0,0.248188,0
209213,209213,,0,6,6,0,6,6,0,0.000022,0,22706,22,0.00001,15,0.157622,0.168358,0,0.166667,0
209214,209214,,1,16,17,1,16,17,0.000059,0.002007,0,22707,30,0.00001,15,0.186515,0.210332,169.333024,0.330882,0.000219
209217,209217,,6,32,38,6,32,38,0.000129,0.001295,0,22708,3,0.000014,15,0.197877,0.220986,37710.360555,0.124467,0.001423
209218,209218,,3,24,27,3,24,27,0.000433,0.003249,0,22709,41,0.000011,15,0.202855,0.225612,5077.204461,0.24359,0.000859
209219,209219,,7,35,42,7,35,42,0.000863,0.005533,0,22710,41,0.000011,15,0.20876,0.233198,3708.574753,0.18583,0.001668
209220,209220,,0,13,13,0,13,13,0,0.003913,0,22711,8,0.00001,16,0.172662,0.193139,0,0.205128,0
209221,209221,,0,15,15,0,15,15,0,0.00065,0,22712,30,0.00001,17,0.18232,0.199572,0,0.214286,0
209224,209224,,11,22,33,11,22,33,0.001499,0.021135,0,22713,41,0.000014,18,0.200986,0.229988,3340.099863,0.255682,0.002637
209225,209225,,12,41,53,12,41,53,0.000681,0.004794,0,22714,41,0.000013,16,0.210596,0.236083,64624.636581,0.083817,0.003144
209226,209226,,5,25,30,5,25,30,0.000497,0.002882,0,22715,1,0.000012,16,0.200545,0.225656,21428.872084,0.057471,0.001144
209227,209227,,5,8,13,5,8,13,0.000436,0.000637,0,22716,25,0.000012,15,0.175511,0.193745,2246.054204,0.128205,0.001109
209228,209228,,2,30,32,2,30,32,0.000057,0.001609,0,22717,52,0.000011,14,0.203773,0.230615,4120.405296,0.166331,0.000445
209229,209229,,0,3,3,0,3,3,0,0,0,22718,6,0.00001,17,0.173509,0.188083,0,0.5,0
209230,209230,,4,197,201,4,197,201,0.000527,0.023117,0,22719,52,0.000011,14,0.226097,0.273366,16761.565199,0.048035,0.000929
209231,209231,,16,21,37,16,21,37,0.001279,0.000606,0,21556,8,0.00002,16,0.188022,0.208564,16649.685989,0.172673,0.003862
209232,209232,,5,48,53,5,48,53,0.000111,0.00206,0,22720,3,0.000011,14,0.205489,0.231096,9558.158618,0.137881,0.001123
209233,209233,,1,1,2,1,1,2,0,0,0,22721,22,0.000014,3,0.444444,0.541667,0,0.5,0.000219
209234,209234,,3,10,13,3,10,13,0.00004,0.001105,0,22722,30,0.000012,17,0.177289,0.195046,1117.648865,0.141026,0.000658
209235,209235,,0,59,59,0,59,59,0,0.024444,0,22723,1,0.00001,13,0.214407,0.247343,0,0.099065,0
209236,209236,,1,10,11,1,10,11,0,0.000012,0,22724,23,0.00001,20,0.143612,0.154221,1166.521806,0.227273,0.000226
209237,209237,,2,10,12,2,10,12,0,0.000012,0,22725,23,0.000011,20,0.143797,0.154598,2691.351369,0.257576,0.000458
209238,209238,,2,24,26,2,24,26,0.00021,0.020015,0,22726,1,0.000011,14,0.197537,0.228977,1083.042227,0.170769,0.000451
209239,209239,,7,20,27,7,20,27,0.000194,0.003739,0,22727,2,0.000013,19,0.212073,0.240402,8133.381305,0.118234,0.001607
209240,209240,,2,24,26,2,24,26,0.000078,0.001254,0,22728,30,0.000011,17,0.205333,0.232068,2324.177355,0.126154,0.000438
209241,209241,,7,177,184,7,177,184,0.000152,0.011055,0,22729,52,0.000013,14,0.239754,0.284793,58831.776213,0.045023,0.001554
209242,209242,,9,19,28,9,19,28,0.000381,0.000427,0,22730,25,0.000014,16,0.178437,0.198254,38256.551452,0.134921,0.002064
209244,209244,,11,17,28,11,17,28,0.000618,0.001932,0,22731,41,0.000015,17,0.192107,0.212026,45686.675615,0.251323,0.002976
209245,209245,,1,12,13,1,12,13,0.000032,0.001561,0,22732,0,0.00001,16,0.185728,0.206789,96.961052,0.282051,0.000219
209246,209246,,1,3,4,1,3,4,0,0,0,22733,6,0.000012,14,0.137378,0.154251,1,0.25,0.000219
209247,209247,,4,22,26,4,22,26,0.000359,0.002586,0,22734,41,0.000011,17,0.210151,0.235598,2435.793931,0.233846,0.000997
209248,209248,,1,19,20,1,19,20,0.000037,0.005705,0,22735,8,0.000011,13,0.209109,0.237907,3360.132006,0.171053,0.000219
209249,209249,,2,1,3,2,1,3,0.000001,0,0,22736,25,0.000013,1,1,1,0.5,0.333333,0.000445
209251,209251,,7,26,33,7,26,33,0.001058,0.011559,0,22737,41,0.000012,16,0.206571,0.228797,8008.150418,0.213068,0.001779
209252,209252,,1,13,14,1,13,14,0.000004,0.000294,0,22738,1,0.000011,18,0.169775,0.192306,1526.179025,0.291209,0.000226
209253,209253,,3,8,11,3,8,11,0.000039,0.00042,0,22739,30,0.000013,17,0.170152,0.185193,4077.613504,0.227273,0.00069
209254,209254,,4,28,32,4,28,32,0.000098,0.001421,0,22740,30,0.000012,15,0.190723,0.210693,3257.644982,0.121976,0.000903
209255,209255,,9,77,86,9,77,86,0.000275,0.002207,0,22741,3,0.000012,14,0.223176,0.252334,33835.827673,0.120109,0.002271
209256,209256,,3,10,13,3,10,13,0.000548,0.00748,0,22742,1,0.000011,16,0.182549,0.205248,666.28102,0.205128,0.00072
209257,209257,,0,41,41,0,41,41,0,0.020699,0,22743,1,0.00001,15,0.212363,0.244776,0,0.076829,0
209258,209258,,0,16,16,0,16,16,0,0.019821,0,22744,1,0.00001,16,0.188526,0.22243,0,0.3375,0
209259,209259,,0,1,1,0,1,1,0,0.000001,0,22745,30,0.00001,15,0.155831,0.163803,0,0,0
209260,209260,,0,10,10,0,10,10,0,0.001505,0,22746,0,0.00001,16,0.174188,0.194062,0,0.244444,0
209262,209262,,0,9,9,0,9,9,0,0.00002,0,22747,22,0.00001,17,0.130858,0.139911,0,0.222222,0
209263,209263,,14,21,35,14,21,35,0.00111,0.001572,0,22748,41,0.000015,17,0.191189,0.209854,214.488483,0.379832,0.004083
209264,209264,,2,17,19,2,17,19,0.000049,0.000041,0,22749,15,0.000011,14,0.18076,0.193713,1815.307121,0.178363,0.000445
209265,209265,,5,17,22,5,17,22,0.000396,0.002388,0,22753,41,0.000011,17,0.209712,0.234846,5471.811663,0.220779,0.001189
9807159,9807159,,2,5,7,2,5,7,0.000258,0.000006,0,22752,23,0.000011,11,0.181052,0.225804,1340.522087,0.071429,0.000472
9710050,9710050,,2,5,7,2,5,7,0.000001,0.000006,0,22751,23,0.000013,10,0.207272,0.253521,1316.907646,0.095238,0.000458
209266,209266,,0,13,13,0,13,13,0,0.002956,0,22754,4,0.00001,18,0.172718,0.196883,0,0.141026,0
209267,209267,,0,11,11,0,11,11,0,0.002219,0,22755,4,0.00001,18,0.150334,0.165841,0,0.181818,0
210001,210001,,3,1,4,3,1,4,0.000071,0,0,22756,0,0.000011,15,0.138609,0.14588,41.239075,0.083333,0.000725
210002,210002,,0,2,2,0,2,2,0,0.000017,0,22757,8,0.00001,15,0.170343,0.183351,0,0,0
210003,210003,,0,2,2,0,2,2,0,0,0,22759,22,0.00001,11,0.150025,0.164141,0,0,0
9903247,9903247,,1,0,1,1,0,1,0,0,0,22758,22,0.000014,0,0,0,0,0,0.000219
210004,210004,,3,9,12,3,9,12,0.00007,0.000173,0,22760,0,0.00001,15,0.178674,0.197345,165.102341,0.424242,0.000812
210005,210005,,2,27,29,2,27,29,0.000174,0.005196,0,22761,25,0.000011,15,0.187661,0.214147,1332.657423,0.141626,0.000445
210006,210006,,0,8,8,0,8,8,0,0.001156,0,22762,25,0.00001,16,0.173516,0.19498,0,0.303571,0
210007,210007,,2,29,31,2,29,31,0.000046,0.011784,0,22763,4,0.00001,14,0.209172,0.244081,2655.137769,0.126882,0.000445
210008,210008,,0,6,6,0,6,6,0,0.000434,0,22764,0,0.00001,18,0.176993,0.197097,0,0.166667,0
210009,210009,,0,35,35,0,35,35,0,0.000098,0,22765,20,0.00001,22,0.154326,0.17632,0,0.130252,0
210010,210010,,1,16,17,1,16,17,0.000016,0.000617,0,22766,30,0.00001,17,0.203666,0.229021,779.654081,0.180147,0.000232
210011,210011,,2,26,28,2,26,28,0.000101,0.009636,0,22767,13,0.000011,14,0.203441,0.236279,2142.958863,0.113757,0.000451
210012,210012,,0,30,30,0,30,30,0,0.001346,0,22768,13,0.00001,15,0.178354,0.214162,0,0.149425,0
210014,210014,,0,28,28,0,28,28,0,0.000481,0,22769,52,0.00001,16,0.170971,0.190211,0,0.178571,0
210016,210016,,2,6,8,2,6,8,0.000244,0.000019,0,22770,0,0.000011,15,0.172784,0.195105,2823.500248,0.089286,0.000445
210017,210017,,2,29,31,2,29,31,0.00005,0.00255,0,22771,5,0.000011,15,0.193421,0.22138,2658.015979,0.124731,0.000445
210019,210019,,0,5,5,0,5,5,0,0.000001,0,22772,6,0.00001,8,0.195556,0.267844,0,0.2,0
210020,210020,,0,19,19,0,19,19,0,0.000007,0,22776,21,0.00001,13,0.174571,0.202952,0,0.169591,0
9608038,9608038,,2,0,2,2,0,2,0,0,0,22774,21,0.000013,0,0,0,0,0.5,0.000458
9610183,9610183,,2,0,2,2,0,2,0,0,0,22773,21,0.000013,0,0,0,0,0.5,0.000458
9712036,9712036,,3,5,8,3,5,8,0,0.000001,0,22775,21,0.000014,8,0.201351,0.256743,20.033333,0.142857,0.000658
9510051,9510051,,1,0,1,1,0,1,0,0,0,14045,21,0.000011,0,0,0,0,0,0.000246
9510052,9510052,,1,0,1,1,0,1,0,0,0,14044,21,0.000011,0,0,0,0,0,0.000246
210022,210022,,0,22,22,0,22,22,0,0.00491,0,22777,4,0.00001,17,0.187377,0.215999,0,0.099567,0
210023,210023,,0,3,3,0,3,3,0,0,0,22778,28,0.00001,3,0.6,0.722222,0,0.166667,0
210025,210025,,1,16,17,1,16,17,0.000001,0.00021,0,22779,0,0.00001,17,0.163832,0.184362,323.224102,0.180147,0.000219
210026,210026,,0,11,11,0,11,11,0,0.000737,0,22780,0,0.00001,16,0.187144,0.207471,0,0.327273,0
210027,210027,,0,1,1,0,1,1,0,0,0,22782,30,0.00001,1,1,1,0,0,0
112213,112213,,2,0,2,2,0,2,0.000001,0,0,22781,30,0.000021,0,0,0,0,0,0.000438
210028,210028,,0,12,12,0,12,12,0,0.000427,0,22783,30,0.00001,15,0.182819,0.198769,0,0.212121,0
210029,210029,,5,40,45,5,40,45,0.000204,0.004219,0,22784,25,0.000011,16,0.189809,0.216686,9416.89196,0.139899,0.001148
210030,210030,,10,15,25,10,15,25,0.00036,0.002132,0,22785,3,0.000013,14,0.211845,0.235564,25376.753995,0.138333,0.002353
210031,210031,,1,1,2,1,1,2,0,0,0,22786,23,0.000014,17,0.111066,0.116001,0,0.5,0.000219
210032,210032,,0,13,13,0,13,13,0,0.000195,0,22787,52,0.00001,16,0.164042,0.181769,0,0.173077,0
210033,210033,,3,13,16,3,13,16,0.000008,0.001309,0,22788,25,0.000011,16,0.17466,0.194957,461.582746,0.254167,0.000677
210034,210034,,0,6,6,0,6,6,0,0.000004,0,22789,10,0.00001,16,0.166186,0.179923,0,0.466667,0
210035,210035,,5,44,49,5,44,49,0.000654,0.011795,0,22790,41,0.000011,15,0.216454,0.242404,20496.440836,0.117772,0.001277
210036,210036,,5,11,16,5,11,16,0,0.000002,0,22791,23,0.000013,17,0.140588,0.152765,15.736793,0.345833,0.001195
210037,210037,,0,2,2,0,2,2,0,0.000589,0,22792,10,0.00001,6,0.280397,0.311136,0,0,0
210038,210038,,0,6,6,0,6,6,0,0.000208,0,22793,1,0.00001,18,0.168431,0.187349,0,0.133333,0
210039,210039,,0,16,16,0,16,16,0,0.020382,0,22794,25,0.00001,13,0.215653,0.246075,0,0.229167,0
210040,210040,,0,13,13,0,13,13,0,0.000372,0,22795,30,0.00001,16,0.208788,0.232338,0,0.211538,0
210041,210041,,4,18,22,4,18,22,0.000932,0.0169,0,22796,1,0.000011,16,0.188647,0.212618,1776.30904,0.231602,0.000903
210042,210042,,3,20,23,3,20,23,0.000031,0.001686,0,22797,30,0.000011,18,0.207497,0.230754,4456.961465,0.16996,0.000671
210043,210043,,4,6,10,4,6,10,0.00003,0.000024,0,22798,28,0.000013,15,0.154151,0.168193,2463.25728,0.122222,0.001029
210044,210044,,1,40,41,1,40,41,0.000002,0.009297,0,22799,4,0.000011,15,0.223533,0.258047,5865.442191,0.095732,0.000229
9507087,9507087,,4,3,7,4,3,7,0.00004,0.000002,0,2484,6,0.000019,4,0.388889,0.449405,92220.813782,0.119048,0.000957
210046,210046,,3,53,56,3,53,56,0.000295,0.004178,0,22800,8,0.000011,14,0.210343,0.236672,14680.535353,0.135714,0.000719
210047,210047,,2,8,10,2,8,10,0.000029,0.00159,0,22801,4,0.000011,18,0.162617,0.175797,21664.25518,0.077778,0.00055
210048,210048,,0,37,37,0,37,37,0,0.004074,0,22802,1,0.00001,15,0.205718,0.234001,0,0.111862,0
210049,210049,,2,10,12,2,10,12,0.000068,0.007401,0,22803,2,0.000011,16,0.19871,0.222292,10054.829921,0.204545,0.000438
210050,210050,,1,8,9,1,8,9,0.000061,0.010993,0,22804,8,0.000011,14,0.1753,0.193067,5129.013932,0.138889,0.000219
210051,210051,,2,7,9,2,7,9,0.000125,0.013802,0,22805,1,0.000012,15,0.208388,0.238795,1447.724628,0.347222,0.000438
210052,210052,,0,2,2,0,2,2,0,0,0,22807,23,0.00001,1,1,1,0,0,0
111167,111167,,3,0,3,3,0,3,0,0,0,22806,23,0.000032,0,0,0,0,0.166667,0.000664
210053,210053,,3,28,31,3,28,31,0.000027,0.00171,0,22808,25,0.000012,15,0.189276,0.212717,2698.731481,0.13871,0.000658
210054,210054,,3,18,21,3,18,21,0.000098,0.000676,0,22809,3,0.000011,18,0.185875,0.211484,1354.277196,0.15,0.000664
210055,210055,,0,14,14,0,14,14,0,0.002678,0,22810,8,0.00001,17,0.18979,0.21268,0,0.203297,0
210056,210056,,2,15,17,2,15,17,0.000091,0.017799,0,22811,8,0.000011,17,0.20835,0.240165,10798.526908,0.301471,0.000445
210057,210057,,1,4,5,1,4,5,0.000068,0.000043,0,22812,52,0.00001,19,0.165338,0.184481,333.297683,0.3,0.000226
210058,210058,,10,25,35,10,25,35,0.000986,0.000627,0,21558,8,0.000014,16,0.19601,0.218455,6148.159421,0.251261,0.002339
210059,210059,,1,12,13,1,12,13,0.000035,0.000096,0,22813,30,0.00001,15,0.183424,0.202849,329.742743,0.294872,0.000219
210060,210060,,1,14,15,1,14,15,0.000001,0.000057,0,22814,5,0.00001,15,0.181498,0.202539,418.051921,0.119048,0.000226
9404157,9404157,,4,37,41,4,37,41,0.000043,0.000408,0,950,5,0.000015,4,0.531008,0.610097,103356.186074,0.040854,0.000958
9207096,9207096,,11,0,11,11,0,11,0.000069,0,0,948,4,0.000038,0,0,0,0,0.136364,0.002622
9308036,9308036,,5,3,8,5,3,8,0.000006,0.000004,0,945,5,0.000016,3,0.369863,0.419753,67.08542,0.071429,0.001159
9309157,9309157,,2,0,2,2,0,2,0.000005,0,0,944,5,0.000011,0,0,0,0,0.5,0.000465
9312190,9312190,,2,7,9,2,7,9,0.000006,0.000047,0,931,4,0.000011,2,0.652174,0.733333,15684.36724,0.069444,0.000481
210061,210061,,0,11,11,0,11,11,0,0,0,22816,15,0.00001,15,0.167451,0.178593,0,0.136364,0
9702130,9702130,,2,0,2,2,0,2,0.000001,0,0,22815,15,0.000011,0,0,0,0,0,0.000438
210062,210062,,1,12,13,1,12,13,0.000014,0.000041,0,22817,15,0.00001,15,0.175354,0.190969,839.943628,0.185897,0.000219
210063,210063,,0,8,8,0,8,8,0,0.007388,0,22818,1,0.00001,18,0.180344,0.203348,0,0.25,0
210064,210064,,0,19,19,0,19,19,0,0.017501,0,22819,2,0.00001,18,0.193229,0.222245,0,0.178363,0
210065,210065,,0,4,4,0,4,4,0,0.000151,0,22820,25,0.00001,13,0.174912,0.19024,0,0.083333,0
210066,210066,,4,17,21,4,17,21,0.000164,0.001317,0,22821,25,0.000011,16,0.18069,0.201242,771.860517,0.278571,0.000909
210067,210067,,1,20,21,1,20,21,0.000007,0.000347,0,22822,30,0.00001,16,0.205519,0.228879,815.266161,0.245238,0.000239
210068,210068,,5,37,42,5,37,42,0.001129,0.01984,0,22823,1,0.000011,14,0.206066,0.235864,5588.849811,0.236353,0.001122
210070,210070,,1,82,83,1,82,83,0.000008,0.000789,0,22824,9,0.00001,19,0.195959,0.229374,2970.989178,0.163385,0.000219
210071,210071,,0,2,2,0,2,2,0,0.000005,0,22827,52,0.00001,14,0.147312,0.157122,0,0,0
9910070,9910070,,1,6,7,1,6,7,0,0.000013,0,22826,52,0.000014,14,0.158539,0.17519,508.820966,0.02381,0.000219
9907137,9907137,,1,4,5,1,4,5,0,0.000011,0,22825,52,0.000012,13,0.18658,0.210445,2583.976522,0.15,0.000226
210072,210072,,5,37,42,5,37,42,0.000561,0.021811,0,22828,41,0.000011,15,0.210131,0.240598,2627.585441,0.197445,0.001148
210073,210073,,1,23,24,1,23,24,0.000026,0.002316,0,22829,30,0.00001,13,0.202704,0.2294,2110.234195,0.117754,0.000219
210074,210074,,0,6,6,0,6,6,0,0.000001,0,22830,52,0.00001,4,0.433333,0.538462,0,0.366667,0
210075,210075,,2,29,31,2,29,31,0.000011,0.000744,0,22831,3,0.000011,15,0.204265,0.230859,11615.75164,0.156989,0.000438
210076,210076,,1,7,8,1,7,8,0.000001,0.001136,0,22832,0,0.000011,14,0.183145,0.201343,973.209503,0.285714,0.000219
210077,210077,,4,16,20,4,16,20,0,0.000008,0,22833,23,0.000012,15,0.15347,0.167773,10622.454314,0.236842,0.000949
210078,210078,,4,21,25,4,21,25,0.000242,0.016166,0,22834,41,0.000011,16,0.194954,0.217518,2845.519089,0.131667,0.00104
210079,210079,,0,36,36,0,36,36,0,0.004106,0,22835,9,0.00001,16,0.199116,0.225718,0,0.069048,0
210080,210080,,2,28,30,2,28,30,0.000098,0.001379,0,22836,0,0.000011,15,0.185058,0.209448,5763.055449,0.16092,0.000438
210082,210082,,0,3,3,0,3,3,0,0,0,22837,23,0.00001,3,0.625,0.766667,0,0.5,0
210084,210084,,0,6,6,0,6,6,0,0.001515,0,22838,30,0.00001,13,0.19057,0.209689,0,0.266667,0
210085,210085,,2,17,19,2,17,19,0.000008,0.000004,0,22839,23,0.000012,14,0.171502,0.186193,13380.3742,0.125731,0.000438
9807106,9807106,,4,9,13,4,9,13,0.000057,0.00001,0,7581,26,0.000013,15,0.154677,0.177027,121741.692218,0.102564,0.000937
9707234,9707234,,3,5,8,3,5,8,0,0.000002,0,7574,26,0.000017,3,0.7,0.833333,19388.376387,0.089286,0.000684
210086,210086,,0,5,5,0,5,5,0,0.001341,0,22840,25,0.00001,13,0.181168,0.198207,0,0.45,0
210087,210087,,0,3,3,0,3,3,0,0,0,22841,6,0.00001,7,0.247788,0.354932,0,0.5,0
210089,210089,,0,33,33,0,33,33,0,0.003419,0,22842,1,0.00001,15,0.195851,0.221081,0,0.086174,0
210090,210090,,0,15,15,0,15,15,0,0.00267,0,22843,2,0.00001,16,0.18883,0.214091,0,0.180952,0
210091,210091,,7,20,27,7,20,27,0.001135,0.001707,0,22844,41,0.000012,16,0.196503,0.21885,3166.236017,0.183761,0.001673
210092,210092,,0,2,2,0,2,2,0,0,0,22845,23,0.00001,17,0.111076,0.116091,0,0.5,0
210093,210093,,7,25,32,7,25,32,0.00078,0.021309,0,22846,1,0.000013,12,0.21918,0.248565,15538.501394,0.166331,0.001818
210094,210094,,0,25,25,0,25,25,0,0.002179,0,22847,8,0.00001,15,0.194568,0.218606,0,0.206667,0
210095,210095,,1,11,12,1,11,12,0.000001,0.000191,0,22848,13,0.000011,15,0.140955,0.15431,216.600169,0.212121,0.000219
210096,210096,,6,13,19,6,13,19,0.000069,0.001574,0,22849,4,0.000012,16,0.183497,0.205921,509.151137,0.187135,0.002045
210097,210097,,1,4,5,1,4,5,0,0.000012,0,22850,22,0.000019,17,0.141501,0.149777,10326,0.15,0.000219
210098,210098,,1,7,8,1,7,8,0,0.000002,0,22851,23,0.000011,4,0.522727,0.619565,39.55,0.142857,0.000226
210099,210099,,0,2,2,0,2,2,0,0,0,22853,5,0.00001,2,0.625,0.7,0,0,0
9812236,9812236,,1,3,4,1,3,4,0,0,0,22852,5,0.000014,1,1,1,2.5,0,0.000219
210100,210100,,0,9,9,0,9,9,0,0.000069,0,22854,41,0.00001,15,0.158527,0.176063,0,0.097222,0
210101,210101,,10,38,48,10,38,48,0.000201,0.000786,0,22855,3,0.000012,15,0.202079,0.225194,4144.954722,0.277926,0.00255
210102,210102,,25,27,52,25,27,52,0.002818,0.001755,0,22856,41,0.000018,17,0.195434,0.214527,4271.546497,0.313348,0.006794
210103,210103,,0,3,3,0,3,3,0,0.000213,0,22857,13,0.00001,9,0.217923,0.245309,0,0.333333,0
210104,210104,,1,7,8,1,7,8,0,0,0,22858,23,0.000011,16,0.122698,0.12975,0,0.464286,0.000219
210105,210105,,3,38,41,3,38,41,0.000699,0.004183,0,22859,13,0.00001,15,0.197981,0.228345,2136.834627,0.111585,0.00069
210107,210107,,3,5,8,3,5,8,0.000031,0.000907,0,22860,30,0.000013,13,0.213649,0.234353,1577.858415,0.267857,0.00067
210108,210108,,1,13,14,1,13,14,0.00001,0.000276,0,22861,3,0.00001,15,0.188617,0.207679,0,0.445055,0.000253
210109,210109,,2,1,3,2,1,3,0.000007,0,0,22862,15,0.000012,15,0.153248,0.160823,1237.90039,0,0.000507
210110,210110,,0,2,2,0,2,2,0,0,0,22863,26,0.00001,16,0.131045,0.138089,0,0.5,0
210111,210111,,2,6,8,2,6,8,0.000001,0.000012,0,22865,15,0.000012,14,0.157173,0.165623,2038.1123,0.232143,0.000445
207085,207085,,2,0,2,2,0,2,0,0,0,22864,0,0.000014,0,0,0,0,0,0.000451
210112,210112,,0,7,7,0,7,7,0,0.000013,0,22866,30,0.00001,19,0.17348,0.187423,0,0.214286,0
210113,210113,,0,2,2,0,2,2,0,0.000007,0,22868,30,0.00001,16,0.127421,0.139535,0,0,0
7003,7003,,1,0,1,1,0,1,0,0,0,22867,30,0.000014,0,0,0,0,0,0.000219
210114,210114,,17,25,42,17,25,42,0.002707,0.017005,0,22869,1,0.000018,14,0.204727,0.229235,41535.191326,0.145761,0.00393
210115,210115,,7,12,19,7,12,19,0.001221,0.019233,0,22870,1,0.000013,18,0.188897,0.219263,2976.41402,0.309942,0.001633
210116,210116,,0,11,11,0,11,11,0,0.000377,0,22871,13,0.00001,15,0.17589,0.193367,0,0.1,0
210117,210117,,0,13,13,0,13,13,0,0.001503,0,22872,25,0.00001,14,0.180546,0.199449,0,0.307692,0
210118,210118,,0,8,8,0,8,8,0,0.012078,0,22873,1,0.00001,16,0.184614,0.205506,0,0.25,0
210119,210119,,0,3,3,0,3,3,0,0,0,22874,23,0.00001,9,0.204233,0.223842,0,0.166667,0
210120,210120,,0,2,2,0,2,2,0,0,25,22875,47,0.00001,1,1,1,0,0.5,0
210121,210121,,0,5,5,0,5,5,0,0,0,22876,30,0.00001,7,0.236559,0.391775,0,0.4,0
210122,210122,,7,28,35,7,28,35,0.000898,0.019213,0,22877,41,0.000012,17,0.199039,0.221929,1856.419754,0.211765,0.001652
210123,210123,,2,5,7,2,5,7,0.000015,0.000284,0,22878,1,0.000011,19,0.138827,0.154467,58.134662,0.333333,0.000471
210124,210124,,1,14,15,1,14,15,0.000009,0.000349,0,22879,1,0.000011,18,0.157876,0.175856,289.130599,0.280952,0.000219
210125,210125,,0,6,6,0,6,6,0,0.000001,0,22881,23,0.00001,17,0.094396,0.100004,0,0.166667,0
9309098,9309098,,2,1,3,2,1,3,0,0.000002,0,9616,23,0.000016,1,1,1,7.414458,0.166667,0.000465
9511113,9511113,,1,0,1,1,0,1,0,0,0,22880,23,0.000011,0,0,0,0,0,0.000219
9305147,9305147,,1,0,1,1,0,1,0,0,0,9617,23,0.000014,0,0,0,0,0,0.000246
210126,210126,,5,13,18,5,13,18,0.000631,0.017242,0,22882,1,0.000013,15,0.176961,0.200961,2544.817942,0.228758,0.001188
210127,210127,,3,32,35,3,32,35,0.000069,0.002051,0,22883,10,0.000011,15,0.200565,0.226722,2566.499372,0.143697,0.00067
210128,210128,,1,8,9,1,8,9,0.000003,0.000043,0,22884,15,0.00001,16,0.15711,0.176943,139.93301,0.277778,0.000219
210129,210129,,0,3,3,0,3,3,0,0.000007,0,22885,8,0.00001,15,0.140535,0.153,0,0.333333,0
210130,210130,,0,1,1,0,1,1,0,0,0,22886,2,0.00001,16,0.149528,0.158998,0,0,0
210131,210131,,3,25,28,3,25,28,0.000103,0.001181,0,22887,0,0.000011,14,0.201294,0.225387,1034.834918,0.18254,0.000808
210132,210132,,2,33,35,2,33,35,0.000073,0.004929,0,22889,10,0.000011,15,0.18804,0.215265,8799.071281,0.072269,0.000438
9211042,9211042,,1,0,1,1,0,1,0.000058,0,0,22888,10,0.00001,0,0,0,0,0,0.000232
210133,210133,,1,32,33,1,32,33,0.00006,0.011771,0,22890,2,0.00001,15,0.205089,0.239821,640.485679,0.253788,0.000219
210134,210134,,0,93,93,0,93,93,0,0.025234,0,22891,2,0.00001,15,0.229215,0.27204,0,0.053763,0
210135,210135,,50,27,77,50,27,77,0.001763,0.003581,0,22892,4,0.000032,16,0.189129,0.213207,11565.785153,0.230861,0.019562
210136,210136,,0,5,5,0,5,5,0,0.000011,0,22894,6,0.00001,14,0.148157,0.174464,0,0.15,0
9612081,9612081,,2,4,6,2,4,6,0,0.000003,0,22893,6,0.000012,14,0.143565,0.162281,2.15,0.166667,0.000438
210137,210137,,0,26,26,0,26,26,0,0.001431,0,22896,52,0.00001,18,0.193337,0.219518,0,0.08,0
9804040,9804040,,1,7,8,1,7,8,0.000017,0.000002,0,22895,52,0.00001,4,0.5,0.634259,9.272817,0.107143,0.000219
210138,210138,,0,10,10,0,10,10,0,0,0,22897,23,0.00001,18,0.140201,0.151221,0,0.233333,0
210139,210139,,1,19,20,1,19,20,0.000018,0.00081,0,22898,3,0.00001,16,0.195476,0.219629,848.612446,0.173684,0.000226
210141,210141,,0,6,6,0,6,6,0,0.000013,0,22899,15,0.00001,15,0.152578,0.16197,0,0.333333,0
210143,210143,,1,2,3,1,2,3,0,0.000003,0,22900,23,0.000014,17,0.118471,0.127564,13,0.166667,0.000219
210144,210144,,1,4,5,1,4,5,0.000003,0.000212,0,22901,6,0.000011,18,0.165087,0.18012,376.023376,0.2,0.000219
210145,210145,,2,60,62,2,60,62,0.000036,0.003633,0,22902,4,0.000011,15,0.212104,0.246279,6795.850309,0.123744,0.000453
210146,210146,,3,28,31,3,28,31,0.000213,0.001801,0,22903,2,0.000011,16,0.203528,0.229161,3777.851977,0.160215,0.000703
210147,210147,,1,6,7,1,6,7,0,0.000003,0,22904,23,0.00001,14,0.133794,0.14603,39.637014,0.333333,0.000219
210148,210148,,42,24,66,42,24,66,0.001189,0.000874,0,22905,4,0.000029,15,0.196701,0.222812,11359.567649,0.277622,0.016597
210149,210149,,0,2,2,0,2,2,0,0,22,22906,44,0.00001,1,1,1,0,0.5,0
210150,210150,,0,34,34,0,34,34,0,0.004483,0,22907,0,0.00001,15,0.196623,0.223465,0,0.157754,0
210151,210151,,0,5,5,0,5,5,0,0.000123,0,22909,5,0.00001,14,0.145508,0.166889,0,0.1,0
9906143,9906143,,1,10,11,1,10,11,0.000001,0.000022,0,22908,23,0.000012,12,0.151435,0.173341,727.896664,0.063636,0.000219
210152,210152,,2,22,24,2,22,24,0.000106,0.004344,0,22910,2,0.000011,19,0.198655,0.230165,2669.994436,0.11413,0.000438
210153,210153,,25,31,56,25,31,56,0.002887,0.002625,0,22911,41,0.000018,17,0.19865,0.218803,4848.342919,0.318831,0.00665
210154,210154,,1,6,7,1,6,7,0,0.000003,0,22912,23,0.000013,18,0.142145,0.153341,7929.799943,0.190476,0.000219
210155,210155,,4,10,14,4,10,14,0.00002,0.000068,0,22913,3,0.000013,14,0.182379,0.197196,249.536657,0.296703,0.000952
210156,210156,,0,1,1,0,1,1,0,0.000001,0,22914,15,0.00001,1,1,1,0,0,0
210157,210157,,4,288,292,4,288,292,0.000125,0.051748,0,22915,13,0.000011,15,0.23758,0.293774,35266.919569,0.037095,0.000896
210230,210230,,6,33,39,6,33,39,0.000484,0.004017,0,22916,41,0.000011,16,0.201166,0.225336,1076.879948,0.195007,0.001431
210158,210158,,6,42,48,6,42,48,0.000379,0.003293,0,22917,41,0.000011,15,0.207189,0.231307,6673.589262,0.20922,0.001496
210159,210159,,3,9,12,3,9,12,0.000014,0.000024,0,22918,4,0.000011,14,0.145927,0.157359,732.527119,0.166667,0.000684
210161,210161,,0,1,1,0,1,1,0,0,0,22919,6,0.00001,14,0.1164,0.129827,0,0,0
210162,210162,,1,3,4,1,3,4,0.000377,0.000096,0,22920,30,0.00001,14,0.206734,0.225609,459.960054,0.083333,0.000219
210163,210163,,2,16,18,2,16,18,0.000148,0.000558,0,22921,30,0.000011,13,0.218679,0.24197,85.564717,0.267974,0.000451
210164,210164,,1,10,11,1,10,11,0,0.000025,0,22922,30,0.000011,13,0.186407,0.201754,13988.977027,0.072727,0.000219
210165,210165,,0,1,1,0,1,1,0,0,0,22923,25,0.00001,1,1,1,0,0,0
210166,210166,,0,14,14,0,14,14,0,0.000472,0,22925,30,0.00001,14,0.200308,0.222094,0,0.126374,0
209118,209118,,4,0,4,4,0,4,0.000053,0,0,22924,30,0.000011,0,0,0,0,0.083333,0.000916
210167,210167,,0,63,63,0,63,63,0,0.00447,0,22926,30,0.00001,12,0.221645,0.253543,0,0.074245,0
210168,210168,,0,16,16,0,16,16,0,0.0196,0,22927,1,0.00001,16,0.193833,0.2317,0,0.1625,0
210169,210169,,2,6,8,2,6,8,0.000025,0.000028,0,22928,3,0.00001,14,0.178232,0.191244,12.161395,0.375,0.000539
210170,210170,,1,6,7,1,6,7,0.000001,0.000008,0,22929,2,0.00001,16,0.175213,0.19039,336.71604,0.190476,0.000226
210171,210171,,0,9,9,0,9,9,0,0.000821,0,22930,30,0.00001,18,0.17594,0.194274,0,0.166667,0
210173,210173,,1,20,21,1,20,21,0.000001,0.001087,0,22931,30,0.000011,13,0.212646,0.235017,1353.690261,0.145238,0.000219
210174,210174,,0,10,10,0,10,10,0,0.009165,0,22932,1,0.00001,15,0.2085,0.239132,0,0.211111,0
210175,210175,,0,18,18,0,18,18,0,0.004148,0,22933,2,0.00001,18,0.211789,0.241654,0,0.120915,0
210176,210176,,0,2,2,0,2,2,0,0.000001,0,22934,23,0.00001,3,0.5,0.633333,0,0,0
210177,210177,,1,6,7,1,6,7,0,0.000009,0,22935,0,0.000011,14,0.161157,0.173709,0,0.5,0.000219
210178,210178,,6,22,28,6,22,28,0.000022,0.004165,0,22936,13,0.000015,13,0.209685,0.235952,34215.812619,0.128307,0.001354
210179,210179,,0,6,6,0,6,6,0,0.000004,0,22937,26,0.00001,17,0.134556,0.149378,0,0.166667,0
210180,210180,,0,1,1,0,1,1,0,0.00001,0,22938,9,0.00001,1,1,1,0,0,0
210181,210181,,0,22,22,0,22,22,0,0.000203,0,22939,0,0.00001,13,0.18292,0.199777,0,0.19697,0
210182,210182,,0,7,7,0,7,7,0,0.000004,0,22940,9,0.00001,14,0.157148,0.171324,0,0.285714,0
210183,210183,,46,40,86,46,40,86,0.0014,0.003568,0,22941,4,0.000028,15,0.206128,0.234625,47193.067245,0.184952,0.017112
210184,210184,,11,10,21,11,10,21,0.000523,0.000151,0,22942,25,0.000021,17,0.169139,0.187726,14038.85866,0.1,0.002483
210185,210185,,1,7,8,1,7,8,0,0.000005,0,22943,23,0.000013,19,0.138348,0.159961,4476.977927,0.125,0.000219
210186,210186,,4,23,27,4,23,27,0.00005,0.000269,0,22944,8,0.000012,16,0.192201,0.214104,5227.462203,0.212251,0.000922
210187,210187,,4,42,46,4,42,46,0.000409,0.005925,0,22945,8,0.000011,12,0.21444,0.239063,500.097636,0.218841,0.000909
210188,210188,,1,3,4,1,3,4,0,0,0,22946,15,0.000019,17,0.110563,0.11532,5967,0.083333,0.000219
210189,210189,,0,9,9,0,9,9,0,0.001438,0,22947,25,0.00001,16,0.17401,0.192702,0,0.319444,0
210190,210190,,0,6,6,0,6,6,0,0.000006,0,22948,22,0.00001,14,0.158548,0.172286,0,0.233333,0
210192,210192,,0,4,4,0,4,4,0,0.001154,0,22949,4,0.00001,12,0.186539,0.207925,0,0.25,0
210193,210193,,1,27,28,1,27,28,0.000056,0.003919,0,22950,2,0.00001,18,0.203836,0.232011,148.099675,0.146825,0.000219
210194,210194,,0,10,10,0,10,10,0,0.001635,0,22951,30,0.00001,15,0.177713,0.195242,0,0.222222,0
210195,210195,,3,13,16,3,13,16,0.000472,0.0181,0,22952,1,0.000011,15,0.19243,0.222552,803.74785,0.2875,0.000697
210196,210196,,8,15,23,8,15,23,0.000601,0.015928,0,22953,1,0.000015,17,0.184807,0.20959,7698.556825,0.195652,0.001838
210197,210197,,0,5,5,0,5,5,0,0.000018,0,22954,23,0.00001,23,0.113398,0.167801,0,0.2,0
210198,210198,,5,38,43,5,38,43,0.000703,0.01795,0,22955,8,0.000011,17,0.197057,0.223921,9903.973375,0.1268,0.001115
210199,210199,,2,8,10,2,8,10,0.000019,0.000033,0,22956,3,0.00001,14,0.180071,0.193759,0.879996,0.433333,0.000486
210201,210201,,0,1,1,0,1,1,0,0,0,22957,5,0.00001,1,1,1,0,0,0
210202,210202,,0,5,5,0,5,5,0,0.000027,0,22958,25,0.00001,14,0.164758,0.176709,0,0.05,0
210203,210203,,4,28,32,4,28,32,0.000168,0.002032,0,22959,30,0.000012,16,0.214901,0.239205,10833.625472,0.154234,0.000896
210205,210205,,2,9,11,2,9,11,0.00006,0.000972,0,22960,25,0.00001,16,0.18,0.203626,427.944946,0.309091,0.000478
210206,210206,,8,31,39,8,31,39,0.000189,0.00293,0,22961,3,0.000012,14,0.209694,0.233339,11172.719072,0.160594,0.001977
210207,210207,,2,25,27,2,25,27,0,0.000093,0,22962,23,0.000024,14,0.16513,0.179392,17297,0.049858,0.000445
210208,210208,,1,8,9,1,8,9,0.000002,0.001073,0,22964,52,0.00001,15,0.166483,0.181193,65.229465,0.111111,0.000219
9906116,9906116,,1,7,8,1,7,8,0.000013,0.00005,0,22963,52,0.000011,8,0.185841,0.247433,35.745315,0.160714,0.000226
210209,210209,,9,43,52,9,43,52,0.000304,0.003521,0,22965,0,0.000012,14,0.198841,0.230383,7583.159972,0.095777,0.002365
210210,210210,,0,6,6,0,6,6,0,0.000013,0,22966,23,0.00001,15,0.158827,0.1728,0,0.166667,0
210211,210211,,0,17,17,0,17,17,0,0.000286,0,22967,0,0.00001,14,0.175824,0.196029,0,0.158088,0
210212,210212,,3,20,23,3,20,23,0.000128,0.002715,0,22968,41,0.000011,16,0.194921,0.216174,855.822109,0.140316,0.000717
210213,210213,,1,8,9,1,8,9,0.000001,0.000033,0,22969,15,0.00001,15,0.180187,0.199726,29.912384,0.222222,0.000226
210215,210215,,0,4,4,0,4,4,0,0.000006,0,22971,9,0.00001,17,0.149204,0.164824,0,0.083333,0
9707069,9707069,,1,7,8,1,7,8,0,0.000029,0,22970,52,0.000012,7,0.222692,0.259588,92.713016,0.035714,0.000219
210216,210216,,0,8,8,0,8,8,0,0.000055,0,22972,4,0.00001,14,0.170298,0.187102,0,0.196429,0
210218,210218,,5,50,55,5,50,55,0.000424,0.022481,0,22973,41,0.000011,17,0.217635,0.2507,7518.248876,0.128283,0.001142
210219,210219,,11,28,39,11,28,39,0.000236,0.001168,0,20092,0,0.000013,15,0.201033,0.226916,7154.728875,0.251012,0.0028
210220,210220,,4,11,15,4,11,15,0.000446,0.016115,0,22974,1,0.000012,15,0.174027,0.196436,175.115854,0.3,0.000923
210221,210221,,2,34,36,2,34,36,0.000014,0.001649,0,22975,3,0.00001,14,0.206097,0.228969,1793.048452,0.229365,0.000478
210222,210222,,0,9,9,0,9,9,0,0.000283,0,22976,1,0.00001,14,0.188562,0.207145,0,0.402778,0
210223,210223,,1,8,9,1,8,9,0.000008,0.002273,0,22977,2,0.000011,16,0.161946,0.180942,1297.506492,0.166667,0.000226
210224,210224,,2,161,163,2,161,163,0.00002,0.025244,0,22978,3,0.00001,13,0.260693,0.303532,75368.105377,0.036128,0.000578
210246,210246,,23,29,52,23,29,52,0.002571,0.017506,0,22979,41,0.000017,17,0.197939,0.220383,3249.345323,0.260935,0.005842
210313,210313,,2,59,61,2,59,61,0.00006,0.005363,0,22980,3,0.00001,15,0.214126,0.243355,1492.123539,0.121858,0.000532
211017,211017,,67,4,71,67,4,71,0.002103,0.000252,0,22981,4,0.000037,16,0.179679,0.199064,2237.195833,0.197183,0.022259
211170,211170,,69,26,95,69,26,95,0.002204,0.004545,0,22994,4,0.000034,15,0.199864,0.231336,67021.844372,0.160918,0.020516
210238,210238,,55,30,85,55,30,85,0.002002,0.002305,0,22984,4,0.000033,15,0.200214,0.22604,52604.484704,0.209944,0.020468
210281,210281,,41,22,63,41,22,63,0.001266,0.000734,0,22985,4,0.000026,15,0.193172,0.219169,11905.53446,0.256016,0.015256
211100,211100,,37,32,69,37,32,69,0.001206,0.008158,0,22992,4,0.00002,16,0.195032,0.219793,5836.299415,0.274936,0.012362
211123,211123,,39,44,83,39,44,83,0.001207,0.00488,0,22993,4,0.000022,15,0.202037,0.229899,19666.885968,0.23876,0.013166
211220,211220,,10,23,33,10,23,33,0.001127,0.001662,0,22997,41,0.000012,17,0.192452,0.211582,107.893261,0.39678,0.002545
211188,211188,,12,20,32,12,20,32,0.001153,0.007838,0,22996,41,0.000013,17,0.192231,0.212665,351.399921,0.34375,0.003036
211198,211198,,17,16,33,17,16,33,0.002115,0.001148,0,22995,41,0.000015,17,0.190338,0.208358,422.787167,0.348485,0.004267
212269,212269,,11,32,43,11,32,43,0.001592,0.002427,0,23006,41,0.000012,17,0.193232,0.21562,1433.397263,0.348837,0.002664
211032,211032,,16,41,57,16,41,57,0.00185,0.003128,0,22998,41,0.000014,17,0.197983,0.219997,4281.208811,0.205514,0.004035
212118,212118,,8,20,28,8,20,28,0.000792,0.00156,0,22999,41,0.000012,17,0.19154,0.210472,116.357685,0.387566,0.002096
212208,212208,,11,47,58,11,47,58,0.001301,0.018434,0,23005,41,0.000013,16,0.202015,0.228096,17321.223314,0.215064,0.002672
301117,301117,,9,28,37,9,28,37,0.000128,0.000393,0,23010,3,0.000015,15,0.202818,0.226104,27473.559489,0.114114,0.002193
212256,212256,,5,27,32,5,27,32,0.000101,0.000623,0,23009,13,0.000012,15,0.196866,0.224232,25219.277672,0.083669,0.00117
301024,301024,,1,8,9,1,8,9,0.000005,0.000179,0,23008,0,0.00001,15,0.179596,0.197131,1347.122905,0.25,0.000281
210225,210225,,0,20,20,0,20,20,0,0.00005,0,23011,6,0.00001,16,0.167167,0.183868,0,0.092105,0
210226,210226,,0,1,1,0,1,1,0,0,0,23012,22,0.00001,18,0.123971,0.129353,0,0,0
210228,210228,,1,21,22,1,21,22,0.000031,0.002526,0,23013,0,0.00001,15,0.195639,0.219708,7651.963984,0.103896,0.000226
210229,210229,,5,40,45,5,40,45,0.000451,0.009968,0,23014,41,0.000011,15,0.2215,0.249357,14171.113932,0.147475,0.001188
210231,210231,,6,39,45,6,39,45,0.000346,0.002817,0,23015,3,0.000013,13,0.21149,0.238805,17173.052048,0.086364,0.001394
210232,210232,,1,5,6,1,5,6,0,0.000003,0,23016,25,0.000012,15,0.175916,0.18894,11819.735984,0.333333,0.000226
210233,210233,,2,18,20,2,18,20,0.000248,0.000209,0,21559,8,0.000011,16,0.184946,0.203877,4968.123508,0.297368,0.00054
210234,210234,,12,20,32,12,20,32,0.000955,0.013805,0,23017,41,0.000014,15,0.211026,0.239007,20288.327941,0.155242,0.003052
210235,210235,,0,6,6,0,6,6,0,0.000084,0,23018,0,0.00001,16,0.164633,0.177122,0,0.266667,0
210236,210236,,3,3,6,3,3,6,0.000066,0.000002,0,23019,8,0.000017,15,0.123811,0.132344,37.473413,0.266667,0.000664
210237,210237,,0,4,4,0,4,4,0,0.000004,0,23020,30,0.00001,14,0.180434,0.193557,0,0.416667,0
9205057,9205057,,2,0,2,2,0,2,0.000027,0,0,22983,4,0.000012,0,0,0,0,0,0.000909
210239,210239,,37,24,61,37,24,61,0.001143,0.007489,0,22982,4,0.000025,16,0.194824,0.222652,13728.5543,0.224317,0.014052
210240,210240,,1,10,11,1,10,11,0,0.000015,0,23021,28,0.000012,15,0.162676,0.178391,11131,0.090909,0.000219
210241,210241,,2,29,31,2,29,31,0.000048,0.000863,0,23022,4,0.00001,13,0.206241,0.231408,4706.548334,0.225806,0.000445
210242,210242,,0,2,2,0,2,2,0,0,0,23023,23,0.00001,17,0.118458,0.127386,0,0.5,0
210243,210243,,0,14,14,0,14,14,0,0.004055,0,23024,2,0.00001,16,0.187674,0.2091,0,0.17033,0
210244,210244,,1,10,11,1,10,11,0.000012,0.003945,0,23025,4,0.000011,13,0.18043,0.205319,267.193305,0.163636,0.000219
210245,210245,,1,3,4,1,3,4,0.000002,0.000007,0,23026,13,0.000011,14,0.166801,0.179927,0,0.333333,0.000219
210247,210247,,0,6,6,0,6,6,0,0.000248,0,23027,25,0.00001,13,0.188681,0.205099,0,0.266667,0
210248,210248,,1,8,9,1,8,9,0.000009,0.000272,0,23028,52,0.00001,18,0.192351,0.213867,5.920425,0.305556,0.000219
210249,210249,,0,108,108,0,108,108,0,0.036132,0,23029,2,0.00001,14,0.237327,0.277202,0,0.067151,0
210250,210250,,3,23,26,3,23,26,0.000143,0.001857,0,23030,25,0.00001,16,0.187444,0.213946,1772.853912,0.189231,0.00067
210251,210251,,2,9,11,2,9,11,0.000008,0.000114,0,23031,4,0.000011,15,0.1724,0.189625,126.587309,0.272727,0.000451
210252,210252,,4,37,41,4,37,41,0.000379,0.019862,0,23032,8,0.000011,17,0.208893,0.242981,1106.641997,0.221951,0.00089
210253,210253,,0,21,21,0,21,21,0,0.003342,0,23033,30,0.00001,14,0.193256,0.215489,0,0.27619,0
210254,210254,,6,35,41,6,35,41,0.000133,0.003484,0,23034,0,0.000012,14,0.207552,0.235264,11287.58606,0.138415,0.001608
210255,210255,,0,3,3,0,3,3,0,0.000001,0,23036,22,0.00001,3,0.555556,0.633333,0,0,0
210191,210191,,1,0,1,1,0,1,0,0,0,23035,22,0.000013,0,0,0,0,0,0.000219
9302079,9302079,,2,2,4,2,2,4,0,0.000001,0,1576,22,0.000015,1,1,1,0,0.416667,0.000499
210256,210256,,2,17,19,2,17,19,0.000441,0.019574,0,23037,1,0.000011,18,0.196457,0.225566,3958.295475,0.315789,0.000445
210257,210257,,1,18,19,1,18,19,0.000052,0.010398,0,23038,25,0.000011,15,0.186967,0.213071,795.550353,0.169591,0.000219
210258,210258,,1,11,12,1,11,12,0.000004,0.001178,0,23039,25,0.00001,17,0.188823,0.210468,3987.253513,0.098485,0.000219
210261,210261,,1,9,10,1,9,10,0.000042,0.003647,0,23040,2,0.000011,19,0.164502,0.182733,0.426923,0.355556,0.000219
210262,210262,,10,49,59,10,49,59,0.000407,0.003908,0,23001,41,0.000014,16,0.216167,0.242625,37636.263815,0.143483,0.002568
210263,210263,,1,25,26,1,25,26,0.00002,0.000924,0,23041,0,0.00001,15,0.193081,0.218401,39.499464,0.195385,0.00024
210264,210264,,1,13,14,1,13,14,0.00002,0.000056,0,23042,15,0.00001,14,0.187408,0.203733,657.72442,0.098901,0.000226
210265,210265,,2,35,37,2,35,37,0.000282,0.017788,0,23043,1,0.00001,14,0.200789,0.227162,917.97485,0.201952,0.000451
210266,210266,,0,6,6,0,6,6,0,0.006807,0,23044,8,0.00001,16,0.166779,0.184269,0,0.266667,0
210267,210267,,0,16,16,0,16,16,0,0.000023,0,23046,6,0.00001,14,0.149609,0.182348,0,0.125,0
9906186,9906186,,1,4,5,1,4,5,0,0.000006,0,23045,6,0.00001,3,0.578947,0.666667,0,0.45,0.000219
9308137,9308137,,1,0,1,1,0,1,0,0,0,10444,6,0.000017,0,0,0,0,0,0.000279
210268,210268,,1,8,9,1,8,9,0.000006,0.00011,0,23047,4,0.000011,14,0.159745,0.177776,0,0.180556,0.000232
210269,210269,,13,30,43,13,30,43,0.000372,0.001565,0,23048,3,0.000014,14,0.214582,0.243812,13538.752201,0.148948,0.003176
210270,210270,,0,26,26,0,26,26,0,0.000709,0,23049,3,0.00001,14,0.191295,0.212515,0,0.252308,0
210271,210271,,0,13,13,0,13,13,0,0.001968,0,23050,30,0.00001,13,0.191697,0.210111,0,0.269231,0
210272,210272,,4,43,47,4,43,47,0.000193,0.018677,0,23051,8,0.000011,17,0.192277,0.217434,7283.215855,0.203978,0.000896
210274,210274,,0,13,13,0,13,13,0,0.020676,0,23052,1,0.00001,13,0.193589,0.225005,0,0.346154,0
210275,210275,,0,13,13,0,13,13,0,0.000792,0,23053,5,0.00001,15,0.175062,0.194956,0,0.051282,0
210276,210276,,0,5,5,0,5,5,0,0.000016,0,23054,13,0.00001,12,0.187668,0.204501,0,0.25,0
210277,210277,,0,3,3,0,3,3,0,0.000001,0,23055,20,0.00001,1,1,1,0,0.5,0
210278,210278,,6,34,40,6,34,40,0.000007,0.000291,0,23056,23,0.000014,14,0.19801,0.222763,44650.102139,0.08141,0.001354
210279,210279,,1,15,16,1,15,16,0.000015,0.001756,0,23057,25,0.000011,18,0.166151,0.189907,132.502888,0.225,0.000226
210280,210280,,0,11,11,0,11,11,0,0.001382,0,23058,1,0.00001,15,0.188952,0.207589,0,0.281818,0
210282,210282,,2,15,17,2,15,17,0,0.000009,0,23059,5,0.000012,14,0.173449,0.187913,17545.856222,0.143382,0.000451
210283,210283,,0,2,2,0,2,2,0,0.000001,0,23060,20,0.00001,1,1,1,0,0.5,0
210285,210285,,0,15,15,0,15,15,0,0.014885,0,23061,1,0.00001,16,0.204968,0.22949,0,0.247619,0
210286,210286,,0,7,7,0,7,7,0,0.000319,0,23062,8,0.00001,14,0.178436,0.195914,0,0.357143,0
210287,210287,,1,6,7,1,6,7,0,0.000008,0,23063,23,0.000011,17,0.145081,0.159118,469.362864,0.309524,0.000219
210288,210288,,3,10,13,3,10,13,0.000044,0.000877,0,23064,30,0.000012,14,0.188042,0.205033,126.456236,0.217949,0.000684
210289,210289,,0,14,14,0,14,14,0,0.00036,0,23065,25,0.00001,17,0.178159,0.199155,0,0.137363,0
210290,210290,,0,12,12,0,12,12,0,0.000477,0,23066,0,0.00001,16,0.180306,0.201622,0,0.363636,0
210291,210291,,46,19,65,46,19,65,0.001343,0.0007,0,22986,4,0.000027,16,0.190733,0.213523,1430.920995,0.336538,0.017014
210293,210293,,0,6,6,0,6,6,0,0.000004,0,23067,23,0.00001,17,0.157935,0.173649,0,0.433333,0
210294,210294,,0,28,28,0,28,28,0,0.001555,0,23068,0,0.00001,15,0.173707,0.199237,0,0.085979,0
210295,210295,,1,7,8,1,7,8,0.000027,0.001213,0,23069,8,0.000011,14,0.182166,0.200915,35.055997,0.267857,0.000219
210296,210296,,0,17,17,0,17,17,0,0.000251,0,23070,52,0.00001,16,0.182962,0.205808,0,0.183824,0
210297,210297,,1,8,9,1,8,9,0.000001,0.000037,0,23072,30,0.000011,15,0.185441,0.199847,196.751513,0.097222,0.000219
9904171,9904171,,2,7,9,2,7,9,0.000002,0.000077,0,23071,30,0.000011,12,0.15206,0.169066,51.82016,0.111111,0.000445
210298,210298,,0,3,3,0,3,3,0,0,0,23074,23,0.00001,1,1,1,0,0,0
9408163,9408163,,4,0,4,4,0,4,0,0,0,23073,23,0.00002,0,0,0,0,0.083333,0.000883
210299,210299,,0,13,13,0,13,13,0,0.000014,0,23076,23,0.00001,18,0.140133,0.154482,0,0.224359,0
9705213,9705213,,1,3,4,1,3,4,0,0,0,23075,23,0.000011,1,1,1,0,0.25,0.000219
210300,210300,,0,17,17,0,17,17,0,0.00211,0,23077,8,0.00001,13,0.175502,0.191705,0,0.224265,0
210301,210301,,1,16,17,1,16,17,0.000001,0.000046,0,23078,52,0.00001,18,0.148147,0.166164,319.661556,0.172794,0.000219
210302,210302,,2,39,41,2,39,41,0.000052,0.00111,0,23080,52,0.00001,17,0.201189,0.225688,699.169159,0.162805,0.000458
9310082,9310082,,1,9,10,1,9,10,0.000013,0.00014,0,23079,52,0.00001,2,0.764706,0.846154,23.523448,0.055556,0.000232
9204100,9204100,,5,0,5,5,0,5,0.000006,0,0,4080,52,0.000032,0,0,0,0,0,0.001179
210303,210303,,1,6,7,1,6,7,0.000019,0.000211,0,23081,25,0.00001,16,0.178654,0.195198,8992.919568,0.190476,0.000278
210304,210304,,0,1,1,0,1,1,0,0,0,23082,15,0.00001,3,0.454545,0.533333,0,0,0
210305,210305,,0,40,40,0,40,40,0,0.000784,0,23083,52,0.00001,14,0.209413,0.23322,0,0.146795,0
210306,210306,,3,12,15,3,12,15,0.000047,0.00078,0,23084,2,0.000011,18,0.195165,0.216038,340.788522,0.266667,0.00069
210307,210307,,0,4,4,0,4,4,0,0,0,23085,28,0.00001,16,0.12543,0.133381,0,0.083333,0
210308,210308,,10,42,52,10,42,52,0.00056,0.019431,0,23086,41,0.000013,15,0.207058,0.233292,12823.101735,0.144419,0.002432
210309,210309,,13,22,35,13,22,35,0.000856,0.002477,0,23087,41,0.000014,16,0.196385,0.219112,9812.072963,0.170588,0.003176
210310,210310,,1,15,16,1,15,16,0,0.000004,0,23090,23,0.000012,19,0.139685,0.151901,12587.622305,0.145833,0.000219
9802124,9802124,,1,4,5,1,4,5,0,0.000003,0,23089,23,0.000011,18,0.104229,0.118185,0,0.45,0.000226
9906063,9906063,,1,7,8,1,7,8,0,0.000003,0,23088,23,0.000011,18,0.110121,0.129282,1,0.375,0.000226
210311,210311,,0,21,21,0,21,21,0,0.000525,0,23091,3,0.00001,15,0.181571,0.202735,0,0.088095,0
210312,210312,,0,6,6,0,6,6,0,0.000003,0,23093,5,0.00001,16,0.119587,0.129002,0,0.1,0
9304017,9304017,,3,0,3,3,0,3,0,0,0,23092,28,0.000018,0,0,0,0,0,0.000664
211001,211001,,2,9,11,2,9,11,0,0.000007,0,23094,6,0.000012,15,0.121435,0.130371,4022.632077,0.163636,0.000445
211003,211003,,1,12,13,1,12,13,0.000007,0.000555,0,23095,52,0.00001,19,0.156166,0.174358,0,0.358974,0.000219
211004,211004,,0,2,2,0,2,2,0,0,0,23096,26,0.00001,4,0.428571,0.527778,0,0.5,0
211005,211005,,0,8,8,0,8,8,0,0.000001,0,23097,5,0.00001,19,0.120533,0.13362,0,0.303571,0
211006,211006,,5,27,32,5,27,32,0.000236,0.001819,0,23098,8,0.000013,16,0.195945,0.218763,8947.617376,0.226815,0.001122
211007,211007,,2,13,15,2,13,15,0,0.000006,0,23099,23,0.000011,15,0.147488,0.162139,519.277847,0.361905,0.000458
211008,211008,,6,13,19,6,13,19,0.000247,0.000408,0,23100,2,0.000012,18,0.188753,0.208641,2635.720394,0.157895,0.001441
211009,211009,,43,34,77,43,34,77,0.001259,0.003268,0,22988,4,0.000024,15,0.197064,0.222165,26683.736808,0.234108,0.015355
211010,211010,,1,16,17,1,16,17,0.000004,0.000157,0,23101,4,0.00001,16,0.18336,0.203389,2717.141706,0.136029,0.000232
211011,211011,,18,34,52,18,34,52,0.001633,0.003417,0,23002,41,0.000015,16,0.207473,0.230934,33088.647668,0.190045,0.004321
211012,211012,,7,83,90,7,83,90,0.000203,0.001532,0,23102,3,0.000012,14,0.205063,0.229211,24361.699284,0.149688,0.001672
211013,211013,,0,16,16,0,16,16,0,0.001603,0,23103,25,0.00001,17,0.192056,0.213876,0,0.191667,0
211014,211014,,1,25,26,1,25,26,0,0.0001,0,23104,23,0.00001,16,0.161224,0.179074,2017.826401,0.133846,0.000226
211015,211015,,0,3,3,0,3,3,0,0.003151,0,23105,0,0.00001,8,0.222535,0.253664,0,0,0
211016,211016,,0,13,13,0,13,13,0,0.003085,0,23106,4,0.00001,15,0.19651,0.217722,0,0.275641,0
211018,211018,,1,20,21,1,20,21,0.000228,0.019001,0,23107,8,0.00001,16,0.195134,0.226114,118.928804,0.242857,0.000219
211019,211019,,1,18,19,1,18,19,0.000132,0.008279,0,23108,25,0.00001,16,0.197863,0.223916,0,0.157895,0.000219
211020,211020,,1,20,21,1,20,21,0.000152,0.002502,0,23109,1,0.00001,15,0.188024,0.212544,1358.568143,0.133333,0.000219
211021,211021,,0,15,15,0,15,15,0,0.005733,0,23112,1,0.00001,16,0.175683,0.198073,0,0.119048,0
9812098,9812098,,1,5,6,1,5,6,0.000067,0.000011,0,23111,1,0.00001,7,0.235411,0.258348,92.790431,0.2,0.000219
9912096,9912096,,1,14,15,1,14,15,0.000067,0.018546,0,23110,1,0.00001,11,0.229379,0.260494,2578.721401,0.209524,0.000219
211022,211022,,3,7,10,3,7,10,0.000016,0.000119,0,23113,15,0.000012,13,0.174676,0.18616,1181.023134,0.222222,0.000664
211023,211023,,1,32,33,1,32,33,0.000027,0.02002,0,23114,1,0.000011,15,0.201478,0.23346,5295.031779,0.189394,0.000219
211024,211024,,4,15,19,4,15,19,0.000474,0.003446,0,23115,1,0.000012,17,0.186557,0.217158,7600.958891,0.178363,0.000897
211026,211026,,1,5,6,1,5,6,0.000377,0.000017,0,23116,15,0.00001,13,0.185948,0.200495,63.919417,0.133333,0.000219
211027,211027,,7,14,21,7,14,21,0.00029,0.00117,0,23117,0,0.000013,15,0.19086,0.216129,9526.258188,0.211905,0.001685
211028,211028,,9,28,37,9,28,37,0.000441,0.001659,0,23118,25,0.000016,15,0.185408,0.20989,23415.469003,0.179429,0.002033
211029,211029,,6,42,48,6,42,48,0.00035,0.007293,0,23119,41,0.000011,16,0.212398,0.243609,6785.22399,0.162677,0.001335
211030,211030,,2,25,27,2,25,27,0.000086,0.001812,0,23120,13,0.00001,16,0.195476,0.22521,77.421735,0.200855,0.000445
211033,211033,,0,11,11,0,11,11,0,0.000652,0,23121,2,0.00001,19,0.215398,0.24399,0,0.127273,0
211034,211034,,0,8,8,0,8,8,0,0.000011,0,23122,1,0.00001,14,0.15673,0.168708,0,0.357143,0
211035,211035,,0,9,9,0,9,9,0,0.001785,0,23123,0,0.00001,16,0.175363,0.194845,0,0.361111,0
211036,211036,,0,30,30,0,30,30,0,0.003502,0,23124,23,0.00001,16,0.206456,0.245724,0,0.056322,0
211037,211037,,0,4,4,0,4,4,0,0.001085,0,23125,8,0.00001,14,0.158132,0.170558,0,0.083333,0
211038,211038,,2,16,18,2,16,18,0.000062,0.000396,0,23126,52,0.000011,15,0.192907,0.216609,963.799546,0.235294,0.000458
211039,211039,,0,14,14,0,14,14,0,0.000053,0,23127,0,0.00001,14,0.166531,0.189269,0,0.153846,0
211040,211040,,0,21,21,0,21,21,0,0.000462,0,23128,3,0.00001,14,0.185302,0.203853,0,0.228571,0
211041,211041,,5,43,48,5,43,48,0.000217,0.001512,0,23129,30,0.000011,13,0.21695,0.243073,4156.409268,0.198582,0.001148
211042,211042,,11,51,62,11,51,62,0.000282,0.004317,0,23130,2,0.000013,14,0.215904,0.242869,19410.53274,0.089371,0.002603
211043,211043,,0,15,15,0,15,15,0,0.000428,0,23131,25,0.00001,17,0.171287,0.1925,0,0.190476,0
211044,211044,,0,12,12,0,12,12,0,0.000755,0,23132,25,0.00001,14,0.173449,0.190309,0,0.143939,0
211045,211045,,0,2,2,0,2,2,0,0.000004,0,23133,26,0.00001,13,0.164296,0.174884,0,0,0
211046,211046,,0,1,1,0,1,1,0,0,37,23134,61,0.00001,2,0.666667,0.75,0,0,0
211047,211047,,0,12,12,0,12,12,0,0.000385,0,23135,2,0.00001,17,0.175961,0.195083,0,0.106061,0
211048,211048,,2,7,9,2,7,9,0.000006,0.000082,0,23136,25,0.000011,17,0.168303,0.187947,1204.315339,0.166667,0.000438
211049,211049,,2,20,22,2,20,22,0.000182,0.012272,0,23137,4,0.000011,17,0.180409,0.201579,257.568016,0.257576,0.000438
211050,211050,,0,11,11,0,11,11,0,0.00173,0,23138,4,0.00001,16,0.127593,0.14762,0,0.2,0
211051,211051,,1,7,8,1,7,8,0,0.000004,0,23139,15,0.000011,15,0.138695,0.145567,0,0.464286,0.000219
211052,211052,,40,16,56,40,16,56,0.001211,0.000386,0,22987,4,0.000023,16,0.187203,0.207739,407.620573,0.345455,0.014258
211053,211053,,0,21,21,0,21,21,0,0.0001,0,23140,15,0.00001,15,0.18172,0.200085,0,0.066667,0
211054,211054,,1,16,17,1,16,17,0.000003,0.000908,0,23141,26,0.000011,15,0.173619,0.193294,10592.246789,0.191176,0.000219
211055,211055,,1,18,19,1,18,19,0,0.000016,0,23143,20,0.000011,22,0.149509,0.166723,2282.485053,0.207602,0.000219
7093,7093,,1,0,1,1,0,1,0,0,0,23142,20,0.00001,0,0,0,0,0,0.000226
211056,211056,,2,27,29,2,27,29,0.000299,0.00236,0,23144,30,0.00001,14,0.204089,0.229598,7986.175449,0.144089,0.000451
211057,211057,,3,15,18,3,15,18,0.000001,0.00003,0,23145,15,0.000013,21,0.180832,0.201303,20966.871467,0.222222,0.000677
211058,211058,,2,15,17,2,15,17,0.000075,0.00034,0,23146,25,0.00001,14,0.195388,0.215792,561.168207,0.150735,0.000458
211060,211060,,1,14,15,1,14,15,0.000019,0.000368,0,23147,30,0.00001,16,0.203348,0.227744,1830.434145,0.190476,0.000245
211061,211061,,2,16,18,2,16,18,0.000001,0.000506,0,23148,4,0.000012,13,0.179599,0.199267,2186.172219,0.143791,0.000445
211062,211062,,0,3,3,0,3,3,0,0.000546,0,23150,41,0.00001,15,0.164304,0.179375,0,0.166667,0
9905154,9905154,,2,0,2,2,0,2,0.000009,0,0,23149,5,0.000015,0,0,0,0,0,0.000445
211063,211063,,5,11,16,5,11,16,0.000364,0.000427,0,23151,3,0.000013,18,0.177692,0.200302,2361.174244,0.145833,0.001096
211064,211064,,0,2,2,0,2,2,0,0,0,23152,22,0.00001,16,0.141102,0.1496,0,0.5,0
211065,211065,,2,16,18,2,16,18,0.000067,0.003208,0,23153,2,0.000011,14,0.212733,0.242801,9362.556164,0.071895,0.000445
211066,211066,,0,10,10,0,10,10,0,0.000003,0,23154,23,0.00001,23,0.138364,0.156834,0,0.166667,0
211067,211067,,1,23,24,1,23,24,0.000041,0.000572,0,23155,4,0.00001,14,0.186279,0.208135,1.59981,0.304348,0.000219
211068,211068,,1,45,46,1,45,46,0.000038,0.005419,0,23156,30,0.00001,15,0.209515,0.243082,5320.402752,0.071981,0.000226
211069,211069,,38,29,67,38,29,67,0.001238,0.003436,0,22991,4,0.000021,15,0.193147,0.216665,11059.717483,0.211895,0.012733
211070,211070,,2,22,24,2,22,24,0.00004,0.001591,0,23162,30,0.00001,12,0.199713,0.217107,3941.766292,0.144928,0.000451
9406130,9406130,,4,1,5,4,1,5,0.000019,0,0,23157,30,0.000056,1,1,1,9.666667,0.1,0.000943
9508137,9508137,,5,1,6,5,1,6,0.000029,0,0,23158,30,0.000044,2,0.666667,0.75,7,0.2,0.001155
9604197,9604197,,3,1,4,3,1,4,0.000029,0,0,23159,30,0.000018,3,0.5,0.611111,3,0.25,0.000684
9712235,9712235,,2,4,6,2,4,6,0.000019,0.000834,0,23161,30,0.000015,7,0.228956,0.27409,149.485074,0.166667,0.000451
9601093,9601093,,2,3,5,2,3,5,0.00001,0.000001,0,23160,30,0.000018,2,0.714286,0.8,10.885965,0.15,0.000451
211071,211071,,1,3,4,1,3,4,0.000021,0.000001,0,23163,17,0.000011,6,0.293578,0.36875,3.283333,0.166667,0.000219
211072,211072,,1,7,8,1,7,8,0.000021,0.000002,0,23164,17,0.000011,16,0.157461,0.173712,25.860206,0.089286,0.000219
211073,211073,,4,20,24,4,20,24,0.000565,0.002437,0,23165,41,0.000011,16,0.193678,0.21297,480.064042,0.293478,0.00091
211075,211075,,41,24,65,41,24,65,0.001231,0.001195,0,22990,4,0.000022,16,0.191967,0.214709,1158.253659,0.320673,0.014151
211076,211076,,2,39,41,2,39,41,0.000155,0.002538,0,23166,30,0.00001,15,0.201127,0.223412,908.339367,0.195732,0.000438
211078,211078,,0,3,3,0,3,3,0,0.000004,0,23167,8,0.00001,13,0.149113,0.158805,0,0.333333,0
211080,211080,,2,11,13,2,11,13,0,0.000003,0,23168,5,0.000012,15,0.156845,0.168729,9268.420429,0.153846,0.000438
211081,211081,,0,12,12,0,12,12,0,0.004386,0,23169,25,0.00001,15,0.178372,0.200765,0,0.242424,0
211082,211082,,41,17,58,41,17,58,0.001231,0.000644,0,22989,4,0.000022,16,0.191104,0.212716,913.169589,0.34997,0.014151
211083,211083,,0,7,7,0,7,7,0,0.000077,0,23170,2,0.00001,15,0.173441,0.188814,0,0.357143,0
211084,211084,,1,5,6,1,5,6,0.000001,0.000001,0,23171,23,0.000011,14,0.132024,0.148057,189.096323,0.233333,0.000239
211085,211085,,0,5,5,0,5,5,0,0.000033,0,23172,23,0.00001,15,0.118838,0.133547,0,0.3,0
211086,211086,,0,32,32,0,32,32,0,0.003319,0,23173,4,0.00001,14,0.177562,0.204058,0,0.159274,0
211087,211087,,0,16,16,0,16,16,0,0.000101,0,23174,5,0.00001,15,0.169078,0.183336,0,0.316667,0
211088,211088,,1,2,3,1,2,3,0,0.000008,0,23176,0,0.000012,16,0.163186,0.178597,0,0.333333,0.000219
111137,111137,,2,0,2,2,0,2,0,0,0,23175,0,0.000017,0,0,0,0,0.5,0.000445
211089,211089,,3,19,22,3,19,22,0.000171,0.004606,0,23177,41,0.000011,16,0.19542,0.227538,5952.619581,0.147186,0.000737
211091,211091,,3,24,27,3,24,27,0.000056,0.000588,0,23178,0,0.00001,14,0.197084,0.220832,287.497675,0.363248,0.000724
211092,211092,,3,10,13,3,10,13,0.000222,0.017001,0,23179,1,0.000011,15,0.203254,0.233673,1667.06601,0.262821,0.000703
211093,211093,,1,14,15,1,14,15,0.000204,0.002528,0,23180,41,0.00001,15,0.187895,0.209243,132.371881,0.261905,0.000233
211094,211094,,1,18,19,1,18,19,0,0.000003,0,23181,6,0.00001,15,0.142377,0.156054,3987.650843,0.163743,0.000219
211095,211095,,2,17,19,2,17,19,0.000005,0.000129,0,23182,2,0.000011,17,0.165395,0.183181,60.174068,0.280702,0.000445
211097,211097,,3,26,29,3,26,29,0.000275,0.004399,0,23183,13,0.000011,17,0.18736,0.214328,3774.068991,0.149015,0.000732
211098,211098,,25,33,58,25,33,58,0.001118,0.001523,0,23184,4,0.000016,15,0.201432,0.225605,40691.475845,0.137629,0.00819
211099,211099,,0,1,1,0,1,1,0,0,15,23185,36,0.00001,1,1,1,0,0,0
211101,211101,,0,20,20,0,20,20,0,0.014362,0,23186,2,0.00001,16,0.191056,0.217335,0,0.165789,0
211102,211102,,16,53,69,16,53,69,0.000364,0.001845,0,23187,0,0.000017,14,0.216645,0.24757,34654.12645,0.096121,0.004047
211103,211103,,5,38,43,5,38,43,0.000244,0.001668,0,23188,25,0.000011,15,0.186451,0.213666,4798.264811,0.138427,0.001122
211104,211104,,0,4,4,0,4,4,0,0.000005,0,23189,23,0.00001,6,0.248394,0.287213,0,0.083333,0
211105,211105,,0,17,17,0,17,17,0,0.000878,0,23190,30,0.00001,18,0.188155,0.206735,0,0.143382,0
211106,211106,,0,4,4,0,4,4,0,0.000134,0,23191,1,0.00001,17,0.165028,0.18379,0,0.333333,0
211107,211107,,2,6,8,2,6,8,0.000378,0.007445,0,23192,1,0.00001,16,0.178985,0.200842,63.204213,0.232143,0.000479
211108,211108,,1,31,32,1,31,32,0.000315,0.004018,0,23193,4,0.00001,14,0.213244,0.237919,154.119124,0.160282,0.000219
211250,211250,,1,32,33,1,32,33,0.00025,0.006925,0,23194,2,0.00001,15,0.217906,0.246637,939.86599,0.133523,0.000226
211109,211109,,1,4,5,1,4,5,0,0.000001,0,23195,25,0.000011,16,0.149616,0.157502,265.735984,0.3,0.000219
211110,211110,,0,35,35,0,35,35,0,0.009869,0,23196,30,0.00001,13,0.246613,0.281706,0,0.130252,0
211111,211111,,6,24,30,6,24,30,0.000403,0.00264,0,23197,0,0.000013,13,0.217492,0.25202,42568.280207,0.104598,0.001367
211112,211112,,2,9,11,2,9,11,0.000228,0.001398,0,23198,25,0.000011,16,0.17979,0.199314,71.558771,0.3,0.000451
211113,211113,,6,12,18,6,12,18,0.000655,0.000314,0,23199,1,0.000012,13,0.189964,0.209032,1960.216297,0.222222,0.001354
211114,211114,,0,6,6,0,6,6,0,0.000004,0,23200,6,0.00001,17,0.150389,0.163399,0,0.033333,0
211115,211115,,2,20,22,2,20,22,0.000039,0.004477,0,23201,2,0.000011,17,0.203065,0.2305,979.561974,0.235931,0.000445
211116,211116,,0,34,34,0,34,34,0,0.016503,0,23202,0,0.00001,16,0.188919,0.218606,0,0.116756,0
211118,211118,,15,48,63,15,48,63,0.000251,0.00347,0,23203,0,0.000017,13,0.21167,0.241834,36245.075341,0.105223,0.003698
211119,211119,,0,6,6,0,6,6,0,0.000016,0,23204,30,0.00001,19,0.156216,0.166513,0,0.3,0
211120,211120,,0,17,17,0,17,17,0,0.000809,0,23205,1,0.00001,17,0.180006,0.201747,0,0.058824,0
211121,211121,,0,35,35,0,35,35,0,0.003435,0,23206,52,0.00001,18,0.191896,0.222978,0,0.130252,0
211122,211122,,12,19,31,12,19,31,0.00113,0.002511,0,23003,41,0.000014,16,0.198476,0.22024,13489.493905,0.210753,0.002869
211124,211124,,7,10,17,7,10,17,0.000132,0.003192,0,23207,0,0.000013,16,0.176143,0.196279,222.270965,0.231618,0.001586
211125,211125,,1,7,8,1,7,8,0.000017,0.000883,0,23208,30,0.00001,14,0.203212,0.222916,17790.358026,0.125,0.000398
211126,211126,,0,10,10,0,10,10,0,0.000038,0,23209,0,0.00001,16,0.169772,0.185472,0,0.311111,0
211127,211127,,2,27,29,2,27,29,0.000072,0.001251,0,23211,3,0.00001,15,0.196192,0.220915,524.248322,0.227833,0.000452
209092,209092,,1,0,1,1,0,1,0.000015,0,0,23210,3,0.00001,0,0,0,0,0,0.000232
211128,211128,,0,17,17,0,17,17,0,0.00001,0,23212,23,0.00001,14,0.146629,0.157014,0,0.216912,0
211129,211129,,3,33,36,3,33,36,0.000185,0.002547,0,23213,30,0.00001,17,0.207304,0.232859,476.994054,0.134921,0.000684
211130,211130,,3,38,41,3,38,41,0.000259,0.002177,0,23214,10,0.000011,16,0.204437,0.232532,4513.473598,0.302439,0.00069
211131,211131,,6,35,41,6,35,41,0.000128,0.000758,0,23215,3,0.000011,15,0.197654,0.218405,7123.196313,0.220732,0.001394
211132,211132,,1,13,14,1,13,14,0,0.000011,0,23217,6,0.000011,17,0.149412,0.16432,6986.919234,0.21978,0.000219
201230,201230,,1,0,1,1,0,1,0,0,0,23216,6,0.000011,0,0,0,0,0,0.000226
211133,211133,,0,12,12,0,12,12,0,0.000282,0,23219,26,0.00001,16,0.14836,0.161569,0,0.295455,0
9601099,9601099,,1,7,8,1,7,8,0.000003,0.000573,0,23218,26,0.000011,8,0.258089,0.313188,7.882773,0.303571,0.000219
211134,211134,,0,19,19,0,19,19,0,0.000088,0,23220,28,0.00001,17,0.167657,0.18457,0,0.245614,0
211135,211135,,0,41,41,0,41,41,0,0.021334,0,23221,25,0.00001,15,0.210773,0.239868,0,0.17622,0
211136,211136,,1,18,19,1,18,19,0,0.000042,0,23222,22,0.000011,18,0.170195,0.188929,9509.412043,0.280702,0.000219
211137,211137,,3,18,21,3,18,21,0.000026,0.002405,0,23223,41,0.000011,16,0.195429,0.217443,1919.481669,0.204762,0.000717
211138,211138,,0,37,37,0,37,37,0,0.005419,0,23224,41,0.00001,16,0.209868,0.243935,0,0.153153,0
211139,211139,,5,21,26,5,21,26,0.000231,0.00423,0,23225,41,0.000011,16,0.203889,0.231602,7120.580791,0.133846,0.001115
211140,211140,,0,10,10,0,10,10,0,0.002453,0,23226,4,0.00001,17,0.165718,0.183745,0,0.188889,0
211141,211141,,2,26,28,2,26,28,0.000071,0.019872,0,23227,1,0.00001,14,0.21161,0.239767,4003.950386,0.18254,0.000478
211142,211142,,8,20,28,8,20,28,0.001114,0.001961,0,23228,1,0.000012,16,0.196063,0.222092,1821.39497,0.162698,0.001839
211143,211143,,0,4,4,0,4,4,0,0.000003,0,23231,52,0.00001,19,0.161425,0.174389,0,0.083333,0
9402137,9402137,,2,0,2,2,0,2,0,0,0,23230,22,0.000014,0,0,0,0,0,0.000438
9905166,9905166,,1,4,5,1,4,5,0,0.000001,0,23229,23,0.000012,4,0.409836,0.49,25,0.15,0.000219
211144,211144,,6,18,24,6,18,24,0.000001,0.000002,0,23232,23,0.000015,15,0.1456,0.158294,9209.256874,0.224638,0.001367
211145,211145,,0,2,2,0,2,2,0,0.000009,0,23234,26,0.00001,2,0.625,0.7,0,0,0
9207083,9207083,,1,0,1,1,0,1,0,0,0,23233,26,0.000014,0,0,0,0,0,0.000219
211146,211146,,0,22,22,0,22,22,0,0.013107,0,23235,4,0.00001,17,0.180423,0.201678,0,0.261905,0
211147,211147,,2,10,12,2,10,12,0.000017,0.000744,0,23236,28,0.000013,15,0.154228,0.170031,11751.945059,0.090909,0.000438
9610103,9610103,,2,5,7,2,5,7,0.000001,0.00017,0,6955,0,0.000021,10,0.197109,0.220944,2853.563075,0.119048,0.000486
211148,211148,,3,20,23,3,20,23,0.000185,0.000513,0,23237,30,0.00001,14,0.204447,0.22888,37.133712,0.262846,0.000684
211149,211149,,2,14,16,2,14,16,0.000008,0.000035,0,23238,5,0.000013,15,0.159617,0.170895,6075.456682,0.341667,0.000438
211150,211150,,0,8,8,0,8,8,0,0.000562,0,23239,1,0.00001,15,0.19133,0.21186,0,0.107143,0
211151,211151,,0,3,3,0,3,3,0,0,0,23241,23,0.00001,15,0.122003,0.133365,0,0.166667,0
9905051,9905051,,1,1,2,1,1,2,0,0,0,23240,23,0.000013,10,0.175075,0.19175,0,0.5,0.000219
211152,211152,,3,20,23,3,20,23,0.000426,0.01917,0,23242,1,0.000011,18,0.20659,0.237909,5358.76829,0.250988,0.000763
211153,211153,,1,2,3,1,2,3,0,0,0,23245,23,0.000013,1,1,1,0,0.333333,0.000219
204003,204003,,3,0,3,3,0,3,0,0,0,23244,23,0.000022,0,0,0,0,0.166667,0.000664
206008,206008,,3,0,3,3,0,3,0,0,0,23243,23,0.000022,0,0,0,0,0.166667,0.000664
211154,211154,,1,16,17,1,16,17,0,0.000008,0,23246,9,0.000011,17,0.152693,0.169532,10747.148865,0.209559,0.000219
211155,211155,,3,3,6,3,3,6,0,0.000001,0,23247,23,0.000017,14,0.161878,0.172248,4314,0.4,0.00067
211156,211156,,0,29,29,0,29,29,0,0.003013,0,23248,30,0.00001,16,0.197495,0.224304,0,0.135468,0
211157,211157,,0,9,9,0,9,9,0,0.000025,0,23249,23,0.00001,18,0.138341,0.161656,0,0.222222,0
211158,211158,,2,33,35,2,33,35,0.000001,0.000051,0,23250,23,0.000012,14,0.18352,0.201758,5143.162182,0.141176,0.000445
211159,211159,,0,2,2,0,2,2,0,0.001261,0,23251,0,0.00001,9,0.219521,0.250058,0,0.5,0
211160,211160,,3,20,23,3,20,23,0.000293,0.017672,0,23252,8,0.000011,18,0.1796,0.201713,458.618096,0.132411,0.00069
211161,211161,,0,13,13,0,13,13,0,0.000133,0,23253,2,0.00001,18,0.139827,0.165379,0,0.108974,0
211162,211162,,0,39,39,0,39,39,0,0.012915,0,23254,1,0.00001,16,0.207502,0.241918,0,0.118084,0
211163,211163,,2,17,19,2,17,19,0.000014,0.000281,0,23255,52,0.000011,15,0.192852,0.214341,642.098394,0.184211,0.000452
211164,211164,,2,35,37,2,35,37,0.000025,0.001123,0,23256,30,0.000011,15,0.199499,0.223991,5194.496303,0.104354,0.000438
211165,211165,,2,7,9,2,7,9,0.000041,0.001055,0,23257,30,0.000011,14,0.201149,0.220481,56.211643,0.263889,0.000438
211167,211167,,1,11,12,1,11,12,0,0.000047,0,23258,15,0.000011,14,0.165145,0.178557,9772.455219,0.106061,0.000219
211168,211168,,2,9,11,2,9,11,0.000007,0.000004,0,23259,6,0.000011,16,0.142534,0.156116,2337.513757,0.181818,0.000445
211169,211169,,1,21,22,1,21,22,0.000015,0.000567,0,23260,30,0.000011,15,0.212044,0.234385,1082.756845,0.285714,0.000226
211171,211171,,2,28,30,2,28,30,0.000039,0.001349,0,23261,30,0.000011,16,0.196068,0.222317,4916.294112,0.128736,0.000451
211172,211172,,1,28,29,1,28,29,0.000013,0.005029,0,23262,3,0.00001,15,0.195612,0.22166,645.047648,0.125616,0.000219
211173,211173,,1,7,8,1,7,8,0.000012,0.000136,0,23263,52,0.00001,17,0.185592,0.207261,567.325161,0.303571,0.000468
211174,211174,,0,25,25,0,25,25,0,0.00001,0,23264,6,0.00001,15,0.157664,0.175476,0,0.141667,0
211175,211175,,0,3,3,0,3,3,0,0.000012,0,23265,25,0.00001,18,0.143526,0.155666,0,0.166667,0
211176,211176,,1,22,23,1,22,23,0.000031,0.00151,0,23266,30,0.00001,13,0.21289,0.236627,0.5,0.245059,0.000219
211177,211177,,0,8,8,0,8,8,0,0.000097,0,23267,13,0.00001,18,0.183284,0.202486,0,0.303571,0
211178,211178,,5,170,175,5,170,175,0.000372,0.014716,0,23268,41,0.000011,15,0.235714,0.269057,26643.92147,0.086174,0.001188
211179,211179,,0,2,2,0,2,2,0,0,0,23271,23,0.00001,19,0.099253,0.111685,0,0,0
9810175,9810175,,1,1,2,1,1,2,0,0,0,23270,23,0.000014,1,1,1,1,0,0.000219
9407140,9407140,,1,0,1,1,0,1,0,0,0,23269,23,0.000023,0,0,0,0,0,0.000226
211180,211180,,6,36,42,6,36,42,0.00054,0.002833,0,23272,3,0.000011,13,0.209723,0.235014,3717.117458,0.186411,0.001416
211181,211181,,1,77,78,1,77,78,0.000009,0.003312,0,23273,41,0.00001,14,0.229238,0.263092,5119.550792,0.024975,0.000226
211182,211182,,15,48,63,15,48,63,0.000433,0.001946,0,23274,0,0.000014,14,0.208812,0.241194,26258.197921,0.11828,0.003552
211183,211183,,0,11,11,0,11,11,0,0.000196,0,23275,25,0.00001,13,0.184659,0.201132,0,0.290909,0
211184,211184,,0,22,22,0,22,22,0,0.016158,0,23276,41,0.00001,16,0.171153,0.195324,0,0.136364,0
211185,211185,,1,10,11,1,10,11,0,0,0,23277,6,0.000011,15,0.135423,0.14639,118.695359,0.2,0.000226
9312156,9312156,,3,2,5,3,2,5,0,0,0,2056,6,0.000013,4,0.444444,0.520833,1.834524,0.25,0.000691
9501005,9501005,,4,27,31,4,27,31,0,0.000005,0,2060,6,0.000014,6,0.332461,0.468241,90033.555318,0.107527,0.00094
9204081,9204081,,1,0,1,1,0,1,0,0,0,2059,6,0.00001,0,0,0,0,0,0.000246
9405041,9405041,,1,6,7,1,6,7,0,0,0,2053,6,0.00001,4,0.535714,0.661111,14032,0.142857,0.000246
211186,211186,,0,4,4,0,4,4,0,0,0,23278,6,0.00001,6,0.288939,0.34362,0,0.25,0
211187,211187,,0,5,5,0,5,5,0,0,0,23279,2,0.00001,14,0.157018,0.166249,0,0.35,0
211189,211189,,34,22,56,34,22,56,0.000961,0.000433,0,23280,4,0.000019,16,0.189738,0.21078,657.64956,0.340909,0.011051
211190,211190,,0,6,6,0,6,6,0,0.000135,0,23281,30,0.00001,14,0.206605,0.229443,0,0.133333,0
211191,211191,,1,18,19,1,18,19,0.000175,0.000537,0,23282,1,0.00001,13,0.20187,0.222486,888.985078,0.090643,0.000219
211192,211192,,0,12,12,0,12,12,0,0.003798,0,23283,1,0.00001,15,0.179362,0.20091,0,0.174242,0
211193,211193,,3,11,14,3,11,14,0.000165,0.00123,0,23284,30,0.000011,16,0.212199,0.234343,194.126602,0.230769,0.000671
211194,211194,,26,11,37,26,11,37,0.001067,0.002708,0,23285,4,0.000016,16,0.181415,0.203628,12788.015135,0.21021,0.008238
211195,211195,,8,40,48,8,40,48,0.000515,0.01985,0,23286,41,0.000013,14,0.221498,0.251658,17486.905865,0.115691,0.001972
211196,211196,,1,26,27,1,26,27,0.000108,0.002497,0,23287,25,0.00001,15,0.189846,0.211772,5754.132199,0.172365,0.000259
211197,211197,,4,25,29,4,25,29,0.000385,0.002613,0,23288,41,0.000011,17,0.199034,0.220263,447.265689,0.274631,0.000916
211199,211199,,0,28,28,0,28,28,0,0.003012,0,23289,3,0.00001,15,0.191595,0.212271,0,0.152116,0
211200,211200,,3,8,11,3,8,11,0.000546,0.001657,0,23290,25,0.00001,18,0.164348,0.187637,30.80862,0.281818,0.000683
211201,211201,,4,18,22,4,18,22,0.000523,0.012635,0,23291,41,0.000011,15,0.204234,0.225585,841.351787,0.179654,0.000909
211202,211202,,35,33,68,35,33,68,0.001029,0.000922,0,23292,4,0.000019,14,0.197989,0.221438,7551.615511,0.303117,0.011397
211203,211203,,2,49,51,2,49,51,0.000229,0.002561,0,23293,10,0.000011,16,0.202943,0.232578,2084.483648,0.233333,0.000458
211204,211204,,2,17,19,2,17,19,0.000229,0.008091,0,23294,10,0.000011,21,0.180771,0.21383,734.407639,0.195906,0.000458
211205,211205,,0,1,1,0,1,1,0,0,0,23295,8,0.00001,15,0.142472,0.152396,0,0,0
211206,211206,,6,24,30,6,24,30,0.000517,0.002689,0,23296,41,0.000012,14,0.209171,0.232972,8427.815177,0.098851,0.001433
211207,211207,,1,26,27,1,26,27,0.000001,0.000159,0,23297,5,0.00001,15,0.182183,0.211731,14.200335,0.149573,0.000219
211208,211208,,1,7,8,1,7,8,0,0.000041,0,23299,23,0.000011,20,0.142635,0.154119,2171.628553,0.214286,0.000219
9512151,9512151,,3,0,3,3,0,3,0.000068,0,0,23298,23,0.000012,0,0,0,0,0.166667,0.000664
211209,211209,,1,23,24,1,23,24,0.000011,0.000155,0,23300,30,0.00001,19,0.186363,0.204269,244.066121,0.264493,0.000219
211210,211210,,1,8,9,1,8,9,0.000026,0.00031,0,23301,25,0.00001,16,0.164331,0.180984,7.707098,0.319444,0.000219
211211,211211,,0,1,1,0,1,1,0,0.000009,0,23302,2,0.00001,7,0.182213,0.206293,0,0,0
211212,211212,,1,31,32,1,31,32,0.00001,0.020882,0,23303,3,0.00001,16,0.205724,0.232328,1305.42873,0.129032,0.000219
211213,211213,,2,22,24,2,22,24,0.000397,0.002122,0,23304,0,0.00001,17,0.16644,0.189549,482.702495,0.213768,0.000452
211214,211214,,0,7,7,0,7,7,0,0.000012,0,23305,15,0.00001,15,0.166982,0.179507,0,0.404762,0
211216,211216,,31,33,64,31,33,64,0.000985,0.003703,0,23306,4,0.000019,15,0.199738,0.225434,29265.466129,0.151538,0.009796
211217,211217,,7,41,48,7,41,48,0.000694,0.003428,0,23307,41,0.000012,17,0.202215,0.224223,3167.166058,0.281915,0.001722
211218,211218,,6,27,33,6,27,33,0.000145,0.000611,0,23308,3,0.000011,13,0.209089,0.232637,3253.930854,0.289773,0.001455
211221,211221,,3,20,23,3,20,23,0.000043,0.002304,0,23309,8,0.000014,17,0.173055,0.193569,2621.045623,0.201581,0.000677
211222,211222,,6,40,46,6,40,46,0.000382,0.009181,0,23310,41,0.000012,12,0.215528,0.244717,15922.664846,0.075845,0.00142
211223,211223,,3,1,4,3,1,4,0,0.000008,0,23311,11,0.000033,16,0.15327,0.166121,32475,0.25,0.000677
211224,211224,,0,11,11,0,11,11,0,0.000007,0,23312,23,0.00001,12,0.187025,0.202969,0,0.227273,0
211225,211225,,1,12,13,1,12,13,0.000143,0.00045,0,23313,30,0.00001,13,0.216852,0.239269,0,0.371795,0.000226
211226,211226,,0,4,4,0,4,4,0,0.000478,0,23314,41,0.00001,19,0.178517,0.198392,0,0.25,0
211227,211227,,0,9,9,0,9,9,0,0.000063,0,23315,4,0.00001,14,0.170086,0.195378,0,0.083333,0
211228,211228,,1,4,5,1,4,5,0.000001,0.000112,0,23316,13,0.000013,18,0.181877,0.200087,1008.011733,0.2,0.000219
211229,211229,,0,11,11,0,11,11,0,0.016308,0,23317,1,0.00001,19,0.176191,0.196879,0,0.409091,0
211230,211230,,0,5,5,0,5,5,0,0.00018,0,23318,0,0.00001,16,0.173929,0.197272,0,0.1,0
211231,211231,,0,3,3,0,3,3,0,0,0,23321,23,0.00001,8,0.181074,0.203894,0,0,0
102204,102204,,1,0,1,1,0,1,0,0,0,23320,23,0.000013,0,0,0,0,0,0.000219
102205,102205,,1,0,1,1,0,1,0,0,0,23319,23,0.000013,0,0,0,0,0,0.000219
211232,211232,,2,43,45,2,43,45,0.000095,0.021035,0,23322,30,0.00001,14,0.207903,0.232889,1522.653178,0.140404,0.000451
211233,211233,,2,10,12,2,10,12,0.000001,0.000065,0,23323,1,0.000012,16,0.164337,0.18447,2134.49036,0.174242,0.000438
211234,211234,,32,36,68,32,36,68,0.000878,0.000991,0,23324,4,0.000018,14,0.198159,0.221743,7204.375594,0.285777,0.010039
211235,211235,,1,7,8,1,7,8,0.000001,0.000074,0,23325,9,0.000011,14,0.140301,0.153756,0.395833,0.196429,0.000219
211236,211236,,15,34,49,15,34,49,0.000559,0.002026,0,23326,4,0.000013,19,0.184876,0.211322,22981.811729,0.12415,0.004342
211237,211237,,0,7,7,0,7,7,0,0.000034,0,23327,8,0.00001,14,0.187891,0.203774,0,0.190476,0
9303008,9303008,,1,0,1,1,0,1,0,0,0,10022,22,0.000021,0,0,0,0,0,0.000258
211238,211238,,8,52,60,8,52,60,0.000377,0.000623,0,23328,3,0.000012,16,0.201614,0.227823,11628.9829,0.175706,0.001838
211239,211239,,0,5,5,0,5,5,0,0,0,23329,23,0.00001,17,0.168696,0.18568,0,0.2,0
211240,211240,,1,13,14,1,13,14,0.000028,0.001228,0,23330,4,0.00001,17,0.172953,0.190132,23.084075,0.324176,0.000219
212125,212125,,0,5,5,0,5,5,0,0.000036,0,23331,4,0.00001,14,0.158848,0.173666,0,0.25,0
211241,211241,,28,21,49,28,21,49,0.000811,0.00184,0,23332,4,0.000017,15,0.188053,0.212206,4025.27079,0.204932,0.008353
211242,211242,,1,8,9,1,8,9,0,0.000009,0,23333,23,0.000013,13,0.160919,0.17352,1808.844742,0.222222,0.000219
211244,211244,,1,8,9,1,8,9,0.00001,0.000008,0,23334,5,0.00001,15,0.13347,0.140704,426.646462,0.208333,0.000226
211245,211245,,26,155,181,26,155,181,0.00089,0.008951,0,23337,4,0.000015,14,0.208571,0.245223,45511.809629,0.08097,0.008046
9810076,9810076,,2,0,2,2,0,2,0.000163,0,0,23336,4,0.00001,0,0,0,0,0.5,0.000768
9904103,9904103,,2,1,3,2,1,3,0.000163,0.000002,0,23335,4,0.00001,3,0.444444,0.5,25.810041,0.166667,0.000768
211259,211259,,17,79,96,17,79,96,0.000539,0.004896,0,23340,4,0.000013,20,0.191603,0.222558,6443.637224,0.160636,0.005066
211249,211249,,29,13,42,29,13,42,0.000852,0.000402,0,23339,4,0.000017,15,0.183115,0.201677,33.257298,0.340883,0.008882
211254,211254,,33,35,68,33,35,68,0.000979,0.002914,0,23338,4,0.000017,14,0.203767,0.231454,29786.429293,0.244293,0.009876
9308039,9308039,,1,4,5,1,4,5,0.000043,0.000085,0,6002,4,0.00001,2,0.7,0.785714,19686.996291,0,0.000325
9310086,9310086,,1,0,1,1,0,1,0.000043,0,0,5999,4,0.00001,0,0,0,0,0,0.000325
9511092,9511092,,1,3,4,1,3,4,0.000043,0.000001,0,5997,23,0.00001,3,0.485714,0.54902,17387.339415,0,0.000325
9707064,9707064,,2,2,4,2,2,4,0.000109,0.000002,0,5988,4,0.00001,19,0.111515,0.123299,345.089026,0.25,0.000544
9711058,9711058,,1,5,6,1,5,6,0.000043,0.00002,0,5986,4,0.00001,5,0.387387,0.467442,45754.719222,0.166667,0.000325
211246,211246,,1,5,6,1,5,6,0.000005,0.000034,0,23341,23,0.00001,15,0.157371,0.169418,86.14606,0.166667,0.000226
211247,211247,,0,3,3,0,3,3,0,0.000167,0,23342,13,0.00001,14,0.184959,0.209064,0,0.5,0
211248,211248,,0,7,7,0,7,7,0,0.000025,0,23343,23,0.00001,13,0.166435,0.183427,0,0.095238,0
211252,211252,,4,31,35,4,31,35,0.000756,0.018799,0,23344,1,0.000011,15,0.210256,0.241258,1509.722062,0.276471,0.000917
211253,211253,,0,8,8,0,8,8,0,0.001412,0,23345,8,0.00001,14,0.182012,0.200664,0,0.375,0
211256,211256,,0,4,4,0,4,4,0,0.000859,0,23346,1,0.00001,15,0.164074,0.178187,0,0.25,0
211257,211257,,6,55,61,6,55,61,0.000537,0.014037,0,23004,41,0.000012,15,0.205396,0.232957,15591.389773,0.084426,0.001515
9405017,9405017,,1,0,1,1,0,1,0.000165,0,0,23000,41,0.00001,0,0,0,0,0,0.000261
211258,211258,,2,44,46,2,44,46,0.000003,0.001921,0,23348,30,0.000011,17,0.207263,0.235038,5247.406028,0.114493,0.000438
9301124,9301124,,2,1,3,2,1,3,0.000023,0,0,23347,30,0.000027,1,1,1,2,0.166667,0.000458
211260,211260,,0,4,4,0,4,4,0,0,0,23349,20,0.00001,3,0.5,0.583333,0,0.166667,0
211261,211261,,27,21,48,27,21,48,0.000673,0.000433,0,23350,4,0.000017,14,0.190443,0.212835,1094.938591,0.328014,0.00794
211262,211262,,0,29,29,0,29,29,0,0.001249,0,23351,5,0.00001,15,0.182683,0.213145,0,0.107143,0
211263,211263,,2,61,63,2,61,63,0.00015,0.002934,0,23352,30,0.00001,16,0.208561,0.240354,2741.572169,0.145161,0.000451
211264,211264,,0,5,5,0,5,5,0,0,0,23353,15,0.00001,16,0.155431,0.164112,0,0.15,0
211265,211265,,0,3,3,0,3,3,0,0.000209,0,23354,25,0.00001,14,0.145479,0.157558,0,0.166667,0
211266,211266,,2,22,24,2,22,24,0.000051,0.000192,0,23355,52,0.000011,13,0.205081,0.230375,3898.888585,0.048913,0.000458
211267,211267,,0,5,5,0,5,5,0,0.000007,0,23356,23,0.00001,14,0.154478,0.16788,0,0.1,0
211268,211268,,1,11,12,1,11,12,0.000021,0.001508,0,23357,25,0.00001,14,0.180879,0.201122,138.514177,0.272727,0.000219
211271,211271,,26,55,81,26,55,81,0.000715,0.00255,0,23358,4,0.000016,14,0.206847,0.23496,13568.458118,0.218827,0.007753
211272,211272,,3,29,32,3,29,32,0.000241,0.003701,0,23359,30,0.000011,13,0.196479,0.220502,2456.397293,0.163306,0.00069
211273,211273,,0,4,4,0,4,4,0,0.000007,0,23363,6,0.00001,19,0.162476,0.183726,0,0.083333,0
9201035,9201035,,3,0,3,3,0,3,0,0,0,23362,6,0.000021,0,0,0,0,0,0.000658
9308109,9308109,,4,0,4,4,0,4,0,0,0,23361,6,0.000028,0,0,0,0,0,0.000877
9911054,9911054,,1,1,2,1,1,2,0,0.000007,0,23360,6,0.000012,19,0.162418,0.183377,0,0.5,0.000219
211274,211274,,16,31,47,16,31,47,0.000415,0.000534,0,23364,4,0.000013,14,0.191127,0.213087,211.751591,0.350139,0.004691
211275,211275,,0,2,2,0,2,2,0,0,39,23367,62,0.00001,1,1,1,0,0,0
201020,201020,,1,0,1,1,0,1,0,0,39,23366,62,0.000014,0,0,0,0,0,0.000219
205120,205120,,1,0,1,1,0,1,0,0,39,23365,62,0.000014,0,0,0,0,0,0.000219
211276,211276,,0,7,7,0,7,7,0,0,0,23368,23,0.00001,16,0.11893,0.132359,0,0.428571,0
211277,211277,,0,17,17,0,17,17,0,0.000012,0,23369,23,0.00001,19,0.151159,0.170641,0,0.169118,0
211278,211278,,0,19,19,0,19,19,0,0.013423,0,23370,1,0.00001,16,0.178537,0.206217,0,0.195906,0
211279,211279,,1,5,6,1,5,6,0.000003,0.000113,0,23371,28,0.00001,13,0.164193,0.176007,2,0.2,0.000219
211280,211280,,0,4,4,0,4,4,0,0.000009,0,23372,23,0.00001,3,0.545455,0.638889,0,0.166667,0
211281,211281,,0,14,14,0,14,14,0,0.000437,0,23373,0,0.00001,16,0.182567,0.206348,0,0.197802,0
211282,211282,,1,22,23,1,22,23,0.000041,0.00344,0,23374,4,0.00001,17,0.156391,0.174828,2848.136105,0.304348,0.000219
211284,211284,,1,5,6,1,5,6,0.000015,0.000282,0,23375,0,0.00001,16,0.169452,0.188812,0.25,0.366667,0.000219
211285,211285,,1,43,44,1,43,44,0.000016,0.010361,0,23376,41,0.00001,14,0.214246,0.239369,1554.330206,0.158562,0.000245
211286,211286,,0,11,11,0,11,11,0,0.000279,0,23377,3,0.00001,16,0.172698,0.189068,0,0.472727,0
211287,211287,,24,40,64,24,40,64,0.000613,0.001435,0,23378,4,0.000015,21,0.194033,0.226992,22039.166815,0.225446,0.006944
211288,211288,,0,33,33,0,33,33,0,0.002465,0,23379,52,0.00001,15,0.191263,0.217657,0,0.164773,0
211289,211289,,15,40,55,15,40,55,0.000482,0.002691,0,23380,41,0.000018,13,0.218716,0.244872,73164.056479,0.126936,0.003493
211290,211290,,4,26,30,4,26,30,0.000167,0.002796,0,23381,13,0.000012,16,0.181295,0.205628,15782.059749,0.1,0.000991
211291,211291,,29,67,96,29,67,96,0.000753,0.00489,0,23382,4,0.000017,14,0.201104,0.230755,15194.071419,0.165789,0.007989
212069,212069,,23,45,68,23,45,68,0.000558,0.002973,0,23384,4,0.000015,21,0.187861,0.215649,1726.955193,0.270413,0.006204
212010,212010,,24,61,85,24,61,85,0.000595,0.004283,0,23383,4,0.000015,20,0.195442,0.225936,6669.125641,0.238375,0.006695
211292,211292,,2,27,29,2,27,29,0.00029,0.019123,0,23385,1,0.00001,18,0.188605,0.217255,430.371178,0.204434,0.000465
212001,212001,,0,1,1,0,1,1,0,0.000099,0,23386,13,0.00001,12,0.171498,0.187343,0,0,0
212002,212002,,6,31,37,6,31,37,0.000508,0.010401,0,23387,13,0.000012,17,0.202453,0.237004,8803.758171,0.102853,0.001407
212003,212003,,0,42,42,0,42,42,0,0.004079,0,23388,0,0.00001,15,0.196683,0.223404,0,0.103368,0
212004,212004,,2,1,3,2,1,3,0,0,0,23389,11,0.000017,17,0.132911,0.14107,0,0.5,0.000445
212006,212006,,0,13,13,0,13,13,0,0.000005,0,23393,9,0.00001,18,0.136905,0.150654,0,0.166667,0
9910112,9910112,,2,16,18,2,16,18,0,0.000019,0,23391,9,0.000011,14,0.163349,0.184479,2302.407807,0.163399,0.000445
9912173,9912173,,1,11,12,1,11,12,0,0.000011,0,23392,9,0.000011,15,0.142101,0.159286,2.095238,0.227273,0.000219
9312042,9312042,,2,8,10,2,8,10,0.000001,0.00002,0,2803,4,0.000013,3,0.705882,0.819444,841.479337,0.155556,0.000545
9808096,9808096,,1,3,4,1,3,4,0,0.000009,0,23390,9,0.00001,14,0.156812,0.170007,0,0.333333,0.000232
212007,212007,,0,13,13,0,13,13,0,0.000002,0,23394,22,0.00001,18,0.134114,0.144246,0,0.403846,0
212008,212008,,11,19,30,11,19,30,0.000274,0.000859,0,23395,0,0.000019,15,0.193237,0.21737,22159.363014,0.077011,0.002522
212009,212009,,3,28,31,3,28,31,0.00005,0.00261,0,23396,2,0.000011,14,0.202615,0.227008,878.018174,0.111828,0.000697
212012,212012,,1,23,24,1,23,24,0.000028,0.000928,0,23397,2,0.00001,15,0.203864,0.226572,1570.23891,0.226449,0.000219
212013,212013,,0,2,2,0,2,2,0,0.000077,0,23398,23,0.00001,16,0.153743,0.166184,0,0,0
212014,212014,,1,16,17,1,16,17,0.000072,0.000815,0,23399,25,0.00001,15,0.199861,0.223234,1652.427392,0.055147,0.000232
212015,212015,,0,12,12,0,12,12,0,0.00152,0,23400,25,0.00001,15,0.179326,0.200751,0,0.121212,0
212016,212016,,1,17,18,1,17,18,0.000008,0.000132,0,23401,9,0.00001,14,0.19525,0.215807,284.471676,0.251634,0.000219
212017,212017,,4,19,23,4,19,23,0.000107,0.001278,0,23402,41,0.000011,15,0.201081,0.221876,4318.364418,0.199605,0.000929
212018,212018,,0,16,16,0,16,16,0,0.001483,0,23404,4,0.00001,16,0.185983,0.207681,0,0.145833,0
9512049,9512049,,1,0,1,1,0,1,0.000017,0,0,23403,4,0.00001,0,0,0,0,0,0.000219
212019,212019,,0,10,10,0,10,10,0,0.000001,0,23406,23,0.00001,14,0.117114,0.131173,0,0.122222,0
9810048,9810048,,1,4,5,1,4,5,0,0,0,23405,23,0.000011,11,0.136042,0.158232,3.666667,0.35,0.000219
212020,212020,,1,32,33,1,32,33,0.000008,0.003553,0,23408,4,0.00001,14,0.172893,0.204841,702.663099,0.182765,0.000344
9909032,9909032,,1,23,24,1,23,24,0.000042,0.003739,0,23407,0,0.00001,13,0.185322,0.216248,2308.836462,0.202899,0.000227
9505015,9505015,,2,0,2,2,0,2,0.000124,0,0,10675,4,0.00001,0,0,0,0,0.5,0.000526
212021,212021,,0,19,19,0,19,19,0,0.003191,0,23409,52,0.00001,14,0.191589,0.217398,0,0.201754,0
212022,212022,,0,2,2,0,2,2,0,0.000002,0,23410,15,0.00001,20,0.153036,0.171079,0,0,0
212023,212023,,2,8,10,2,8,10,0.00008,0.001548,0,23411,25,0.000011,16,0.178609,0.197097,2526.488279,0.255556,0.000488
212024,212024,,4,14,18,4,14,18,0.000006,0.001123,0,23412,13,0.000013,14,0.189095,0.213965,3387.007274,0.140523,0.00089
212025,212025,,22,33,55,22,33,55,0.0005,0.001114,0,23413,4,0.000015,21,0.187447,0.215939,3515.209019,0.326263,0.006161
212026,212026,,1,9,10,1,9,10,0,0.000037,0,23414,23,0.000011,19,0.136936,0.157387,708.5221,0.177778,0.000219
212027,212027,,0,5,5,0,5,5,0,0.000029,0,23415,8,0.00001,20,0.160514,0.174825,0,0.35,0
212028,212028,,0,4,4,0,4,4,0,0,0,23416,22,0.00001,17,0.141119,0.149248,0,0.25,0
212029,212029,,1,19,20,1,19,20,0.000091,0.002046,0,23417,8,0.00001,14,0.206248,0.228975,1936.632137,0.136842,0.000226
212030,212030,,1,9,10,1,9,10,0.000008,0.000008,0,23418,1,0.00001,15,0.162141,0.177134,36.708475,0.166667,0.000219
212031,212031,,2,7,9,2,7,9,0.000021,0.000906,0,23419,30,0.000012,13,0.214498,0.235421,1734.816123,0.208333,0.000438
212032,212032,,14,71,85,14,71,85,0.000349,0.004664,0,23420,4,0.000012,20,0.193493,0.223205,2403.487019,0.196218,0.003705
212033,212033,,0,6,6,0,6,6,0,0.010264,0,23421,0,0.00001,13,0.182112,0.202614,0,0.133333,0
212034,212034,,0,1,1,0,1,1,0,0,0,23422,6,0.00001,5,0.35,0.445238,0,0,0
212035,212035,,0,15,15,0,15,15,0,0.001409,0,23423,30,0.00001,15,0.202016,0.224096,0,0.238095,0
212036,212036,,1,9,10,1,9,10,0.000016,0.000311,0,23424,25,0.000011,17,0.172025,0.193384,1953.282463,0.211111,0.000219
212037,212037,,1,20,21,1,20,21,0.00021,0.002655,0,23425,25,0.00001,16,0.178393,0.201355,1031.730799,0.138095,0.000219
212038,212038,,0,5,5,0,5,5,0,0.001339,0,23426,26,0.00001,7,0.246287,0.287066,0,0.05,0
212039,212039,,1,25,26,1,25,26,0.00002,0.000407,0,23427,2,0.00001,14,0.189925,0.210383,2211.733015,0.18,0.000219
212041,212041,,2,8,10,2,8,10,0.0001,0.008291,0,23428,1,0.000012,14,0.18582,0.2064,540.373087,0.188889,0.000451
212042,212042,,1,8,9,1,8,9,0.000004,0.000073,0,23429,52,0.00001,15,0.196892,0.218844,311.782443,0.25,0.000219
212043,212043,,0,22,22,0,22,22,0,0.000762,0,23431,30,0.00001,15,0.190443,0.21413,0,0.112554,0
206120,206120,,1,0,1,1,0,1,0.000009,0,0,23430,30,0.00001,0,0,0,0,0,0.000219
212044,212044,,1,14,15,1,14,15,0.000023,0.002196,0,23432,30,0.000012,14,0.185387,0.204055,690.117336,0.247619,0.000226
212046,212046,,0,6,6,0,6,6,0,0.000008,0,23433,6,0.00001,17,0.188122,0.205977,0,0.433333,0
212047,212047,,1,43,44,1,43,44,0.000049,0.003342,0,23434,8,0.00001,16,0.197288,0.223765,1699.454719,0.176533,0.000226
212048,212048,,0,10,10,0,10,10,0,0.003547,0,23435,2,0.00001,19,0.165152,0.184081,0,0.366667,0
212049,212049,,0,4,4,0,4,4,0,0.000008,0,23436,8,0.00001,13,0.164796,0.178272,0,0,0
212050,212050,,0,8,8,0,8,8,0,0.000215,0,23437,13,0.00001,14,0.178368,0.195461,0,0.375,0
212051,212051,,1,27,28,1,27,28,0,0.000691,0,23438,17,0.00001,17,0.188856,0.208793,15483.578485,0.146825,0.000219
212052,212052,,3,12,15,3,12,15,0.000175,0.001635,0,23439,41,0.000011,17,0.191761,0.211754,14.316651,0.452381,0.000717
212053,212053,,0,3,3,0,3,3,0,0.000004,0,23440,23,0.00001,19,0.093858,0.103417,0,0.166667,0
212054,212054,,1,21,22,1,21,22,0.000017,0.003913,0,23441,0,0.00001,14,0.193018,0.214691,3142.568708,0.119048,0.000219
212055,212055,,0,57,57,0,57,57,0,0.001473,0,23442,3,0.00001,13,0.204533,0.228732,0,0.259398,0
212056,212056,,0,30,30,0,30,30,0,0.003273,0,23443,41,0.00001,16,0.197657,0.221726,0,0.154023,0
212057,212057,,3,29,32,3,29,32,0.000272,0.019207,0,23444,8,0.000013,15,0.202385,0.226257,27764.918611,0.126008,0.000677
212059,212059,,4,34,38,4,34,38,0.000095,0.002076,0,23445,52,0.000011,17,0.20283,0.231572,9753.325589,0.133713,0.000916
212060,212060,,0,35,35,0,35,35,0,0.011261,0,23446,0,0.00001,17,0.18155,0.212457,0,0.098319,0
212061,212061,,5,40,45,5,40,45,0.000826,0.007119,0,23447,41,0.000011,15,0.201776,0.227955,5187.753412,0.137879,0.001142
212062,212062,,1,6,7,1,6,7,0.000025,0.000031,0,23448,30,0.00001,11,0.162117,0.17532,10.5,0.142857,0.000226
212063,212063,,2,58,60,2,58,60,0.000029,0.004494,0,23450,3,0.00001,15,0.208272,0.236305,1163.133322,0.114407,0.000472
9705100,9705100,,4,6,10,4,6,10,0.000355,0.000489,0,23449,5,0.000012,3,0.537037,0.591954,58.764358,0.111111,0.00089
212064,212064,,3,10,13,3,10,13,0.00001,0.000066,0,23451,23,0.000013,17,0.146418,0.163646,9699.04045,0.102564,0.000665
212065,212065,,8,21,29,8,21,29,0.000235,0.001656,0,23452,4,0.000012,16,0.186334,0.210423,420.071058,0.176108,0.002146
212066,212066,,1,30,31,1,30,31,0.000027,0.000951,0,23453,0,0.00001,14,0.20858,0.237927,519.571279,0.265591,0.000252
212067,212067,,2,23,25,2,23,25,0.000084,0.001059,0,23456,25,0.00001,15,0.192906,0.219224,779.472404,0.196667,0.000445
9907218,9907218,,2,4,6,2,4,6,0.000328,0,0,23455,9,0.00001,13,0.153856,0.173026,572.490225,0.133333,0.000464
9812186,9812186,,1,8,9,1,8,9,0,0.000003,0,23454,9,0.000012,12,0.176807,0.20075,393.789257,0.138889,0.000232
212068,212068,,0,3,3,0,3,3,0,0,0,23457,3,0.00001,3,0.533333,0.645833,0,0,0
212070,212070,,2,24,26,2,24,26,0,0.00004,0,23458,23,0.000013,18,0.146104,0.173775,1965.852339,0.115385,0.000438
212071,212071,,2,11,13,2,11,13,0.000042,0.000854,0,23459,30,0.000011,17,0.18971,0.208059,42.939908,0.365385,0.000445
212072,212072,,7,13,20,7,13,20,0.000954,0.017214,0,23460,1,0.000013,14,0.178126,0.201368,4228.991122,0.252632,0.001593
212073,212073,,0,3,3,0,3,3,0,0.000002,0,23461,5,0.00001,16,0.139507,0.146902,0,0.333333,0
212074,212074,,0,17,17,0,17,17,0,0.002003,0,23462,41,0.00001,14,0.198745,0.219397,0,0.25,0
212075,212075,,0,2,2,0,2,2,0,0.000001,0,23463,23,0.00001,14,0.133591,0.14462,0,0.5,0
212076,212076,,0,2,2,0,2,2,0,0.000001,0,23464,23,0.00001,14,0.133591,0.14462,0,0.5,0
212077,212077,,0,10,10,0,10,10,0,0.000045,0,23465,9,0.00001,14,0.17559,0.194054,0,0.133333,0
212079,212079,,14,49,63,14,49,63,0.000359,0.006751,0,23466,4,0.000012,17,0.202265,0.228866,13937.744254,0.271377,0.00372
212081,212081,,6,44,50,6,44,50,0.000102,0.004283,0,23467,2,0.000013,13,0.211655,0.241961,22649.778081,0.072245,0.001322
212082,212082,,13,35,48,13,35,48,0.000342,0.002696,0,23468,4,0.000013,19,0.196877,0.222769,16355.761646,0.238475,0.003421
212083,212083,,17,35,52,17,35,52,0.000398,0.000666,0,23469,4,0.000013,21,0.187008,0.214912,1458.904609,0.351056,0.004778
212084,212084,,0,12,12,0,12,12,0,0.000002,0,23470,6,0.00001,14,0.162469,0.174249,0,0.090909,0
212085,212085,,1,6,7,1,6,7,0.000007,0.000742,0,23471,0,0.00001,15,0.192946,0.216266,38.697394,0.285714,0.000219
212086,212086,,0,11,11,0,11,11,0,0.000009,0,23472,5,0.00001,15,0.147826,0.157345,0,0.354545,0
212087,212087,,6,26,32,6,26,32,0.000593,0.003021,0,23473,8,0.000012,18,0.192779,0.21994,7109.621071,0.101815,0.001374
212088,212088,,0,36,36,0,36,36,0,0.004835,0,23474,30,0.00001,14,0.195675,0.220716,0,0.161905,0
212089,212089,,4,23,27,4,23,27,0.000668,0.019061,0,23475,1,0.000011,13,0.189052,0.212176,5378.362603,0.198006,0.000883
212090,212090,,0,25,25,0,25,25,0,0.001325,0,23476,30,0.00001,15,0.217357,0.24048,0,0.181667,0
212091,212091,,3,48,51,3,48,51,0.000086,0.002165,0,23477,0,0.000011,14,0.216631,0.248456,28544.846631,0.071765,0.000775
212092,212092,,1,19,20,1,19,20,0.000175,0.007768,0,23478,1,0.00001,15,0.199463,0.22211,538.667373,0.168421,0.000219
212093,212093,,0,6,6,0,6,6,0,0.001442,0,23479,25,0.00001,15,0.182986,0.202483,0,0.366667,0
212094,212094,,1,5,6,1,5,6,0.000011,0.001067,0,23480,30,0.000011,17,0.175197,0.192303,520.392968,0.166667,0.000226
212095,212095,,20,46,66,20,46,66,0.00046,0.000975,0,23481,4,0.000014,18,0.194534,0.220457,6582.928422,0.311422,0.005426
212096,212096,,1,30,31,1,30,31,0.000066,0.01293,0,23482,1,0.00001,13,0.195221,0.217866,342.338754,0.12043,0.000226
212097,212097,,0,8,8,0,8,8,0,0.002656,0,23483,1,0.00001,16,0.189433,0.217472,0,0.107143,0
9411228,9411228,,8,0,8,8,0,8,0.000052,0,0,3977,23,0.000059,0,0,0,0,0.035714,0.001863
212098,212098,,1,19,20,1,19,20,0.000061,0.002106,0,23484,0,0.00001,18,0.164427,0.187826,2738.922781,0.144737,0.000313
212099,212099,,1,16,17,1,16,17,0.000029,0.000551,0,23485,2,0.00001,14,0.191904,0.219223,859.56893,0.080882,0.000219
212100,212100,,1,16,17,1,16,17,0.000016,0.003795,0,23486,0,0.000011,17,0.175749,0.202737,1987.270071,0.125,0.000219
212101,212101,,2,8,10,2,8,10,0.000023,0.000113,0,23487,25,0.000011,16,0.184626,0.205779,199.0504,0.344444,0.000451
212102,212102,,2,14,16,2,14,16,0.000237,0.001508,0,23488,25,0.000011,16,0.180982,0.200758,406.855381,0.2,0.000438
212103,212103,,1,19,20,1,19,20,0.00004,0.004836,0,23489,30,0.00001,15,0.204818,0.235706,651.67541,0.110526,0.000226
212104,212104,,0,2,2,0,2,2,0,0,0,23490,0,0.00001,15,0.131762,0.140749,0,0.5,0
212105,212105,,1,5,6,1,5,6,0,0.000082,0,23491,25,0.000011,15,0.158957,0.170964,52.468403,0.1,0.000219
212106,212106,,0,9,9,0,9,9,0,0.000071,0,23492,23,0.00001,15,0.128185,0.14597,0,0.111111,0
9404042,9404042,,1,4,5,1,4,5,0,0.000004,0,4965,4,0.000021,3,0.6,0.703704,13034.66598,0.05,0.000255
212107,212107,,0,45,45,0,45,45,0,0.004981,0,23493,30,0.00001,15,0.200686,0.23263,0,0.182323,0
212108,212108,,0,12,12,0,12,12,0,0.000774,0,23494,25,0.00001,16,0.182698,0.204982,0,0.083333,0
212109,212109,,1,19,20,1,19,20,0.000027,0.001705,0,23495,0,0.00001,15,0.199411,0.224815,176.610211,0.247368,0.000252
212110,212110,,0,4,4,0,4,4,0,0.000009,0,23496,1,0.00001,13,0.179214,0.193521,0,0.25,0
212111,212111,,2,42,44,2,42,44,0.000156,0.021948,0,23497,41,0.00001,17,0.208636,0.240197,2220.062143,0.144292,0.000445
212112,212112,,8,35,43,8,35,43,0.000177,0.001191,0,20093,0,0.000012,15,0.204471,0.23202,5009.774004,0.233666,0.001941
212113,212113,,0,17,17,0,17,17,0,0.001456,0,23498,0,0.00001,15,0.19098,0.211876,0,0.121324,0
212114,212114,,1,77,78,1,77,78,0.000377,0.028833,0,23499,4,0.00001,11,0.24223,0.277677,1227.172479,0.052781,0.000219
212115,212115,,0,3,3,0,3,3,0,0.000015,0,23500,5,0.00001,16,0.136219,0.149182,0,0.5,0
212116,212116,,3,41,44,3,41,44,0.000544,0.018075,0,23501,1,0.00001,19,0.179988,0.203683,448.12944,0.260571,0.000678
212117,212117,,1,25,26,1,25,26,0.000026,0.002544,0,23502,30,0.00001,15,0.211529,0.240693,4849.897831,0.121538,0.000219
212119,212119,,1,21,22,1,21,22,0.000003,0.000938,0,23503,52,0.00001,15,0.198961,0.222867,1227.671397,0.164502,0.000226
212120,212120,,0,6,6,0,6,6,0,0.000003,0,23507,23,0.00001,5,0.298913,0.387273,0,0.166667,0
9802065,9802065,,2,2,4,2,2,4,0.000001,0.000001,0,23505,23,0.000013,2,0.75,0.833333,6,0.083333,0.000445
9912256,9912256,,1,6,7,1,6,7,0,0.000071,0,23506,23,0.000011,4,0.362416,0.441358,34,0.119048,0.000219
9303083,9303083,,1,0,1,1,0,1,0,0,0,23504,23,0.000016,0,0,0,0,0,0.000232
212121,212121,,14,29,43,14,29,43,0.000317,0.000694,0,23508,4,0.000012,21,0.182991,0.210011,227.538013,0.364895,0.003754
212122,212122,,1,10,11,1,10,11,0.000021,0.000941,0,23509,30,0.00001,18,0.208575,0.232536,62.355934,0.218182,0.000219
212123,212123,,0,17,17,0,17,17,0,0.002792,0,23510,22,0.00001,17,0.21375,0.236227,0,0.125,0
212124,212124,,1,11,12,1,11,12,0.000023,0.001505,0,23511,25,0.00001,16,0.182551,0.203688,307.707115,0.189394,0.000219
212126,212126,,1,54,55,1,54,55,0.000049,0.017317,0,23512,8,0.00001,15,0.210498,0.242154,3584.051701,0.155219,0.000226
212127,212127,,0,1,1,0,1,1,0,0,0,23514,6,0.00001,9,0.186047,0.209583,0,0,0
9707098,9707098,,2,4,6,2,4,6,0,0,0,23513,6,0.00002,8,0.227211,0.271849,190.491667,0.2,0.000438
212128,212128,,1,14,15,1,14,15,0.000056,0.000353,0,23515,4,0.00001,16,0.187865,0.207546,503.505491,0.161905,0.000267
212130,212130,,1,1,2,1,1,2,0.000045,0.000001,0,23516,2,0.00001,17,0.157143,0.170546,0,0.5,0.000226
212131,212131,,0,14,14,0,14,14,0,0.000054,0,23517,23,0.00001,15,0.173684,0.192114,0,0.186813,0
212132,212132,,3,9,12,3,9,12,0.000618,0.003353,0,23518,25,0.00001,16,0.190127,0.222722,238.046013,0.280303,0.000684
212133,212133,,0,20,20,0,20,20,0,0.000119,0,23519,30,0.00001,14,0.188607,0.206904,0,0.186842,0
212134,212134,,0,1,1,0,1,1,0,0,0,23520,5,0.00001,5,0.277778,0.319167,0,0,0
212135,212135,,6,48,54,6,48,54,0.000257,0.003118,0,23521,41,0.000012,14,0.217872,0.24285,10296.03883,0.1471,0.001348
212136,212136,,4,37,41,4,37,41,0.000249,0.00418,0,23522,41,0.000012,13,0.208963,0.236033,17261.020134,0.09939,0.00089
212137,212137,,0,9,9,0,9,9,0,0.000373,0,23523,13,0.00001,16,0.165412,0.188117,0,0.152778,0
212138,212138,,4,22,26,4,22,26,0.000277,0.022048,0,23524,1,0.000011,15,0.20871,0.239329,3500.600598,0.223077,0.000909
212139,212139,,3,17,20,3,17,20,0.000735,0.001712,0,23525,10,0.00001,17,0.186279,0.212183,669.056674,0.218421,0.000671
212140,212140,,1,18,19,1,18,19,0,0.000012,0,23526,23,0.000011,16,0.142246,0.159474,2639.78588,0.163743,0.000219
212141,212141,,2,14,16,2,14,16,0.000032,0.00031,0,23527,0,0.00001,16,0.18333,0.205511,36.092313,0.220833,0.000451
212142,212142,,1,22,23,1,22,23,0.000083,0.006983,0,23528,2,0.00001,17,0.184404,0.210011,0,0.199605,0.000219
212143,212143,,0,7,7,0,7,7,0,0.001079,0,23529,25,0.00001,15,0.166479,0.186751,0,0.357143,0
212144,212144,,0,17,17,0,17,17,0,0.003231,0,23530,0,0.00001,15,0.198548,0.222779,0,0.165441,0
212145,212145,,1,36,37,1,36,37,0.000244,0.002639,0,23531,52,0.00001,13,0.211236,0.238968,576.389498,0.085586,0.000232
212146,212146,,1,7,8,1,7,8,0.000001,0.000823,0,23532,30,0.00001,14,0.190351,0.207268,347.519232,0.125,0.000219
212147,212147,,5,20,25,5,20,25,0.00082,0.002705,0,23533,41,0.000011,15,0.207107,0.234078,3413.838062,0.246667,0.001128
212148,212148,,1,3,4,1,3,4,0,0.000002,0,23534,8,0.000014,15,0.123747,0.132009,5937,0.333333,0.000219
212149,212149,,0,5,5,0,5,5,0,0.000421,0,23535,8,0.00001,13,0.166732,0.181842,0,0.1,0
212150,212150,,3,38,41,3,38,41,0.000117,0.001477,0,23536,3,0.00001,14,0.217,0.244025,1231.117585,0.218293,0.000765
212151,212151,,3,16,19,3,16,19,0.000048,0.001865,0,23537,0,0.000012,15,0.193628,0.215468,9482.659657,0.143275,0.000664
212153,212153,,0,7,7,0,7,7,0,0.000052,0,23538,8,0.00001,15,0.175621,0.19387,0,0.214286,0
212154,212154,,0,1,1,0,1,1,0,0,0,23539,23,0.00001,9,0.179231,0.194344,0,0,0
212155,212155,,0,21,21,0,21,21,0,0.00034,0,23540,25,0.00001,18,0.179622,0.200941,0,0.192857,0
212156,212156,,0,6,6,0,6,6,0,0.000012,0,23541,22,0.00001,16,0.137936,0.145705,0,0.166667,0
212157,212157,,0,3,3,0,3,3,0,0.000025,0,23542,5,0.00001,13,0.135307,0.159483,0,0.333333,0
212159,212159,,5,10,15,5,10,15,0.000312,0.000311,0,23543,2,0.000012,18,0.205351,0.23128,1611.187524,0.195238,0.001155
212160,212160,,0,19,19,0,19,19,0,0.00022,0,23544,28,0.00001,17,0.17216,0.192983,0,0.210526,0
212161,212161,,0,1,1,0,1,1,0,0,0,23545,20,0.00001,1,1,1,0,0,0
212162,212162,,4,19,23,4,19,23,0.000434,0.001227,0,23546,1,0.000012,19,0.19335,0.218746,9945.512726,0.201581,0.00089
212163,212163,,1,7,8,1,7,8,0.000014,0.000268,0,23547,3,0.00001,16,0.187101,0.204395,5.451019,0.285714,0.000226
212164,212164,,0,1,1,0,1,1,0,0,40,23549,63,0.00001,1,1,1,0,0,0
212129,212129,,2,0,2,2,0,2,0,0,40,23548,63,0.000028,0,0,0,0,0,0.000438
212165,212165,,2,27,29,2,27,29,0.000053,0.005069,0,23550,41,0.000011,13,0.210441,0.240939,1052.900656,0.337438,0.000451
212166,212166,,1,18,19,1,18,19,0.000034,0.007735,0,23551,41,0.00001,17,0.197458,0.219156,307.271106,0.22807,0.000232
212167,212167,,1,8,9,1,8,9,0.000007,0.00069,0,23552,2,0.000012,16,0.165153,0.186606,9165.63579,0.152778,0.000219
212168,212168,,1,12,13,1,12,13,0,0.004877,0,23553,1,0.000014,18,0.163446,0.183383,1017.279079,0.115385,0.000252
212169,212169,,0,19,19,0,19,19,0,0.002091,0,23554,4,0.00001,14,0.172043,0.190893,0,0.157895,0
212170,212170,,0,22,22,0,22,22,0,0.000158,0,23555,30,0.00001,16,0.191772,0.211899,0,0.201299,0
212171,212171,,0,4,4,0,4,4,0,0,0,23557,26,0.00001,12,0.183474,0.208461,0,0.5,0
9806212,9806212,,1,15,16,1,15,16,0,0.000001,0,23556,26,0.000012,11,0.2012,0.240375,301.164957,0.15,0.000219
9608176,9608176,,4,11,15,4,11,15,0,0.000016,0,12038,26,0.000013,8,0.230343,0.270003,187.41646,0.190476,0.000916
9712032,9712032,,5,7,12,5,7,12,0,0.000012,0,7942,26,0.000018,10,0.192837,0.222717,1799.932879,0.128788,0.001123
212172,212172,,0,20,20,0,20,20,0,0.017118,0,23558,1,0.00001,13,0.208237,0.231714,0,0.178947,0
212174,212174,,1,18,19,1,18,19,0.000005,0.000495,0,23559,2,0.00001,19,0.192638,0.217007,133.512556,0.166667,0.000219
212175,212175,,2,28,30,2,28,30,0.000059,0.010064,0,23560,25,0.00001,16,0.203664,0.239527,4248.064067,0.154023,0.000445
212176,212176,,0,5,5,0,5,5,0,0.000811,0,23562,30,0.00001,17,0.177642,0.194677,0,0.25,0
209243,209243,,1,0,1,1,0,1,0.00001,0,0,23561,30,0.000012,0,0,0,0,0,0.000219
212178,212178,,0,7,7,0,7,7,0,0.000218,0,23563,6,0.00001,17,0.168157,0.182442,0,0.142857,0
212179,212179,,0,47,47,0,47,47,0,0.017771,0,23564,10,0.00001,16,0.20559,0.236176,0,0.240518,0
212180,212180,,1,5,6,1,5,6,0,0,0,23565,23,0.000011,17,0.168696,0.18568,803.237905,0.133333,0.000219
212181,212181,,4,22,26,4,22,26,0.000472,0.000966,0,23566,1,0.000011,13,0.198366,0.218025,1141.540919,0.183077,0.000896
212182,212182,,3,4,7,3,4,7,0,0.000006,0,23567,23,0.000012,16,0.1347,0.148836,1152.345505,0.142857,0.000684
212183,212183,,0,24,24,0,24,24,0,0.004736,0,23568,2,0.00001,15,0.207258,0.234844,0,0.164855,0
212184,212184,,9,21,30,9,21,30,0.000998,0.002429,0,23569,41,0.000012,16,0.199116,0.220202,4017.171281,0.290805,0.002051
212185,212185,,6,14,20,6,14,20,0.000404,0.000253,0,23570,1,0.000013,13,0.211205,0.234291,29158.880428,0.157895,0.001374
212186,212186,,2,23,25,2,23,25,0.000248,0.017666,0,23571,8,0.00001,14,0.199586,0.224377,2694.121264,0.138333,0.000445
212187,212187,,0,8,8,0,8,8,0,0.000039,0,23572,26,0.00001,12,0.190512,0.206157,0,0.160714,0
212188,212188,,2,56,58,2,56,58,0.000096,0.005816,0,23573,3,0.00001,15,0.201344,0.230389,1366.32383,0.113733,0.000458
212189,212189,,0,6,6,0,6,6,0,0.000016,0,23574,1,0.00001,12,0.189861,0.206449,0,0.2,0
212190,212190,,1,22,23,1,22,23,0.000245,0.005123,0,23575,1,0.00001,16,0.183853,0.209106,1094.234908,0.110672,0.000219
212191,212191,,3,10,13,3,10,13,0.000015,0.000446,0,23576,0,0.000012,14,0.180231,0.199961,1.220428,0.339744,0.00067
212198,212198,,3,14,17,3,14,17,0.000015,0.0005,0,23577,0,0.000012,14,0.18944,0.21448,1.220428,0.294118,0.00067
212219,212219,,2,16,18,2,16,18,0.00001,0.0005,0,23578,0,0.000011,14,0.189463,0.214596,1.220428,0.300654,0.000438
212192,212192,,1,3,4,1,3,4,0,0.000003,0,23579,25,0.000014,14,0.131686,0.146207,1581,0,0.000219
212193,212193,,2,42,44,2,42,44,0.000564,0.024763,0,23580,1,0.00001,12,0.220674,0.253438,1934.782918,0.138478,0.000438
212194,212194,,1,5,6,1,5,6,0.000011,0.000082,0,23581,52,0.00001,15,0.146116,0.155328,0.5,0.233333,0.000219
212195,212195,,0,4,4,0,4,4,0,0.000032,0,23582,52,0.00001,15,0.16587,0.18211,0,0.083333,0
212196,212196,,2,6,8,2,6,8,0,0.000606,0,23583,3,0.000014,18,0.189132,0.207645,30758,0.107143,0.000445
212197,212197,,0,3,3,0,3,3,0,0.000038,0,23584,1,0.00001,13,0.18865,0.205233,0,0.5,0
212199,212199,,1,24,25,1,24,25,0.000003,0.000448,0,23585,52,0.00001,19,0.18847,0.21179,769.119996,0.14,0.000219
212200,212200,,3,21,24,3,21,24,0.000325,0.001791,0,23586,0,0.000011,15,0.198584,0.226186,3613.778568,0.15942,0.000671
212201,212201,,1,12,13,1,12,13,0.000008,0.00091,0,23587,0,0.00001,15,0.171176,0.192618,165.504477,0.102564,0.000219
212202,212202,,0,9,9,0,9,9,0,0.000077,0,23588,26,0.00001,15,0.181598,0.199636,0,0.097222,0
212203,212203,,1,10,11,1,10,11,0.000204,0.00069,0,23589,1,0.00001,16,0.189152,0.211406,15.175485,0.345455,0.000233
212204,212204,,6,15,21,6,15,21,0.000501,0.002177,0,23590,1,0.000013,17,0.199846,0.233962,7625.69335,0.180952,0.001361
212205,212205,,1,6,7,1,6,7,0.000024,0.000509,0,23591,8,0.00001,14,0.167537,0.182975,2.259833,0.333333,0.000219
212206,212206,,1,13,14,1,13,14,0.000002,0.000091,0,23592,0,0.000011,15,0.173603,0.190314,1861.170476,0.203297,0.000219
212207,212207,,0,16,16,0,16,16,0,0.019716,0,23593,1,0.00001,15,0.197492,0.229155,0,0.270833,0
212209,212209,,8,19,27,8,19,27,0.001014,0.012951,0,23594,8,0.000013,16,0.184354,0.207383,14095.707353,0.162393,0.00195
212210,212210,,4,32,36,4,32,36,0.000288,0.004661,0,23595,1,0.000011,15,0.208306,0.239153,6002.508045,0.107937,0.000896
212211,212211,,5,36,41,5,36,41,0.00015,0.004309,0,23596,0,0.000011,15,0.211424,0.240529,6594.363292,0.104268,0.001193
212233,212233,,0,39,39,0,39,39,0,0.003371,0,23597,0,0.00001,16,0.2065,0.236285,0,0.0722,0
212212,212212,,14,38,52,14,38,52,0.000339,0.003213,0,23598,4,0.000012,19,0.191569,0.217808,721.469321,0.323529,0.003709
212213,212213,,0,9,9,0,9,9,0,0.000051,0,23599,23,0.00001,16,0.176512,0.193829,0,0.194444,0
212214,212214,,1,20,21,1,20,21,0.000114,0.003051,0,23600,30,0.00001,19,0.191069,0.215838,168.053919,0.183333,0.000219
212215,212215,,10,46,56,10,46,56,0.000479,0.001645,0,23601,3,0.000013,13,0.219436,0.244941,50597.325128,0.160065,0.002451
212216,212216,,2,8,10,2,8,10,0.000136,0.000471,0,23603,0,0.000011,16,0.181559,0.203112,2165.18432,0.111111,0.000556
9503038,9503038,,1,9,10,1,9,10,0.000006,0.001843,0,23602,13,0.000011,6,0.318182,0.37596,78.012942,0.166667,0.000234
212217,212217,,5,38,43,5,38,43,0.000119,0.002741,0,23604,41,0.000012,14,0.218031,0.244481,9577.89752,0.109635,0.001128
212218,212218,,3,17,20,3,17,20,0.000025,0.00131,0,23605,52,0.000011,17,0.184623,0.208829,9589.761145,0.113158,0.000658
212220,212220,,0,6,6,0,6,6,0,0.000228,0,23606,3,0.00001,19,0.178778,0.198958,0,0.333333,0
212221,212221,,2,8,10,2,8,10,0.000065,0.002053,0,23607,0,0.000011,13,0.176667,0.195695,21.890197,0.422222,0.000445
212222,212222,,5,15,20,5,15,20,0.000015,0.001282,0,23608,25,0.000014,16,0.180509,0.203008,2001.682312,0.215789,0.001128
212223,212223,,4,56,60,4,56,60,0.000166,0.001387,0,23609,3,0.000011,13,0.224105,0.251049,8515.444878,0.122034,0.000903
9404018,9404018,,2,3,5,2,3,5,0.000017,0.000073,0,1082,41,0.000012,2,0.666667,0.75,54.895744,0.25,0.000544
212224,212224,,0,4,4,0,4,4,0,0.000002,0,23610,23,0.00001,12,0.187803,0.203735,0,0.166667,0
212225,212225,,24,30,54,24,30,54,0.000452,0.000927,0,23611,4,0.000016,19,0.184786,0.209767,4997.272076,0.251922,0.006133
212226,212226,,0,9,9,0,9,9,0,0.000001,0,23612,23,0.00001,16,0.122729,0.130004,0,0.361111,0
212227,212227,,6,20,26,6,20,26,0.000091,0.016039,0,23613,25,0.000013,17,0.17555,0.201538,10769.360324,0.163077,0.001354
212228,212228,,1,21,22,1,21,22,0.000205,0.016681,0,23614,41,0.00001,16,0.201207,0.224336,701.993376,0.229437,0.000219
212229,212229,,0,4,4,0,4,4,0,0.000003,0,23615,23,0.00001,18,0.150024,0.162378,0,0.333333,0
212230,212230,,1,3,4,1,3,4,0,0.000004,0,23616,23,0.00001,15,0.16177,0.175543,0,0.5,0.000219
212231,212231,,11,51,62,11,51,62,0.000243,0.000683,0,23617,4,0.000012,14,0.221488,0.246004,33487.321912,0.306716,0.002824
212234,212234,,2,4,6,2,4,6,0,0.000003,0,23618,26,0.000015,16,0.105654,0.115121,27.702785,0.1,0.000445
212235,212235,,3,17,20,3,17,20,0.000166,0.002025,0,23619,1,0.000011,17,0.174052,0.198681,2985.333802,0.136842,0.000684
212236,212236,,2,36,38,2,36,38,0.000044,0.000982,0,23620,0,0.00001,15,0.194618,0.221267,318.208473,0.186344,0.000458
212237,212237,,0,10,10,0,10,10,0,0.000027,0,23621,23,0.00001,17,0.133697,0.148821,0,0.144444,0
212238,212238,,3,15,18,3,15,18,0.000062,0.00096,0,23622,30,0.000011,16,0.199967,0.223559,2590.596143,0.127451,0.000671
212239,212239,,5,11,16,5,11,16,0.000192,0.000137,0,23007,0,0.000012,14,0.18393,0.205363,2532.596096,0.120833,0.001116
212245,212245,,2,52,54,2,52,54,0.000018,0.025008,0,23623,0,0.00001,14,0.216559,0.25456,5752.912255,0.061845,0.000445
212240,212240,,1,18,19,1,18,19,0,0.000016,0,23624,23,0.000011,20,0.155816,0.1755,5327.359948,0.254386,0.000219
212242,212242,,4,29,33,4,29,33,0.000091,0.001586,0,23625,3,0.000011,13,0.211991,0.236681,9965.94551,0.183712,0.000903
212243,212243,,0,5,5,0,5,5,0,0.000049,0,23626,52,0.00001,14,0.18647,0.203606,0,0.15,0
212244,212244,,0,20,20,0,20,20,0,0.000578,0,23627,52,0.00001,15,0.202443,0.226831,0,0.126316,0
212246,212246,,2,38,40,2,38,40,0.000237,0.010487,0,23628,13,0.000011,16,0.187406,0.216636,4604.504342,0.088462,0.000438
9302142,9302142,,1,0,1,1,0,1,0.000004,0,0,995,5,0.000011,0,0,0,0,0,0.000315
212247,212247,,0,2,2,0,2,2,0,0.000007,0,23629,0,0.00001,14,0.17583,0.190908,0,0.5,0
212248,212248,,18,18,36,18,18,36,0.000411,0.000537,0,23630,3,0.000015,14,0.197937,0.2175,18177.635406,0.219048,0.004635
212249,212249,,0,3,3,0,3,3,0,0.000052,0,23631,13,0.00001,18,0.169891,0.184655,0,0.333333,0
212250,212250,,0,26,26,0,26,26,0,0.004121,0,23633,2,0.00001,15,0.211879,0.239914,0,0.130769,0
201083,201083,,1,0,1,1,0,1,0.000048,0,0,23632,2,0.00001,0,0,0,0,0,0.000219
212251,212251,,0,4,4,0,4,4,0,0.000124,0,23634,30,0.00001,13,0.212247,0.232447,0,0.083333,0
212252,212252,,0,33,33,0,33,33,0,0.020865,0,23635,1,0.00001,15,0.206546,0.235214,0,0.141098,0
212253,212253,,7,103,110,7,103,110,0.000204,0.005038,0,23636,4,0.000011,18,0.205713,0.238279,8582.250295,0.135196,0.001809
212254,212254,,1,7,8,1,7,8,0.000022,0.007606,0,23637,41,0.000011,15,0.193817,0.225628,108.003166,0.267857,0.000232
212255,212255,,1,37,38,1,37,38,0.000077,0.002517,0,23638,0,0.00001,13,0.213133,0.242423,5086.982385,0.122333,0.000219
212257,212257,,0,18,18,0,18,18,0,0.002679,0,23639,2,0.00001,15,0.192658,0.219374,0,0.238562,0
212258,212258,,4,28,32,4,28,32,0.000088,0.001578,0,23640,30,0.000011,15,0.196917,0.220047,2251.616374,0.110887,0.000896
212259,212259,,2,9,11,2,9,11,0.000048,0.000895,0,23641,30,0.000011,14,0.187288,0.203651,55.817087,0.318182,0.000445
212260,212260,,0,19,19,0,19,19,0,0.000209,0,23642,4,0.00001,13,0.178466,0.20106,0,0.336257,0
212261,212261,,0,14,14,0,14,14,0,0.00017,0,23643,2,0.00001,17,0.164446,0.182547,0,0.252747,0
212262,212262,,1,12,13,1,12,13,0.000012,0.001235,0,23644,30,0.000011,16,0.208959,0.232655,763.088656,0.237179,0.000219
212263,212263,,0,15,15,0,15,15,0,0.001966,0,23645,0,0.00001,12,0.186426,0.210239,0,0.219048,0
212264,212264,,0,2,2,0,2,2,0,0,0,23646,23,0.00001,19,0.129681,0.13925,0,0.5,0
212265,212265,,0,26,26,0,26,26,0,0.000967,0,23647,41,0.00001,13,0.206687,0.231445,0,0.138462,0
212266,212266,,0,10,10,0,10,10,0,0.002153,0,23648,30,0.00001,17,0.177574,0.196544,0,0.355556,0
212267,212267,,1,18,19,1,18,19,0,0.000104,0,23649,2,0.000011,15,0.183479,0.200889,4511.794942,0.137427,0.000219
212268,212268,,0,1,1,0,1,1,0,0.000005,0,23650,41,0.00001,1,1,1,0,0,0
212270,212270,,1,20,21,1,20,21,0.000038,0.002137,0,23651,30,0.00001,15,0.215978,0.242614,569.849764,0.114286,0.000226
212271,212271,,0,10,10,0,10,10,0,0.000077,0,23652,2,0.00001,16,0.164734,0.182518,0,0.344444,0
212272,212272,,0,13,13,0,13,13,0,0.000562,0,23653,0,0.00001,15,0.188484,0.21075,0,0.294872,0
212274,212274,,11,51,62,11,51,62,0.000239,0.000651,0,23654,4,0.000012,14,0.204609,0.227706,4679.531614,0.323109,0.002833
212275,212275,,0,19,19,0,19,19,0,0.000585,0,23655,52,0.00001,19,0.156319,0.175123,0,0.230994,0
212276,212276,,0,17,17,0,17,17,0,0.000005,0,23656,22,0.00001,15,0.16907,0.183968,0,0.205882,0
9512002,9512002,,4,0,4,4,0,4,0,0,0,5073,22,0.00004,0,0,0,0,0,0.000938
212277,212277,,5,47,52,5,47,52,0.000408,0.021671,0,23657,1,0.000012,14,0.21005,0.236804,22875.702019,0.110483,0.001096
212278,212278,,5,40,45,5,40,45,0.000135,0.001124,0,23658,0,0.000012,15,0.205821,0.236656,3675.743707,0.188384,0.001245
212279,212279,,1,25,26,1,25,26,0.000056,0.002727,0,23659,4,0.00001,15,0.196264,0.221491,884.344735,0.184615,0.000267
212280,212280,,0,1,1,0,1,1,0,0,15,23660,36,0.00001,1,1,1,0,0,0
212281,212281,,3,49,52,3,49,52,0.000062,0.001733,0,23661,0,0.00001,14,0.19985,0.227294,300.20237,0.236425,0.000763
212282,212282,,0,1,1,0,1,1,0,0,41,23663,64,0.00001,1,1,1,0,0,0
9705042,9705042,,1,0,1,1,0,1,0,0,41,23662,64,0.000019,0,0,0,0,0,0.000219
212284,212284,,1,36,37,1,36,37,0.000012,0.00222,0,23664,30,0.00001,16,0.200756,0.225942,1154.706955,0.162162,0.000219
212285,212285,,1,7,8,1,7,8,0,0.000001,0,23665,28,0.000011,2,0.818182,0.888889,5.333333,0.178571,0.000226
212286,212286,,0,4,4,0,4,4,0,0.000006,0,23666,2,0.00001,14,0.154934,0.168023,0,0.166667,0
212287,212287,,0,5,5,0,5,5,0,0.000183,0,23667,1,0.00001,16,0.189533,0.212027,0,0.4,0
212288,212288,,0,5,5,0,5,5,0,0.000944,0,23668,25,0.00001,19,0.172777,0.195142,0,0.2,0
212289,212289,,0,2,2,0,2,2,0,0,0,23670,23,0.00001,3,0.571429,0.708333,0,0,0
201143,201143,,1,0,1,1,0,1,0,0,0,23669,23,0.000014,0,0,0,0,0,0.000219
212290,212290,,4,40,44,4,40,44,0.000089,0.009529,0,23671,3,0.000012,14,0.207976,0.233342,9819.409598,0.132664,0.000896
212291,212291,,3,18,21,3,18,21,0.000063,0.00029,0,23672,13,0.000012,15,0.177215,0.198502,10371.223002,0.116667,0.000677
212292,212292,,3,4,7,3,4,7,0.000254,0.000553,0,23673,8,0.000012,13,0.19125,0.209692,7544.252378,0.142857,0.000658
212293,212293,,2,30,32,2,30,32,0.000059,0.004818,0,23674,25,0.00001,16,0.189721,0.214334,13128.672701,0.134073,0.000451
212294,212294,,4,38,42,4,38,42,0.000321,0.001483,0,23675,0,0.000011,14,0.210202,0.241886,10193.608493,0.122532,0.001014
212295,212295,,0,30,30,0,30,30,0,0.007049,0,23676,2,0.00001,17,0.187274,0.214004,0,0.171264,0
212296,212296,,0,21,21,0,21,21,0,0.004831,0,23677,1,0.00001,17,0.206736,0.235029,0,0.271429,0
212297,212297,,1,24,25,1,24,25,0.000033,0.020791,0,23678,41,0.00001,17,0.205829,0.234335,1506.639601,0.156667,0.000219
212298,212298,,0,23,23,0,23,23,0,0.000119,0,23679,5,0.00001,15,0.183329,0.212883,0,0.15415,0
9503216,9503216,,1,6,7,1,6,7,0.000001,0.000117,0,6253,0,0.000011,4,0.486486,0.606481,409.455539,0.071429,0.000273
212299,212299,,2,12,14,2,12,14,0.000049,0.000344,0,23680,52,0.00001,15,0.183644,0.206404,113.626599,0.28022,0.000445
212300,212300,,0,11,11,0,11,11,0,0.000004,0,23681,6,0.00001,18,0.134879,0.148041,0,0.181818,0
212302,212302,,1,2,3,1,2,3,0,0.000004,0,23682,20,0.000014,13,0.163582,0.175912,2,0.166667,0.000219
212303,212303,,4,27,31,4,27,31,0.000031,0.015551,0,23683,1,0.000013,15,0.194521,0.218535,18577.46204,0.133333,0.00089
212305,212305,,0,6,6,0,6,6,0,0.000006,0,23684,6,0.00001,16,0.128526,0.141438,0,0.066667,0
212306,212306,,0,11,11,0,11,11,0,0.0023,0,23685,25,0.00001,16,0.182292,0.204127,0,0.072727,0
212307,212307,,5,16,21,5,16,21,0.0001,0.00029,0,23686,0,0.000012,15,0.191424,0.21674,2098.008624,0.197619,0.001237
212308,212308,,2,27,29,2,27,29,0.000027,0.018236,0,23687,1,0.000014,16,0.190097,0.222513,24831.623226,0.147783,0.000471
212309,212309,,0,1,1,0,1,1,0,0.00002,0,23688,22,0.00001,2,0.538462,0.571429,0,0,0
212310,212310,,0,15,15,0,15,15,0,0.001951,0,23689,25,0.00001,15,0.187734,0.208649,0,0.109524,0
212311,212311,,0,8,8,0,8,8,0,0.000182,0,23690,2,0.00001,15,0.177198,0.195293,0,0.392857,0
212312,212312,,2,10,12,2,10,12,0.000035,0.001112,0,23691,0,0.00001,17,0.190711,0.219641,1161.893035,0.174242,0.000445
212313,212313,,2,91,93,2,91,93,0.000057,0.006981,0,23692,4,0.000012,15,0.208761,0.243056,17927.367429,0.123305,0.000486
9305039,9305039,,5,1,6,5,1,6,0.000001,0,0,1063,9,0.000018,2,0.666667,0.75,4230.292688,0.066667,0.00116
212314,212314,,1,101,102,1,101,102,0.000067,0.029171,0,23693,1,0.00001,18,0.2238,0.26029,4396.575436,0.088138,0.000226
212315,212315,,0,2,2,0,2,2,0,0,0,23694,2,0.00001,2,0.75,0.833333,0,0,0
212316,212316,,1,28,29,1,28,29,0.00003,0.000275,0,23695,2,0.00001,16,0.177914,0.196315,1838.52975,0.219212,0.000219
212317,212317,,1,27,28,1,27,28,0.000028,0.000331,0,23696,3,0.00001,15,0.193366,0.212659,87.063153,0.324074,0.000219
212318,212318,,0,6,6,0,6,6,0,0.000031,0,23697,52,0.00001,15,0.169126,0.183939,0,0.066667,0
212320,212320,,0,16,16,0,16,16,0,0.001666,0,23698,30,0.00001,18,0.18308,0.202324,0,0.145833,0
212321,212321,,1,4,5,1,4,5,0.000029,0.000017,0,23699,30,0.00001,15,0.163777,0.175174,10.340482,0.25,0.000219
212322,212322,,0,6,6,0,6,6,0,0.001028,0,23700,0,0.00001,13,0.177386,0.192744,0,0.266667,0
212323,212323,,1,21,22,1,21,22,0.000077,0.007715,0,23701,1,0.00001,16,0.191771,0.219179,112.240822,0.17316,0.000219
212324,212324,,1,4,5,1,4,5,0.000212,0.000019,0,23702,26,0.00001,16,0.143535,0.15591,0,0.45,0.000219
212326,212326,,1,10,11,1,10,11,0.000209,0.000723,0,23705,8,0.00001,15,0.194263,0.215699,178.000076,0.172727,0.000219
9501130,9501130,,2,1,3,2,1,3,0.000008,0,0,23704,8,0.00002,1,1,1,3,0,0.000445
9410092,9410092,,1,0,1,1,0,1,0,0,0,23703,8,0.000028,0,0,0,0,0,0.000232
212327,212327,,2,3,5,2,3,5,0.000042,0.000117,0,23706,8,0.000011,17,0.173125,0.18995,1254.171379,0.2,0.000445
212328,212328,,1,14,15,1,14,15,0.000143,0.001161,0,23707,2,0.00001,13,0.195482,0.216432,15.682988,0.147619,0.000226
212329,212329,,0,45,45,0,45,45,0,0.009812,0,23708,30,0.00001,17,0.202548,0.231166,0,0.101515,0
212330,212330,,2,4,6,2,4,6,0,0.000007,0,23709,22,0.000012,17,0.141177,0.149766,330.099793,0.333333,0.000445
212331,212331,,0,32,32,0,32,32,0,0.002215,0,23710,25,0.00001,15,0.192909,0.218911,0,0.158266,0
212332,212332,,1,51,52,1,51,52,0.000037,0.021281,0,23711,1,0.00001,17,0.198168,0.226997,3876.924009,0.151584,0.000226
212333,212333,,1,4,5,1,4,5,0.000234,0.0011,0,23712,25,0.00001,14,0.176014,0.194112,0,0.45,0.000226
212334,212334,,0,9,9,0,9,9,0,0.00001,0,23713,5,0.00001,15,0.165323,0.179258,0,0.138889,0
212335,212335,,0,12,12,0,12,12,0,0.000095,0,23714,3,0.00001,14,0.181955,0.19822,0,0.348485,0
212336,212336,,1,4,5,1,4,5,0.000014,0.000009,0,23715,28,0.00001,13,0.148428,0.176247,9.25,0.2,0.000219
212337,212337,,0,16,16,0,16,16,0,0.018095,0,23716,1,0.00001,17,0.215647,0.249456,0,0.254167,0
212338,212338,,0,9,9,0,9,9,0,0.001356,0,23717,52,0.00001,15,0.172723,0.191316,0,0.138889,0
212339,212339,,0,11,11,0,11,11,0,0.0015,0,23718,13,0.00001,15,0.199997,0.224699,0,0.127273,0
212340,212340,,0,18,18,0,18,18,0,0.000073,0,23719,17,0.00001,15,0.136879,0.153588,0,0.25817,0
212341,212341,,2,8,10,2,8,10,0,0.00014,0,23720,30,0.000012,17,0.173138,0.188188,22032.858647,0.044444,0.000438
212342,212342,,0,16,16,0,16,16,0,0.000009,0,23721,6,0.00001,17,0.138291,0.157852,0,0.170833,0
212343,212343,,3,40,43,3,40,43,0.000169,0.002789,0,23722,41,0.00001,16,0.201413,0.223213,1033.873252,0.211517,0.000658
212344,212344,,1,34,35,1,34,35,0.000056,0.000644,0,23723,0,0.00001,14,0.216539,0.245852,13308.750444,0.088235,0.000267
212345,212345,,1,17,18,1,17,18,0.000228,0.002217,0,23724,41,0.00001,17,0.189934,0.212048,447.75479,0.166667,0.000226
212346,212346,,2,12,14,2,12,14,0.000019,0.000091,0,23725,13,0.000011,17,0.161877,0.184872,3114.670109,0.214286,0.000438
212347,212347,,0,19,19,0,19,19,0,0.000808,0,23726,2,0.00001,15,0.176785,0.199911,0,0.116959,0
212348,212348,,0,13,13,0,13,13,0,0.002043,0,23727,52,0.00001,15,0.170763,0.193695,0,0.282051,0
301001,301001,,0,8,8,0,8,8,0,0.000003,0,23729,9,0.00001,16,0.148424,0.162413,0,0.267857,0
9612100,9612100,,1,0,1,1,0,1,0,0,0,23728,9,0.000011,0,0,0,0,0,0.000219
301002,301002,,1,22,23,1,22,23,0.000009,0.003068,0,23730,25,0.00001,16,0.178948,0.205829,268.009526,0.203557,0.000219
301003,301003,,1,24,25,1,24,25,0.000027,0.002486,0,23731,41,0.00001,14,0.203694,0.22967,50.103897,0.19,0.000219
301004,301004,,0,2,2,0,2,2,0,0,0,23732,22,0.00001,3,0.5,0.633333,0,0.5,0
301005,301005,,1,22,23,1,22,23,0.000012,0.000551,0,23733,13,0.00001,14,0.197704,0.223212,246.4159,0.090909,0.000219
301006,301006,,26,18,44,26,18,44,0.000708,0.002617,0,23734,4,0.000016,15,0.191032,0.214371,4078.960661,0.183404,0.006436
301007,301007,,0,8,8,0,8,8,0,0.000004,0,23735,15,0.00001,15,0.138709,0.145667,0,0.464286,0
301008,301008,,0,11,11,0,11,11,0,0.000006,0,23736,17,0.00001,13,0.147295,0.179151,0,0.281818,0
301009,301009,,2,40,42,2,40,42,0.00011,0.002892,0,23737,41,0.00001,16,0.213754,0.237093,8417.230909,0.200929,0.000445
301010,301010,,2,44,46,2,44,46,0.000137,0.006091,0,23738,8,0.00001,16,0.210686,0.24311,4486.411853,0.136715,0.000451
301011,301011,,9,63,72,9,63,72,0.000214,0.001021,0,23739,4,0.000011,14,0.222971,0.248148,34036.381516,0.252543,0.002279
301012,301012,,1,14,15,1,14,15,0.00004,0.003745,0,23740,2,0.00001,16,0.191322,0.218179,619.003262,0.2,0.000226
301013,301013,,0,18,18,0,18,18,0,0.001879,0,23741,23,0.00001,18,0.141402,0.158666,0,0.254902,0
301014,301014,,0,4,4,0,4,4,0,0.000115,0,23742,25,0.00001,18,0.161637,0.177437,0,0.25,0
301015,301015,,0,12,12,0,12,12,0,0.000033,0,23743,22,0.00001,19,0.149949,0.164243,0,0.280303,0
301016,301016,,1,9,10,1,9,10,0.000182,0.015212,0,23744,1,0.00001,14,0.182384,0.200733,0.090909,0.355556,0.000232
301017,301017,,1,13,14,1,13,14,0,0.000122,0,23745,13,0.000011,16,0.160819,0.18016,197.902534,0.131868,0.000219
301018,301018,,0,16,16,0,16,16,0,0.000407,0,23746,0,0.00001,14,0.189442,0.214537,0,0.283333,0
301019,301019,,0,4,4,0,4,4,0,0,0,23749,21,0.00001,4,0.421053,0.5,0,0.166667,0
9810156,9810156,,2,1,3,2,1,3,0,0,0,23747,21,0.000023,3,0.5,0.555556,12,0.166667,0.000445
9905189,9905189,,1,1,2,1,1,2,0,0,0,23748,21,0.000012,4,0.368421,0.440476,0,0.5,0.000219
301020,301020,,0,21,21,0,21,21,0,0.000756,0,23750,25,0.00001,16,0.178309,0.204028,0,0.22381,0
301021,301021,,0,21,21,0,21,21,0,0.001478,0,23751,2,0.00001,15,0.19742,0.222221,0,0.109524,0
301022,301022,,0,10,10,0,10,10,0,0.00002,0,23752,28,0.00001,15,0.158635,0.172531,0,0.166667,0
301023,301023,,1,4,5,1,4,5,0.000228,0.000456,0,23753,8,0.00001,13,0.183147,0.197188,8.368304,0.25,0.000219
301025,301025,,0,8,8,0,8,8,0,0.012232,0,23754,1,0.00001,18,0.188568,0.227304,0,0.428571,0
301026,301026,,1,4,5,1,4,5,0.000001,0.000021,0,23756,25,0.00001,17,0.170399,0.186702,453.408014,0,0.000219
9809041,9809041,,1,4,5,1,4,5,0,0.000102,0,23755,13,0.000012,11,0.171681,0.201826,80.677374,0.05,0.000226
301027,301027,,0,8,8,0,8,8,0,0.001724,0,23757,2,0.00001,14,0.173116,0.190627,0,0.035714,0
301028,301028,,1,16,17,1,16,17,0.000017,0.001903,0,23758,2,0.00001,18,0.195481,0.216244,62.514896,0.150735,0.000232
301029,301029,,0,12,12,0,12,12,0,0.000827,0,23759,2,0.00001,16,0.195729,0.220028,0,0.19697,0
301030,301030,,1,40,41,1,40,41,0.000004,0.002572,0,23760,30,0.00001,13,0.218858,0.241873,852.546526,0.139634,0.000219
301031,301031,,1,11,12,1,11,12,0.000014,0.000049,0,23761,0,0.00001,16,0.173057,0.191085,0,0.340909,0.000219
301032,301032,,7,32,39,7,32,39,0.000228,0.003576,0,23762,0,0.000011,14,0.203206,0.230247,11200.430815,0.264507,0.00166
301033,301033,,0,6,6,0,6,6,0,0.000184,0,23764,1,0.00001,12,0.180393,0.194958,0,0.166667,0
9312099,9312099,,1,0,1,1,0,1,0.000002,0,0,23763,1,0.000011,0,0,0,0,0,0.000219
301034,301034,,0,5,5,0,5,5,0,0.000075,0,23765,4,0.00001,17,0.151888,0.171312,0,0.45,0
301035,301035,,3,38,41,3,38,41,0.000277,0.003454,0,23766,41,0.000011,15,0.21294,0.236916,4962.099358,0.161585,0.00067
301036,301036,,10,41,51,10,41,51,0.001241,0.01155,0,23767,41,0.000012,17,0.196642,0.220195,3319.498835,0.299216,0.002392
301037,301037,,1,4,5,1,4,5,0.000008,0.000916,0,23768,1,0.00001,17,0.177317,0.194346,2128.774558,0.1,0.000219
301038,301038,,13,22,35,13,22,35,0.000352,0.000304,0,23769,3,0.000013,15,0.189096,0.207673,8708.494571,0.152101,0.003271
301039,301039,,1,7,8,1,7,8,0.000203,0.00002,0,23770,23,0.00001,13,0.16691,0.180423,161.101768,0.232143,0.000219
301040,301040,,0,29,29,0,29,29,0,0.000318,0,23771,52,0.00001,16,0.19215,0.212758,0,0.181034,0
301041,301041,,1,2,3,1,2,3,0,0,0,23772,11,0.000012,17,0.132922,0.14115,0,0.5,0.000219
301042,301042,,1,7,8,1,7,8,0.000067,0.000004,0,23773,6,0.00001,17,0.148074,0.16357,228.432822,0.125,0.000219
301043,301043,,1,11,12,1,11,12,0,0.000007,0,23774,23,0.000011,17,0.152055,0.163517,2616.125562,0.174242,0.000219
301044,301044,,0,5,5,0,5,5,0,0.001584,0,23775,25,0.00001,17,0.174108,0.195793,0,0.15,0
301045,301045,,1,3,4,1,3,4,0,0,0,23776,26,0.000011,16,0.105629,0.114512,8.036118,0.25,0.000219
301046,301046,,0,7,7,0,7,7,0,0.000181,0,23777,25,0.00001,18,0.183132,0.204188,0,0.047619,0
301047,301047,,2,12,14,2,12,14,0.000199,0.00135,0,23778,30,0.00001,14,0.214821,0.237486,365.132302,0.351648,0.000445
301048,301048,,0,13,13,0,13,13,0,0.001201,0,23779,0,0.00001,14,0.186128,0.208288,0,0.121795,0
301049,301049,,10,58,68,10,58,68,0.000172,0.001498,0,23780,3,0.000012,15,0.208562,0.234835,7468.086726,0.186787,0.002498
301050,301050,,0,6,6,0,6,6,0,0.000029,0,23781,1,0.00001,16,0.176881,0.193473,0,0.133333,0
301051,301051,,0,7,7,0,7,7,0,0.002962,0,23782,2,0.00001,16,0.180985,0.202024,0,0.142857,0
9404164,9404164,,1,0,1,1,0,1,0,0,0,18641,28,0.000024,0,0,0,0,0,0.000239
301054,301054,,1,8,9,1,8,9,0.000005,0.000178,0,23783,1,0.00001,18,0.190082,0.209475,18.405125,0.277778,0.000219
301055,301055,,0,40,40,0,40,40,0,0.009676,0,23784,30,0.00001,14,0.20659,0.234025,0,0.157692,0
301056,301056,,0,4,4,0,4,4,0,0.000005,0,23785,15,0.00001,4,0.526316,0.658333,0,0.166667,0
301057,301057,,0,5,5,0,5,5,0,0,0,23786,6,0.00001,15,0.118751,0.138918,0,0.25,0
301058,301058,,1,36,37,1,36,37,0.000075,0.003177,0,23787,1,0.00001,18,0.182376,0.205255,292.756644,0.220721,0.000245
301059,301059,,0,28,28,0,28,28,0,0.002049,0,23788,1,0.00001,15,0.19129,0.214881,0,0.140212,0
301060,301060,,0,6,6,0,6,6,0,0.000007,0,23791,23,0.00001,11,0.216123,0.27163,0,0.233333,0
9503197,9503197,,1,0,1,1,0,1,0,0,0,23790,23,0.000011,0,0,0,0,0,0.000219
9601013,9601013,,1,37,38,1,37,38,0,0.002043,0,23789,23,0.000011,10,0.251205,0.345387,364.452381,0.043385,0.000219
9303020,9303020,,2,1,3,2,1,3,0.000024,0,0,2176,23,0.000023,1,1,1,14199,0.166667,0.000655
9305098,9305098,,3,11,14,3,11,14,0.000024,0.000001,0,458,9,0.000014,2,0.866667,0.923077,3343.756605,0.142857,0.000722
9505174,9505174,,3,4,7,3,4,7,0.000067,0.000004,0,2186,0,0.000013,4,0.411215,0.462121,23155.440939,0.119048,0.000792
301061,301061,,1,22,23,1,22,23,0,0.000074,0,23792,15,0.000011,15,0.191696,0.213264,6504.338433,0.098814,0.000226
301062,301062,,2,20,22,2,20,22,0.000026,0.000028,0,23794,22,0.000011,13,0.180613,0.19626,10896.725662,0.142857,0.000438
9606028,9606028,,3,1,4,3,1,4,0,0,0,23793,22,0.000031,1,1,1,5.333333,0.083333,0.00069
301063,301063,,2,7,9,2,7,9,0.000019,0.000028,0,23795,0,0.000011,16,0.181045,0.200821,21.231185,0.319444,0.000458
301064,301064,,0,1,1,0,1,1,0,0,42,23797,65,0.00001,1,1,1,0,0,0
210015,210015,,1,0,1,1,0,1,0,0,42,23796,65,0.000019,0,0,0,0,0,0.000219
301065,301065,,0,14,14,0,14,14,0,0.002374,0,23798,2,0.00001,16,0.206249,0.233953,0,0.263736,0
301066,301066,,1,35,36,1,35,36,0.000019,0.001737,0,23801,30,0.00001,13,0.21017,0.233078,1133.084149,0.114286,0.000226
210260,210260,,1,0,1,1,0,1,0.00002,0,0,23800,30,0.00001,0,0,0,0,0,0.000226
9309160,9309160,,3,1,4,3,1,4,0.00002,0.000004,0,23799,30,0.000017,1,1,1,3.583333,0,0.000664
301067,301067,,0,33,33,0,33,33,0,0.000389,0,23802,1,0.00001,15,0.196258,0.220605,0,0.110795,0
301068,301068,,1,11,12,1,11,12,0.000006,0.000394,0,23803,1,0.00001,18,0.176235,0.197639,167.61538,0.143939,0.000226
301069,301069,,0,5,5,0,5,5,0,0.000474,0,23804,2,0.00001,12,0.200381,0.220117,0,0.25,0
301070,301070,,0,21,21,0,21,21,0,0.004691,0,23805,52,0.00001,15,0.183797,0.210208,0,0.188095,0
301071,301071,,7,73,80,7,73,80,0.000202,0.002235,0,23806,4,0.000011,17,0.201604,0.229005,4585.389533,0.175633,0.001758
9202017,9202017,,1,0,1,1,0,1,0.000034,0,0,10913,4,0.00001,0,0,0,0,0,0.000241
301072,301072,,2,24,26,2,24,26,0.000117,0.000552,0,23807,8,0.00001,16,0.195263,0.217733,6123.274977,0.2,0.000451
301073,301073,,0,20,20,0,20,20,0,0.002078,0,23808,8,0.00001,18,0.176278,0.200257,0,0.273684,0
301074,301074,,0,12,12,0,12,12,0,0.000937,0,23809,0,0.00001,18,0.161015,0.184552,0,0.295455,0
301075,301075,,0,12,12,0,12,12,0,0.000056,0,23810,6,0.00001,18,0.150583,0.167645,0,0.143939,0
301076,301076,,6,57,63,6,57,63,0.000096,0.002479,0,23811,3,0.000011,15,0.203614,0.228994,1858.895027,0.232719,0.001436
301077,301077,,0,1,1,0,1,1,0,0,0,23812,20,0.00001,1,1,1,0,0,0
301078,301078,,0,5,5,0,5,5,0,0.000019,0,23813,9,0.00001,14,0.15721,0.182359,0,0.1,0
301079,301079,,2,12,14,2,12,14,0.000012,0.000896,0,23814,3,0.00001,15,0.181557,0.200006,392.573351,0.28022,0.000458
301080,301080,,2,65,67,2,65,67,0.000238,0.017225,0,23815,41,0.00001,14,0.22478,0.25277,4213.162728,0.090909,0.000451
301081,301081,,2,9,11,2,9,11,0.000027,0.000157,0,23816,1,0.000014,16,0.164362,0.185564,393.146288,0.318182,0.000471
301082,301082,,0,3,3,0,3,3,0,0,0,23817,6,0.00001,17,0.157384,0.168692,0,0,0
9511022,9511022,,2,1,3,2,1,3,0,0,0,10179,6,0.000034,1,1,1,0,0.5,0.000484
301083,301083,,1,23,24,1,23,24,0.000017,0.002015,0,23818,41,0.00001,17,0.197574,0.223545,1025.535275,0.108696,0.000219
301084,301084,,0,20,20,0,20,20,0,0.001625,0,23819,30,0.00001,15,0.204403,0.226157,0,0.260526,0
301085,301085,,0,7,7,0,7,7,0,0.000002,0,23820,23,0.00001,18,0.156161,0.170959,0,0.119048,0
301086,301086,,0,6,6,0,6,6,0,0.001938,0,23821,4,0.00001,13,0.158601,0.179779,0,0.433333,0
301088,301088,,1,11,12,1,11,12,0.000001,0.000006,0,23822,6,0.00001,15,0.14338,0.159996,89.903184,0.212121,0.000219
301089,301089,,5,18,23,5,18,23,0.000557,0.000736,0,23823,41,0.000011,16,0.203806,0.224192,6375.575058,0.15415,0.001129
301090,301090,,1,48,49,1,48,49,0.000023,0.007804,0,23824,41,0.00001,15,0.216906,0.243331,1279.943154,0.139031,0.000219
301091,301091,,3,80,83,3,80,83,0.000068,0.006397,0,23825,30,0.000011,13,0.219608,0.249314,2210.306456,0.113576,0.000677
303037,303037,,2,3,5,2,3,5,0.000054,0.000007,0,23826,15,0.000011,4,0.311927,0.377451,19.636738,0.15,0.000438
301092,301092,,0,13,13,0,13,13,0,0.001302,0,23827,2,0.00001,15,0.199405,0.224772,0,0.102564,0
301093,301093,,0,8,8,0,8,8,0,0.000013,0,23828,22,0.00001,14,0.157969,0.167999,0,0.232143,0
301094,301094,,6,90,96,6,90,96,0.000209,0.013712,0,23829,3,0.000011,15,0.226272,0.265003,20040.13107,0.100329,0.001355
301095,301095,,12,20,32,12,20,32,0.000206,0.001662,0,23830,3,0.000022,15,0.201901,0.226231,12059.913715,0.170363,0.002992
301096,301096,,0,41,41,0,41,41,0,0.000713,0,23832,23,0.00001,14,0.185304,0.207287,0,0.07439,0
9803181,9803181,,1,6,7,1,6,7,0.000008,0.000001,0,23831,23,0.00001,10,0.170301,0.209761,1,0.333333,0.000219
301097,301097,,1,8,9,1,8,9,0,0.000001,0,23833,23,0.000011,12,0.140917,0.153962,35.679403,0.222222,0.000219
301098,301098,,0,30,30,0,30,30,0,0.001074,0,23834,10,0.00001,14,0.202481,0.230977,0,0.15977,0
301099,301099,,1,33,34,1,33,34,0.00002,0.00289,0,23835,30,0.00001,14,0.217365,0.245759,2880.437986,0.136364,0.000226
301100,301100,,1,5,6,1,5,6,0.000012,0.000959,0,23836,30,0.000011,18,0.164538,0.179834,796.636946,0.133333,0.000219
301101,301101,,8,35,43,8,35,43,0.000226,0.001499,0,23837,3,0.000012,15,0.199621,0.224758,3355.294243,0.170543,0.001956
301102,301102,,0,16,16,0,16,16,0,0.000013,0,23838,6,0.00001,16,0.154849,0.169208,0,0.145833,0
301103,301103,,0,9,9,0,9,9,0,0.015308,0,23839,1,0.00001,13,0.193295,0.21139,0,0.208333,0
301104,301104,,1,55,56,1,55,56,0.000075,0.021833,0,23840,1,0.00001,18,0.206818,0.240719,812.834644,0.207792,0.000245
301105,301105,,0,41,41,0,41,41,0,0.005108,0,23841,4,0.00001,16,0.191983,0.220225,0,0.228049,0
301106,301106,,1,25,26,1,25,26,0.000029,0.002779,0,23842,30,0.00001,16,0.210973,0.236076,477.482811,0.181538,0.000219
301107,301107,,0,5,5,0,5,5,0,0.000807,0,23843,6,0.00001,17,0.157441,0.168935,0,0.05,0
301108,301108,,0,10,10,0,10,10,0,0.000036,0,23844,22,0.00001,16,0.136884,0.157323,0,0.277778,0
301109,301109,,0,6,6,0,6,6,0,0.000195,0,23845,13,0.00001,14,0.167769,0.182047,0,0.2,0
301110,301110,,5,13,18,5,13,18,0.000169,0.000904,0,23846,1,0.000012,14,0.189329,0.211518,1662.912596,0.169935,0.001109
301111,301111,,0,1,1,0,1,1,0,0,0,23847,23,0.00001,7,0.24,0.321032,0,0,0
301112,301112,,1,9,10,1,9,10,0.000004,0.001554,0,23848,30,0.00001,16,0.178035,0.194552,52.234862,0.188889,0.000219
301113,301113,,1,5,6,1,5,6,0,0.000017,0,23849,22,0.000013,14,0.18082,0.193388,10877.155258,0.033333,0.000219
301114,301114,,0,10,10,0,10,10,0,0.000029,0,23851,25,0.00001,13,0.181205,0.196591,0,0.1,0
9905158,9905158,,1,0,1,1,0,1,0,0,0,23850,25,0.000011,0,0,0,0,0,0.000219
301115,301115,,0,1,1,0,1,1,0,0,0,23852,6,0.00001,2,0.6,0.666667,0,0,0
301116,301116,,2,19,21,2,19,21,0.000019,0.000245,0,23853,25,0.000011,14,0.198727,0.218622,12100.473325,0.157143,0.000438
301118,301118,,2,46,48,2,46,48,0.000663,0.005709,0,23854,1,0.00001,13,0.214114,0.240767,2412.242102,0.131649,0.000452
301119,301119,,0,30,30,0,30,30,0,0.004546,0,23855,3,0.00001,15,0.207346,0.234371,0,0.14023,0
301120,301120,,1,27,28,1,27,28,0.000021,0.002612,0,23856,41,0.00001,16,0.201912,0.227595,265.085198,0.138889,0.000219
301121,301121,,0,10,10,0,10,10,0,0.000036,0,23857,4,0.00001,14,0.153892,0.166163,0,0.122222,0
301122,301122,,6,21,27,6,21,27,0.000178,0.000582,0,23858,3,0.000011,14,0.207029,0.231039,2928.243796,0.19943,0.001518
301123,301123,,1,22,23,1,22,23,0.000169,0.017008,0,23859,1,0.000011,13,0.203905,0.233337,4751.256743,0.164032,0.000219
301124,301124,,0,20,20,0,20,20,0,0.000324,0,23860,30,0.00001,15,0.215003,0.236958,0,0.15,0
301125,301125,,1,36,37,1,36,37,0.000233,0.004866,0,23861,0,0.00001,15,0.191991,0.220373,385.640483,0.156907,0.000226
301126,301126,,0,18,18,0,18,18,0,0.003043,0,23862,0,0.00001,15,0.189226,0.210445,0,0.202614,0
301127,301127,,0,4,4,0,4,4,0,0.000153,0,23863,30,0.00001,13,0.213064,0.233481,0,0.166667,0
301128,301128,,1,1,2,1,1,2,0,0.000021,0,23864,13,0.000019,14,0.151033,0.163841,5938,0,0.000219
301129,301129,,0,9,9,0,9,9,0,0.000068,0,23865,0,0.00001,17,0.17306,0.189297,0,0.097222,0
301130,301130,,0,11,11,0,11,11,0,0.002279,0,23866,8,0.00001,14,0.182932,0.202262,0,0.409091,0
301131,301131,,0,9,9,0,9,9,0,0.00007,0,23867,8,0.00001,16,0.176222,0.194893,0,0.166667,0
301132,301132,,0,4,4,0,4,4,0,0.000002,0,23868,28,0.00001,16,0.131215,0.150198,0,0.25,0
301133,301133,,0,28,28,0,28,28,0,0.001637,0,23869,30,0.00001,18,0.193647,0.218522,0,0.164021,0
301134,301134,,0,3,3,0,3,3,0,0,0,23870,23,0.00001,1,1,1,0,0.333333,0
301135,301135,,5,64,69,5,64,69,0.000154,0.00295,0,23872,4,0.000011,14,0.203842,0.229065,781.889778,0.257459,0.001227
301136,301136,,7,89,96,7,89,96,0.000249,0.004798,0,23871,4,0.000011,14,0.215325,0.242345,21081.29237,0.19682,0.001705
301137,301137,,4,23,27,4,23,27,0.00004,0.000887,0,23873,3,0.000011,14,0.213486,0.23821,6132.171597,0.196581,0.000982
301138,301138,,2,12,14,2,12,14,0.000041,0.00147,0,23874,0,0.000011,14,0.202269,0.226783,645.765713,0.148352,0.000458
301139,301139,,9,38,47,9,38,47,0.000376,0.002017,0,23875,0,0.000013,15,0.195886,0.226611,11196.849401,0.166975,0.002171
301140,301140,,5,61,66,5,61,66,0.000136,0.000825,0,23876,3,0.000011,13,0.217719,0.246272,9968.574879,0.21655,0.00119
301142,301142,,6,48,54,6,48,54,0.000137,0.000911,0,23877,3,0.000011,16,0.202275,0.227821,1847.885813,0.276031,0.001429
301179,301179,,5,23,28,5,23,28,0.000155,0.000639,0,23878,3,0.000011,14,0.197076,0.216369,3438.049281,0.269841,0.001303
301141,301141,,0,1,1,0,1,1,0,0,43,23880,66,0.00001,1,1,1,0,0,0
9706016,9706016,,1,0,1,1,0,1,0,0,43,23879,66,0.000019,0,0,0,0,0,0.000219
301143,301143,,0,13,13,0,13,13,0,0.000008,0,23882,5,0.00001,16,0.166689,0.181522,0,0.070513,0
9208033,9208033,,1,1,2,1,1,2,0,0,0,23881,6,0.000011,1,1,1,1,0,0.000219
301144,301144,,2,32,34,2,32,34,0.000066,0.01025,0,23883,8,0.00001,17,0.198228,0.224277,1785.082594,0.185383,0.000445
301146,301146,,2,7,9,2,7,9,0,0.000016,0,23884,5,0.000017,14,0.154591,0.166374,12381.333333,0.125,0.000445
301147,301147,,1,24,25,1,24,25,0.000032,0.002866,0,23885,0,0.00001,16,0.183174,0.211797,199.71513,0.18,0.000219
301148,301148,,0,4,4,0,4,4,0,0,0,23886,1,0.00001,5,0.292453,0.376344,0,0.083333,0
301149,301149,,0,19,19,0,19,19,0,0.001503,0,23887,25,0.00001,16,0.178515,0.198638,0,0.073099,0
301150,301150,,7,37,44,7,37,44,0.000937,0.004347,0,23888,41,0.000011,17,0.200585,0.231998,2480.016866,0.34408,0.001687
301151,301151,,0,13,13,0,13,13,0,0.019015,0,23889,25,0.00001,13,0.211815,0.241538,0,0.352564,0
301152,301152,,0,4,4,0,4,4,0,0,0,23893,9,0.00001,19,0.1203,0.127984,0,0.083333,0
208189,208189,,1,0,1,1,0,1,0,0,0,23892,9,0.000012,0,0,0,0,0,0.000219
9501095,9501095,,2,1,3,2,1,3,0,0,0,23891,9,0.000016,4,0.395349,0.441176,34,0,0.000438
9410165,9410165,,1,8,9,1,8,9,0,0,0,23890,9,0.000025,3,0.615385,0.729167,48,0.138889,0.000232
301153,301153,,1,8,9,1,8,9,0,0.000013,0,23894,15,0.000011,22,0.170675,0.189281,7679.424819,0.222222,0.000226
301154,301154,,0,9,9,0,9,9,0,0.000058,0,23895,26,0.00001,17,0.173572,0.192322,0,0.180556,0
301155,301155,,1,15,16,1,15,16,0.000022,0.000423,0,23896,4,0.00001,16,0.182101,0.204278,878.432503,0.095833,0.000266
301157,301157,,7,18,25,7,18,25,0.000173,0.000612,0,23897,4,0.000011,15,0.192167,0.215323,1063.436378,0.241667,0.001772
301160,301160,,0,1,1,0,1,1,0,0.000013,0,23898,52,0.00001,12,0.187423,0.203113,0,0,0
301161,301161,,6,41,47,6,41,47,0.000117,0.003453,0,23899,0,0.000012,15,0.198532,0.228276,6119.807999,0.118871,0.001459
301162,301162,,1,34,35,1,34,35,0.00001,0.001689,0,23900,52,0.00001,14,0.215164,0.241462,2851.77789,0.131092,0.000219
301163,301163,,0,11,11,0,11,11,0,0.000644,0,23901,13,0.00001,14,0.187167,0.207802,0,0.090909,0
301164,301164,,0,67,67,0,67,67,0,0.021464,0,23902,10,0.00001,16,0.210959,0.246151,0,0.087969,0
301165,301165,,3,25,28,3,25,28,0.000134,0.003402,0,23903,25,0.000011,17,0.17651,0.199814,3057.79932,0.247354,0.000684
301166,301166,,0,5,5,0,5,5,0,0.000038,0,23905,5,0.00001,16,0.155273,0.174239,0,0.2,0
9911167,9911167,,1,6,7,1,6,7,0,0.000186,0,23904,5,0.000012,19,0.12936,0.150396,254.27276,0.142857,0.000219
301167,301167,,1,5,6,1,5,6,0,0.000034,0,23906,20,0.000011,16,0.134444,0.142551,0,0.366667,0.000219
301168,301168,,1,10,11,1,10,11,0.000021,0.001203,0,23907,25,0.00001,18,0.181943,0.204769,93.385472,0.309091,0.000226
301169,301169,,0,3,3,0,3,3,0,0.000011,0,23908,28,0.00001,16,0.165561,0.178715,0,0,0
301170,301170,,0,2,2,0,2,2,0,0,0,23910,6,0.00001,1,1,1,0,0,0
9408117,9408117,,1,0,1,1,0,1,0,0,0,23909,6,0.000014,0,0,0,0,0,0.000219
301171,301171,,2,38,40,2,38,40,0.000481,0.017355,0,23911,1,0.00001,14,0.21672,0.244952,9140.127496,0.141667,0.000486
301172,301172,,0,35,35,0,35,35,0,0.002469,0,23912,25,0.00001,15,0.197378,0.219766,0,0.123529,0
301173,301173,,5,4,9,5,4,9,0.000427,0.000008,0,23913,1,0.000018,17,0.167653,0.185674,35587.833313,0.041667,0.001102
301174,301174,,0,26,26,0,26,26,0,0.001024,0,23914,30,0.00001,17,0.193667,0.217301,0,0.210769,0
301175,301175,,0,3,3,0,3,3,0,0,0,23915,5,0.00001,14,0.151313,0.160129,0,0,0
301176,301176,,1,37,38,1,37,38,0.000143,0.002211,0,23916,30,0.00001,14,0.204177,0.230706,100.698302,0.1899,0.000226
301177,301177,,2,7,9,2,7,9,0,0.000128,0,23918,0,0.000014,16,0.178326,0.198296,21315.044085,0.069444,0.000438
206099,206099,,1,0,1,1,0,1,0.000002,0,0,23917,0,0.000012,0,0,0,0,0,0.000232
301178,301178,,3,35,38,3,35,38,0.000353,0.018537,0,23919,41,0.000011,16,0.206186,0.231316,2599.062471,0.175676,0.000664
301180,301180,,2,29,31,2,29,31,0.000052,0.00037,0,23920,0,0.000011,15,0.207491,0.232328,8141.374422,0.093548,0.000445
9305138,9305138,,2,3,5,2,3,5,0.000005,0.00007,0,2884,0,0.000013,4,0.319672,0.384615,52.367201,0.1,0.000458
301181,301181,,0,6,6,0,6,6,0,0.000022,0,23921,52,0.00001,16,0.167725,0.183582,0,0.1,0
301182,301182,,1,24,25,1,24,25,0.000019,0.001506,0,23922,8,0.00001,17,0.177561,0.197677,2893.18133,0.103333,0.000219
301183,301183,,0,4,4,0,4,4,0,0,0,23924,20,0.00001,16,0.140001,0.149726,0,0.083333,0
209151,209151,,1,0,1,1,0,1,0,0,0,23923,20,0.000012,0,0,0,0,0,0.000219
301184,301184,,0,26,26,0,26,26,0,0.001451,0,23925,3,0.00001,14,0.197643,0.222324,0,0.158462,0
301185,301185,,0,4,4,0,4,4,0,0.000004,0,23926,23,0.00001,19,0.122484,0.132871,0,0.416667,0
301186,301186,,1,50,51,1,50,51,0.000018,0.020037,0,23927,41,0.00001,15,0.212111,0.237091,1125.666565,0.135686,0.000219
301187,301187,,1,41,42,1,41,42,0.000019,0.01941,0,23928,41,0.00001,14,0.21342,0.238792,1992.002309,0.130662,0.000226
301189,301189,,1,27,28,1,27,28,0.00004,0.003362,0,23929,25,0.00001,13,0.226892,0.255592,3133.646678,0.101852,0.000226
301190,301190,,0,19,19,0,19,19,0,0.017246,0,23930,1,0.00001,16,0.188902,0.213121,0,0.143275,0
301191,301191,,0,2,2,0,2,2,0,0,0,23933,2,0.00001,17,0.164657,0.178956,0,0,0
9701116,9701116,,1,5,6,1,5,6,0,0.001535,0,23932,2,0.000014,12,0.189308,0.215192,476.636563,0.233333,0.000219
9612249,9612249,,1,15,16,1,15,16,0.000018,0.00649,0,23931,13,0.000012,12,0.208048,0.245024,558.584323,0.175,0.000226
301192,301192,,0,10,10,0,10,10,0,0.000002,0,23934,5,0.00001,15,0.15148,0.16222,0,0.166667,0
301193,301193,,0,16,16,0,16,16,0,0.001863,0,23935,52,0.00001,12,0.22656,0.256245,0,0.166667,0
301195,301195,,0,7,7,0,7,7,0,0.000381,0,23936,52,0.00001,17,0.198159,0.218819,0,0.119048,0
301196,301196,,2,65,67,2,65,67,0.000016,0.003007,0,23937,4,0.00001,14,0.210415,0.23542,2973.5006,0.252827,0.000519
301197,301197,,0,1,1,0,1,1,0,0,0,23938,26,0.00001,1,1,1,0,0,0
301198,301198,,2,13,15,2,13,15,0.000087,0.000155,0,23939,0,0.00001,16,0.177697,0.20086,102.886489,0.27619,0.000451
301199,301199,,0,1,1,0,1,1,0,0,0,23940,22,0.00001,1,1,1,0,0,0
301200,301200,,0,10,10,0,10,10,0,0.000734,0,23941,22,0.00001,14,0.153254,0.172503,0,0.1,0
301202,301202,,0,6,6,0,6,6,0,0.000003,0,23942,5,0.00001,16,0.161942,0.175247,0,0.233333,0
301203,301203,,5,55,60,5,55,60,0.000069,0.001028,0,23943,4,0.000011,14,0.200946,0.2232,287.571264,0.239548,0.00125
301204,301204,,0,1,1,0,1,1,0,0,0,23945,23,0.00001,1,1,1,0,0,0
9906003,9906003,,2,0,2,2,0,2,0,0,0,23944,23,0.000023,0,0,0,0,0,0.000438
301206,301206,,5,37,42,5,37,42,0.000144,0.011864,0,23946,41,0.000014,13,0.216024,0.24581,27145.792095,0.162021,0.001115
301207,301207,,0,8,8,0,8,8,0,0.000003,0,23947,23,0.00001,18,0.148563,0.158812,0,0.142857,0
301209,301209,,0,9,9,0,9,9,0,0.00002,0,23951,9,0.00001,15,0.166222,0.186669,0,0.013889,0
203214,203214,,1,0,1,1,0,1,0,0,0,23950,9,0.000011,0,0,0,0,0,0.000219
9607222,9607222,,1,1,2,1,1,2,0,0,0,23949,9,0.000011,1,1,1,1,0,0.000219
9306149,9306149,,1,0,1,1,0,1,0,0,0,23948,9,0.00002,0,0,0,0,0,0.000226
301210,301210,,0,3,3,0,3,3,0,0.000001,0,23952,23,0.00001,15,0.157847,0.168937,0,0,0
301211,301211,,0,10,10,0,10,10,0,0.00002,0,23953,23,0.00001,18,0.14155,0.165623,0,0.144444,0
301212,301212,,0,11,11,0,11,11,0,0.000669,0,23956,13,0.00001,14,0.193347,0.21836,0,0.118182,0
9610176,9610176,,1,10,11,1,10,11,0.000008,0.003195,0,23955,0,0.000011,10,0.214347,0.248328,80.175492,0.263636,0.000219
9606058,9606058,,1,7,8,1,7,8,0.000038,0.00309,0,23954,0,0.000011,10,0.2,0.232235,0,0.410714,0.000226
301213,301213,,1,33,34,1,33,34,0.000143,0.000623,0,23957,30,0.00001,17,0.197406,0.228055,0,0.190731,0.000226
301214,301214,,0,7,7,0,7,7,0,0.000019,0,23958,28,0.00001,14,0.145269,0.162202,0,0.309524,0
301215,301215,,0,14,14,0,14,14,0,0.000054,0,23959,52,0.00001,15,0.178318,0.196073,0,0.159341,0
301216,301216,,0,2,2,0,2,2,0,0.000071,0,23960,25,0.00001,13,0.144361,0.158421,0,0.5,0
301217,301217,,8,79,87,8,79,87,0.000128,0.003524,0,23961,4,0.000012,13,0.21607,0.244902,17312.882306,0.195135,0.002035
301218,301218,,3,7,10,3,7,10,0.000044,0.000076,0,23962,0,0.000013,15,0.158362,0.171333,1958.427385,0.166667,0.000658
301219,301219,,0,1,1,0,1,1,0,0,44,23964,67,0.00001,1,1,1,0,0,0
301194,301194,,1,0,1,1,0,1,0,0,44,23963,67,0.000019,0,0,0,0,0,0.000219
301220,301220,,0,5,5,0,5,5,0,0.000563,0,23965,4,0.00001,17,0.143951,0.160336,0,0.05,0
301221,301221,,0,20,20,0,20,20,0,0.001926,0,23966,41,0.00001,16,0.198126,0.218685,0,0.339474,0
301222,301222,,0,4,4,0,4,4,0,0.000001,0,23967,23,0.00001,19,0.158533,0.168637,0,0.5,0
301223,301223,,0,21,21,0,21,21,0,0.006788,0,23968,30,0.00001,14,0.206988,0.229723,0,0.228571,0
301224,301224,,1,7,8,1,7,8,0,0.000007,0,23969,22,0.000011,17,0.139818,0.148201,11,0.196429,0.000219
301225,301225,,0,2,2,0,2,2,0,0.00001,0,23971,28,0.00001,1,1,1,0,0,0
108086,108086,,1,0,1,1,0,1,0,0,0,23970,28,0.000014,0,0,0,0,0,0.000219
301226,301226,,6,67,73,6,67,73,0.000068,0.00178,0,23972,4,0.000012,14,0.209002,0.234945,5717.177213,0.236111,0.001463
301227,301227,,1,27,28,1,27,28,0.000001,0.001651,0,23973,30,0.000011,13,0.203811,0.225547,1815.251998,0.181217,0.000219
301228,301228,,0,2,2,0,2,2,0,0.000332,0,23974,25,0.00001,12,0.176701,0.19091,0,0.5,0
301229,301229,,1,30,31,1,30,31,0.00005,0.000216,0,23975,52,0.00001,15,0.191091,0.21413,239.034036,0.152688,0.000232
301230,301230,,0,19,19,0,19,19,0,0.002502,0,23976,2,0.00001,16,0.194684,0.221108,0,0.108187,0
301231,301231,,2,14,16,2,14,16,0.000052,0.001587,0,23977,52,0.00001,17,0.191915,0.216757,750.144313,0.195833,0.000458
301232,301232,,0,7,7,0,7,7,0,0.000012,0,23978,0,0.00001,17,0.156468,0.171711,0,0.119048,0
301233,301233,,0,10,10,0,10,10,0,0.000225,0,23979,2,0.00001,14,0.188113,0.209911,0,0.077778,0
9712091,9712091,,1,41,42,1,41,42,0.000008,0.003621,0,8722,0,0.00001,11,0.228094,0.268462,13619.867342,0.105691,0.000253
301235,301235,,2,25,27,2,25,27,0.000187,0.015492,0,23980,1,0.000011,13,0.207575,0.229567,2753.919825,0.172365,0.000445
301236,301236,,0,10,10,0,10,10,0,0.000218,0,23981,13,0.00001,14,0.178617,0.195221,0,0.188889,0
301237,301237,,0,42,42,0,42,42,0,0.002672,0,23982,30,0.00001,13,0.214462,0.239579,0,0.143438,0
301238,301238,,0,4,4,0,4,4,0,0,0,23983,5,0.00001,14,0.173088,0.183815,0,0.5,0
301239,301239,,0,9,9,0,9,9,0,0.000736,0,23984,13,0.00001,13,0.171465,0.190744,0,0.180556,0
301240,301240,,17,52,69,17,52,69,0.001235,0.003529,0,23985,0,0.000016,15,0.211763,0.242171,60387.658187,0.080776,0.003837
301241,301241,,0,1,1,0,1,1,0,0.000003,0,23986,28,0.00001,12,0.15257,0.166069,0,0,0
301242,301242,,0,18,18,0,18,18,0,0.000938,0,23987,30,0.00001,17,0.182736,0.203526,0,0.248366,0
301243,301243,,3,9,12,3,9,12,0.000005,0.000095,0,23988,1,0.000012,14,0.186587,0.203636,9063.08262,0.143939,0.000671
301244,301244,,1,16,17,1,16,17,0.000026,0.016944,0,23989,1,0.00001,17,0.197537,0.231345,4.840762,0.165441,0.000219
301246,301246,,0,31,31,0,31,31,0,0.005085,0,23990,2,0.00001,17,0.19067,0.216915,0,0.231183,0
301247,301247,,0,14,14,0,14,14,0,0.008255,0,23991,1,0.00001,15,0.188433,0.216336,0,0.225275,0
301248,301248,,1,12,13,1,12,13,0,0.000788,0,23992,30,0.000011,14,0.200543,0.220662,2401.895532,0.166667,0.000219
301249,301249,,0,37,37,0,37,37,0,0.002842,0,23993,2,0.00001,17,0.202492,0.229279,0,0.13964,0
301250,301250,,7,43,50,7,43,50,0.000919,0.003126,0,23994,41,0.000011,17,0.194652,0.217575,1465.359934,0.357959,0.001653
301251,301251,,1,6,7,1,6,7,0.000002,0.000132,0,23995,1,0.000011,16,0.164175,0.17803,0,0.333333,0.000219
301252,301252,,0,7,7,0,7,7,0,0,0,23996,23,0.00001,16,0.142464,0.153205,0,0.095238,0
301253,301253,,4,24,28,4,24,28,0.000418,0.018881,0,23997,41,0.000011,16,0.210458,0.240163,2701.383903,0.231481,0.000909
301255,301255,,1,8,9,1,8,9,0.000049,0.002734,0,23998,2,0.00001,17,0.190685,0.223213,4379.461349,0.111111,0.000226
302001,302001,,0,7,7,0,7,7,0,0.000397,0,23999,0,0.00001,18,0.156007,0.17548,0,0.357143,0
302002,302002,,0,3,3,0,3,3,0,0,0,24000,23,0.00001,2,0.8,0.875,0,0,0
302003,302003,,0,8,8,0,8,8,0,0.000002,0,24001,22,0.00001,14,0.158258,0.16996,0,0.303571,0
302004,302004,,0,1,1,0,1,1,0,0.000001,0,24002,22,0.00001,15,0.156924,0.1667,0,0,0
302005,302005,,1,49,50,1,49,50,0.000205,0.009426,0,24003,41,0.00001,15,0.215322,0.241233,2550.507622,0.15551,0.000219
302006,302006,,0,42,42,0,42,42,0,0.002692,0,24004,0,0.00001,15,0.207141,0.238449,0,0.103949,0
302007,302007,,1,2,3,1,2,3,0,0.000008,0,24006,8,0.000014,20,0.153553,0.166118,698.434451,0,0.000219
9911102,9911102,,1,0,1,1,0,1,0,0,0,24005,8,0.000016,0,0,0,0,0,0.000226
302008,302008,,0,52,52,0,52,52,0,0.01776,0,24007,8,0.00001,15,0.209516,0.235672,0,0.169683,0
9605004,9605004,,2,0,2,2,0,2,0.000209,0,0,7573,26,0.000013,0,0,0,0,0,0.000458
302009,302009,,2,4,6,2,4,6,0,0.000001,0,24008,23,0.000014,14,0.161894,0.172344,4314,0.4,0.000438
302010,302010,,0,18,18,0,18,18,0,0.005751,0,24009,3,0.00001,17,0.199225,0.233751,0,0.071895,0
302011,302011,,14,49,63,14,49,63,0.000338,0.005227,0,24010,4,0.000015,20,0.190439,0.222766,33190.775627,0.078085,0.003274
302012,302012,,0,11,11,0,11,11,0,0.017866,0,24011,1,0.00001,15,0.180781,0.206191,0,0.3,0
302013,302013,,1,4,5,1,4,5,0,0,0,24012,23,0.000013,14,0.133835,0.145592,2774,0.2,0.000219
302014,302014,,0,7,7,0,7,7,0,0.000008,0,24014,22,0.00001,14,0.129688,0.139489,0,0.071429,0
9503100,9503100,,1,1,2,1,1,2,0,0,0,24013,23,0.000011,1,1,1,1,0,0.000219
9802159,9802159,,2,2,4,2,2,4,0,0.000002,0,9647,22,0.000012,2,0.666667,0.75,16.654948,0.166667,0.000453
9505115,9505115,,3,3,6,3,3,6,0,0,0,7245,22,0.000016,5,0.387755,0.484211,2497.884677,0.1,0.000726
9702029,9702029,,4,1,5,4,1,5,0,0,0,9649,22,0.000015,2,0.6,0.666667,3.5,0.2,0.000905
9703184,9703184,,3,1,4,3,1,4,0,0,0,9648,22,0.000015,2,0.6,0.666667,0.5,0.333333,0.000686
9802062,9802062,,2,5,7,2,5,7,0,0,0,9651,22,0.000012,6,0.342857,0.474306,7,0.190476,0.000453
302015,302015,,2,12,14,2,12,14,0,0.000012,0,24015,23,0.000011,15,0.156436,0.170397,2158.948104,0.335165,0.000458
302017,302017,,3,28,31,3,28,31,0.000069,0.002091,0,24016,25,0.000011,17,0.173217,0.197696,1530.773946,0.136559,0.000684
302018,302018,,0,5,5,0,5,5,0,0.000006,0,24017,22,0.00001,9,0.163062,0.201667,0,0.1,0
9609049,9609049,,1,7,8,1,7,8,0,0.000002,0,12615,22,0.000014,4,0.511111,0.612319,103.675753,0.339286,0.000239
302019,302019,,0,37,37,0,37,37,0,0.021867,0,24018,1,0.00001,13,0.2141,0.244977,0,0.254505,0
302020,302020,,1,16,17,1,16,17,0.000032,0.001955,0,24019,41,0.00001,15,0.19754,0.21746,976.181596,0.220588,0.000219
302021,302021,,3,5,8,3,5,8,0.000011,0.000114,0,24020,10,0.000012,15,0.182057,0.199745,2508.864636,0.178571,0.000664
302022,302022,,0,6,6,0,6,6,0,0.000042,0,24021,25,0.00001,18,0.165697,0.178593,0,0,0
302023,302023,,0,14,14,0,14,14,0,0.001528,0,24022,0,0.00001,15,0.181346,0.200475,0,0.087912,0
302024,302024,,0,12,12,0,12,12,0,0.000105,0,24023,0,0.00001,13,0.172947,0.189308,0,0.174242,0
302026,302026,,0,25,25,0,25,25,0,0.002285,0,24024,1,0.00001,15,0.187418,0.208941,0,0.148333,0
302027,302027,,0,56,56,0,56,56,0,0.021191,0,24025,41,0.00001,16,0.206693,0.232608,0,0.139935,0
302028,302028,,1,44,45,1,44,45,0.000018,0.00345,0,24026,25,0.00001,17,0.182639,0.209263,1021.246796,0.166162,0.000226
302029,302029,,0,2,2,0,2,2,0,0.000946,0,24027,0,0.00001,16,0.155989,0.17823,0,0.5,0
302030,302030,,2,93,95,2,93,95,0.000075,0.026866,0,24028,25,0.000011,16,0.201619,0.242366,5836.793269,0.099552,0.000445
302031,302031,,0,3,3,0,3,3,0,0,0,24029,23,0.00001,15,0.118085,0.126024,0,0.5,0
302032,302032,,0,3,3,0,3,3,0,0,0,24030,23,0.00001,20,0.126305,0.142983,0,0.5,0
302033,302033,,0,8,8,0,8,8,0,0.000068,0,24032,2,0.00001,13,0.168884,0.184397,0,0.125,0
301256,301256,,1,0,1,1,0,1,0.000001,0,0,24031,2,0.000011,0,0,0,0,0,0.000219
9309048,9309048,,1,3,4,1,3,4,0,0.000011,0,14487,9,0.000014,1,1,1,39.347045,0,0.000233
302034,302034,,0,8,8,0,8,8,0,0.000076,0,24033,0,0.00001,15,0.158373,0.171402,0,0.232143,0
302035,302035,,0,6,6,0,6,6,0,0.000618,0,24034,13,0.00001,12,0.190933,0.210303,0,0.3,0
302036,302036,,1,7,8,1,7,8,0,0.00001,0,24035,15,0.00001,23,0.153333,0.16677,1955.778779,0.142857,0.000226
302037,302037,,0,22,22,0,22,22,0,0.000066,0,24036,23,0.00001,15,0.18231,0.206746,0,0.121212,0
302038,302038,,0,9,9,0,9,9,0,0.000442,0,24037,30,0.00001,13,0.187694,0.202613,0,0.222222,0
302039,302039,,0,4,4,0,4,4,0,0.000015,0,24038,5,0.00001,16,0.135977,0.148544,0,0.333333,0
302040,302040,,0,1,1,0,1,1,0,0.000003,0,24039,4,0.00001,14,0.154717,0.169167,0,0,0
302041,302041,,0,9,9,0,9,9,0,0.001387,0,24040,25,0.00001,18,0.167707,0.193091,0,0.236111,0
302043,302043,,0,7,7,0,7,7,0,0.000046,0,24041,2,0.00001,18,0.181126,0.199688,0,0.214286,0
302044,302044,,0,2,2,0,2,2,0,0.000004,0,24042,20,0.00001,13,0.163592,0.17593,0,0.5,0
302045,302045,,1,7,8,1,7,8,0.000017,0.000003,0,24043,23,0.00001,20,0.128957,0.144952,169.437513,0.178571,0.000232
302046,302046,,0,3,3,0,3,3,0,0.000001,0,24046,22,0.00001,2,0.8,0.875,0,0,0
9208073,9208073,,1,1,2,1,1,2,0,0,0,24045,22,0.000013,1,1,1,1,0,0.000219
9304107,9304107,,3,0,3,3,0,3,0,0,0,24044,22,0.000024,0,0,0,0,0,0.000658
302047,302047,,2,25,27,2,25,27,0.000019,0.000812,0,24047,0,0.000011,15,0.195165,0.222347,1832.681281,0.109687,0.000458
302049,302049,,1,30,31,1,30,31,0.00003,0.00342,0,24048,30,0.00001,14,0.21448,0.241802,1876.4053,0.073118,0.000219
302050,302050,,2,10,12,2,10,12,0.000231,0.00047,0,24049,8,0.000011,16,0.181473,0.198094,79.548777,0.371212,0.000438
302052,302052,,1,26,27,1,26,27,0.000008,0.010239,0,24050,13,0.00001,19,0.196444,0.229575,640.384698,0.11396,0.000219
302053,302053,,0,22,22,0,22,22,0,0.000037,0,24052,5,0.00001,17,0.158868,0.175599,0,0.142857,0
109221,109221,,2,0,2,2,0,2,0,0,0,24051,5,0.000011,0,0,0,0,0,0.000438
302054,302054,,1,28,29,1,28,29,0.000049,0.005677,0,24053,1,0.00001,16,0.210136,0.24247,2027.256443,0.100985,0.000226
302055,302055,,0,7,7,0,7,7,0,0.000817,0,24054,30,0.00001,15,0.183381,0.200585,0,0.166667,0
302056,302056,,0,18,18,0,18,18,0,0.000002,0,24055,6,0.00001,15,0.150989,0.163748,0,0.169935,0
302057,302057,,0,13,13,0,13,13,0,0.016334,0,24056,1,0.00001,13,0.180722,0.203988,0,0.224359,0
302058,302058,,0,24,24,0,24,24,0,0.001639,0,24057,8,0.00001,18,0.189142,0.218812,0,0.097826,0
302059,302059,,0,32,32,0,32,32,0,0.004875,0,24058,10,0.00001,15,0.186816,0.213463,0,0.081653,0
302060,302060,,4,35,39,4,35,39,0.000641,0.003031,0,24059,41,0.000011,16,0.205754,0.22714,4817.79739,0.266532,0.000922
302062,302062,,1,1,2,1,1,2,0,0,0,24060,8,0.000019,1,1,1,1,0,0.000219
302063,302063,,3,29,32,3,29,32,0.000278,0.016496,0,24061,1,0.000011,13,0.204255,0.226191,2935.832701,0.152218,0.000658
302064,302064,,4,35,39,4,35,39,0.000536,0.011144,0,24062,41,0.000011,17,0.191511,0.214787,226.373957,0.359649,0.000949
302065,302065,,1,7,8,1,7,8,0,0.000014,0,24063,15,0.00001,22,0.163376,0.179401,52.982882,0.392857,0.000226
302066,302066,,0,7,7,0,7,7,0,0.000546,0,24064,0,0.00001,17,0.186189,0.20731,0,0.238095,0
302067,302067,,5,11,16,5,11,16,0.000097,0.002864,0,24065,25,0.000012,14,0.184241,0.206363,559.265238,0.145833,0.001129
302069,302069,,2,13,15,2,13,15,0.000259,0.001514,0,24066,25,0.00001,18,0.17303,0.195284,2354.742923,0.185714,0.000445
302070,302070,,0,18,18,0,18,18,0,0.001343,0,24067,30,0.00001,16,0.207142,0.229225,0,0.147059,0
302071,302071,,1,32,33,1,32,33,0.00006,0.002243,0,24068,13,0.00001,16,0.197364,0.228696,120.801784,0.177083,0.000219
302072,302072,,0,5,5,0,5,5,0,0.000191,0,24069,25,0.00001,16,0.172924,0.190848,0,0.4,0
302073,302073,,0,16,16,0,16,16,0,0.001582,0,24070,41,0.00001,15,0.198805,0.220247,0,0.179167,0
302074,302074,,0,8,8,0,8,8,0,0.000843,0,24071,30,0.00001,16,0.185611,0.205723,0,0.142857,0
302075,302075,,0,68,68,0,68,68,0,0.000643,0,24072,9,0.00001,20,0.18012,0.212448,0,0.200176,0
302077,302077,,2,11,13,2,11,13,0.000059,0.000526,0,24073,4,0.00001,16,0.188111,0.210694,62.2816,0.307692,0.000465
302078,302078,,3,18,21,3,18,21,0.000057,0.00229,0,24077,30,0.000012,16,0.190382,0.214046,7859.655528,0.083333,0.000684
9611067,9611067,,1,2,3,1,2,3,0.000027,0,0,24076,15,0.00001,3,0.555556,0.666667,31.066667,0,0.000239
9212093,9212093,,1,1,2,1,1,2,0,0.000005,0,24075,15,0.000015,1,1,1,4.033333,0,0.000226
9401141,9401141,,1,2,3,1,2,3,0,0.000005,0,24074,15,0.000015,2,0.75,0.833333,14.033333,0.166667,0.000226
302081,302081,,2,17,19,2,17,19,0.000096,0.002883,0,24078,3,0.00001,14,0.197707,0.221824,1202.165189,0.119883,0.000458
302083,302083,,3,11,14,3,11,14,0.000026,0.000241,0,24079,4,0.000011,15,0.185825,0.205754,30.108709,0.373626,0.000724
302084,302084,,0,8,8,0,8,8,0,0.000008,0,24081,41,0.00001,17,0.142744,0.153732,0,0.107143,0
204135,204135,,1,0,1,1,0,1,0,0,0,24080,41,0.000011,0,0,0,0,0,0.000219
302085,302085,,1,10,11,1,10,11,0.00001,0.000455,0,24082,25,0.00001,16,0.170699,0.191422,33.317036,0.281818,0.000219
302086,302086,,0,14,14,0,14,14,0,0.016453,0,24083,1,0.00001,13,0.179373,0.200443,0,0.302198,0
302087,302087,,0,42,42,0,42,42,0,0.019425,0,24084,8,0.00001,14,0.220609,0.24988,0,0.112079,0
302089,302089,,0,2,2,0,2,2,0,0.00002,0,24085,22,0.00001,15,0.116547,0.127182,0,0,0
302090,302090,,2,6,8,2,6,8,0,0.000003,0,24086,10,0.000013,16,0.16717,0.181566,6265.968653,0.214286,0.000438
302091,302091,,0,10,10,0,10,10,0,0.000025,0,24087,13,0.00001,17,0.15889,0.176355,0,0.177778,0
302092,302092,,1,3,4,1,3,4,0,0,0,24088,26,0.000013,10,0.184654,0.204403,1.5,0.333333,0.000219
302093,302093,,1,12,13,1,12,13,0,0.000004,0,24089,6,0.00001,20,0.147397,0.161075,10537.993794,0.147436,0.000219
302094,302094,,0,1,1,0,1,1,0,0,0,24090,6,0.00001,7,0.234375,0.262275,0,0,0
302095,302095,,0,1,1,0,1,1,0,0,0,24091,8,0.00001,2,0.666667,0.75,0,0,0
302096,302096,,0,13,13,0,13,13,0,0.001715,0,24092,3,0.00001,16,0.168318,0.19137,0,0.192308,0
302097,302097,,0,19,19,0,19,19,0,0.000078,0,24093,6,0.00001,16,0.179651,0.200218,0,0.119883,0
302098,302098,,0,16,16,0,16,16,0,0.017444,0,24094,1,0.00001,15,0.189923,0.216585,0,0.4,0
302099,302099,,0,18,18,0,18,18,0,0.000557,0,24095,52,0.00001,17,0.172534,0.196044,0,0.094771,0
302100,302100,,0,5,5,0,5,5,0,0,0,24096,23,0.00001,18,0.14989,0.163027,0,0.25,0
302101,302101,,1,1,2,1,1,2,0,0,45,24098,68,0.000019,1,1,1,1,0,0.000219
9706064,9706064,,1,0,1,1,0,1,0,0,45,24097,68,0.000027,0,0,0,0,0,0.000226
302102,302102,,0,1,1,0,1,1,0,0,45,24099,68,0.00001,2,0.666667,0.75,0,0,0
302103,302103,,0,1,1,0,1,1,0,0,0,24100,23,0.00001,1,1,1,0,0,0
302104,302104,,1,18,19,1,18,19,0.000377,0.013947,0,24101,41,0.00001,18,0.199343,0.228334,587.258141,0.178363,0.000219
302105,302105,,9,60,69,9,60,69,0.000154,0.00226,0,24102,0,0.000013,15,0.205951,0.235933,32232.666669,0.171142,0.002071
302106,302106,,2,24,26,2,24,26,0.000236,0.000349,0,24103,4,0.000011,20,0.182391,0.206986,5713.122864,0.123077,0.000445
302107,302107,,0,16,16,0,16,16,0,0.009174,0,24104,1,0.00001,14,0.205729,0.23532,0,0.270833,0
302108,302108,,0,26,26,0,26,26,0,0.002429,0,24105,2,0.00001,14,0.185216,0.209722,0,0.183077,0
302109,302109,,4,25,29,4,25,29,0.000066,0.002926,0,24106,4,0.000012,21,0.186016,0.214575,11734.285437,0.133005,0.000896
302110,302110,,3,7,10,3,7,10,0.000243,0.000088,0,24107,0,0.000013,16,0.175678,0.191108,12924.44744,0.255556,0.000664
302111,302111,,1,2,3,1,2,3,0.000377,0.00009,0,24108,41,0.00001,14,0.166092,0.178747,0,0.5,0.000219
302112,302112,,0,4,4,0,4,4,0,0,0,24109,23,0.00001,15,0.147018,0.156382,0,0.166667,0
302113,302113,,0,16,16,0,16,16,0,0.000647,0,24110,1,0.00001,18,0.185015,0.206823,0,0.0875,0
302115,302115,,0,3,3,0,3,3,0,0.000006,0,24111,0,0.00001,14,0.15097,0.161286,0,0.333333,0
302116,302116,,2,5,7,2,5,7,0,0.000006,0,24112,20,0.000013,15,0.140546,0.147137,0,0.380952,0.000438
302117,302117,,0,9,9,0,9,9,0,0.000042,0,24113,4,0.00001,12,0.181935,0.201078,0,0.194444,0
302118,302118,,0,21,21,0,21,21,0,0.001231,0,24114,0,0.00001,15,0.200039,0.224308,0,0.15,0
302119,302119,,0,6,6,0,6,6,0,0.000367,0,24115,23,0.00001,18,0.152251,0.1758,0,0.133333,0
302120,302120,,0,8,8,0,8,8,0,0.000796,0,24116,30,0.00001,14,0.176987,0.193248,0,0.071429,0
302121,302121,,0,10,10,0,10,10,0,0.00006,0,24118,26,0.00001,13,0.170733,0.186884,0,0.044444,0
9911036,9911036,,2,7,9,2,7,9,0.000002,0.000056,0,24117,26,0.000011,16,0.149082,0.164973,218.511615,0.166667,0.000438
9308046,9308046,,7,0,7,7,0,7,0.000001,0,0,3899,26,0.000041,0,0,0,0,0.333333,0.001688
9312064,9312064,,5,0,5,5,0,5,0,0,0,12031,26,0.000024,0,0,0,0,0.45,0.001215
9412205,9412205,,4,0,4,4,0,4,0,0,0,12033,26,0.000016,0,0,0,0,0.5,0.00097
9412239,9412239,,4,2,6,4,2,6,0,0,0,12032,26,0.000017,1,1,1,0.4,0.4,0.000943
9610044,9610044,,4,7,11,4,7,11,0,0,0,12035,26,0.000016,1,1,1,131.9,0.227273,0.000943
9610149,9610149,,4,8,12,4,8,12,0,0,0,12036,26,0.000015,7,0.222047,0.281577,843.350166,0.159091,0.000949
302122,302122,,0,15,15,0,15,15,0,0.001901,0,24119,30,0.00001,15,0.20257,0.224893,0,0.142857,0
302123,302123,,1,5,6,1,5,6,0,0.000016,0,24120,9,0.000012,19,0.159175,0.170126,1,0.233333,0.000219
302124,302124,,0,6,6,0,6,6,0,0.000006,0,24121,20,0.00001,15,0.140559,0.147234,0,0.366667,0
302125,302125,,0,122,122,0,122,122,0,0.023175,0,24122,3,0.00001,15,0.2242,0.264037,0,0.102425,0
302126,302126,,0,9,9,0,9,9,0,0.000026,0,24123,15,0.00001,15,0.154867,0.165173,0,0.263889,0
302127,302127,,0,48,48,0,48,48,0,0.011257,0,24124,41,0.00001,14,0.215787,0.242474,0,0.145833,0
302128,302128,,1,10,11,1,10,11,0,0,0,24126,23,0.00001,16,0.1557,0.170735,1559.482906,0.163636,0.000226
210204,210204,,3,0,3,3,0,3,0,0,0,24125,23,0.000012,0,0,0,0,0.166667,0.000684
302129,302129,,3,9,12,3,9,12,0.000087,0.000422,0,24127,25,0.000011,13,0.19038,0.208239,410.450477,0.219697,0.000671
302130,302130,,0,11,11,0,11,11,0,0.000037,0,24128,23,0.00001,20,0.140996,0.155891,0,0.136364,0
302131,302131,,0,10,10,0,10,10,0,0.001812,0,24129,28,0.00001,11,0.226777,0.256212,0,0.211111,0
302132,302132,,0,44,44,0,44,44,0,0.014914,0,24130,1,0.00001,16,0.204405,0.2298,0,0.10518,0
9810043,9810043,,1,4,5,1,4,5,0.000232,0,0,7779,23,0.000011,4,0.410714,0.5,104994.951088,0,0.000409
302133,302133,,0,4,4,0,4,4,0,0,0,24131,11,0.00001,17,0.132943,0.141308,0,0.25,0
302135,302135,,0,4,4,0,4,4,0,0,0,24132,10,0.00001,17,0.137589,0.152073,0,0.25,0
302136,302136,,0,26,26,0,26,26,0,0.008277,0,24133,1,0.00001,13,0.201244,0.226708,0,0.067692,0
302137,302137,,1,43,44,1,43,44,0.000008,0.001228,0,24134,3,0.00001,13,0.226323,0.25396,1228.890184,0.225159,0.000219
302138,302138,,1,8,9,1,8,9,0,0.001973,0,24135,30,0.000019,14,0.174506,0.19343,11075,0.180556,0.000219
302139,302139,,0,8,8,0,8,8,0,0.005735,0,24137,28,0.00001,15,0.166128,0.185884,0,0.053571,0
302079,302079,,1,0,1,1,0,1,0.000067,0,0,24136,28,0.000011,0,0,0,0,0,0.000219
302140,302140,,1,28,29,1,28,29,0.000002,0.002232,0,24138,3,0.000011,14,0.201827,0.228502,5819.339797,0.147783,0.000259
302141,302141,,1,23,24,1,23,24,0,0.000025,0,24139,23,0.000011,16,0.159457,0.176714,4815.260993,0.110507,0.000219
302142,302142,,0,1,1,0,1,1,0,0,0,24140,28,0.00001,14,0.136222,0.147354,0,0,0
302143,302143,,3,17,20,3,17,20,0.000068,0.0013,0,24141,25,0.000012,17,0.170553,0.192811,1038.621433,0.255263,0.000664
302144,302144,,0,21,21,0,21,21,0,0.000049,0,24142,9,0.00001,16,0.165232,0.18865,0,0.07619,0
302145,302145,,2,14,16,2,14,16,0.000029,0.000669,0,24143,2,0.000011,18,0.196639,0.217381,204.60739,0.283333,0.000438
302146,302146,,12,31,43,12,31,43,0.000279,0.001702,0,24144,3,0.000013,14,0.208604,0.233688,14124.567663,0.151163,0.002937
302147,302147,,0,17,17,0,17,17,0,0.000128,0,24145,2,0.00001,17,0.165404,0.183207,0,0.275735,0
302148,302148,,2,40,42,2,40,42,0.00026,0.003261,0,24146,8,0.00001,16,0.194284,0.220391,2035.784496,0.186992,0.000445
302149,302149,,0,2,2,0,2,2,0,0.000025,0,24147,23,0.00001,16,0.16566,0.178248,0,0,0
302150,302150,,7,86,93,7,86,93,0.000099,0.001871,0,24148,4,0.000012,13,0.216086,0.243497,15275.476505,0.20021,0.001674
302151,302151,,3,38,41,3,38,41,0.000014,0.000627,0,24149,3,0.000011,15,0.19518,0.215859,1068.83469,0.207317,0.000664
302152,302152,,0,18,18,0,18,18,0,0.000423,0,24150,52,0.00001,18,0.173468,0.197519,0,0.166667,0
302153,302153,,0,15,15,0,15,15,0,0.001641,0,24151,41,0.00001,14,0.195745,0.215389,0,0.295238,0
302154,302154,,0,6,6,0,6,6,0,0.000036,0,24152,30,0.00001,16,0.18417,0.199678,0,0.133333,0
302155,302155,,0,16,16,0,16,16,0,0.000793,0,24153,8,0.00001,18,0.175931,0.197508,0,0.233333,0
302156,302156,,2,7,9,2,7,9,0.000003,0.000362,0,24154,1,0.000012,13,0.181531,0.201268,1397.506231,0.125,0.000445
302157,302157,,0,9,9,0,9,9,0,0.000022,0,24155,15,0.00001,15,0.176642,0.189513,0,0.333333,0
302158,302158,,3,28,31,3,28,31,0.000033,0.001139,0,24156,0,0.000011,15,0.199004,0.225365,4908.335934,0.122581,0.000664
302159,302159,,2,35,37,2,35,37,0.00005,0.003047,0,24157,41,0.000011,14,0.212908,0.236706,2633.353598,0.093844,0.000445
302160,302160,,1,33,34,1,33,34,0.000019,0.004811,0,24158,3,0.00001,16,0.199408,0.226271,1917.199915,0.0918,0.000239
302161,302161,,0,1,1,0,1,1,0,0,0,24159,0,0.00001,15,0.138609,0.14588,0,0,0
302162,302162,,2,39,41,2,39,41,0.000054,0.00116,0,24161,30,0.00001,13,0.21687,0.246142,670.064515,0.117073,0.000445
9707092,9707092,,1,9,10,1,9,10,0.000014,0.000037,0,24160,26,0.00001,13,0.151797,0.181965,48.091399,0.2,0.000232
302163,302163,,2,16,18,2,16,18,0.000352,0.001286,0,24162,1,0.00001,17,0.175269,0.202488,2393.454381,0.140523,0.000445
302164,302164,,0,18,18,0,18,18,0,0.00118,0,24163,2,0.00001,14,0.185857,0.210172,0,0.143791,0
302165,302165,,2,15,17,2,15,17,0.000368,0.000583,0,24164,4,0.00001,21,0.175537,0.202174,1324.615133,0.242647,0.000458
302167,302167,,0,7,7,0,7,7,0,0.000105,0,24165,30,0.00001,13,0.20116,0.221102,0,0.095238,0
302168,302168,,3,20,23,3,20,23,0,0.00001,0,24166,23,0.000011,15,0.159377,0.175059,4231.160948,0.229249,0.000664
302169,302169,,0,3,3,0,3,3,0,0.000002,0,24167,22,0.00001,5,0.336449,0.397685,0,0.5,0
302170,302170,,1,13,14,1,13,14,0.000192,0.001861,0,24168,13,0.000011,17,0.172996,0.191159,5139.443906,0.208791,0.000219
302171,302171,,1,30,31,1,30,31,0.000049,0.019944,0,24169,25,0.00001,18,0.196769,0.230169,626.307026,0.109677,0.000226
302172,302172,,2,38,40,2,38,40,0.000029,0.001427,0,24170,2,0.000011,14,0.214947,0.240147,9637.566037,0.107051,0.000438
302173,302173,,0,11,11,0,11,11,0,0.000037,0,24171,22,0.00001,16,0.163663,0.176329,0,0.272727,0
302174,302174,,1,51,52,1,51,52,0.00002,0.00199,0,24172,0,0.00001,16,0.202101,0.230873,173.105582,0.161011,0.000232
302175,302175,,0,18,18,0,18,18,0,0.001127,0,24173,30,0.00001,16,0.181149,0.201631,0,0.183007,0
302176,302176,,0,17,17,0,17,17,0,0.000024,0,24174,26,0.00001,16,0.13482,0.165847,0,0.125,0
9511124,9511124,,1,2,3,1,2,3,0,0.000006,0,7561,23,0.000013,7,0.328467,0.363849,3939.273071,0.166667,0.000267
302177,302177,,0,11,11,0,11,11,0,0.000406,0,24175,3,0.00001,16,0.184247,0.204585,0,0.2,0
302178,302178,,0,2,2,0,2,2,0,0.000198,0,24176,5,0.00001,9,0.22251,0.268076,0,0.5,0
302179,302179,,0,28,28,0,28,28,0,0.002858,0,24177,30,0.00001,14,0.215155,0.239042,0,0.179894,0
302180,302180,,1,26,27,1,26,27,0.000004,0.003255,0,24178,30,0.00001,16,0.200783,0.227875,4516.858026,0.189459,0.000219
302181,302181,,1,36,37,1,36,37,0.000033,0.001605,0,24179,0,0.00001,16,0.191888,0.217748,649.890727,0.142643,0.000219
302182,302182,,3,30,33,3,30,33,0.000019,0.000461,0,24180,3,0.000011,15,0.190604,0.209376,1878.835307,0.225379,0.000664
302183,302183,,0,4,4,0,4,4,0,0.000201,0,24181,8,0.00001,14,0.155168,0.166417,0,0.083333,0
302184,302184,,1,9,10,1,9,10,0.000003,0.000091,0,24182,8,0.00001,17,0.178885,0.199743,452.643741,0.322222,0.000219
302185,302185,,0,4,4,0,4,4,0,0,0,24183,6,0.00001,7,0.266129,0.381962,0,0.083333,0
302186,302186,,0,13,13,0,13,13,0,0.002863,0,24184,5,0.00001,15,0.196608,0.225234,0,0.179487,0
302187,302187,,0,7,7,0,7,7,0,0.000003,0,24188,9,0.00001,15,0.14781,0.157931,0,0.047619,0
301052,301052,,1,0,1,1,0,1,0,0,0,24187,9,0.000011,0,0,0,0,0,0.000219
9610221,9610221,,3,1,4,3,1,4,0,0,0,24186,9,0.000016,4,0.347826,0.427083,9.333333,0,0.000658
9606089,9606089,,1,2,3,1,2,3,0,0,0,24185,9,0.000024,3,0.466667,0.571429,13.333333,0.166667,0.000239
302188,302188,,0,2,2,0,2,2,0,0,35,24189,58,0.00001,1,1,1,0,0.5,0
302189,302189,,0,3,3,0,3,3,0,0.000002,0,24190,23,0.00001,19,0.128087,0.137534,0,0.5,0
302190,302190,,0,12,12,0,12,12,0,0.002832,0,24191,2,0.00001,18,0.197486,0.224245,0,0.212121,0
302191,302191,,0,92,92,0,92,92,0,0.026819,0,24192,4,0.00001,22,0.196228,0.24016,0,0.050048,0
302192,302192,,1,21,22,1,21,22,0.000019,0.001498,0,24193,25,0.00001,15,0.190254,0.211483,959.44717,0.138528,0.000219
302193,302193,,0,8,8,0,8,8,0,0.001369,0,24195,0,0.00001,16,0.167974,0.190571,0,0.196429,0
9807147,9807147,,1,5,6,1,5,6,0.000016,0.000024,0,24194,4,0.000011,16,0.169117,0.18953,34.363145,0.2,0.000219
302194,302194,,5,6,11,5,6,11,0.00007,0.000223,0,24196,4,0.000012,16,0.190933,0.215053,5002.397946,0.181818,0.001216
302195,302195,,1,38,39,1,38,39,0.000026,0.002455,0,24197,30,0.00001,13,0.212423,0.239082,37.947564,0.167341,0.000219
302196,302196,,1,19,20,1,19,20,0.000019,0.001295,0,24198,25,0.00001,16,0.182104,0.20552,70.878109,0.160526,0.000219
302197,302197,,0,20,20,0,20,20,0,0.006395,0,24199,8,0.00001,18,0.172647,0.197674,0,0.115789,0
302198,302198,,0,21,21,0,21,21,0,0.001422,0,24200,1,0.00001,15,0.193495,0.21784,0,0.088095,0
302199,302199,,4,8,12,4,8,12,0.000009,0.000048,0,24201,3,0.000019,16,0.179758,0.196134,24491.232728,0.068182,0.000896
302200,302200,,1,10,11,1,10,11,0.00005,0.000172,0,24202,52,0.00001,16,0.174297,0.193019,91.456743,0.181818,0.000232
302201,302201,,0,2,2,0,2,2,0,0.000369,0,24203,4,0.00001,17,0.140553,0.158167,0,0,0
302202,302202,,0,18,18,0,18,18,0,0.000015,0,24204,23,0.00001,13,0.174027,0.190245,0,0.169935,0
302203,302203,,0,31,31,0,31,31,0,0.002591,0,24205,2,0.00001,16,0.187545,0.214604,0,0.121505,0
9708021,9708021,,1,13,14,1,13,14,0.000063,0.001652,0,6171,2,0.000011,16,0.176585,0.202056,26179.452037,0.10989,0.000305
302204,302204,,0,3,3,0,3,3,0,0.000498,0,24206,8,0.00001,15,0.163464,0.178126,0,0,0
302205,302205,,1,20,21,1,20,21,0.000041,0.000428,0,24207,4,0.00001,16,0.192649,0.216795,1235.979111,0.116667,0.000219
302206,302206,,0,25,25,0,25,25,0,0.001072,0,24208,3,0.00001,14,0.204099,0.228308,0,0.233333,0
302207,302207,,0,16,16,0,16,16,0,0.00221,0,24209,5,0.00001,16,0.191695,0.220078,0,0.179167,0
302208,302208,,0,1,1,0,1,1,0,0,0,24210,4,0.00001,16,0.118548,0.126544,0,0,0
302209,302209,,0,1,1,0,1,1,0,0.000017,0,24211,0,0.00001,1,1,1,0,0,0
302210,302210,,0,5,5,0,5,5,0,0.000001,0,24212,23,0.00001,18,0.114002,0.122889,0,0.25,0
302211,302211,,0,13,13,0,13,13,0,0.000143,0,24213,52,0.00001,15,0.163206,0.17722,0,0.173077,0
302212,302212,,0,7,7,0,7,7,0,0.000425,0,24214,8,0.00001,14,0.171012,0.184973,0,0.119048,0
302213,302213,,0,15,15,0,15,15,0,0.000017,0,24215,23,0.00001,16,0.131441,0.160321,0,0.238095,0
302214,302214,,1,3,4,1,3,4,0.000005,0.000259,0,24216,41,0.00001,14,0.182179,0.196824,31.59229,0.166667,0.000219
302215,302215,,0,7,7,0,7,7,0,0,0,24218,23,0.00001,17,0.139764,0.151515,0,0.119048,0
9712250,9712250,,2,0,2,2,0,2,0.000001,0,0,24217,23,0.000013,0,0,0,0,0,0.000438
302216,302216,,0,9,9,0,9,9,0,0,0,24227,21,0.00001,13,0.158924,0.169155,0,0.138889,0
9406004,9406004,,8,1,9,8,1,9,0.000006,0,0,9336,21,0.000031,1,1,1,3082,0.111111,0.001842
9409080,9409080,,8,0,8,8,0,8,0.000006,0,0,9334,21,0.000028,0,0,0,0,0.107143,0.001849
9508160,9508160,,3,0,3,3,0,3,0,0,0,24219,21,0.000025,0,0,0,0,0.333333,0.000677
9609042,9609042,,1,1,2,1,1,2,0,0,0,24226,21,0.000011,1,1,1,0,0.5,0.000219
9803187,9803187,,2,3,5,2,3,5,0.000002,0.000003,0,24220,21,0.000013,9,0.187992,0.218296,231.810202,0.1,0.000451
9809189,9809189,,2,5,7,2,5,7,0,0.000199,0,24221,21,0.000012,12,0.173237,0.189916,2027.233096,0.166667,0.000445
9901108,9901108,,1,6,7,1,6,7,0,0,0,24225,21,0.000011,13,0.148767,0.161697,19,0.238095,0.000219
9210027,9210027,,2,0,2,2,0,2,0,0,0,9335,21,0.00004,0,0,0,0,0.5,0.000504
9702064,9702064,,2,2,4,2,2,4,0,0,0,24222,21,0.000013,2,0.75,0.833333,2,0.25,0.000451
9702191,9702191,,2,9,11,2,9,11,0,0,0,24224,21,0.000016,3,0.6,0.722222,43,0.081818,0.000445
9703181,9703181,,1,6,7,1,6,7,0,0,0,24223,21,0.000011,2,0.8,0.875,4,0.119048,0.000226
302217,302217,,1,13,14,1,13,14,0.000038,0.000855,0,24228,1,0.00001,15,0.186194,0.207638,41.651949,0.230769,0.000226
302218,302218,,2,44,46,2,44,46,0.000395,0.006128,0,24229,1,0.000011,15,0.215427,0.248719,2905.237033,0.126087,0.000445
302219,302219,,5,10,15,5,10,15,0.000622,0.001248,0,24230,8,0.000011,16,0.184907,0.204838,858.640941,0.2,0.001109
302220,302220,,0,14,14,0,14,14,0,0.000004,0,24232,6,0.00001,16,0.131314,0.142802,0,0.21978,0
9512090,9512090,,1,2,3,1,2,3,0,0,0,24231,6,0.00001,3,0.529412,0.592593,7.083333,0,0.000219
9406133,9406133,,2,2,4,2,2,4,0,0.000001,0,6754,6,0.000017,1,1,1,83.692557,0.083333,0.000452
302222,302222,,3,22,25,3,22,25,0.000111,0.0016,0,24233,3,0.000011,14,0.205915,0.23034,2961.877134,0.186667,0.00069
302223,302223,,1,29,30,1,29,30,0.000028,0.003821,0,24234,25,0.00001,16,0.192817,0.219016,357.263681,0.164368,0.000219
302224,302224,,0,22,22,0,22,22,0,0.001599,0,24235,30,0.00001,17,0.185682,0.206642,0,0.095238,0
302225,302225,,1,5,6,1,5,6,0,0.000011,0,24236,1,0.000014,14,0.17541,0.188466,6370.304489,0.1,0.000219
302226,302226,,0,19,19,0,19,19,0,0.001127,0,24237,52,0.00001,15,0.202122,0.228872,0,0.067251,0
302227,302227,,0,7,7,0,7,7,0,0.000004,0,24238,20,0.00001,23,0.144374,0.162782,0,0.285714,0
302228,302228,,0,17,17,0,17,17,0,0.000039,0,24239,41,0.00001,14,0.155779,0.170965,0,0.117647,0
302229,302229,,0,2,2,0,2,2,0,0,0,24240,8,0.00001,2,0.75,0.833333,0,0.5,0
302230,302230,,0,37,37,0,37,37,0,0.020408,0,24241,8,0.00001,15,0.204387,0.22942,0,0.147898,0
303001,303001,,9,36,45,9,36,45,0.000145,0.000481,0,24242,4,0.000012,14,0.191163,0.213046,1523.743596,0.224747,0.002132
9510018,9510018,,1,8,9,1,8,9,0.000004,0.000434,0,3050,4,0.000022,10,0.181428,0.227247,10340.110184,0.25,0.000407
303002,303002,,0,3,3,0,3,3,0,0,0,24243,26,0.00001,15,0.147784,0.161321,0,0.333333,0
303003,303003,,0,8,8,0,8,8,0,0.001223,0,24244,25,0.00001,17,0.166085,0.186323,0,0.357143,0
303004,303004,,0,1,1,0,1,1,0,0,0,24245,30,0.00001,15,0.148589,0.159721,0,0,0
303005,303005,,1,6,7,1,6,7,0,0,0,24246,6,0.000019,15,0.142784,0.152285,9213,0.166667,0.000219
303006,303006,,0,21,21,0,21,21,0,0.017751,0,24247,1,0.00001,15,0.194319,0.215708,0,0.159524,0
303007,303007,,2,24,26,2,24,26,0.000147,0.017401,0,24248,41,0.00001,17,0.195587,0.216531,125.972243,0.310769,0.000458
303008,303008,,5,27,32,5,27,32,0.000072,0.000645,0,24250,4,0.000011,14,0.195501,0.218022,1166.485525,0.21875,0.001202
9509124,9509124,,2,11,13,2,11,13,0.000016,0.000018,0,24249,4,0.00001,3,0.539683,0.632353,101.078221,0.064103,0.000519
303032,303032,,7,46,53,7,46,53,0.000124,0.000713,0,24251,4,0.000012,14,0.201207,0.224084,7337.062791,0.176705,0.001614
303009,303009,,2,14,16,2,14,16,0.000009,0.000066,0,24252,0,0.000011,16,0.177968,0.199129,417.798929,0.141667,0.000451
9307172,9307172,,2,2,4,2,2,4,0.000008,0.00008,0,1703,0,0.000014,1,1,1,0.75,0.083333,0.000507
303010,303010,,0,11,11,0,11,11,0,0.019026,0,24253,1,0.00001,15,0.188719,0.223156,0,0.363636,0
303011,303011,,1,33,34,1,33,34,0.000007,0.004175,0,24254,25,0.00001,14,0.216033,0.247169,3259.376434,0.13369,0.000219
303012,303012,,0,5,5,0,5,5,0,0.000005,0,24255,9,0.00001,19,0.159182,0.170148,0,0.35,0
303013,303013,,0,19,19,0,19,19,0,0.000446,0,24256,3,0.00001,15,0.204129,0.224606,0,0.277778,0
303014,303014,,0,6,6,0,6,6,0,0.000001,0,24257,23,0.00001,18,0.151973,0.163493,0,0.166667,0
303015,303015,,5,73,78,5,73,78,0.000117,0.002287,0,24258,0,0.000011,15,0.211844,0.241429,4578.300251,0.218615,0.001142
303016,303016,,2,56,58,2,56,58,0.000089,0.001735,0,24259,0,0.00001,16,0.212661,0.243792,1682.143803,0.159105,0.000445
303017,303017,,0,19,19,0,19,19,0,0.011875,0,24260,41,0.00001,17,0.194843,0.214952,0,0.21345,0
303018,303018,,0,4,4,0,4,4,0,0.00008,0,24261,4,0.00001,15,0.199978,0.219183,0,0.25,0
303019,303019,,0,1,1,0,1,1,0,0.000002,0,24262,0,0.00001,1,1,1,0,0,0
303020,303020,,1,11,12,1,11,12,0.00004,0.002159,0,24263,0,0.00001,13,0.177729,0.19798,24.730325,0.378788,0.000219
303021,303021,,0,4,4,0,4,4,0,0.000001,0,24269,22,0.00001,16,0.157412,0.173079,0,0,0
9910084,9910084,,1,0,1,1,0,1,0,0,0,24268,22,0.000012,0,0,0,0,0,0.000219
9910239,9910239,,2,11,13,2,11,13,0,0.002804,0,24267,2,0.000013,15,0.186275,0.213376,6935.850883,0.064103,0.000438
9705085,9705085,,2,4,6,2,4,6,0.000034,0,0,24266,41,0.000014,3,0.521739,0.625,45.5,0.1,0.000451
9809011,9809011,,1,3,4,1,3,4,0.000033,0.000042,0,24264,4,0.000011,15,0.178857,0.201066,0,0.25,0.000232
303022,303022,,0,11,11,0,11,11,0,0.000917,0,24270,30,0.00001,18,0.207108,0.231615,0,0.163636,0
303023,303023,,1,31,32,1,31,32,0.000021,0.003661,0,24271,25,0.00001,16,0.194016,0.222635,875.743288,0.050403,0.000226
303024,303024,,1,73,74,1,73,74,0.000138,0.003901,0,24272,0,0.00001,15,0.213811,0.245791,2237.380078,0.134395,0.000245
303025,303025,,0,8,8,0,8,8,0,0.000801,0,24274,15,0.00001,14,0.178594,0.195274,0,0.053571,0
9212047,9212047,,5,0,5,5,0,5,0.00001,0,0,18038,15,0.000023,0,0,0,0,0.05,0.001129
9407053,9407053,,1,2,3,1,2,3,0.000009,0.000001,0,24273,15,0.000011,2,0.75,0.833333,1,0.166667,0.000219
303026,303026,,0,3,3,0,3,3,0,0,0,24275,26,0.00001,10,0.185185,0.205747,0,0.166667,0
303027,303027,,0,4,4,0,4,4,0,0.000009,0,24276,9,0.00001,16,0.167407,0.183211,0,0,0
303029,303029,,1,2,3,1,2,3,0.000018,0.000015,0,24277,1,0.000011,18,0.144628,0.156685,10.026691,0.166667,0.000219
303030,303030,,1,16,17,1,16,17,0.000026,0.001981,0,24278,30,0.00001,16,0.201738,0.226001,30.590564,0.224265,0.000219
303031,303031,,1,23,24,1,23,24,0.000233,0.001547,0,24279,8,0.00001,16,0.197531,0.221234,3237.95029,0.153986,0.000226
303033,303033,,3,50,53,3,50,53,0.000056,0.003838,0,24280,4,0.00001,21,0.191664,0.226454,1851.323343,0.121553,0.000678
303034,303034,,1,56,57,1,56,57,0.00021,0.00426,0,24281,8,0.00001,17,0.191061,0.220559,360.159047,0.153509,0.000219
303035,303035,,11,77,88,11,77,88,0.000323,0.003147,0,24282,3,0.000013,13,0.222755,0.252433,29980.068857,0.114028,0.002603
303139,303139,,12,36,48,12,36,48,0.00029,0.000934,0,24284,3,0.000013,13,0.21238,0.236547,14643.273157,0.187943,0.002762
303057,303057,,9,69,78,9,69,78,0.000235,0.007059,0,24283,3,0.000012,13,0.209038,0.236701,6635.389233,0.125541,0.002164
303036,303036,,1,23,24,1,23,24,0.000006,0.000315,0,24285,1,0.00001,14,0.190313,0.210388,270.07689,0.123188,0.000226
303038,303038,,0,1,1,0,1,1,0,0,26,24286,48,0.00001,1,1,1,0,0,0
303039,303039,,1,19,20,1,19,20,0.000047,0.001376,0,24287,41,0.00001,16,0.201418,0.222598,658.071518,0.142105,0.000226
303040,303040,,0,5,5,0,5,5,0,0.000006,0,24288,23,0.00001,19,0.125524,0.136951,0,0.25,0
303041,303041,,0,34,34,0,34,34,0,0.001818,0,24289,52,0.00001,15,0.205639,0.23585,0,0.144385,0
9302057,9302057,,7,2,9,7,2,9,0.000024,0.000001,0,955,4,0.000021,1,1,1,6,0.125,0.001598
9512029,9512029,,2,2,4,2,2,4,0.000001,0,0,5512,9,0.000013,7,0.351032,0.394198,16729.133875,0.083333,0.000455
303042,303042,,0,23,23,0,23,23,0,0.002686,0,24290,41,0.00001,16,0.199145,0.222522,0,0.262846,0
303043,303043,,0,6,6,0,6,6,0,0.00022,0,24291,41,0.00001,17,0.192145,0.20897,0,0.1,0
303044,303044,,1,15,16,1,15,16,0.00002,0.001464,0,24292,41,0.00001,16,0.186268,0.207332,193.377178,0.295833,0.000219
303045,303045,,0,3,3,0,3,3,0,0.000148,0,24293,0,0.00001,15,0.167887,0.190263,0,0.166667,0
303046,303046,,0,18,18,0,18,18,0,0.001558,0,24294,2,0.00001,14,0.186279,0.210457,0,0.120915,0
303047,303047,,0,21,21,0,21,21,0,0.002379,0,24295,4,0.00001,17,0.180255,0.200187,0,0.290476,0
303048,303048,,1,14,15,1,14,15,0.000014,0.000519,0,24296,0,0.00001,14,0.183981,0.206968,2879.203983,0.128571,0.000219
303049,303049,,0,49,49,0,49,49,0,0.000993,0,24297,0,0.00001,15,0.206803,0.236735,0,0.128401,0
303050,303050,,0,28,28,0,28,28,0,0.002806,0,24298,41,0.00001,14,0.206288,0.229678,0,0.137566,0
303051,303051,,2,7,9,2,7,9,0.000047,0.000849,0,24299,3,0.000011,15,0.194183,0.213167,3024.378639,0.166667,0.000445
303052,303052,,0,6,6,0,6,6,0,0.000001,0,24300,26,0.00001,17,0.124677,0.135553,0,0.166667,0
303053,303053,,1,11,12,1,11,12,0,0.000052,0,24302,4,0.000012,15,0.183159,0.203147,11379.521684,0.05303,0.000219
9707084,9707084,,1,0,1,1,0,1,0.000001,0,0,24301,4,0.000011,0,0,0,0,0,0.000226
303054,303054,,1,25,26,1,25,26,0.000017,0.001225,0,24303,4,0.00001,20,0.183811,0.214517,157.472056,0.149231,0.000233
303055,303055,,1,34,35,1,34,35,0.00002,0.023051,0,24304,41,0.00001,16,0.216532,0.247809,2336.225807,0.136134,0.000219
303056,303056,,0,10,10,0,10,10,0,0.000153,0,24305,22,0.00001,14,0.179185,0.194953,0,0.066667,0
303058,303058,,0,6,6,0,6,6,0,0.000004,0,24310,41,0.00001,3,0.576923,0.677778,0,0.066667,0
9705222,9705222,,1,5,6,1,5,6,0,0.000001,0,24309,41,0.000011,2,0.777778,0.857143,3.738095,0.2,0.000219
9801001,9801001,,2,1,3,2,1,3,0,0,0,24306,41,0.000013,1,1,1,2,0.166667,0.000445
9903185,9903185,,1,5,6,1,5,6,0,0.000003,0,24307,41,0.000011,2,0.666667,0.75,2.52381,0.233333,0.000219
9607116,9607116,,1,1,2,1,1,2,0,0,0,24308,41,0.000012,3,0.454545,0.533333,0,0.5,0.000226
303059,303059,,1,2,3,1,2,3,0,0,0,24311,5,0.000012,15,0.133914,0.141297,0,0.5,0.000219
303060,303060,,4,58,62,4,58,62,0.000715,0.006409,0,24312,41,0.000011,17,0.206188,0.239359,4666.497506,0.20624,0.000903
303061,303061,,0,1,1,0,1,1,0,0,0,24313,6,0.00001,16,0.124956,0.131039,0,0,0
303062,303062,,1,5,6,1,5,6,0,0.00001,0,24314,6,0.000011,17,0.139446,0.158994,598.938824,0.2,0.000219
303063,303063,,3,19,22,3,19,22,0.000062,0.000849,0,24315,4,0.000011,21,0.181595,0.206177,2058.651945,0.222944,0.000658
303064,303064,,0,10,10,0,10,10,0,0.001049,0,24316,30,0.00001,14,0.20022,0.221397,0,0.144444,0
303065,303065,,5,34,39,5,34,39,0.000066,0.002317,0,24317,4,0.000011,14,0.192569,0.214068,703.596717,0.219298,0.001189
303066,303066,,1,8,9,1,8,9,0.000023,0.000318,0,24318,0,0.00001,16,0.178913,0.197751,5904.692185,0.152778,0.000219
303067,303067,,2,9,11,2,9,11,0.000152,0.001219,0,24319,8,0.000011,14,0.182035,0.200949,40.034299,0.181818,0.000438
303068,303068,,1,11,12,1,11,12,0.00021,0.001397,0,24320,25,0.00001,17,0.175103,0.197509,1504.287525,0.242424,0.000219
303069,303069,,1,7,8,1,7,8,0,0.000286,0,24321,4,0.000011,17,0.164019,0.182704,5075.540998,0.142857,0.000219
303070,303070,,0,1,1,0,1,1,0,0,0,24322,20,0.00001,14,0.141582,0.149594,0,0,0
303072,303072,,1,121,122,1,121,122,0.000013,0.016862,0,24323,2,0.00001,18,0.231923,0.278123,5593.927196,0.055142,0.000219
303073,303073,,3,39,42,3,39,42,0.000259,0.021353,0,24324,25,0.000011,15,0.203097,0.229646,9523.739078,0.089431,0.000658
303074,303074,,2,27,29,2,27,29,0.000031,0.001157,0,24325,4,0.00001,14,0.190927,0.21203,40.911572,0.226601,0.000459
303075,303075,,1,29,30,1,29,30,0.000006,0.004193,0,24326,2,0.00001,15,0.193101,0.219358,6101.080432,0.093103,0.000226
303076,303076,,0,6,6,0,6,6,0,0.000843,0,24327,3,0.00001,14,0.173716,0.192122,0,0.266667,0
303078,303078,,0,3,3,0,3,3,0,0.000003,0,24328,8,0.00001,13,0.149148,0.158921,0,0.166667,0
303079,303079,,1,18,19,1,18,19,0,0.000065,0,24329,23,0.000011,14,0.19281,0.213094,5528.420889,0.122807,0.000219
303080,303080,,0,6,6,0,6,6,0,0.001046,0,24330,30,0.00001,19,0.190805,0.213981,0,0.266667,0
303081,303081,,0,19,19,0,19,19,0,0.010199,0,24331,0,0.00001,15,0.205655,0.235381,0,0.175439,0
303082,303082,,0,12,12,0,12,12,0,0.000228,0,24332,30,0.00001,16,0.210709,0.235099,0,0.143939,0
303083,303083,,3,36,39,3,36,39,0.000028,0.000992,0,24333,0,0.000011,16,0.198487,0.223919,597.251791,0.255061,0.000677
303084,303084,,0,4,4,0,4,4,0,0.000028,0,24334,4,0.00001,16,0.158893,0.175223,0,0.25,0
303085,303085,,0,3,3,0,3,3,0,0.000022,0,24335,0,0.00001,14,0.183243,0.200154,0,0.5,0
303086,303086,,0,12,12,0,12,12,0,0.000084,0,24336,26,0.00001,18,0.124187,0.14218,0,0.181818,0
303087,303087,,1,49,50,1,49,50,0.000004,0.005607,0,24337,8,0.00001,14,0.218269,0.252113,5030.957512,0.036327,0.000226
303088,303088,,0,6,6,0,6,6,0,0,0,24338,2,0.00001,16,0.166648,0.180225,0,0.166667,0
303089,303089,,1,38,39,1,38,39,0.000001,0.004158,0,24339,8,0.00001,16,0.204149,0.231216,5991.315745,0.082321,0.000219
303090,303090,,0,9,9,0,9,9,0,0.000424,0,24340,30,0.00001,17,0.180284,0.202932,0,0.333333,0
303091,303091,,0,20,20,0,20,20,0,0.002171,0,24341,30,0.00001,14,0.205027,0.231962,0,0.231579,0
303092,303092,,0,6,6,0,6,6,0,0.000003,0,24342,23,0.00001,18,0.104591,0.120225,0,0.333333,0
303093,303093,,0,2,2,0,2,2,0,0,0,24343,8,0.00001,17,0.153116,0.163209,0,0,0
303094,303094,,0,16,16,0,16,16,0,0.000021,0,24344,22,0.00001,16,0.123987,0.142634,0,0.2,0
303095,303095,,1,103,104,1,103,104,0.000021,0.005762,0,24345,25,0.00001,14,0.217235,0.246922,5960.508474,0.083831,0.000219
303096,303096,,2,14,16,2,14,16,0.000036,0.002536,0,24346,25,0.000011,15,0.184414,0.206466,3457.698447,0.166667,0.000445
303097,303097,,7,4,11,7,4,11,0.000042,0.000269,0,24347,3,0.000018,16,0.185164,0.204943,820.598228,0.345455,0.001659
304124,304124,,3,12,15,3,12,15,0.000026,0.000089,0,24354,3,0.000012,14,0.191165,0.211336,3938.945632,0.280952,0.00067
303232,303232,,2,35,37,2,35,37,0.000011,0.003141,0,24352,3,0.000012,13,0.20837,0.235099,11316.678418,0.158408,0.000484
303238,303238,,6,10,16,6,10,16,0.00004,0.000172,0,24348,3,0.000016,15,0.184318,0.205648,5198.090298,0.279167,0.0014
304084,304084,,4,14,18,4,14,18,0.000027,0.000885,0,24353,3,0.000013,14,0.192629,0.215613,3416.397499,0.254902,0.000909
304089,304089,,4,5,9,4,5,9,0.000027,0.000221,0,24349,3,0.000013,16,0.170402,0.192079,249.89232,0.319444,0.000909
304177,304177,,1,7,8,1,7,8,0.000004,0.000243,0,24355,3,0.00001,15,0.179743,0.200336,32.080716,0.392857,0.000219
303098,303098,,0,7,7,0,7,7,0,0.000097,0,24361,10,0.00001,14,0.159396,0.173064,0,0.142857,0
9604083,9604083,,1,2,3,1,2,3,0.000001,0,0,24360,10,0.000011,1,1,1,1.333333,0,0.000219
9707178,9707178,,1,1,2,1,1,2,0.000001,0,0,24358,10,0.000011,1,1,1,0.333333,0,0.000219
9811161,9811161,,1,7,8,1,7,8,0.000001,0.001074,0,24357,10,0.000011,12,0.184188,0.205183,953.842571,0.125,0.000219
9509041,9509041,,1,0,1,1,0,1,0,0,0,24359,10,0.000015,0,0,0,0,0,0.000226
9605060,9605060,,2,1,3,2,1,3,0.000013,0,0,24356,10,0.000016,1,1,1,0,0.333333,0.000445
9611118,9611118,,5,8,13,5,8,13,0.000091,0.001432,0,16620,4,0.000015,13,0.171793,0.199771,2349.862935,0.25641,0.001116
303099,303099,,0,10,10,0,10,10,0,0.000039,0,24362,30,0.00001,14,0.177276,0.19061,0,0.277778,0
303100,303100,,0,5,5,0,5,5,0,0.000001,0,24363,22,0.00001,3,0.56,0.654762,0,0.3,0
303101,303101,,0,14,14,0,14,14,0,0.000103,0,24364,0,0.00001,17,0.16297,0.182325,0,0.269231,0
303102,303102,,1,16,17,1,16,17,0.000018,0.00053,0,24365,2,0.00001,16,0.176484,0.200736,231.357412,0.161765,0.000219
303103,303103,,0,18,18,0,18,18,0,0.000247,0,24366,8,0.00001,16,0.187195,0.207402,0,0.202614,0
303104,303104,,6,17,23,6,17,23,0.000096,0.000297,0,24367,4,0.000011,20,0.182463,0.205472,438.685552,0.280632,0.001381
303105,303105,,0,12,12,0,12,12,0,0.003184,0,24368,8,0.00001,13,0.199404,0.218172,0,0.113636,0
303106,303106,,0,3,3,0,3,3,0,0.00002,0,24369,22,0.00001,2,0.588235,0.65,0,0.5,0
303107,303107,,3,26,29,3,26,29,0.00046,0.001825,0,24370,41,0.000011,17,0.189216,0.211819,403.101479,0.352217,0.000684
303108,303108,,0,2,2,0,2,2,0,0.000002,0,24371,28,0.00001,17,0.142966,0.151218,0,0.5,0
303109,303109,,1,27,28,1,27,28,0.000222,0.011126,0,24372,1,0.00001,18,0.182925,0.215929,359.296359,0.130952,0.000219
303110,303110,,0,8,8,0,8,8,0,0.001801,0,24373,0,0.00001,14,0.178568,0.196963,0,0.25,0
303111,303111,,0,18,18,0,18,18,0,0.001261,0,24374,13,0.00001,16,0.17138,0.194244,0,0.232026,0
303112,303112,,1,1,2,1,1,2,0,0,0,24375,23,0.000014,1,1,1,0,0.5,0.000219
303113,303113,,1,22,23,1,22,23,0.000057,0.008023,0,24376,13,0.00001,17,0.190769,0.217598,3593.025392,0.098814,0.000219
303114,303114,,1,6,7,1,6,7,0.000001,0.000208,0,24377,0,0.000011,17,0.167179,0.185668,1261.087971,0.261905,0.000219
303115,303115,,2,63,65,2,63,65,0.000041,0.001463,0,24378,4,0.00001,13,0.21034,0.237003,1701.139273,0.224279,0.000478
303116,303116,,2,9,11,2,9,11,0.000004,0.001082,0,24379,25,0.000012,17,0.173235,0.192936,529.91268,0.227273,0.000451
303117,303117,,2,3,5,2,3,5,0.000008,0.000091,0,24380,8,0.000011,17,0.178177,0.195041,2870.02257,0.2,0.000445
303118,303118,,0,1,1,0,1,1,0,0,0,24381,23,0.00001,17,0.109234,0.113774,0,0,0
303119,303119,,0,20,20,0,20,20,0,0.000337,0,24382,30,0.00001,17,0.18355,0.207204,0,0.142105,0
303120,303120,,1,28,29,1,28,29,0.00003,0.005167,0,24383,30,0.000011,18,0.206734,0.232864,6138.855246,0.140394,0.000219
9504075,9504075,,2,6,8,2,6,8,0.000061,0.000157,0,7466,5,0.000011,5,0.349398,0.413506,112.645439,0.089286,0.000464
303121,303121,,0,15,15,0,15,15,0,0.000665,0,24384,0,0.00001,16,0.184278,0.207409,0,0.228571,0
303122,303122,,0,22,22,0,22,22,0,0.001008,0,24385,22,0.00001,13,0.212135,0.23336,0,0.134199,0
303123,303123,,0,3,3,0,3,3,0,0.001363,0,24386,0,0.00001,12,0.203888,0.230158,0,0.333333,0
303124,303124,,2,30,32,2,30,32,0.00002,0.000718,0,24387,0,0.00001,16,0.199917,0.226689,1125.156303,0.273185,0.000445
303125,303125,,2,11,13,2,11,13,0.000023,0.000252,0,24388,25,0.000011,16,0.181425,0.200884,937.836369,0.192308,0.000438
303126,303126,,0,2,2,0,2,2,0,0,0,24390,9,0.00001,8,0.256729,0.318692,0,0,0
212158,212158,,1,0,1,1,0,1,0,0,0,24389,9,0.000014,0,0,0,0,0,0.000219
303127,303127,,0,18,18,0,18,18,0,0.000475,0,24391,0,0.00001,16,0.189215,0.21429,0,0.147059,0
303128,303128,,0,11,11,0,11,11,0,0.000054,0,24392,30,0.00001,18,0.127971,0.139906,0,0.063636,0
9405022,9405022,,4,1,5,4,1,5,0.000002,0.00001,0,7846,30,0.000017,1,1,1,0,0.25,0.000909
303130,303130,,0,7,7,0,7,7,0,0,0,24394,6,0.00001,10,0.177129,0.209784,0,0.142857,0
9909057,9909057,,1,0,1,1,0,1,0,0,0,24393,6,0.000011,0,0,0,0,0,0.000219
303132,303132,,0,7,7,0,7,7,0,0.000045,0,24395,6,0.00001,16,0.142317,0.150393,0,0.142857,0
303131,303131,,0,14,14,0,14,14,0,0.00131,0,24396,25,0.00001,16,0.188037,0.20963,0,0.192308,0
303133,303133,,4,28,32,4,28,32,0.000094,0.000516,0,24350,3,0.000011,15,0.195979,0.21717,290.319296,0.267137,0.000943
303134,303134,,0,9,9,0,9,9,0,0.000132,0,24397,1,0.00001,16,0.165897,0.180608,0,0.208333,0
303135,303135,,0,68,68,0,68,68,0,0.003672,0,24398,52,0.00001,16,0.212874,0.245129,0,0.082748,0
303137,303137,,0,4,4,0,4,4,0,0.000132,0,24399,25,0.00001,16,0.165655,0.178815,0,0.166667,0
303138,303138,,0,26,26,0,26,26,0,0.000862,0,24400,3,0.00001,15,0.203407,0.228728,0,0.172308,0
303140,303140,,2,20,22,2,20,22,0.000395,0.001104,0,24401,13,0.000011,14,0.193033,0.216697,10998.83229,0.08658,0.000445
303141,303141,,0,18,18,0,18,18,0,0.017235,0,24402,1,0.00001,15,0.186015,0.209669,0,0.271242,0
303143,303143,,1,4,5,1,4,5,0.000001,0.000062,0,24403,30,0.000011,14,0.175019,0.188899,0,0.5,0.000219
303144,303144,,1,67,68,1,67,68,0.000027,0.001209,0,24404,4,0.00001,14,0.203713,0.226558,1497.06903,0.244952,0.000252
303145,303145,,0,4,4,0,4,4,0,0.000006,0,24405,23,0.00001,18,0.14084,0.161983,0,0.166667,0
303146,303146,,0,7,7,0,7,7,0,0.000284,0,24406,4,0.00001,15,0.147971,0.164525,0,0.166667,0
303147,303147,,0,9,9,0,9,9,0,0.000004,0,24407,22,0.00001,15,0.121928,0.139412,0,0.319444,0
9411064,9411064,,1,0,1,1,0,1,0,0,0,6860,22,0.000014,0,0,0,0,0,0.00028
9506003,9506003,,3,2,5,3,2,5,0,0,0,4640,22,0.000032,1,1,1,0,0.5,0.000804
303148,303148,,0,4,4,0,4,4,0,0,0,24408,5,0.00001,15,0.133936,0.141517,0,0.416667,0
303149,303149,,0,5,5,0,5,5,0,0.000049,0,24409,52,0.00001,14,0.18647,0.203606,0,0.15,0
303150,303150,,0,7,7,0,7,7,0,0.000069,0,24410,52,0.00001,15,0.162686,0.176054,0,0.238095,0
303151,303151,,1,37,38,1,37,38,0.000088,0.001572,0,24411,25,0.00001,17,0.18937,0.219117,6238.595484,0.081792,0.000219
303152,303152,,0,16,16,0,16,16,0,0.000407,0,24412,0,0.00001,14,0.189442,0.214537,0,0.283333,0
303153,303153,,0,32,32,0,32,32,0,0.001922,0,24413,41,0.00001,15,0.203278,0.225794,0,0.246976,0
303154,303154,,0,10,10,0,10,10,0,0.000004,0,24414,20,0.00001,15,0.14752,0.160942,0,0.355556,0
303155,303155,,0,12,12,0,12,12,0,0.000202,0,24415,0,0.00001,16,0.172632,0.189764,0,0.136364,0
303156,303156,,0,25,25,0,25,25,0,0.001418,0,24416,3,0.00001,14,0.203481,0.226445,0,0.135,0
303157,303157,,0,29,29,0,29,29,0,0.018136,0,24417,1,0.00001,15,0.200809,0.225038,0,0.155172,0
303158,303158,,1,7,8,1,7,8,0.000001,0.001803,0,24418,30,0.000011,14,0.202394,0.224675,4640.687765,0.125,0.000219
303159,303159,,0,4,4,0,4,4,0,0.000001,0,24419,5,0.00001,18,0.122802,0.131617,0,0.5,0
303160,303160,,0,63,63,0,63,63,0,0.008925,0,24420,1,0.00001,13,0.218604,0.254285,0,0.132104,0
303161,303161,,0,7,7,0,7,7,0,0.00046,0,24421,4,0.00001,18,0.173219,0.191219,0,0.119048,0
303162,303162,,0,12,12,0,12,12,0,0,0,24422,22,0.00001,9,0.167943,0.214253,0,0.265152,0
303163,303163,,0,6,6,0,6,6,0,0.000006,0,24423,20,0.00001,15,0.140559,0.147234,0,0.366667,0
303164,303164,,0,11,11,0,11,11,0,0.014402,0,24424,1,0.00001,14,0.188834,0.21847,0,0.290909,0
303165,303165,,1,10,11,1,10,11,0.000007,0.000053,0,24425,10,0.00001,15,0.167158,0.183255,7.409741,0.263636,0.000219
303166,303166,,0,21,21,0,21,21,0,0.000337,0,24426,8,0.00001,17,0.166934,0.1871,0,0.138095,0
303167,303167,,0,14,14,0,14,14,0,0.001535,0,24427,25,0.00001,17,0.180956,0.206863,0,0.21978,0
303168,303168,,0,14,14,0,14,14,0,0.001289,0,24428,30,0.00001,16,0.212403,0.234805,0,0.230769,0
303169,303169,,0,1,1,0,1,1,0,0,0,24429,26,0.00001,7,0.212972,0.235325,0,0,0
9605005,9605005,,4,8,12,4,8,12,0.000003,0.000059,0,14526,26,0.000021,6,0.269373,0.318189,295.904658,0.280303,0.00089
9512225,9512225,,3,9,12,3,9,12,0.000004,0.000098,0,14525,26,0.000014,7,0.285714,0.35546,438.979799,0.151515,0.000697
9601022,9601022,,4,21,25,4,21,25,0.000003,0.000079,0,14524,26,0.000015,7,0.263354,0.346754,9999.398642,0.101667,0.00091
303170,303170,,1,26,27,1,26,27,0.000235,0.000736,0,24430,3,0.00001,15,0.215861,0.242422,4871.787164,0.133903,0.000219
303171,303171,,0,17,17,0,17,17,0,0.016951,0,24431,30,0.00001,15,0.190416,0.21126,0,0.169118,0
303172,303172,,3,96,99,3,96,99,0.000119,0.00367,0,24351,3,0.000011,13,0.223572,0.253024,13440.918641,0.114616,0.000704
303173,303173,,0,41,41,0,41,41,0,0.011142,0,24432,2,0.00001,14,0.207706,0.235129,0,0.096341,0
303174,303174,,0,4,4,0,4,4,0,0.000098,0,24433,25,0.00001,15,0.176721,0.193641,0,0.083333,0
303175,303175,,0,2,2,0,2,2,0,0,0,24435,22,0.00001,2,0.75,0.833333,0,0,0
301053,301053,,1,0,1,1,0,1,0,0,0,24434,22,0.000014,0,0,0,0,0,0.000219
303176,303176,,0,7,7,0,7,7,0,0.000031,0,24436,23,0.00001,18,0.13794,0.153181,0,0.214286,0
303177,303177,,0,10,10,0,10,10,0,0,0,24437,20,0.00001,4,0.527778,0.70614,0,0.255556,0
303178,303178,,0,17,17,0,17,17,0,0.001403,0,24438,13,0.00001,18,0.167299,0.199394,0,0.110294,0
303179,303179,,1,1,2,1,1,2,0,0,0,24439,13,0.000011,5,0.280702,0.341667,13.613131,0,0.000219
303180,303180,,0,7,7,0,7,7,0,0.000008,0,24440,26,0.00001,17,0.128142,0.140331,0,0.119048,0
303181,303181,,0,13,13,0,13,13,0,0.000671,0,24441,0,0.00001,17,0.179826,0.200338,0,0.230769,0
303182,303182,,3,25,28,3,25,28,0.000391,0.002256,0,24442,41,0.00001,16,0.202892,0.224804,295.037294,0.28836,0.000671
303183,303183,,0,27,27,0,27,27,0,0.001764,0,24443,2,0.00001,14,0.206867,0.234419,0,0.159544,0
303184,303184,,0,14,14,0,14,14,0,0.000011,0,24444,23,0.00001,17,0.167257,0.185366,0,0.263736,0
303185,303185,,0,120,120,0,120,120,0,0.032081,0,24445,41,0.00001,14,0.231331,0.266918,0,0.035364,0
303186,303186,,0,35,35,0,35,35,0,0.001825,0,24446,30,0.00001,14,0.219984,0.24568,0,0.229412,0
303187,303187,,0,16,16,0,16,16,0,0.00008,0,24447,6,0.00001,16,0.1868,0.209688,0,0.158333,0
303189,303189,,0,1,1,0,1,1,0,0,0,24448,21,0.00001,1,1,1,0,0,0
303190,303190,,0,18,18,0,18,18,0,0.000369,0,24449,4,0.00001,15,0.199088,0.221887,0,0.127451,0
303191,303191,,0,139,139,0,139,139,0,0.039037,0,24450,1,0.00001,13,0.23,0.270314,0,0.089772,0
303192,303192,,0,13,13,0,13,13,0,0.000374,0,24451,2,0.00001,15,0.194997,0.217624,0,0.224359,0
303193,303193,,0,57,57,0,57,57,0,0.00889,0,24452,41,0.00001,13,0.212772,0.237688,0,0.16698,0
303194,303194,,4,54,58,4,54,58,0.000188,0.011768,0,24453,0,0.000011,16,0.219342,0.254952,13808.415205,0.062916,0.000883
303196,303196,,0,11,11,0,11,11,0,0.002523,0,24454,30,0.00001,19,0.1908,0.217737,0,0.218182,0
303197,303197,,1,34,35,1,34,35,0.00004,0.000971,0,24455,0,0.00001,16,0.197807,0.222723,383.375849,0.315126,0.000219
303198,303198,,1,50,51,1,50,51,0.000025,0.002073,0,24456,10,0.00001,15,0.200681,0.230552,580.814357,0.107843,0.000219
303199,303199,,0,49,49,0,49,49,0,0.000557,0,24457,3,0.00001,15,0.216922,0.243983,0,0.169218,0
303200,303200,,0,5,5,0,5,5,0,0.000931,0,24458,4,0.00001,15,0.173367,0.189338,0,0.2,0
303201,303201,,0,1,1,0,1,1,0,0,46,24460,69,0.00001,1,1,1,0,0,0
9604108,9604108,,1,0,1,1,0,1,0,0,46,24459,69,0.000019,0,0,0,0,0,0.000219
303202,303202,,0,22,22,0,22,22,0,0.015501,0,24461,1,0.00001,14,0.194031,0.214899,0,0.28355,0
303203,303203,,1,41,42,1,41,42,0.000007,0.004161,0,24462,25,0.00001,17,0.195677,0.224307,1293.246813,0.134146,0.000219
303204,303204,,3,39,42,3,39,42,0.000058,0.004909,0,24463,3,0.000011,13,0.211734,0.2378,6445.724847,0.113821,0.000664
303205,303205,,1,20,21,1,20,21,0,0.000032,0,24464,6,0.000011,16,0.135026,0.153333,7488.403165,0.1,0.000219
303206,303206,,0,3,3,0,3,3,0,0,0,24465,22,0.00001,15,0.155674,0.163796,0,0,0
303207,303207,,5,42,47,5,42,47,0.000081,0.002257,0,24466,4,0.000012,14,0.193158,0.216338,3308.280436,0.198427,0.001148
303208,303208,,1,50,51,1,50,51,0.00004,0.002158,0,24467,0,0.00001,15,0.208383,0.234849,676.442705,0.211765,0.000219
303209,303209,,0,24,24,0,24,24,0,0.00152,0,24468,2,0.00001,17,0.196011,0.219182,0,0.106884,0
303210,303210,,2,21,23,2,21,23,0.000091,0.00482,0,24469,30,0.00001,15,0.192576,0.217177,1659.52462,0.140316,0.000438
303211,303211,,1,18,19,1,18,19,0.00021,0.015809,0,24470,1,0.00001,15,0.180196,0.205384,155.386642,0.207602,0.000219
303212,303212,,2,20,22,2,20,22,0.000372,0.001774,0,24471,41,0.00001,16,0.196196,0.218145,393.496582,0.179654,0.000458
303213,303213,,0,23,23,0,23,23,0,0.006563,0,24472,1,0.00001,14,0.192684,0.217439,0,0.126482,0
303214,303214,,1,54,55,1,54,55,0.000003,0.003958,0,24473,41,0.000011,14,0.22452,0.251362,4747.052708,0.087205,0.000219
303215,303215,,0,5,5,0,5,5,0,0,0,24474,22,0.00001,13,0.122687,0.144373,0,0.5,0
303216,303216,,0,5,5,0,5,5,0,0.000065,0,24475,30,0.00001,13,0.167685,0.178974,0,0.3,0
9607103,9607103,,1,1,2,1,1,2,0,0,0,10014,22,0.000023,1,1,1,3,0,0.00024
303217,303217,,0,2,2,0,2,2,0,0.000003,0,24477,52,0.00001,13,0.176853,0.191339,0,0,0
102003,102003,,1,0,1,1,0,1,0,0,0,24476,52,0.000014,0,0,0,0,0,0.000219
303218,303218,,0,27,27,0,27,27,0,0.000797,0,24478,0,0.00001,16,0.18361,0.214325,0,0.159544,0
303219,303219,,0,42,42,0,42,42,0,0.012545,0,24479,2,0.00001,14,0.210366,0.239315,0,0.066202,0
303220,303220,,2,33,35,2,33,35,0.000446,0.001658,0,24480,41,0.00001,17,0.190015,0.211196,55.762998,0.380672,0.000445
303221,303221,,1,20,21,1,20,21,0.000013,0.000313,0,24481,3,0.00001,14,0.201845,0.223579,1209.564635,0.17381,0.000252
303222,303222,,2,75,77,2,75,77,0.000165,0.026071,0,24482,41,0.000011,16,0.21622,0.248571,6313.812289,0.112953,0.000451
303223,303223,,2,66,68,2,66,68,0.000446,0.020787,0,24483,41,0.00001,16,0.218211,0.249011,3121.881598,0.179763,0.000445
303224,303224,,0,3,3,0,3,3,0,0,0,24484,28,0.00001,15,0.1239,0.131301,0,0.5,0
303225,303225,,0,19,19,0,19,19,0,0.003477,0,24485,41,0.00001,14,0.187092,0.209429,0,0.081871,0
303226,303226,,0,1,1,0,1,1,0,0,0,24486,26,0.00001,1,1,1,0,0,0
303227,303227,,0,11,11,0,11,11,0,0.000357,0,24487,25,0.00001,17,0.168947,0.188159,0,0.236364,0
303228,303228,,0,6,6,0,6,6,0,0.000316,0,24489,1,0.00001,13,0.172591,0.188416,0,0.2,0
9407059,9407059,,3,4,7,3,4,7,0.000004,0.00001,0,24488,9,0.000029,4,0.363636,0.466667,59.333333,0.02381,0.000658
9309099,9309099,,3,1,4,3,1,4,0,0,0,2408,26,0.000021,1,1,1,5,0.083333,0.00069
303229,303229,,0,13,13,0,13,13,0,0.00099,0,24490,4,0.00001,14,0.18207,0.20221,0,0.076923,0
303230,303230,,0,26,26,0,26,26,0,0.002113,0,24491,4,0.00001,16,0.200607,0.226578,0,0.127692,0
303231,303231,,0,20,20,0,20,20,0,0.0004,0,24492,52,0.00001,15,0.190873,0.211182,0,0.171053,0
303233,303233,,0,27,27,0,27,27,0,0.004751,0,24493,30,0.00001,17,0.211061,0.239852,0,0.155271,0
303234,303234,,0,17,17,0,17,17,0,0.000454,0,24494,10,0.00001,16,0.198224,0.222652,0,0.220588,0
303235,303235,,0,29,29,0,29,29,0,0.0103,0,24495,30,0.00001,16,0.205123,0.229755,0,0.208128,0
303236,303236,,0,54,54,0,54,54,0,0.001602,0,24496,3,0.00001,15,0.209781,0.236626,0,0.148498,0
303237,303237,,0,30,30,0,30,30,0,0.017483,0,24497,41,0.00001,16,0.198878,0.221148,0,0.265517,0
303239,303239,,3,52,55,3,52,55,0.00007,0.001989,0,24498,3,0.000011,14,0.211528,0.238757,1851.642925,0.214478,0.000697
303240,303240,,0,3,3,0,3,3,0,0.000384,0,24499,30,0.00001,14,0.179916,0.195441,0,0.5,0
303241,303241,,0,10,10,0,10,10,0,0.000015,0,24501,6,0.00001,18,0.163572,0.176215,0,0.122222,0
9901114,9901114,,1,4,5,1,4,5,0,0.000001,0,24500,23,0.000011,16,0.129008,0.140461,157.271982,0.3,0.000219
303243,303243,,0,11,11,0,11,11,0,0.000305,0,24502,10,0.00001,15,0.189911,0.211791,0,0.127273,0
303244,303244,,0,7,7,0,7,7,0,0.000019,0,24503,20,0.00001,13,0.169942,0.184479,0,0.261905,0
303245,303245,,0,27,27,0,27,27,0,0.000603,0,24504,3,0.00001,14,0.20817,0.232536,0,0.10114,0
303246,303246,,0,13,13,0,13,13,0,0.000286,0,24505,3,0.00001,15,0.178604,0.196618,0,0.237179,0
303247,303247,,1,15,16,1,15,16,0.000021,0.003014,0,24506,25,0.00001,19,0.166987,0.191184,18.309415,0.270833,0.000226
303248,303248,,0,22,22,0,22,22,0,0.001136,0,24507,2,0.00001,13,0.204705,0.229485,0,0.164502,0
303249,303249,,2,28,30,2,28,30,0.000309,0.01556,0,24508,41,0.000011,13,0.216842,0.247701,6797.990412,0.143678,0.000438
303251,303251,,1,37,38,1,37,38,0,0.000024,0,24513,23,0.00001,15,0.147004,0.162544,186.163818,0.099573,0.000219
9412040,9412040,,3,1,4,3,1,4,0.000033,0.000002,0,24509,4,0.000013,1,1,1,1,0.416667,0.000684
9511007,9511007,,2,4,6,2,4,6,0.000028,0.000456,0,24511,4,0.000011,7,0.223214,0.259548,14.785934,0.2,0.000451
9607045,9607045,,1,10,11,1,10,11,0,0.002325,0,24512,4,0.00001,6,0.260321,0.311821,20.893247,0.236364,0.000226
9412024,9412024,,1,2,3,1,2,3,0.000005,0.000005,0,24510,4,0.000012,3,0.571429,0.708333,10.916667,0,0.000232
303252,303252,,0,11,11,0,11,11,0,0.003431,0,24514,0,0.00001,16,0.169292,0.190648,0,0.063636,0
303253,303253,,0,34,34,0,34,34,0,0.004865,0,24515,2,0.00001,18,0.179303,0.207942,0,0.114973,0
303255,303255,,0,41,41,0,41,41,0,0.00361,0,24516,41,0.00001,16,0.211073,0.234974,0,0.196951,0
303256,303256,,1,136,137,1,136,137,0.000061,0.012157,0,24517,30,0.00001,17,0.214123,0.257321,1675.419326,0.079058,0.000219
303257,303257,,0,1,1,0,1,1,0,0,0,24518,13,0.00001,15,0.131234,0.139429,0,0,0
303258,303258,,0,4,4,0,4,4,0,0,0,24519,23,0.00001,15,0.139361,0.146001,0,0.5,0
303260,303260,,0,1,1,0,1,1,0,0.000002,0,24520,6,0.00001,1,1,1,0,0,0
303261,303261,,0,2,2,0,2,2,0,0,0,24521,20,0.00001,14,0.141605,0.1498,0,0,0
303262,303262,,1,1,2,1,1,2,0,0,0,24522,23,0.000013,15,0.141741,0.149886,0,0.5,0.000219
303263,303263,,0,13,13,0,13,13,0,0.000003,0,24523,6,0.00001,14,0.135761,0.148317,0,0.192308,0
9612046,9612046,,2,24,26,2,24,26,0,0.000007,0,16959,6,0.000011,8,0.255784,0.326591,561.292949,0.046154,0.000445
9402051,9402051,,1,4,5,1,4,5,0,0.000001,0,7523,15,0.000012,2,0.75,0.833333,1811.386899,0.1,0.000253
9502040,9502040,,1,0,1,1,0,1,0,0,0,16958,6,0.00001,0,0,0,0,0,0.000232
9509029,9509029,,3,1,4,3,1,4,0,0.000003,0,16957,15,0.000017,1,1,1,5.844298,0.166667,0.000697
303264,303264,,0,7,7,0,7,7,0,0.000004,0,24524,28,0.00001,15,0.155673,0.168267,0,0.142857,0
303265,303265,,0,2,2,0,2,2,0,0,0,24525,23,0.00001,16,0.110553,0.119241,0,0.5,0
303266,303266,,1,59,60,1,59,60,0.000015,0.019789,0,24530,13,0.00001,14,0.206403,0.237702,6651.939181,0.053672,0.000219
9910176,9910176,,1,7,8,1,7,8,0.000233,0.000313,0,24529,13,0.00001,16,0.150725,0.170696,21.642664,0.089286,0.000226
9811088,9811088,,3,4,7,3,4,7,0.000036,0.000807,0,24526,13,0.000013,15,0.171838,0.196523,8355.442042,0.119048,0.000677
9907017,9907017,,1,14,15,1,14,15,0.000004,0.002312,0,24528,13,0.000011,15,0.169506,0.197833,2456.762811,0.104762,0.000226
303267,303267,,0,9,9,0,9,9,0,0.000088,0,24531,0,0.00001,17,0.159651,0.173387,0,0.347222,0
303268,303268,,4,34,38,4,34,38,0.000042,0.000339,0,24532,4,0.000012,14,0.193441,0.214419,4002.741096,0.214083,0.000909
303269,303269,,2,35,37,2,35,37,0.000027,0.00261,0,24533,3,0.000011,14,0.208829,0.23584,10414.831721,0.158408,0.000451
303270,303270,,0,25,25,0,25,25,0,0.002138,0,24534,2,0.00001,16,0.188034,0.215158,0,0.136667,0
304001,304001,,1,34,35,1,34,35,0.000005,0.001845,0,24535,0,0.000011,14,0.204694,0.23094,4179.699448,0.166387,0.000219
304002,304002,,0,21,21,0,21,21,0,0.001684,0,24536,2,0.00001,14,0.175872,0.197314,0,0.180952,0
304003,304003,,0,11,11,0,11,11,0,0.000364,0,24537,25,0.00001,14,0.181136,0.199677,0,0.136364,0
304004,304004,,0,26,26,0,26,26,0,0.001408,0,24538,25,0.00001,16,0.196456,0.223545,0,0.132308,0
304005,304005,,1,27,28,1,27,28,0.000021,0.000246,0,24539,3,0.00001,15,0.190661,0.209351,3072.116779,0.304233,0.000219
304006,304006,,0,12,12,0,12,12,0,0.000121,0,24540,8,0.00001,17,0.162969,0.181448,0,0.083333,0
304007,304007,,0,42,42,0,42,42,0,0.020026,0,24541,1,0.00001,16,0.210747,0.243496,0,0.106852,0
304008,304008,,0,11,11,0,11,11,0,0.000003,0,24542,5,0.00001,17,0.110676,0.119637,0,0.109091,0
304009,304009,,0,17,17,0,17,17,0,0.001323,0,24543,1,0.00001,15,0.186038,0.206884,0,0.183824,0
304010,304010,,0,2,2,0,2,2,0,0,0,24544,28,0.00001,10,0.173547,0.194265,0,0.5,0
304011,304011,,0,21,21,0,21,21,0,0.00001,0,24545,23,0.00001,14,0.146513,0.1572,0,0.157143,0
304012,304012,,0,8,8,0,8,8,0,0.00139,0,24546,8,0.00001,14,0.182463,0.201346,0,0.446429,0
304013,304013,,0,15,15,0,15,15,0,0.000343,0,24547,52,0.00001,15,0.19831,0.222098,0,0.204762,0
304014,304014,,0,19,19,0,19,19,0,0.020202,0,24548,25,0.00001,15,0.198244,0.231898,0,0.289474,0
304015,304015,,0,13,13,0,13,13,0,0.000458,0,24549,52,0.00001,18,0.202308,0.224231,0,0.179487,0
304018,304018,,2,89,91,2,89,91,0.000068,0.004245,0,24550,3,0.00001,15,0.222367,0.255876,14285.337906,0.056899,0.000438
304019,304019,,0,27,27,0,27,27,0,0.002094,0,24551,0,0.00001,15,0.191864,0.21749,0,0.121083,0
304020,304020,,0,22,22,0,22,22,0,0.015409,0,24552,1,0.00001,15,0.193864,0.216875,0,0.233766,0
304022,304022,,0,35,35,0,35,35,0,0.017843,0,24553,1,0.00001,15,0.184854,0.212705,0,0.159664,0
304023,304023,,0,9,9,0,9,9,0,0.000025,0,24554,23,0.00001,15,0.162117,0.180182,0,0.111111,0
304024,304024,,0,1,1,0,1,1,0,0,0,24555,4,0.00001,17,0.149799,0.161944,0,0,0
304025,304025,,4,45,49,4,45,49,0.000696,0.019266,0,24556,41,0.000011,17,0.201436,0.225314,2924.857129,0.253401,0.000883
304026,304026,,0,8,8,0,8,8,0,0.005175,0,24557,8,0.00001,15,0.161888,0.178324,0,0.178571,0
304027,304027,,1,16,17,1,16,17,0,0.000024,0,24558,15,0.000011,22,0.168194,0.186143,4228.536894,0.290441,0.000219
304028,304028,,1,58,59,1,58,59,0.000122,0.021212,0,24559,1,0.00001,16,0.205157,0.238141,726.295334,0.088252,0.000219
304029,304029,,0,2,2,0,2,2,0,0.000001,0,24560,8,0.00001,16,0.110139,0.115844,0,0.5,0
304030,304030,,0,22,22,0,22,22,0,0.00259,0,24561,30,0.00001,14,0.20449,0.22633,0,0.158009,0
304031,304031,,0,4,4,0,4,4,0,0,0,24562,6,0.00001,16,0.137523,0.1468,0,0.416667,0
304032,304032,,0,35,35,0,35,35,0,0.022974,0,24563,1,0.00001,14,0.210158,0.241818,0,0.15042,0
304033,304033,,0,35,35,0,35,35,0,0.019345,0,24564,8,0.00001,16,0.187909,0.212727,0,0.189076,0
304034,304034,,0,4,4,0,4,4,0,0,0,24565,23,0.00001,2,0.833333,0.9,0,0.333333,0
304035,304035,,0,35,35,0,35,35,0,0.003157,0,24566,41,0.00001,16,0.203298,0.227137,0,0.203361,0
304036,304036,,0,30,30,0,30,30,0,0.003802,0,24567,4,0.00001,14,0.180591,0.212485,0,0.227586,0
304037,304037,,0,11,11,0,11,11,0,0.000124,0,24568,30,0.00001,14,0.200644,0.219539,0,0.109091,0
304038,304038,,0,6,6,0,6,6,0,0.001061,0,24569,25,0.00001,15,0.166169,0.186233,0,0.4,0
304039,304039,,0,14,14,0,14,14,0,0.000249,0,24570,30,0.00001,19,0.178706,0.196892,0,0.082418,0
304040,304040,,0,31,31,0,31,31,0,0.000395,0,24571,25,0.00001,16,0.179287,0.20326,0,0.129032,0
304041,304041,,0,5,5,0,5,5,0,0.000001,0,24572,5,0.00001,18,0.109422,0.121268,0,0.3,0
304042,304042,,0,2,2,0,2,2,0,0.001652,0,24573,2,0.00001,15,0.174452,0.189569,0,0,0
304043,304043,,0,1,1,0,1,1,0,0,0,24574,25,0.00001,15,0.153131,0.164732,0,0,0
304044,304044,,0,29,29,0,29,29,0,0.000408,0,24575,3,0.00001,16,0.2021,0.227606,0,0.257389,0
304045,304045,,5,39,44,5,39,44,0.000101,0.001116,0,24576,3,0.000011,13,0.211789,0.235874,3972.097595,0.183404,0.001142
304046,304046,,0,54,54,0,54,54,0,0.003518,0,24577,4,0.00001,17,0.216708,0.251831,0,0.125786,0
304047,304047,,0,4,4,0,4,4,0,0.000001,0,24578,10,0.00001,17,0.146813,0.156978,0,0.333333,0
304049,304049,,1,29,30,1,29,30,0.000017,0.000474,0,24579,1,0.00001,13,0.202525,0.222664,680.11923,0.126437,0.000219
304050,304050,,0,2,2,0,2,2,0,0,0,24580,1,0.00001,15,0.155966,0.165756,0,0.5,0
304051,304051,,0,32,32,0,32,32,0,0.017899,0,24581,25,0.00001,18,0.179581,0.206898,0,0.117944,0
304052,304052,,0,4,4,0,4,4,0,0.000042,0,24582,4,0.00001,16,0.172843,0.190779,0,0.25,0
304053,304053,,0,13,13,0,13,13,0,0.000071,0,24583,13,0.00001,14,0.16192,0.178367,0,0.333333,0
304056,304056,,0,15,15,0,15,15,0,0.001813,0,24584,25,0.00001,17,0.174087,0.196608,0,0.190476,0
304057,304057,,1,17,18,1,17,18,0.000021,0.000137,0,24585,25,0.00001,16,0.186802,0.20944,196.914642,0.228758,0.000219
304058,304058,,0,7,7,0,7,7,0,0.000024,0,24586,23,0.00001,16,0.187461,0.205763,0,0.02381,0
304059,304059,,0,19,19,0,19,19,0,0.001503,0,24587,30,0.00001,16,0.198615,0.219444,0,0.298246,0
304060,304060,,0,57,57,0,57,57,0,0.005442,0,24588,8,0.00001,17,0.206443,0.236463,0,0.12218,0
304061,304061,,3,41,44,3,41,44,0.000081,0.004486,0,24589,4,0.000011,15,0.195263,0.219837,1154.983237,0.142178,0.000671
304062,304062,,2,26,28,2,26,28,0.0001,0.020072,0,24591,1,0.000012,17,0.212012,0.242083,12124.129669,0.128307,0.000451
6083,6083,,1,0,1,1,0,1,0.000236,0,0,24590,1,0.00001,0,0,0,0,0,0.000232
304063,304063,,0,2,2,0,2,2,0,0.000016,0,24592,6,0.00001,14,0.132615,0.146011,0,0,0
304064,304064,,0,11,11,0,11,11,0,0.000635,0,24593,1,0.00001,17,0.181023,0.202091,0,0.072727,0
304065,304065,,0,1,1,0,1,1,0,0,0,24594,23,0.00001,4,0.409091,0.472222,0,0,0
304066,304066,,0,9,9,0,9,9,0,0.000044,0,24596,25,0.00001,16,0.173124,0.188727,0,0.111111,0
9808176,9808176,,1,2,3,1,2,3,0.000001,0.00001,0,24595,23,0.000011,6,0.267544,0.30765,41.384322,0,0.000219
304067,304067,,0,8,8,0,8,8,0,0.000011,0,24597,23,0.00001,15,0.17312,0.187531,0,0.214286,0
304068,304068,,0,16,16,0,16,16,0,0.000184,0,24598,26,0.00001,11,0.176633,0.223253,0,0.266667,0
304204,304204,,0,10,10,0,10,10,0,0.000071,0,24600,26,0.00001,11,0.177941,0.219752,0,0.288889,0
9910224,9910224,,1,14,15,1,14,15,0.000001,0.000208,0,24599,26,0.000011,11,0.180937,0.229012,40.77619,0.185714,0.000219
304069,304069,,1,9,10,1,9,10,0.000007,0.000071,0,24601,0,0.00001,17,0.181245,0.203803,842.470213,0.111111,0.000219
304070,304070,,0,24,24,0,24,24,0,0.000863,0,24602,25,0.00001,16,0.181443,0.206135,0,0.235507,0
304071,304071,,0,10,10,0,10,10,0,0.000579,0,24603,8,0.00001,17,0.164696,0.183327,0,0.233333,0
304072,304072,,0,54,54,0,54,54,0,0.006135,0,24604,8,0.00001,17,0.205956,0.2353,0,0.179245,0
304073,304073,,0,14,14,0,14,14,0,0.000015,0,24605,8,0.00001,18,0.181062,0.200492,0,0.038462,0
304074,304074,,0,4,4,0,4,4,0,0,0,24606,15,0.00001,18,0.140709,0.150811,0,0.166667,0
304075,304075,,0,1,1,0,1,1,0,0.000004,0,24607,25,0.00001,15,0.148136,0.157528,0,0,0
304076,304076,,0,20,20,0,20,20,0,0.000094,0,24608,8,0.00001,17,0.183821,0.205866,0,0.186842,0
304077,304077,,0,5,5,0,5,5,0,0.000001,0,24609,6,0.00001,14,0.137823,0.157382,0,0.2,0
304078,304078,,0,5,5,0,5,5,0,0.000012,0,24610,25,0.00001,16,0.164226,0.177976,0,0.25,0
304079,304079,,0,23,23,0,23,23,0,0.000729,0,24611,0,0.00001,17,0.195339,0.221797,0,0.237154,0
304080,304080,,0,7,7,0,7,7,0,0.001508,0,24612,1,0.00001,18,0.150468,0.167789,0,0.119048,0
304082,304082,,0,4,4,0,4,4,0,0.000006,0,24613,30,0.00001,15,0.164152,0.174418,0,0.25,0
304083,304083,,0,7,7,0,7,7,0,0.000034,0,24614,20,0.00001,15,0.154215,0.165163,0,0.333333,0
304085,304085,,0,5,5,0,5,5,0,0,0,24615,52,0.00001,4,0.428571,0.518519,0,0.4,0
304086,304086,,0,6,6,0,6,6,0,0.000046,0,24616,52,0.00001,13,0.191154,0.213145,0,0.266667,0
304087,304087,,1,12,13,1,12,13,0.000026,0.000153,0,24617,1,0.00001,15,0.186182,0.206425,25.244165,0.160256,0.000219
304088,304088,,0,14,14,0,14,14,0,0.00118,0,24619,28,0.00001,17,0.205683,0.233395,0,0.06044,0
9202031,9202031,,1,0,1,1,0,1,0.000014,0,0,24618,28,0.00001,0,0,0,0,0,0.000219
304090,304090,,0,29,29,0,29,29,0,0.002189,0,24620,30,0.00001,16,0.210038,0.237216,0,0.189655,0
304091,304091,,0,3,3,0,3,3,0,0.000001,0,24622,28,0.00001,16,0.121325,0.126347,0,0,0
110083,110083,,1,0,1,1,0,1,0,0,0,24621,28,0.000013,0,0,0,0,0,0.000219
304092,304092,,0,6,6,0,6,6,0,0.000003,0,24623,6,0.00001,16,0.122733,0.134165,0,0.366667,0
304093,304093,,1,33,34,1,33,34,0.000079,0.019749,0,24624,1,0.00001,21,0.184211,0.211682,897.902326,0.105169,0.000219
304094,304094,,0,17,17,0,17,17,0,0.001806,0,24625,13,0.00001,14,0.198483,0.222356,0,0.216912,0
304095,304095,,0,22,22,0,22,22,0,0.000011,0,24627,17,0.00001,18,0.159449,0.172204,0,0.19697,0
209087,209087,,1,0,1,1,0,1,0,0,0,24626,17,0.00001,0,0,0,0,0,0.000219
304096,304096,,0,10,10,0,10,10,0,0.001585,0,24628,10,0.00001,14,0.178523,0.199431,0,0.244444,0
304097,304097,,0,10,10,0,10,10,0,0.001088,0,24629,8,0.00001,13,0.189418,0.206922,0,0.244444,0
304098,304098,,0,10,10,0,10,10,0,0.000983,0,24630,3,0.00001,14,0.191015,0.211777,0,0.155556,0
304099,304099,,0,6,6,0,6,6,0,0.000037,0,24631,4,0.00001,18,0.150518,0.163834,0,0.166667,0
304100,304100,,0,11,11,0,11,11,0,0.000093,0,24632,23,0.00001,14,0.180458,0.197169,0,0.209091,0
304101,304101,,0,13,13,0,13,13,0,0.000024,0,24633,15,0.00001,23,0.156921,0.17402,0,0.326923,0
9409014,9409014,,2,4,6,2,4,6,0,0.000004,0,6193,15,0.000013,2,0.833333,0.9,10173.632754,0.133333,0.000462
304102,304102,,0,9,9,0,9,9,0,0.011376,0,24634,1,0.00001,15,0.178128,0.198881,0,0.25,0
304103,304103,,0,5,5,0,5,5,0,0.000065,0,24635,28,0.00001,16,0.133803,0.144207,0,0.2,0
304104,304104,,1,6,7,1,6,7,0,0.000012,0,24636,23,0.000012,16,0.148249,0.161669,736.363686,0.238095,0.000219
304105,304105,,0,22,22,0,22,22,0,0.002436,0,24637,30,0.00001,14,0.211177,0.234382,0,0.17316,0
304106,304106,,0,12,12,0,12,12,0,0.000105,0,24638,26,0.00001,16,0.178671,0.195943,0,0.037879,0
304107,304107,,2,7,9,2,7,9,0.000291,0.001835,0,24639,1,0.00001,18,0.189304,0.217543,3001.283712,0.125,0.000438
304108,304108,,4,30,34,4,30,34,0.000092,0.000781,0,24640,3,0.000011,13,0.20683,0.230265,454.357704,0.268271,0.000896
304109,304109,,0,8,8,0,8,8,0,0.000218,0,24641,25,0.00001,14,0.183785,0.205725,0,0.285714,0
304110,304110,,0,8,8,0,8,8,0,0.000273,0,24642,13,0.00001,17,0.16109,0.181031,0,0.071429,0
304111,304111,,0,11,11,0,11,11,0,0.011665,0,24643,1,0.00001,15,0.183907,0.205048,0,0.209091,0
304112,304112,,0,3,3,0,3,3,0,0.000008,0,24644,4,0.00001,6,0.23676,0.282018,0,0.166667,0
304113,304113,,0,3,3,0,3,3,0,0.000155,0,24645,0,0.00001,18,0.169013,0.194946,0,0,0
304114,304114,,1,50,51,1,50,51,0.000213,0.019795,0,24646,41,0.00001,17,0.202813,0.226985,526.45104,0.23451,0.000219
304115,304115,,0,18,18,0,18,18,0,0.001921,0,24647,0,0.00001,17,0.171243,0.195298,0,0.104575,0
304116,304116,,0,9,9,0,9,9,0,0.000031,0,24648,30,0.00001,14,0.176988,0.190919,0,0.236111,0
304117,304117,,0,14,14,0,14,14,0,0.00006,0,24649,20,0.00001,14,0.181142,0.19843,0,0.137363,0
304118,304118,,0,9,9,0,9,9,0,0.000045,0,24650,30,0.00001,22,0.170441,0.192707,0,0.083333,0
304119,304119,,2,32,34,2,32,34,0.000057,0.000323,0,24651,4,0.00001,14,0.200534,0.221643,3826.721684,0.258467,0.000445
304120,304120,,0,39,39,0,39,39,0,0.000163,0,24653,6,0.00001,16,0.191196,0.212805,0,0.089744,0
9804108,9804108,,1,13,14,1,13,14,0.000002,0.002598,0,24652,4,0.00001,13,0.202595,0.236949,519.329919,0.153846,0.000219
304121,304121,,0,7,7,0,7,7,0,0.000016,0,24654,23,0.00001,14,0.170752,0.185233,0,0.261905,0
304122,304122,,0,4,4,0,4,4,0,0,0,24655,22,0.00001,16,0.143982,0.153753,0,0.333333,0
304123,304123,,2,22,24,2,22,24,0.00001,0.002387,0,24656,4,0.000011,14,0.191019,0.21371,1468.263478,0.230072,0.000445
304125,304125,,0,20,20,0,20,20,0,0.000697,0,24657,5,0.00001,14,0.164606,0.178224,0,0.181579,0
304126,304126,,0,11,11,0,11,11,0,0.000451,0,24658,0,0.00001,14,0.184365,0.205667,0,0.127273,0
304127,304127,,0,31,31,0,31,31,0,0.018871,0,24659,1,0.00001,18,0.18788,0.22261,0,0.144086,0
304128,304128,,0,9,9,0,9,9,0,0.00073,0,24661,1,0.00001,17,0.170327,0.186956,0,0.194444,0
9905176,9905176,,1,11,12,1,11,12,0.000009,0.001488,0,24660,1,0.000011,14,0.181104,0.200856,637.362963,0.136364,0.000219
304129,304129,,0,13,13,0,13,13,0,0.019635,0,24662,1,0.00001,14,0.196473,0.226427,0,0.237179,0
304130,304130,,0,5,5,0,5,5,0,0.000106,0,24663,0,0.00001,12,0.194881,0.216323,0,0.05,0
304131,304131,,0,20,20,0,20,20,0,0.000576,0,24664,25,0.00001,15,0.196061,0.218995,0,0.126316,0
304132,304132,,0,9,9,0,9,9,0,0.000479,0,24665,1,0.00001,15,0.18535,0.205193,0,0.069444,0
304133,304133,,0,1,1,0,1,1,0,0.000272,0,24666,0,0.00001,4,0.338235,0.373188,0,0,0
304134,304134,,0,12,12,0,12,12,0,0.000002,0,24667,23,0.00001,15,0.148348,0.15836,0,0.128788,0
304135,304135,,0,6,6,0,6,6,0,0.000431,0,24669,2,0.00001,18,0.147369,0.16173,0,0.033333,0
9907043,9907043,,1,0,1,1,0,1,0.000005,0,0,24668,2,0.000011,0,0,0,0,0,0.000219
304136,304136,,0,14,14,0,14,14,0,0.000043,0,24670,30,0.00001,13,0.187991,0.204017,0,0.098901,0
304138,304138,,1,22,23,1,22,23,0.000053,0.000291,0,24671,4,0.00001,14,0.188482,0.209235,24.051309,0.298419,0.000219
304139,304139,,1,22,23,1,22,23,0.000122,0.012893,0,24672,41,0.00001,17,0.186228,0.208629,106.917717,0.175889,0.000219
304140,304140,,0,6,6,0,6,6,0,0.000003,0,24673,26,0.00001,15,0.16184,0.175722,0,0.066667,0
304141,304141,,0,11,11,0,11,11,0,0.000482,0,24674,30,0.00001,14,0.188426,0.205971,0,0.218182,0
304142,304142,,0,3,3,0,3,3,0,0,0,24675,23,0.00001,15,0.141757,0.150042,0,0.333333,0
304143,304143,,0,45,45,0,45,45,0,0.005092,0,24676,13,0.00001,16,0.197472,0.23,0,0.145455,0
304144,304144,,0,1,1,0,1,1,0,0,0,24677,15,0.00001,18,0.099571,0.102998,0,0,0
304145,304145,,1,32,33,1,32,33,0.000024,0.001516,0,24678,3,0.00001,13,0.210077,0.233763,344.193846,0.236742,0.000232
304146,304146,,0,7,7,0,7,7,0,0.000002,0,24685,23,0.00001,16,0.167949,0.186874,0,0.047619,0
9904123,9904123,,1,7,8,1,7,8,0,0.002695,0,24684,2,0.000011,15,0.179891,0.210333,1579.249724,0.196429,0.000219
9910104,9910104,,1,8,9,1,8,9,0,0.000013,0,24683,6,0.000011,16,0.157665,0.175259,171.191996,0.097222,0.000219
9705001,9705001,,1,3,4,1,3,4,0,0.000024,0,24682,4,0.000011,1,1,1,6,0,0.000226
9809014,9809014,,1,2,3,1,2,3,0,0.000033,0,24680,4,0.000011,15,0.17882,0.200871,3442.764439,0,0.000226
9809042,9809042,,1,7,8,1,7,8,0,0.000087,0,24679,6,0.000011,11,0.189673,0.216024,853.758055,0.125,0.000226
304147,304147,,1,33,34,1,33,34,0.000023,0.001786,0,24686,25,0.00001,15,0.197674,0.222617,839.592261,0.127451,0.000219
304148,304148,,0,11,11,0,11,11,0,0.000106,0,24687,25,0.00001,15,0.180214,0.1981,0,0.245455,0
304149,304149,,0,7,7,0,7,7,0,0.000083,0,24688,2,0.00001,16,0.173246,0.193476,0,0.190476,0
304150,304150,,0,28,28,0,28,28,0,0.009373,0,24689,1,0.00001,14,0.199024,0.222092,0,0.164021,0
304151,304151,,0,11,11,0,11,11,0,0.000107,0,24690,2,0.00001,15,0.177687,0.198673,0,0.218182,0
304152,304152,,0,13,13,0,13,13,0,0.016335,0,24692,13,0.00001,18,0.165343,0.1878,0,0.096154,0
9708136,9708136,,1,14,15,1,14,15,0.000192,0.003236,0,24691,13,0.000011,10,0.213455,0.248975,271.879046,0.152381,0.000219
304153,304153,,1,20,21,1,20,21,0.000041,0.00144,0,24693,3,0.00001,15,0.189086,0.213127,297.648588,0.102381,0.000219
304154,304154,,0,28,28,0,28,28,0,0.001375,0,24695,4,0.00001,15,0.205926,0.228502,0,0.116402,0
9702192,9702192,,1,6,7,1,6,7,0.000016,0.001242,0,24694,4,0.00001,13,0.175158,0.204129,0,0.333333,0.000219
304155,304155,,0,4,4,0,4,4,0,0.000001,0,24696,22,0.00001,2,0.75,0.833333,0,0.333333,0
304156,304156,,0,8,8,0,8,8,0,0.005838,0,24697,1,0.00001,20,0.17668,0.199666,0,0.392857,0
304157,304157,,0,20,20,0,20,20,0,0.003482,0,24698,4,0.00001,18,0.149911,0.170489,0,0.321053,0
304158,304158,,0,18,18,0,18,18,0,0.000103,0,24699,3,0.00001,16,0.191963,0.211484,0,0.310458,0
304159,304159,,0,7,7,0,7,7,0,0.000378,0,24700,30,0.00001,15,0.190827,0.205625,0,0.214286,0
304160,304160,,0,26,26,0,26,26,0,0.018069,0,24703,1,0.00001,19,0.189063,0.221991,0,0.112308,0
9804045,9804045,,2,11,13,2,11,13,0.000326,0.00117,0,24702,26,0.000011,12,0.172462,0.189677,8.296172,0.205128,0.000438
9711015,9711015,,2,14,16,2,14,16,0.000127,0.004628,0,24701,26,0.000011,11,0.206899,0.233766,3193.63409,0.141667,0.000451
304161,304161,,0,2,2,0,2,2,0,0,0,24704,22,0.00001,3,0.470588,0.5625,0,0.5,0
304162,304162,,0,4,4,0,4,4,0,0,0,24705,22,0.00001,3,0.533333,0.6875,0,0.25,0
304163,304163,,1,38,39,1,38,39,0.000011,0.000537,0,24706,3,0.00001,13,0.201656,0.224499,290.597915,0.179487,0.000219
304164,304164,,0,6,6,0,6,6,0,0.002673,0,24707,0,0.00001,14,0.163262,0.181093,0,0.1,0
304165,304165,,0,4,4,0,4,4,0,0.000008,0,24708,23,0.00001,16,0.144241,0.157221,0,0.333333,0
304166,304166,,0,9,9,0,9,9,0,0.000007,0,24709,22,0.00001,15,0.14582,0.156111,0,0.194444,0
304167,304167,,0,7,7,0,7,7,0,0,0,24711,22,0.00001,17,0.140989,0.148909,0,0.190476,0
9709194,9709194,,1,1,2,1,1,2,0,0,0,24710,22,0.000011,1,1,1,0,0.5,0.000219
304168,304168,,0,16,16,0,16,16,0,0.000843,0,24712,0,0.00001,14,0.206602,0.231674,0,0.129167,0
304169,304169,,1,44,45,1,44,45,0.000023,0.010852,0,24713,41,0.00001,14,0.213728,0.23827,2731.869581,0.130303,0.000226
304170,304170,,0,5,5,0,5,5,0,0.000005,0,24714,23,0.00001,14,0.133278,0.144637,0,0.35,0
304171,304171,,0,29,29,0,29,29,0,0.001475,0,24715,3,0.00001,14,0.211276,0.242419,0,0.133005,0
304172,304172,,1,15,16,1,15,16,0.000004,0.001659,0,24717,3,0.00001,15,0.188695,0.210519,282.474323,0.220833,0.000219
202119,202119,,1,0,1,1,0,1,0.000019,0,0,24716,3,0.00001,0,0,0,0,0,0.000226
304173,304173,,0,11,11,0,11,11,0,0.000292,0,24718,13,0.00001,15,0.197657,0.21727,0,0.181818,0
304174,304174,,0,4,4,0,4,4,0,0.000008,0,24719,0,0.00001,16,0.163206,0.178718,0,0.166667,0
304175,304175,,1,4,5,1,4,5,0.000002,0.000133,0,24720,4,0.000011,13,0.175159,0.195845,56.374519,0.2,0.000219
9604180,9604180,,2,0,2,2,0,2,0,0,0,11053,28,0.000017,0,0,0,0,0.5,0.000465
9701111,9701111,,2,1,3,2,1,3,0,0,0,11052,28,0.000017,1,1,1,11,0.166667,0.000465
9804036,9804036,,2,4,6,2,4,6,0,0.000002,0,11054,28,0.000021,2,0.833333,0.9,5,0.133333,0.000452
304176,304176,,0,8,8,0,8,8,0,0.000009,0,24721,5,0.00001,17,0.158133,0.171909,0,0.25,0
304178,304178,,0,69,69,0,69,69,0,0.005682,0,24722,4,0.00001,14,0.212326,0.240098,0,0.032396,0
9404156,9404156,,2,0,2,2,0,2,0.000002,0,0,3254,20,0.000012,0,0,0,0,0,0.000479
304179,304179,,0,1,1,0,1,1,0,0.000009,0,24723,1,0.00001,1,1,1,0,0,0
304180,304180,,2,73,75,2,73,75,0.000067,0.002038,0,24724,3,0.00001,12,0.224487,0.250748,5637.504637,0.201982,0.000438
304181,304181,,1,15,16,1,15,16,0.000008,0.0016,0,24725,41,0.00001,14,0.19626,0.216265,233.286263,0.125,0.000219
304183,304183,,0,29,29,0,29,29,0,0.019621,0,24726,41,0.00001,17,0.195889,0.219587,0,0.200739,0
304184,304184,,0,41,41,0,41,41,0,0.003249,0,24728,4,0.00001,15,0.199649,0.224004,0,0.202439,0
9206091,9206091,,4,0,4,4,0,4,0.00004,0,0,958,4,0.000013,0,0,0,0,0,0.000924
9608172,9608172,,2,2,4,2,2,4,0.000038,0.000001,0,24727,4,0.000012,9,0.205534,0.23156,264.802704,0.083333,0.000438
9202081,9202081,,2,0,2,2,0,2,0.000001,0,0,10421,4,0.000013,0,0,0,0,0.5,0.000486
304185,304185,,0,1,1,0,1,1,0,0,40,24729,63,0.00001,1,1,1,0,0,0
304186,304186,,0,3,3,0,3,3,0,0,0,24730,22,0.00001,17,0.11449,0.119033,0,0,0
304187,304187,,0,37,37,0,37,37,0,0.002373,0,24731,3,0.00001,13,0.21042,0.234471,0,0.145646,0
304197,304197,,0,30,30,0,30,30,0,0.003354,0,24732,3,0.00001,13,0.205755,0.228101,0,0.255172,0
304188,304188,,1,15,16,1,15,16,0.000001,0.00089,0,24733,3,0.000012,15,0.189077,0.210207,7164.752527,0.258333,0.000219
9506176,9506176,,3,1,4,3,1,4,0,0.000002,0,2524,8,0.000041,1,1,1,0,0.416667,0.000765
304189,304189,,0,2,2,0,2,2,0,0,0,24734,22,0.00001,3,0.5,0.633333,0,0.5,0
304190,304190,,0,5,5,0,5,5,0,0.000001,0,24735,6,0.00001,11,0.186211,0.232664,0,0.2,0
304191,304191,,0,23,23,0,23,23,0,0.0017,0,24736,41,0.00001,16,0.196325,0.216881,0,0.179842,0
304192,304192,,3,37,40,3,37,40,0.000122,0.000973,0,24737,3,0.000011,13,0.206279,0.228949,1752.27574,0.155769,0.000658
304193,304193,,0,4,4,0,4,4,0,0,0,24738,23,0.00001,15,0.139361,0.146001,0,0.5,0
304194,304194,,0,10,10,0,10,10,0,0.000042,0,24739,10,0.00001,17,0.147566,0.159294,0,0.177778,0
304195,304195,,0,25,25,0,25,25,0,0.001606,0,24740,25,0.00001,15,0.199248,0.224256,0,0.093333,0
304196,304196,,0,13,13,0,13,13,0,0.001554,0,24741,8,0.00001,14,0.20324,0.226218,0,0.217949,0
304198,304198,,1,23,24,1,23,24,0.000122,0.001997,0,24742,41,0.00001,15,0.203646,0.224618,2712.975121,0.228261,0.000219
304199,304199,,0,6,6,0,6,6,0,0.000983,0,24743,0,0.00001,16,0.178304,0.197144,0,0.033333,0
304200,304200,,0,15,15,0,15,15,0,0.000297,0,24744,0,0.00001,15,0.186964,0.210766,0,0.161905,0
304201,304201,,0,14,14,0,14,14,0,0.000147,0,24745,30,0.00001,18,0.169042,0.191174,0,0.093407,0
304202,304202,,0,19,19,0,19,19,0,0.008027,0,24746,1,0.00001,20,0.181289,0.207195,0,0.111111,0
304203,304203,,0,4,4,0,4,4,0,0.000116,0,24747,2,0.00001,16,0.174402,0.192523,0,0.25,0
304205,304205,,0,5,5,0,5,5,0,0.000002,0,24748,6,0.00001,9,0.166667,0.228527,0,0.15,0
9611216,9611216,,5,0,5,5,0,5,0,0,0,10685,6,0.000042,0,0,0,0,0.05,0.001116
304206,304206,,2,37,39,2,37,39,0.000003,0.005203,0,24749,13,0.000011,16,0.186769,0.211454,4789.276727,0.091768,0.000438
304207,304207,,0,11,11,0,11,11,0,0.000072,0,24750,30,0.00001,14,0.181207,0.197412,0,0.354545,0
304208,304208,,0,29,29,0,29,29,0,0.006705,0,24751,1,0.00001,14,0.203652,0.226902,0,0.14532,0
304209,304209,,0,14,14,0,14,14,0,0.001438,0,24752,0,0.00001,16,0.17835,0.199201,0,0.10989,0
304210,304210,,0,20,20,0,20,20,0,0.001333,0,24753,2,0.00001,15,0.201291,0.224885,0,0.110526,0
304211,304211,,0,23,23,0,23,23,0,0.007505,0,24754,1,0.00001,18,0.174793,0.203258,0,0.144269,0
304212,304212,,0,10,10,0,10,10,0,0.000008,0,24755,0,0.00001,16,0.172205,0.189466,0,0.244444,0
304213,304213,,0,22,22,0,22,22,0,0.000931,0,24756,3,0.00001,14,0.200575,0.221945,0,0.235931,0
304214,304214,,0,5,5,0,5,5,0,0,0,24757,6,0.00001,11,0.16549,0.219404,0,0.1,0
304215,304215,,0,14,14,0,14,14,0,0.000077,0,24758,30,0.00001,16,0.197933,0.219491,0,0.10989,0
304216,304216,,0,18,18,0,18,18,0,0.002787,0,24759,0,0.00001,16,0.18562,0.208236,0,0.215686,0
304217,304217,,0,30,30,0,30,30,0,0.001464,0,24761,1,0.00001,13,0.205119,0.225644,0,0.125287,0
9903194,9903194,,1,26,27,1,26,27,0.000017,0.018406,0,24760,1,0.00001,14,0.197482,0.22511,209.546084,0.18661,0.000219
304219,304219,,1,14,15,1,14,15,0.000021,0.001238,0,24762,25,0.00001,16,0.176026,0.196883,29.832443,0.27619,0.000219
304220,304220,,0,40,40,0,40,40,0,0.011583,0,24763,8,0.00001,16,0.210348,0.238779,0,0.089103,0
304221,304221,,0,20,20,0,20,20,0,0.000618,0,24764,10,0.00001,21,0.179712,0.202054,0,0.118421,0
304222,304222,,0,15,15,0,15,15,0,0.000011,0,24765,20,0.00001,15,0.162915,0.180186,0,0.209524,0
304223,304223,,0,6,6,0,6,6,0,0.000015,0,24766,15,0.00001,17,0.146832,0.15743,0,0.166667,0
304224,304224,,0,36,36,0,36,36,0,0.000941,0,24767,3,0.00001,13,0.207014,0.231425,0,0.138889,0
304225,304225,,0,23,23,0,23,23,0,0.000318,0,24768,3,0.00001,15,0.193901,0.218497,0,0.13834,0
304226,304226,,0,42,42,0,42,42,0,0.003474,0,24769,3,0.00001,14,0.206875,0.235041,0,0.163763,0
304227,304227,,0,10,10,0,10,10,0,0.000175,0,24770,4,0.00001,22,0.175841,0.197893,0,0.222222,0
304228,304228,,0,11,11,0,11,11,0,0.000124,0,24771,4,0.00001,15,0.184346,0.206954,0,0.172727,0
304229,304229,,0,9,9,0,9,9,0,0.000559,0,24772,25,0.00001,17,0.177578,0.196021,0,0.097222,0
304230,304230,,1,21,22,1,21,22,0.000009,0.003192,0,24773,1,0.000011,14,0.203812,0.231238,5288.630198,0.155844,0.000219
304254,304254,,0,13,13,0,13,13,0,0.000786,0,24774,1,0.00001,15,0.184978,0.205492,0,0.185897,0
304231,304231,,0,41,41,0,41,41,0,0.017842,0,24775,8,0.00001,16,0.192693,0.218652,0,0.164634,0
304232,304232,,0,54,54,0,54,54,0,0.018155,0,24776,41,0.00001,17,0.198847,0.222166,0,0.318309,0
304233,304233,,0,14,14,0,14,14,0,0.000182,0,24777,13,0.00001,16,0.18142,0.205324,0,0.269231,0
304234,304234,,0,21,21,0,21,21,0,0.00026,0,24778,13,0.00001,14,0.196535,0.215922,0,0.095238,0
304235,304235,,0,7,7,0,7,7,0,0.000133,0,24779,4,0.00001,15,0.183247,0.20072,0,0.285714,0
304236,304236,,0,23,23,0,23,23,0,0.002307,0,24780,41,0.00001,14,0.202659,0.227792,0,0.213439,0
304237,304237,,0,27,27,0,27,27,0,0.001905,0,24781,0,0.00001,14,0.202977,0.229347,0,0.166667,0
304238,304238,,0,35,35,0,35,35,0,0.020813,0,24782,1,0.00001,14,0.213627,0.247441,0,0.127731,0
304239,304239,,0,19,19,0,19,19,0,0.001573,0,24783,41,0.00001,15,0.20679,0.228139,0,0.263158,0
304240,304240,,0,4,4,0,4,4,0,0,0,24784,6,0.00001,15,0.13797,0.151408,0,0,0
304241,304241,,0,39,39,0,39,39,0,0.000661,0,24785,3,0.00001,14,0.216418,0.240923,0,0.18556,0
304242,304242,,0,2,2,0,2,2,0,0,0,24786,23,0.00001,1,1,1,0,0.5,0
304243,304243,,0,3,3,0,3,3,0,0.000001,0,24787,0,0.00001,17,0.154236,0.168155,0,0.166667,0
304245,304245,,0,3,3,0,3,3,0,0.000003,0,24788,23,0.00001,12,0.156776,0.17168,0,0,0
304246,304246,,0,12,12,0,12,12,0,0.000038,0,24789,13,0.00001,16,0.17706,0.195536,0,0.151515,0
9604155,9604155,,5,2,7,5,2,7,0.000004,0.000162,0,2721,13,0.00003,15,0.183627,0.225209,4362.614719,0.238095,0.001205
304247,304247,,0,34,34,0,34,34,0,0.002069,0,24790,4,0.00001,14,0.197371,0.221309,0,0.164884,0
304248,304248,,0,1,1,0,1,1,0,0,0,24791,9,0.00001,18,0.142573,0.155221,0,0,0
9803161,9803161,,2,4,6,2,4,6,0,0.000091,0,12312,9,0.000024,17,0.166209,0.187255,7062.587787,0.033333,0.000445
304249,304249,,0,22,22,0,22,22,0,0.000001,0,24792,23,0.00001,14,0.164309,0.179425,0,0.257576,0
304250,304250,,0,36,36,0,36,36,0,0.01989,0,24793,25,0.00001,17,0.205906,0.233766,0,0.180159,0
304251,304251,,0,16,16,0,16,16,0,0.000589,0,24794,4,0.00001,15,0.182716,0.204762,0,0.191667,0
304252,304252,,0,11,11,0,11,11,0,0.00105,0,24795,5,0.00001,16,0.188373,0.208856,0,0.163636,0
304253,304253,,0,22,22,0,22,22,0,0.00131,0,24796,1,0.00001,15,0.183885,0.207575,0,0.168831,0
9504002,9504002,,1,0,1,1,0,1,0.000146,0,0,5196,13,0.00001,0,0,0,0,0,0.000273
9611095,9611095,,3,14,17,3,14,17,0.00023,0.002624,0,5194,13,0.000011,11,0.20854,0.244004,21453.053175,0.143382,0.000718
304255,304255,,0,31,31,0,31,31,0,0.010357,0,24797,41,0.00001,15,0.207835,0.237946,0,0.123656,0
304256,304256,,0,43,43,0,43,43,0,0.00199,0,24799,0,0.00001,15,0.203075,0.23286,0,0.062569,0
9906067,9906067,,1,2,3,1,2,3,0.000023,0.000001,0,24798,5,0.00001,1,1,1,2,0.166667,0.000219
304257,304257,,0,37,37,0,37,37,0,0.002181,0,24800,1,0.00001,15,0.208031,0.238624,0,0.126877,0
304258,304258,,0,45,45,0,45,45,0,0.003404,0,24801,0,0.00001,16,0.20382,0.233288,0,0.223737,0
304259,304259,,0,46,46,0,46,46,0,0.008474,0,24802,3,0.00001,14,0.222538,0.254472,0,0.104348,0
304260,304260,,0,21,21,0,21,21,0,0.000005,0,24803,6,0.00001,21,0.130562,0.143014,0,0.17381,0
304261,304261,,0,27,27,0,27,27,0,0.000542,0,24804,3,0.00001,15,0.178102,0.195391,0,0.294872,0
304262,304262,,0,23,23,0,23,23,0,0.001821,0,24805,25,0.00001,15,0.195945,0.21897,0,0.118577,0
304263,304263,,0,51,51,0,51,51,0,0.005206,0,24806,3,0.00001,14,0.213567,0.245338,0,0.096471,0
304264,304264,,0,4,4,0,4,4,0,0,0,24807,23,0.00001,20,0.122689,0.13086,0,0.333333,0
9612053,9612053,,1,3,4,1,3,4,0,0.000002,0,11239,23,0.000015,4,0.45,0.592593,284.75,0,0.000233
304265,304265,,0,2,2,0,2,2,0,0.000013,0,24808,1,0.00001,14,0.164703,0.175236,0,0.5,0
304266,304266,,0,19,19,0,19,19,0,0.002225,0,24809,25,0.00001,17,0.176227,0.201774,0,0.27193,0
304267,304267,,0,14,14,0,14,14,0,0.000084,0,24810,5,0.00001,15,0.167724,0.185835,0,0.098901,0
304268,304268,,0,34,34,0,34,34,0,0.002171,0,24811,30,0.00001,13,0.212605,0.238892,0,0.193405,0
304269,304269,,0,14,14,0,14,14,0,0.001212,0,24812,15,0.00001,15,0.192503,0.220943,0,0.120879,0
304270,304270,,0,49,49,0,49,49,0,0.001827,0,24813,3,0.00001,16,0.185625,0.209397,0,0.210034,0
304271,304271,,0,58,58,0,58,58,0,0.004524,0,24814,4,0.00001,15,0.199452,0.226191,0,0.100121,0
9201042,9201042,,2,0,2,2,0,2,0,0,0,4176,17,0.000131,0,0,0,0,0,0.000542
9205038,9205038,,0,2,2,0,2,2,0,0.000004,0,24816,15,0.00001,1,1,1,0,0,0
9202079,9202079,,1,0,1,1,0,1,0,0,0,24815,15,0.000014,0,0,0,0,0,0.000219
9205104,9205104,,0,1,1,0,1,1,0,0,0,24817,5,0.00001,1,1,1,0,0,0
9202076,9202076,,2,0,2,2,0,2,0,0,0,17159,15,0.000033,0,0,0,0,0,0.000452
9206079,9206079,,1,3,4,1,3,4,0.000016,0.000027,0,2640,13,0.00001,1,1,1,4.653934,0.25,0.000245
9207013,9207013,,1,1,2,1,1,2,0,0,0,24818,9,0.000012,1,1,1,1,0,0.000219
9207028,9207028,,7,1,8,7,1,8,0,0,0,4177,17,0.000081,1,1,1,4579.260272,0.107143,0.001685
9207036,9207036,,0,1,1,0,1,1,0,0.000001,0,24819,15,0.00001,1,1,1,0,0,0
9207059,9207059,,0,1,1,0,1,1,0,0,47,24821,70,0.00001,1,1,1,0,0,0
9204021,9204021,,1,0,1,1,0,1,0,0,47,24820,70,0.000019,0,0,0,0,0,0.000219
9207063,9207063,,0,2,2,0,2,2,0,0.000021,0,24822,5,0.00001,1,1,1,0,0,0
9207093,9207093,,0,1,1,0,1,1,0,0,48,24824,71,0.00001,1,1,1,0,0,0
9206073,9206073,,2,0,2,2,0,2,0,0,48,24823,71,0.000028,0,0,0,0,0,0.000438
9208021,9208021,,0,1,1,0,1,1,0,0.000001,0,24825,6,0.00001,1,1,1,0,0,0
9208022,9208022,,1,2,3,1,2,3,0.000001,0.000023,0,10881,4,0.000011,1,1,1,0,0.333333,0.000226
9208043,9208043,,0,2,2,0,2,2,0,0,49,24828,72,0.00001,1,1,1,0,0,0
9207029,9207029,,3,0,3,3,0,3,0,0,49,24827,72,0.000028,0,0,0,0,0,0.000658
9207030,9207030,,2,0,2,2,0,2,0,0,49,24826,72,0.000019,0,0,0,0,0,0.000438
9208054,9208054,,1,3,4,1,3,4,0,0.000019,0,4256,4,0.000011,1,1,1,11.957183,0,0.00026
9208064,9208064,,5,1,6,5,1,6,0.000003,0.000003,0,930,5,0.000015,1,1,1,7.107576,0.066667,0.001135
9208068,9208068,,1,1,2,1,1,2,0,0,0,3218,9,0.000011,1,1,1,10671.578498,0,0.000242
9208077,9208077,,5,1,6,5,1,6,0.000001,0,0,24829,6,0.000035,1,1,1,6,0.066667,0.001116
9208081,9208081,,0,5,5,0,5,5,0,0.000025,0,24830,5,0.00001,1,1,1,0,0,0
9204038,9204038,,2,0,2,2,0,2,0,0,0,2001,5,0.000016,0,0,0,0,0,0.000541
9203024,9203024,,3,0,3,3,0,3,0,0,0,454,9,0.000112,0,0,0,0,0,0.0009
9202050,9202050,,8,0,8,8,0,8,0.000001,0,0,606,5,0.00028,0,0,0,0,0.125,0.001966
9205013,9205013,,1,0,1,1,0,1,0,0,0,1047,9,0.000049,0,0,0,0,0,0.000282
9209084,9209084,,0,1,1,0,1,1,0,0.000002,0,24831,28,0.00001,1,1,1,0,0,0
9209092,9209092,,0,2,2,0,2,2,0,0,49,24832,72,0.00001,1,1,1,0,0,0
9209098,9209098,,0,1,1,0,1,1,0,0,0,24833,22,0.00001,1,1,1,0,0,0
9209108,9209108,,0,1,1,0,1,1,0,0,0,24834,9,0.00001,1,1,1,0,0,0
9210006,9210006,,0,2,2,0,2,2,0,0.000072,0,24835,25,0.00001,1,1,1,0,0,0
9210066,9210066,,2,6,8,2,6,8,0,0.000023,0,1497,9,0.000013,2,0.8,0.875,12585.868351,0.071429,0.000465
9203028,9203028,,2,0,2,2,0,2,0,0,0,1496,9,0.000014,0,0,0,0,0.5,0.000458
9208065,9208065,,4,0,4,4,0,4,0.000001,0,0,1494,9,0.000016,0,0,0,0,0.333333,0.00093
9210079,9210079,,1,3,4,1,3,4,0.000005,0.000027,0,1104,13,0.000014,1,1,1,43.631647,0.25,0.000282
9210080,9210080,,0,4,4,0,4,4,0,0,0,24836,9,0.00001,2,0.833333,0.9,0,0.083333,0
9210088,9210088,,0,1,1,0,1,1,0,0.00001,0,24837,5,0.00001,1,1,1,0,0,0
9210101,9210101,,0,6,6,0,6,6,0,0.000042,0,24838,5,0.00001,1,1,1,0,0,0
9210111,9210111,,0,1,1,0,1,1,0,0,0,24839,22,0.00001,1,1,1,0,0,0
9210113,9210113,,0,1,1,0,1,1,0,0.000001,0,24840,22,0.00001,1,1,1,0,0,0
9210156,9210156,,0,1,1,0,1,1,0,0,50,24842,73,0.00001,1,1,1,0,0,0
9205026,9205026,,1,0,1,1,0,1,0,0,50,24841,73,0.000019,0,0,0,0,0,0.000219
9210157,9210157,,1,2,3,1,2,3,0,0,0,24843,22,0.000013,1,1,1,1,0.166667,0.000219
9205001,9205001,,2,0,2,2,0,2,0,0,0,13400,22,0.000021,0,0,0,0,0,0.000458
9205087,9205087,,5,0,5,5,0,5,0,0,0,13399,22,0.000037,0,0,0,0,0.2,0.001135
9210165,9210165,,0,2,2,0,2,2,0,0.000015,0,24844,5,0.00001,2,0.75,0.833333,0,0,0
9211009,9211009,,1,3,4,1,3,4,0,0.000001,0,24845,15,0.00001,1,1,1,2,0.166667,0.000219
9211013,9211013,,0,1,1,0,1,1,0,0.000011,0,24846,17,0.00001,1,1,1,0,0,0
9211031,9211031,,0,1,1,0,1,1,0,0,51,24848,74,0.00001,1,1,1,0,0,0
9211002,9211002,,1,0,1,1,0,1,0,0,51,24847,74,0.000019,0,0,0,0,0,0.000219
9211033,9211033,,1,3,4,1,3,4,0,0.000002,0,11464,6,0.000011,2,0.8,0.875,16.371703,0.166667,0.000254
9211036,9211036,,1,6,7,1,6,7,0,0.00001,0,24849,9,0.000011,2,0.75,0.833333,7,0.095238,0.000219
9211051,9211051,,0,1,1,0,1,1,0,0.000021,0,24850,9,0.00001,1,1,1,0,0,0
9211058,9211058,,0,1,1,0,1,1,0,0,0,24851,26,0.00001,1,1,1,0,0,0
9205100,9205100,,4,0,4,4,0,4,0.000004,0,0,6349,26,0.000031,0,0,0,0,0.083333,0.000897
9211068,9211068,,0,1,1,0,1,1,0,0,0,24852,6,0.00001,1,1,1,0,0,0
9211070,9211070,,3,3,6,3,3,6,0.000003,0.000005,0,2047,6,0.000055,2,0.8,0.875,12802.443213,0,0.00074
9211077,9211077,,0,3,3,0,3,3,0,0,0,24853,15,0.00001,1,1,1,0,0.333333,0
9211081,9211081,,0,3,3,0,3,3,0,0.00006,0,24854,13,0.00001,3,0.571429,0.666667,0,0,0
9211087,9211087,,0,1,1,0,1,1,0,0,52,24856,75,0.00001,1,1,1,0,0,0
9205002,9205002,,1,0,1,1,0,1,0,0,52,24855,75,0.000019,0,0,0,0,0,0.000219
9211098,9211098,,0,1,1,0,1,1,0,0,0,24857,9,0.00001,1,1,1,0,0,0
9211110,9211110,,0,4,4,0,4,4,0,0.000122,0,24858,0,0.00001,1,1,1,0,0,0
9212002,9212002,,0,10,10,0,10,10,0,0.000052,0,24860,5,0.00001,1,1,1,0,0,0
9209064,9209064,,1,0,1,1,0,1,0.000001,0,0,24859,5,0.000011,0,0,0,0,0,0.000219
9212013,9212013,,1,1,2,1,1,2,0,0,0,10552,15,0.000011,2,0.666667,0.75,1046.177038,0,0.000232
9212025,9212025,,0,1,1,0,1,1,0,0.000001,0,24861,3,0.00001,1,1,1,0,0,0
9212044,9212044,,0,1,1,0,1,1,0,0.000001,0,24862,5,0.00001,1,1,1,0,0,0
9212055,9212055,,0,1,1,0,1,1,0,0,49,24863,72,0.00001,1,1,1,0,0,0
9212061,9212061,,0,2,2,0,2,2,0,0.000011,0,24864,17,0.00001,1,1,1,0,0,0
9212069,9212069,,2,2,4,2,2,4,0,0.000005,0,13101,17,0.000107,1,1,1,1048.651695,0.083333,0.00046
9201037,9201037,,3,0,3,3,0,3,0,0,0,13100,17,0.000066,0,0,0,0,0.166667,0.000684
9212080,9212080,,0,1,1,0,1,1,0,0,0,24866,5,0.00001,1,1,1,0,0,0
9201068,9201068,,3,0,3,3,0,3,0,0,0,24865,5,0.000024,0,0,0,0,0,0.000664
9212081,9212081,,2,3,5,2,3,5,0.000008,0,0,1444,9,0.000014,1,1,1,16999.674655,0.05,0.000525
9204016,9204016,,4,0,4,4,0,4,0.000008,0,0,1443,9,0.000023,0,0,0,0,0.166667,0.000897
9212095,9212095,,1,4,5,1,4,5,0,0.000051,0,24867,13,0.00002,3,0.571429,0.708333,8.5,0,0.000226
9212100,9212100,,1,5,6,1,5,6,0,0.000003,0,1498,9,0.000011,3,0.578947,0.69697,7419,0.166667,0.000239
9206031,9206031,,3,0,3,3,0,3,0,0,0,452,9,0.000052,0,0,0,0,0.166667,0.000786
9212114,9212114,,1,5,6,1,5,6,0,0,0,24868,17,0.000011,2,0.777778,0.857143,3,0.1,0.000219
9212124,9212124,,0,1,1,0,1,1,0,0.000001,0,24869,6,0.00001,1,1,1,0,0,0
9212137,9212137,,3,1,4,3,1,4,0,0,0,6047,15,0.000023,1,1,1,0,0.25,0.000699
9212139,9212139,,0,5,5,0,5,5,0,0.000036,0,24870,5,0.00001,1,1,1,0,0,0
9212158,9212158,,0,1,1,0,1,1,0,0.000001,0,24871,4,0.00001,1,1,1,0,0,0
9301022,9301022,,0,3,3,0,3,3,0,0.000023,0,24872,9,0.00001,1,1,1,0,0,0
9301028,9301028,,1,4,5,1,4,5,0.000002,0.000018,0,768,15,0.000011,1,1,1,36751.949982,0.05,0.00026
9207041,9207041,,3,0,3,3,0,3,0,0,0,757,15,0.000066,0,0,0,0,0,0.000738
9301065,9301065,,0,2,2,0,2,2,0,0.000001,0,24873,26,0.00001,1,1,1,0,0,0
9301076,9301076,,1,1,2,1,1,2,0,0,0,5985,4,0.000012,1,1,1,9834,0,0.000227
9301051,9301051,,1,0,1,1,0,1,0,0,0,5984,4,0.00002,0,0,0,0,0,0.000226
9301081,9301081,,0,2,2,0,2,2,0,0.000001,0,24874,26,0.00001,1,1,1,0,0,0
9301104,9301104,,0,3,3,0,3,3,0,0,0,24876,6,0.00001,1,1,1,0,0,0
9210083,9210083,,1,0,1,1,0,1,0,0,0,24875,6,0.000013,0,0,0,0,0,0.000219
9301108,9301108,,0,2,2,0,2,2,0,0,0,24877,9,0.00001,1,1,1,0,0,0
9301112,9301112,,0,2,2,0,2,2,0,0.000011,0,24878,9,0.00001,2,0.75,0.833333,0,0,0
9301125,9301125,,0,15,15,0,15,15,0,0.000215,0,24880,13,0.00001,3,0.580247,0.652482,0,0.071429,0
9206017,9206017,,1,0,1,1,0,1,0.000003,0,0,24879,13,0.00001,0,0,0,0,0,0.000219
9301126,9301126,,1,1,2,1,1,2,0,0.000001,0,24881,15,0.000023,2,0.666667,0.75,4,0,0.000226
9301130,9301130,,0,1,1,0,1,1,0,0,0,24882,30,0.00001,1,1,1,0,0,0
9206001,9206001,,1,0,1,1,0,1,0,0,0,2017,6,0.000019,0,0,0,0,0,0.000259
9302009,9302009,,0,3,3,0,3,3,0,0.000012,0,24883,5,0.00001,1,1,1,0,0,0
9302011,9302011,,1,1,2,1,1,2,0,0.00001,0,6249,5,0.000012,1,1,1,0.333333,0,0.000246
9302024,9302024,,1,7,8,1,7,8,0.000001,0.000054,0,1991,5,0.00001,1,1,1,14.392971,0.107143,0.000231
9302030,9302030,,2,1,3,2,1,3,0,0.00001,0,24884,10,0.000016,1,1,1,2,0.166667,0.000445
9302054,9302054,,0,1,1,0,1,1,0,0,53,24886,76,0.00001,1,1,1,0,0,0
9209039,9209039,,2,0,2,2,0,2,0,0,53,24885,76,0.000028,0,0,0,0,0,0.000438
9302064,9302064,,2,1,3,2,1,3,0,0,0,13402,22,0.000013,1,1,1,0,0.333333,0.000445
9302065,9302065,,1,2,3,1,2,3,0.000003,0.000075,0,24887,13,0.000011,1,1,1,0,0.333333,0.000219
9302075,9302075,,6,1,7,6,1,7,0.000008,0.000002,0,938,5,0.000025,1,1,1,146.155617,0.047619,0.001461
9302077,9302077,,1,5,6,1,5,6,0.000006,0.000024,0,24888,13,0.000011,4,0.5,0.641026,2.783333,0.133333,0.000226
9207062,9207062,,1,0,1,1,0,1,0,0,0,1798,28,0.000018,0,0,0,0,0,0.000285
9302092,9302092,,2,2,4,2,2,4,0.00002,0.000001,0,5478,15,0.000015,1,1,1,2,0.166667,0.000466
9302106,9302106,,0,2,2,0,2,2,0,0.000023,0,24889,9,0.00001,1,1,1,0,0,0
9302108,9302108,,0,4,4,0,4,4,0,0.00009,0,24890,13,0.00001,1,1,1,0,0,0
9302135,9302135,,0,1,1,0,1,1,0,0,0,24891,15,0.00001,1,1,1,0,0,0
9302143,9302143,,0,5,5,0,5,5,0,0.000001,0,24892,9,0.00001,2,0.692308,0.777778,0,0.05,0
9303002,9303002,,1,3,4,1,3,4,0.000001,0.000029,0,12126,5,0.000011,2,0.8,0.875,1.5,0.083333,0.000226
9303003,9303003,,0,3,3,0,3,3,0,0.000129,0,24893,0,0.00001,1,1,1,0,0,0
9303004,9303004,,0,1,1,0,1,1,0,0,0,24894,22,0.00001,1,1,1,0,0,0
9202090,9202090,,2,0,2,2,0,2,0,0,0,2175,23,0.000039,0,0,0,0,0,0.000454
9303023,9303023,,0,1,1,0,1,1,0,0,0,24895,23,0.00001,1,1,1,0,0,0
9303031,9303031,,1,2,3,1,2,3,0.000001,0.000001,0,24896,4,0.000011,1,1,1,1,0.166667,0.000219
9303033,9303033,,4,2,6,4,2,6,0.000004,0.000004,0,1096,28,0.000019,1,1,1,800.230073,0.233333,0.000962
9303078,9303078,,1,1,2,1,1,2,0,0,54,24898,90,0.000014,1,1,1,1,0,0.000219
9204033,9204033,,2,0,2,2,0,2,0,0,54,24897,90,0.000032,0,0,0,0,0,0.000445
9303079,9303079,,1,4,5,1,4,5,0,0.000001,0,24899,4,0.00001,2,0.75,0.833333,0.5,0.15,0.000219
9303087,9303087,,2,1,3,2,1,3,0,0,0,24900,9,0.000014,1,1,1,0,0.5,0.000445
9303089,9303089,,2,2,4,2,2,4,0,0.000004,0,1095,28,0.000015,1,1,1,0,0.333333,0.000494
9303090,9303090,,9,5,14,9,5,14,0.000001,0.000006,0,3008,17,0.000035,1,1,1,1402.640628,0.137363,0.002114
9206099,9206099,,11,0,11,11,0,11,0.000002,0,0,3006,17,0.000037,0,0,0,0,0.181818,0.002721
9206102,9206102,,8,0,8,8,0,8,0.000002,0,0,3005,17,0.000033,0,0,0,0,0.160714,0.001977
9303094,9303094,,0,2,2,0,2,2,0,0.000006,0,24901,9,0.00001,1,1,1,0,0,0
9204067,9204067,,2,0,2,2,0,2,0,0,0,9347,9,0.000023,0,0,0,0,0,0.000458
9303110,9303110,,1,1,2,1,1,2,0.000001,0,0,4812,15,0.000011,1,1,1,1435.385961,0,0.000227
9303125,9303125,,1,1,2,1,1,2,0,0,0,7471,5,0.000011,1,1,1,2,0,0.000239
9303126,9303126,,0,2,2,0,2,2,0,0.000007,0,24902,5,0.00001,2,0.75,0.833333,0,0,0
9303134,9303134,,0,1,1,0,1,1,0,0.000003,0,24903,5,0.00001,1,1,1,0,0,0
9303135,9303135,,0,1,1,0,1,1,0,0.000001,0,24904,0,0.00001,1,1,1,0,0,0
9303138,9303138,,0,3,3,0,3,3,0,0.000001,0,24905,4,0.00001,1,1,1,0,0,0
9303157,9303157,,1,1,2,1,1,2,0,0.000005,0,24906,9,0.000011,2,0.666667,0.75,1.5,0,0.000219
9303163,9303163,,0,1,1,0,1,1,0,0,0,24907,22,0.00001,1,1,1,0,0,0
9303169,9303169,,0,1,1,0,1,1,0,0,55,24909,77,0.00001,1,1,1,0,0,0
9302016,9302016,,1,0,1,1,0,1,0,0,55,24908,77,0.000019,0,0,0,0,0,0.000219
9303173,9303173,,0,1,1,0,1,1,0,0.000006,0,24910,41,0.00001,1,1,1,0,0,0
9303174,9303174,,1,1,2,1,1,2,0,0,0,8904,23,0.000015,1,1,1,6384,0,0.000233
9211024,9211024,,2,0,2,2,0,2,0,0,0,8903,23,0.000025,0,0,0,0,0,0.000445
9303177,9303177,,2,1,3,2,1,3,0,0,0,24911,22,0.000028,1,1,1,2,0,0.000438
9304001,9304001,,1,1,2,1,1,2,0.000014,0.000003,0,3604,26,0.000011,1,1,1,11.25,0,0.000233
9304004,9304004,,2,2,4,2,2,4,0.000016,0.000004,0,5411,9,0.000011,1,1,1,82.643273,0,0.000452
9304010,9304010,,1,13,14,1,13,14,0.000001,0.00008,0,24912,5,0.00001,1,1,1,4.892857,0.027473,0.000219
9304038,9304038,,3,1,4,3,1,4,0,0,0,1058,9,0.000013,1,1,1,4243.015483,0.25,0.000708
9304044,9304044,,0,1,1,0,1,1,0,0.000017,0,24913,5,0.00001,2,0.666667,0.75,0,0,0
9304054,9304054,,0,1,1,0,1,1,0,0.000003,0,24914,26,0.00001,1,1,1,0,0,0
9210146,9210146,,1,0,1,1,0,1,0,0,0,1977,6,0.000019,0,0,0,0,0,0.000268
9304058,9304058,,0,1,1,0,1,1,0,0,56,24916,78,0.00001,1,1,1,0,0,0
9212132,9212132,,2,0,2,2,0,2,0,0,56,24915,78,0.000028,0,0,0,0,0,0.000438
9207055,9207055,,2,0,2,2,0,2,0.000012,0,0,5429,17,0.000016,0,0,0,0,0,0.000452
9304066,9304066,,0,3,3,0,3,3,0,0.00008,0,24917,0,0.00001,1,1,1,0,0,0
9304069,9304069,,0,2,2,0,2,2,0,0.000047,0,24918,3,0.00001,2,0.75,0.833333,0,0,0
9304077,9304077,,0,1,1,0,1,1,0,0,57,24920,79,0.00001,1,1,1,0,0,0
9203037,9203037,,1,0,1,1,0,1,0,0,57,24919,79,0.000019,0,0,0,0,0,0.000219
9304083,9304083,,6,2,8,6,2,8,0.000002,0,0,6765,9,0.000021,1,1,1,5877.560362,0.25,0.001431
9207022,9207022,,2,0,2,2,0,2,0,0,0,6764,9,0.000021,0,0,0,0,0.5,0.000506
9210125,9210125,,5,0,5,5,0,5,0,0,0,6763,9,0.000027,0,0,0,0,0.5,0.001238
9304090,9304090,,4,3,7,4,3,7,0.000001,0.000003,0,3015,17,0.000014,1,1,1,784.921673,0.285714,0.000963
9304093,9304093,,0,1,1,0,1,1,0,0.000004,0,24921,5,0.00001,1,1,1,0,0,0
9304105,9304105,,0,2,2,0,2,2,0,0.000011,0,24922,25,0.00001,1,1,1,0,0,0
9304109,9304109,,0,4,4,0,4,4,0,0.000013,0,24923,5,0.00001,4,0.378049,0.438172,0,0.25,0
9304113,9304113,,0,1,1,0,1,1,0,0,48,24924,71,0.00001,1,1,1,0,0,0
9304129,9304129,,0,8,8,0,8,8,0,0.000377,0,24925,5,0.00001,3,0.6,0.68254,0,0.089286,0
9304132,9304132,,1,1,2,1,1,2,0,0.000001,0,24926,52,0.000012,1,1,1,0,0.5,0.000219
9304134,9304134,,1,2,3,1,2,3,0.000001,0,0,24929,3,0.000011,1,1,1,0,0.333333,0.000219
9301107,9301107,,2,0,2,2,0,2,0.000001,0,0,24928,3,0.000016,0,0,0,0,0.5,0.000445
9303084,9303084,,2,0,2,2,0,2,0.000001,0,0,24927,3,0.000016,0,0,0,0,0.5,0.000445
9304137,9304137,,0,1,1,0,1,1,0,0.000001,0,24930,15,0.00001,2,0.666667,0.75,0,0,0
9304162,9304162,,0,2,2,0,2,2,0,0.000001,0,24931,4,0.00001,1,1,1,0,0,0
9305006,9305006,,0,1,1,0,1,1,0,0,0,24932,15,0.00001,1,1,1,0,0,0
9305008,9305008,,0,2,2,0,2,2,0,0.000006,0,24933,5,0.00001,1,1,1,0,0,0
9305017,9305017,,3,2,5,3,2,5,0.000033,0,0,1893,6,0.000015,1,1,1,427.735707,0.05,0.000693
9305019,9305019,,0,5,5,0,5,5,0,0.000012,0,24934,4,0.00001,2,0.777778,0.857143,0,0.2,0
9305022,9305022,,0,1,1,0,1,1,0,0,0,24935,15,0.00001,1,1,1,0,0,0
9305034,9305034,,1,3,4,1,3,4,0,0.000002,0,24936,15,0.000011,1,1,1,0,0.25,0.000219
9307143,9307143,,0,17,17,0,17,17,0,0.000106,0,24937,5,0.00001,3,0.705882,0.833333,0,0.040441,0
9307157,9307157,,0,8,8,0,8,8,0,0.000047,0,24938,5,0.00001,2,0.75,0.833333,0,0.053571,0
9307181,9307181,,1,5,6,1,5,6,0.000001,0.000032,0,24939,5,0.00001,1,1,1,0,0.166667,0.000219
9305044,9305044,,0,1,1,0,1,1,0,0,0,24940,6,0.00001,1,1,1,0,0,0
9305049,9305049,,0,2,2,0,2,2,0,0.000001,0,24941,15,0.00001,1,1,1,0,0,0
9305051,9305051,,1,1,2,1,1,2,0,0,0,24943,15,0.000014,1,1,1,1,0,0.000219
9301091,9301091,,1,0,1,1,0,1,0,0,0,24942,15,0.000023,0,0,0,0,0,0.000226
9305065,9305065,,0,2,2,0,2,2,0,0.000011,0,24944,25,0.00001,1,1,1,0,0,0
9305070,9305070,,0,2,2,0,2,2,0,0,0,24945,9,0.00001,1,1,1,0,0,0
9305089,9305089,,0,4,4,0,4,4,0,0.00009,0,24946,13,0.00001,1,1,1,0,0,0
9305096,9305096,,2,1,3,2,1,3,0,0,0,24948,9,0.000012,1,1,1,0,0.333333,0.000438
9303166,9303166,,3,0,3,3,0,3,0,0,0,24947,9,0.000023,0,0,0,0,0.333333,0.00067
9305101,9305101,,0,2,2,0,2,2,0,0,0,24949,15,0.00001,2,0.625,0.7,0,0,0
9305105,9305105,,0,3,3,0,3,3,0,0.000123,0,24950,23,0.00001,2,0.8,0.875,0,0,0
9305106,9305106,,1,2,3,1,2,3,0.000001,0.00005,0,524,3,0.000015,4,0.4375,0.492063,0,0.5,0.000259
9305118,9305118,,0,1,1,0,1,1,0,0.000005,0,24951,15,0.00001,1,1,1,0,0,0
9305124,9305124,,0,7,7,0,7,7,0,0.000197,0,24952,6,0.00001,2,0.818182,0.888889,0,0.071429,0
9305126,9305126,,1,1,2,1,1,2,0,0.000001,0,24953,26,0.000019,1,1,1,1,0,0.000219
9305127,9305127,,1,3,4,1,3,4,0,0,0,24954,6,0.00001,1,1,1,1.333333,0.083333,0.000219
9305140,9305140,,1,1,2,1,1,2,0.00002,0.000003,0,5476,15,0.00001,4,0.42,0.460317,0,0.5,0.000247
9305164,9305164,,0,3,3,0,3,3,0,0,0,24955,22,0.00001,1,1,1,0,0,0
9206089,9206089,,5,0,5,5,0,5,0,0,0,6092,28,0.000031,0,0,0,0,0.1,0.001143
9305176,9305176,,2,1,3,2,1,3,0.00002,0,0,5475,15,0.000011,1,1,1,10626.289065,0,0.000466
9305178,9305178,,1,1,2,1,1,2,0,0.000002,0,24956,26,0.000019,1,1,1,1,0,0.000219
9212040,9212040,,2,0,2,2,0,2,0,0,0,1894,6,0.000013,0,0,0,0,0,0.000461
9306011,9306011,,1,4,5,1,4,5,0,0,0,24959,10,0.000013,2,0.833333,0.9,3,0.05,0.000219
9302113,9302113,,2,0,2,2,0,2,0.000009,0,0,24958,10,0.000013,0,0,0,0,0,0.000451
9305104,9305104,,1,0,1,1,0,1,0,0,0,24957,10,0.000013,0,0,0,0,0,0.000226
9306020,9306020,,0,1,1,0,1,1,0,0.000027,0,24960,0,0.00001,1,1,1,0,0,0
9306022,9306022,,0,1,1,0,1,1,0,0.000005,0,24961,15,0.00001,1,1,1,0,0,0
9306024,9306024,,1,1,2,1,1,2,0,0.000001,0,24962,22,0.000019,1,1,1,1,0,0.000219
9306025,9306025,,2,1,3,2,1,3,0,0.00001,0,24963,9,0.000013,1,1,1,0,0.333333,0.000445
9306026,9306026,,3,3,6,3,3,6,0,0.00001,0,3210,9,0.000013,2,0.8,0.875,5.72619,0.1,0.000664
9306038,9306038,,0,1,1,0,1,1,0,0,0,24964,9,0.00001,1,1,1,0,0,0
9306045,9306045,,0,1,1,0,1,1,0,0.000004,0,24965,22,0.00001,1,1,1,0,0,0
9306047,9306047,,0,1,1,0,1,1,0,0.000027,0,24966,0,0.00001,1,1,1,0,0,0
9306059,9306059,,1,8,9,1,8,9,0,0.000024,0,12599,9,0.000012,3,0.521739,0.625,75.630952,0.138889,0.000253
9306060,9306060,,0,1,1,0,1,1,0,0,53,24967,76,0.00001,1,1,1,0,0,0
9306070,9306070,,0,1,1,0,1,1,0,0.000017,0,24968,5,0.00001,2,0.666667,0.75,0,0,0
9306074,9306074,,1,1,2,1,1,2,0,0.000004,0,15908,26,0.000012,1,1,1,3.142857,0,0.000226
9207099,9207099,,1,0,1,1,0,1,0,0,0,14242,22,0.000013,0,0,0,0,0,0.000226
9306081,9306081,,0,2,2,0,2,2,0,0.000005,0,24970,9,0.00001,2,0.75,0.833333,0,0,0
9208019,9208019,,1,0,1,1,0,1,0,0,0,24969,9,0.000014,0,0,0,0,0,0.000219
9306088,9306088,,3,1,4,3,1,4,0.000001,0,0,244,26,0.000016,1,1,1,516.977874,0.083333,0.000674
9306099,9306099,,1,1,2,1,1,2,0,0.000006,0,13224,6,0.000012,1,1,1,3,0,0.000226
9306105,9306105,,0,4,4,0,4,4,0,0,0,24972,41,0.00001,1,1,1,0,0.166667,0
9301117,9301117,,1,0,1,1,0,1,0,0,0,24971,41,0.000012,0,0,0,0,0,0.000219
9306109,9306109,,0,3,3,0,3,3,0,0.000029,0,24973,2,0.00001,1,1,1,0,0.333333,0
9306112,9306112,,0,2,2,0,2,2,0,0.000001,0,24974,5,0.00001,1,1,1,0,0,0
9306114,9306114,,0,2,2,0,2,2,0,0.000001,0,24975,23,0.00001,2,0.75,0.833333,0,0,0
9306136,9306136,,0,1,1,0,1,1,0,0,0,24976,15,0.00001,1,1,1,0,0,0
9203021,9203021,,1,0,1,1,0,1,0,0,0,1817,5,0.000017,0,0,0,0,0,0.000233
9205032,9205032,,1,0,1,1,0,1,0,0,0,1816,5,0.000017,0,0,0,0,0,0.000233
9306151,9306151,,1,2,3,1,2,3,0.000012,0.000001,0,1239,13,0.000012,1,1,1,20.460939,0,0.000244
9307005,9307005,,0,2,2,0,2,2,0,0.000006,0,24977,5,0.00001,2,0.625,0.7,0,0,0
9307008,9307008,,0,5,5,0,5,5,0,0,0,24979,6,0.00001,1,1,1,0,0.05,0
9303096,9303096,,3,0,3,3,0,3,0,0,0,24978,6,0.000015,0,0,0,0,0,0.000658
9307016,9307016,,0,2,2,0,2,2,0,0.000005,0,24980,9,0.00001,1,1,1,0,0,0
9206066,9206066,,2,0,2,2,0,2,0,0,0,3963,9,0.000018,0,0,0,0,0,0.000445
9307017,9307017,,1,3,4,1,3,4,0,0.000005,0,3964,9,0.000011,1,1,1,12268.784006,0,0.000261
9307024,9307024,,1,2,3,1,2,3,0.000001,0.000014,0,6000,3,0.000012,1,1,1,3.710714,0,0.000227
9307029,9307029,,2,1,3,2,1,3,0.000007,0.000026,0,2881,0,0.000012,2,0.666667,0.75,153.784236,0.166667,0.000505
9307053,9307053,,0,4,4,0,4,4,0,0.000032,0,24981,26,0.00001,2,0.75,0.833333,0,0.083333,0
9307054,9307054,,3,9,12,3,9,12,0.000001,0.000018,0,3014,17,0.000014,2,0.909091,0.95,4918.614303,0.113636,0.000744
9307060,9307060,,0,1,1,0,1,1,0,0.000008,0,24982,28,0.00001,1,1,1,0,0,0
9307064,9307064,,0,5,5,0,5,5,0,0.000001,0,24983,9,0.00001,2,0.777778,0.857143,0,0.05,0
9307072,9307072,,0,2,2,0,2,2,0,0.00002,0,24984,5,0.00001,1,1,1,0,0,0
9307073,9307073,,1,2,3,1,2,3,0.000002,0.000025,0,3146,4,0.000011,5,0.290598,0.344118,1253.418502,0,0.000254
9307076,9307076,,1,2,3,1,2,3,0.000001,0.000001,0,24985,52,0.000011,1,1,1,2,0,0.000219
9205067,9205067,,2,0,2,2,0,2,0,0,0,2322,52,0.000017,0,0,0,0,0,0.000465
9210093,9210093,,2,0,2,2,0,2,0,0,0,1089,28,0.000016,0,0,0,0,0.5,0.00048
9307103,9307103,,0,2,2,0,2,2,0,0,0,24986,6,0.00001,1,1,1,0,0,0
9307105,9307105,,0,2,2,0,2,2,0,0.000004,0,24987,5,0.00001,1,1,1,0,0,0
9207081,9207081,,2,0,2,2,0,2,0.000001,0,0,1171,15,0.000023,0,0,0,0,0,0.000502
9307124,9307124,,0,2,2,0,2,2,0,0,0,24988,6,0.00001,1,1,1,0,0,0
9307125,9307125,,1,1,2,1,1,2,0,0.000001,0,5422,15,0.000012,1,1,1,0,0.5,0.000226
9307128,9307128,,0,1,1,0,1,1,0,0,58,24990,80,0.00001,1,1,1,0,0,0
9208050,9208050,,1,0,1,1,0,1,0,0,58,24989,80,0.000019,0,0,0,0,0,0.000219
9307129,9307129,,0,2,2,0,2,2,0,0,0,24991,6,0.00001,1,1,1,0,0,0
9307130,9307130,,0,2,2,0,2,2,0,0,0,24992,6,0.00001,1,1,1,0,0,0
9307131,9307131,,0,1,1,0,1,1,0,0.000004,0,24993,5,0.00001,1,1,1,0,0,0
9305113,9305113,,2,0,2,2,0,2,0,0,0,1283,9,0.000013,0,0,0,0,0.5,0.00051
9306142,9306142,,2,0,2,2,0,2,0,0,0,1282,9,0.000013,0,0,0,0,0.5,0.00051
9307149,9307149,,0,1,1,0,1,1,0,0.000005,0,24994,15,0.00001,1,1,1,0,0,0
9307150,9307150,,0,1,1,0,1,1,0,0,0,24995,15,0.00001,1,1,1,0,0,0
9307154,9307154,,6,6,12,6,6,12,0.000079,0.000006,0,3012,17,0.000028,1,1,1,1398.009462,0.136364,0.001396
9208017,9208017,,2,0,2,2,0,2,0,0,0,2650,22,0.000146,0,0,0,0,0.5,0.000593
9307179,9307179,,0,2,2,0,2,2,0,0,0,24996,15,0.00001,1,1,1,0,0,0
9307197,9307197,,1,2,3,1,2,3,0,0,0,24997,6,0.000012,1,1,1,0,0.333333,0.000219
9308008,9308008,,0,1,1,0,1,1,0,0,0,24998,6,0.00001,1,1,1,0,0,0
9308011,9308011,,0,7,7,0,7,7,0,0.000032,0,24999,5,0.00001,3,0.539683,0.593137,0,0.095238,0
9308016,9308016,,1,3,4,1,3,4,0,0,0,25000,9,0.00001,1,1,1,1,0.25,0.000219
9308017,9308017,,1,4,5,1,4,5,0,0.000002,0,25001,9,0.000019,2,0.833333,0.9,5,0.2,0.000219
9308021,9308021,,1,5,6,1,5,6,0.000002,0.000014,0,25002,5,0.000011,2,0.553191,0.596154,21.75,0.166667,0.000219
9308031,9308031,,0,1,1,0,1,1,0,0,0,25003,20,0.00001,2,0.666667,0.75,0,0,0
9308040,9308040,,0,3,3,0,3,3,0,0,0,25004,6,0.00001,2,0.8,0.875,0,0,0
9308047,9308047,,0,3,3,0,3,3,0,0,0,25005,22,0.00001,2,0.8,0.875,0,0.333333,0
9308049,9308049,,0,1,1,0,1,1,0,0,0,25006,6,0.00001,1,1,1,0,0,0
9308050,9308050,,1,1,2,1,1,2,0.000001,0.000021,0,25007,9,0.000013,1,1,1,1,0,0.000219
9308051,9308051,,0,5,5,0,5,5,0,0.00001,0,25008,17,0.00001,2,0.727273,0.8125,0,0.05,0
9308058,9308058,,1,1,2,1,1,2,0,0,0,5113,26,0.000015,1,1,1,0,0.5,0.000247
9308059,9308059,,0,1,1,0,1,1,0,0,0,25009,15,0.00001,1,1,1,0,0,0
9202078,9202078,,2,0,2,2,0,2,0.000001,0,0,963,5,0.000016,0,0,0,0,0,0.000527
9308072,9308072,,0,2,2,0,2,2,0,0.000005,0,25010,15,0.00001,1,1,1,0,0,0
9308080,9308080,,0,12,12,0,12,12,0,0.000057,0,25011,13,0.00001,3,0.613636,0.709877,0,0.136364,0
9308081,9308081,,0,2,2,0,2,2,0,0,0,25012,25,0.00001,1,1,1,0,0.5,0
9308087,9308087,,0,1,1,0,1,1,0,0,0,25013,23,0.00001,1,1,1,0,0,0
9307095,9307095,,2,0,2,2,0,2,0,0,0,4463,23,0.00002,0,0,0,0,0,0.000501
9308095,9308095,,0,8,8,0,8,8,0,0.000024,0,25014,5,0.00001,3,0.559322,0.616162,0,0.053571,0
9308097,9308097,,0,2,2,0,2,2,0,0.000062,0,25015,5,0.00001,2,0.625,0.7,0,0,0
9308101,9308101,,0,1,1,0,1,1,0,0.000002,0,25016,28,0.00001,1,1,1,0,0,0
9308107,9308107,,0,1,1,0,1,1,0,0.000022,0,25017,13,0.00001,1,1,1,0,0,0
9308113,9308113,,0,3,3,0,3,3,0,0.000016,0,25018,9,0.00001,2,0.8,0.875,0,0,0
9309001,9309001,,0,1,1,0,1,1,0,0,0,25019,52,0.00001,1,1,1,0,0,0
9309004,9309004,,0,1,1,0,1,1,0,0,0,25020,23,0.00001,1,1,1,0,0,0
9309005,9309005,,0,5,5,0,5,5,0,0.000005,0,25021,17,0.00001,1,1,1,0,0.25,0
9309007,9309007,,1,3,4,1,3,4,0.000001,0.000007,0,25022,6,0.000011,1,1,1,2.5,0,0.000219
9309008,9309008,,0,9,9,0,9,9,0,0.000016,0,25023,5,0.00001,4,0.354839,0.497475,0,0.027778,0
9309019,9309019,,0,5,5,0,5,5,0,0.000591,0,25024,13,0.00001,4,0.333333,0.391129,0,0.15,0
9309037,9309037,,0,1,1,0,1,1,0,0.000004,0,25025,13,0.00001,1,1,1,0,0,0
9309040,9309040,,1,7,8,1,7,8,0,0.000021,0,25026,5,0.00001,2,0.684211,0.769231,12,0.035714,0.000219
9309043,9309043,,0,1,1,0,1,1,0,0,0,25027,5,0.00001,1,1,1,0,0,0
9309058,9309058,,0,6,6,0,6,6,0,0.000025,0,25028,9,0.00001,5,0.311284,0.38625,0,0.1,0
9309063,9309063,,3,1,4,3,1,4,0.00002,0.000001,0,5467,15,0.000024,1,1,1,3,0.166667,0.000699
9309066,9309066,,0,1,1,0,1,1,0,0.000004,0,25029,9,0.00001,2,0.555556,0.6,0,0,0
9205007,9205007,,4,0,4,4,0,4,0.000053,0,0,769,9,0.000013,0,0,0,0,0.333333,0.000986
9305153,9305153,,1,0,1,1,0,1,0.000002,0,0,756,26,0.000011,0,0,0,0,0,0.00026
9309068,9309068,,0,2,2,0,2,2,0,0,0,25030,26,0.00001,1,1,1,0,0,0
9309069,9309069,,2,2,4,2,2,4,0.000053,0.00008,0,8077,0,0.000012,1,1,1,0.5,0.25,0.000453
9309070,9309070,,1,1,2,1,1,2,0,0,0,25031,6,0.000023,2,0.666667,0.75,4,0,0.000239
9309071,9309071,,0,1,1,0,1,1,0,0,0,25032,6,0.00001,1,1,1,0,0,0
9309072,9309072,,0,2,2,0,2,2,0,0,59,25035,81,0.00001,1,1,1,0,0,0
9307083,9307083,,1,0,1,1,0,1,0,0,59,25034,81,0.000014,0,0,0,0,0,0.000219
9309032,9309032,,1,0,1,1,0,1,0,0,59,25033,81,0.000014,0,0,0,0,0,0.000219
9309080,9309080,,0,1,1,0,1,1,0,0.000001,0,25036,23,0.00001,3,0.464286,0.5,0,0,0
9309082,9309082,,0,3,3,0,3,3,0,0.000009,0,25037,5,0.00001,2,0.8,0.875,0,0.166667,0
9309090,9309090,,3,1,4,3,1,4,0,0,0,7125,21,0.000027,1,1,1,0,0.333333,0.000718
9301054,9301054,,4,0,4,4,0,4,0,0,0,7124,21,0.000052,0,0,0,0,0.333333,0.000958
9309092,9309092,,1,2,3,1,2,3,0,0,0,25038,41,0.000013,2,0.666667,0.75,4,0,0.000219
9309102,9309102,,1,2,3,1,2,3,0.00002,0,0,5469,15,0.00001,2,0.75,0.833333,0,0.333333,0.000247
9309103,9309103,,1,9,10,1,9,10,0.000001,0.000134,0,25039,23,0.000011,3,0.581395,0.666667,11,0.177778,0.000219
9309108,9309108,,0,6,6,0,6,6,0,0.000157,0,25040,26,0.00001,2,0.875,0.928571,0,0.033333,0
9309111,9309111,,1,3,4,1,3,4,0,0.000002,0,12515,23,0.000011,1,1,1,1,0.166667,0.000226
9309114,9309114,,0,1,1,0,1,1,0,0.000094,0,25041,2,0.00001,1,1,1,0,0,0
9309120,9309120,,0,1,1,0,1,1,0,0,0,25042,22,0.00001,1,1,1,0,0,0
9309121,9309121,,0,4,4,0,4,4,0,0.000011,0,25043,22,0.00001,2,0.833333,0.9,0,0.25,0
9309129,9309129,,3,3,6,3,3,6,0.000001,0,0,13502,52,0.000016,2,0.8,0.875,106.10464,0.133333,0.000665
9309138,9309138,,0,7,7,0,7,7,0,0.000051,0,25044,5,0.00001,1,1,1,0,0.047619,0
9309139,9309139,,2,2,4,2,2,4,0,0,0,25045,17,0.000015,2,0.75,0.833333,4,0.333333,0.000451
9309141,9309141,,2,2,4,2,2,4,0.000001,0.000048,0,4478,3,0.000017,4,0.404762,0.470588,8.166667,0.333333,0.000471
9309156,9309156,,0,2,2,0,2,2,0,0.000006,0,25046,5,0.00001,5,0.263566,0.297059,0,0,0
9204086,9204086,,3,0,3,3,0,3,0.000001,0,0,3956,15,0.000025,0,0,0,0,0,0.000679
9310002,9310002,,1,3,4,1,3,4,0.000001,0.000005,0,1559,5,0.000013,2,0.8,0.875,2894.671879,0.166667,0.000262
9310005,9310005,,1,3,4,1,3,4,0,0.000001,0,25047,15,0.000012,1,1,1,0,0.416667,0.000226
9310007,9310007,,2,1,3,2,1,3,0.000001,0.000038,0,4808,15,0.00002,1,1,1,1,0.166667,0.000446
9310012,9310012,,0,7,7,0,7,7,0,0.000086,0,25048,23,0.00001,4,0.45614,0.564103,0,0.309524,0
9310014,9310014,,1,1,2,1,1,2,0,0,0,541,2,0.000019,2,0.666667,0.75,0,0.5,0.000288
9310023,9310023,,2,2,4,2,2,4,0.000053,0.00008,0,8076,0,0.000012,1,1,1,0.5,0.25,0.000453
9310036,9310036,,0,1,1,0,1,1,0,0,0,25049,5,0.00001,1,1,1,0,0,0
9310048,9310048,,0,1,1,0,1,1,0,0,0,25050,5,0.00001,1,1,1,0,0,0
9310050,9310050,,0,1,1,0,1,1,0,0,0,25051,9,0.00001,3,0.5,0.555556,0,0,0
9310057,9310057,,0,1,1,0,1,1,0,0,0,25052,52,0.00001,1,1,1,0,0,0
9310072,9310072,,0,4,4,0,4,4,0,0.000003,0,25053,28,0.00001,2,0.833333,0.9,0,0.25,0
9310075,9310075,,1,4,5,1,4,5,0,0.00002,0,25054,5,0.000011,4,0.333333,0.401042,12.5,0.2,0.000219
9310077,9310077,,0,6,6,0,6,6,0,0.000022,0,25055,9,0.00001,1,1,1,0,0.066667,0
9310079,9310079,,2,3,5,2,3,5,0.000001,0,0,25056,17,0.000012,3,0.526316,0.616667,10.533333,0.15,0.000438
9310090,9310090,,0,2,2,0,2,2,0,0,60,25059,82,0.00001,1,1,1,0,0,0
9212128,9212128,,1,0,1,1,0,1,0,0,60,25058,82,0.000014,0,0,0,0,0,0.000219
9212130,9212130,,1,0,1,1,0,1,0,0,60,25057,82,0.000014,0,0,0,0,0,0.000219
9310092,9310092,,0,2,2,0,2,2,0,0.00001,0,25060,22,0.00001,1,1,1,0,0,0
9310103,9310103,,2,1,3,2,1,3,0,0.000004,0,11020,22,0.000035,1,1,1,2,0.166667,0.000471
9310107,9310107,,0,1,1,0,1,1,0,0.000001,0,25061,22,0.00001,1,1,1,0,0,0
9310108,9310108,,0,2,2,0,2,2,0,0,0,25062,6,0.00001,1,1,1,0,0,0
9210162,9210162,,1,0,1,1,0,1,0.000001,0,0,3955,9,0.000011,0,0,0,0,0,0.000227
9212151,9212151,,2,0,2,2,0,2,0.000001,0,0,3954,9,0.000011,0,0,0,0,0,0.000446
9303148,9303148,,1,0,1,1,0,1,0.000001,0,0,3953,9,0.000011,0,0,0,0,0,0.000227
9310116,9310116,,0,4,4,0,4,4,0,0.000007,0,25063,52,0.00001,1,1,1,0,0.166667,0
9310119,9310119,,0,2,2,0,2,2,0,0,0,25064,6,0.00001,1,1,1,0,0,0
9310131,9310131,,2,6,8,2,6,8,0,0.000002,0,1582,22,0.000014,2,0.875,0.928571,3.5,0.25,0.000452
9310133,9310133,,1,2,3,1,2,3,0,0,0,2032,6,0.000011,4,0.458333,0.537879,0,0.5,0.000255
9310137,9310137,,0,10,10,0,10,10,0,0.000097,0,25065,17,0.00001,4,0.369668,0.45406,0,0.088889,0
9310143,9310143,,0,4,4,0,4,4,0,0.000011,0,25066,5,0.00001,2,0.7,0.785714,0,0.166667,0
9310160,9310160,,2,4,6,2,4,6,0,0.000001,0,1581,22,0.000014,2,0.7,0.785714,2.5,0.2,0.000452
9310163,9310163,,3,4,7,3,4,7,0,0,0,7520,28,0.000018,1,1,1,8360,0.142857,0.000671
9212098,9212098,,4,0,4,4,0,4,0,0,0,7517,28,0.000022,0,0,0,0,0.25,0.000909
9310168,9310168,,1,2,3,1,2,3,0,0.000001,0,25067,23,0.000013,1,1,1,0,0.333333,0.000219
9302061,9302061,,7,0,7,7,0,7,0.000007,0,0,3192,23,0.000037,0,0,0,0,0.02381,0.001574
9310169,9310169,,1,1,2,1,1,2,0.000006,0,0,25068,13,0.000011,4,0.391304,0.462963,2.5,0,0.000226
9202009,9202009,,3,0,3,3,0,3,0,0,0,631,3,0.000028,0,0,0,0,0,0.00068
9310180,9310180,,0,5,5,0,5,5,0,0.000026,0,25069,9,0.00001,3,0.583333,0.666667,0,0.1,0
9310182,9310182,,0,1,1,0,1,1,0,0.000001,0,25070,22,0.00001,1,1,1,0,0,0
9310190,9310190,,0,4,4,0,4,4,0,0.000019,0,25071,9,0.00001,2,0.833333,0.9,0,0,0
9310191,9310191,,0,17,17,0,17,17,0,0.000022,0,25072,4,0.00001,3,0.653061,0.755208,0,0.080882,0
9310192,9310192,,3,1,4,3,1,4,0.000001,0,0,25073,6,0.000014,3,0.5,0.611111,5,0.083333,0.000664
9311004,9311004,,0,3,3,0,3,3,0,0,0,25074,6,0.00001,2,0.666667,0.75,0,0.166667,0
9311006,9311006,,0,5,5,0,5,5,0,0.000016,0,25075,28,0.00001,1,1,1,0,0.1,0
9311013,9311013,,0,1,1,0,1,1,0,0.000004,0,25076,22,0.00001,1,1,1,0,0,0
9311016,9311016,,0,1,1,0,1,1,0,0,0,25077,23,0.00001,1,1,1,0,0,0
9305076,9305076,,2,0,2,2,0,2,0,0,0,11795,23,0.00005,0,0,0,0,0,0.000472
9311020,9311020,,4,2,6,4,2,6,0,0,0,8897,6,0.000018,1,1,1,14.855455,0.233333,0.00089
9305145,9305145,,7,0,7,7,0,7,0,0,0,8896,6,0.000034,0,0,0,0,0.142857,0.00158
9311034,9311034,,1,1,2,1,1,2,0.000001,0.000007,0,8226,3,0.000011,1,1,1,0,0.5,0.000227
9311036,9311036,,0,2,2,0,2,2,0,0,61,25080,83,0.00001,1,1,1,0,0,0
9207088,9207088,,1,0,1,1,0,1,0,0,61,25079,83,0.000014,0,0,0,0,0,0.000219
9207104,9207104,,1,0,1,1,0,1,0,0,61,25078,83,0.000014,0,0,0,0,0,0.000219
9311039,9311039,,0,1,1,0,1,1,0,0,62,25082,102,0.00001,1,1,1,0,0,0
9308029,9308029,,4,0,4,4,0,4,0,0,62,25081,102,0.000041,0,0,0,0,0,0.000877
9311041,9311041,,0,3,3,0,3,3,0,0,0,25084,6,0.00001,1,1,1,0,0,0
9304143,9304143,,1,0,1,1,0,1,0,0,0,25083,6,0.000013,0,0,0,0,0,0.000219
9311054,9311054,,0,1,1,0,1,1,0,0.000002,0,25085,4,0.00001,3,0.5,0.611111,0,0,0
9311063,9311063,,0,1,1,0,1,1,0,0,0,25086,22,0.00001,1,1,1,0,0,0
9311068,9311068,,0,1,1,0,1,1,0,0.00001,0,25087,30,0.00001,1,1,1,0,0,0
9311077,9311077,,0,2,2,0,2,2,0,0.000011,0,25088,25,0.00001,1,1,1,0,0,0
9310129,9310129,,4,0,4,4,0,4,0,0,0,1334,9,0.000025,0,0,0,0,0.083333,0.001088
9311086,9311086,,0,7,7,0,7,7,0,0.000038,0,25089,17,0.00001,5,0.306723,0.391324,0,0.047619,0
9311088,9311088,,2,3,5,2,3,5,0.000012,0.000002,0,5426,15,0.000012,1,1,1,11117,0.2,0.000445
9210028,9210028,,2,0,2,2,0,2,0,0,0,5425,15,0.000015,0,0,0,0,0,0.000451
9207058,9207058,,2,0,2,2,0,2,0,0,0,1269,4,0.000014,0,0,0,0,0,0.000508
9311090,9311090,,3,1,4,3,1,4,0,0,0,5451,15,0.000019,1,1,1,5558.5,0.166667,0.000677
9304147,9304147,,5,0,5,5,0,5,0,0,0,5449,15,0.00007,0,0,0,0,0,0.001135
9311095,9311095,,0,1,1,0,1,1,0,0.000005,0,25090,15,0.00001,1,1,1,0,0,0
9312137,9312137,,0,2,2,0,2,2,0,0.000001,0,25092,23,0.00001,1,1,1,0,0,0
9311099,9311099,,1,0,1,1,0,1,0,0,0,25091,23,0.000014,0,0,0,0,0,0.000219
9311104,9311104,,0,1,1,0,1,1,0,0.000006,0,25093,6,0.00001,1,1,1,0,0,0
9311107,9311107,,1,1,2,1,1,2,0,0,0,11188,6,0.000011,2,0.571429,0.625,0,0.5,0.000233
9311109,9311109,,0,5,5,0,5,5,0,0.000008,0,25094,15,0.00001,1,1,1,0,0,0
9311127,9311127,,3,3,6,3,3,6,0.000026,0.000027,0,25095,0,0.000014,2,0.636364,0.714286,7.416667,0.166667,0.000684
9311131,9311131,,0,3,3,0,3,3,0,0,0,25096,22,0.00001,3,0.5625,0.648148,0,0.166667,0
9311133,9311133,,0,5,5,0,5,5,0,0.000036,0,25097,5,0.00001,2,0.692308,0.777778,0,0,0
9311138,9311138,,0,12,12,0,12,12,0,0.000083,0,25098,0,0.00001,2,0.75,0.833333,0,0,0
9311140,9311140,,0,2,2,0,2,2,0,0.000006,0,25099,26,0.00001,2,0.6,0.666667,0,0,0
9311141,9311141,,1,5,6,1,5,6,0,0.000015,0,25100,22,0.000012,1,1,1,4,0.133333,0.000226
9311151,9311151,,1,1,2,1,1,2,0,0.000001,0,10550,15,0.000011,2,0.666667,0.75,0,0.5,0.000226
9311163,9311163,,2,2,4,2,2,4,0,0,0,25103,22,0.000012,1,1,1,0,0.333333,0.000438
9305071,9305071,,4,0,4,4,0,4,0,0,0,25102,22,0.00002,0,0,0,0,0.166667,0.00089
9306016,9306016,,5,0,5,5,0,5,0,0,0,25101,22,0.00003,0,0,0,0,0.15,0.001115
9311166,9311166,,0,6,6,0,6,6,0,0.00012,0,25104,0,0.00001,2,0.8,0.875,0,0.266667,0
9311171,9311171,,3,2,5,3,2,5,0,0.000003,0,25105,6,0.000021,1,1,1,7,0,0.000664
9311172,9311172,,0,1,1,0,1,1,0,0.000021,0,25106,9,0.00001,1,1,1,0,0,0
9311176,9311176,,1,9,10,1,9,10,0.000004,0.000278,0,1117,13,0.000011,5,0.296552,0.374806,9028.913017,0.166667,0.000227
9311179,9311179,,1,1,2,1,1,2,0,0,0,25107,30,0.000015,1,1,1,2,0,0.000226
9311182,9311182,,0,1,1,0,1,1,0,0.000005,0,25108,28,0.00001,1,1,1,0,0,0
9311184,9311184,,0,2,2,0,2,2,0,0.000003,0,25109,15,0.00001,1,1,1,0,0,0
9312006,9312006,,2,1,3,2,1,3,0,0,0,25110,26,0.000017,1,1,1,3,0,0.000445
9312010,9312010,,3,7,10,3,7,10,0,0.000001,0,3202,9,0.000012,3,0.558824,0.657895,22.816667,0.166667,0.000672
9312011,9312011,,0,2,2,0,2,2,0,0.000003,0,25111,4,0.00001,1,1,1,0,0,0
9312014,9312014,,0,1,1,0,1,1,0,0,0,25112,23,0.00001,1,1,1,0,0,0
9312025,9312025,,0,2,2,0,2,2,0,0.000049,0,25113,13,0.00001,4,0.441176,0.511111,0,0,0
9312027,9312027,,1,4,5,1,4,5,0,0.000002,0,25114,22,0.000013,1,1,1,4,0.05,0.000219
9312035,9312035,,0,2,2,0,2,2,0,0,0,25115,6,0.00001,1,1,1,0,0,0
9312036,9312036,,1,9,10,1,9,10,0.000001,0.000051,0,6539,5,0.000011,2,0.846154,0.909091,49.548767,0.077778,0.000241
9312037,9312037,,0,1,1,0,1,1,0,0,0,25116,6,0.00001,1,1,1,0,0,0
9312046,9312046,,0,1,1,0,1,1,0,0.000001,0,25117,5,0.00001,1,1,1,0,0,0
9312057,9312057,,1,1,2,1,1,2,0,0,0,25118,6,0.000011,1,1,1,0.5,0,0.000219
9312067,9312067,,0,1,1,0,1,1,0,0,0,25119,22,0.00001,2,0.666667,0.75,0,0,0
9312070,9312070,,0,2,2,0,2,2,0,0.000002,0,25120,9,0.00001,1,1,1,0,0,0
9312073,9312073,,1,2,3,1,2,3,0,0.000005,0,25121,15,0.000011,2,0.75,0.833333,1,0.333333,0.000219
9312074,9312074,,0,2,2,0,2,2,0,0.00007,0,25122,5,0.00001,1,1,1,0,0,0
9312076,9312076,,0,2,2,0,2,2,0,0.000005,0,25123,15,0.00001,2,0.75,0.833333,0,0.5,0
9312084,9312084,,1,1,2,1,1,2,0,0,0,2031,6,0.000011,1,1,1,0.5,0,0.000255
9312095,9312095,,4,5,9,4,5,9,0.00003,0.000048,0,4318,4,0.000017,2,0.777778,0.857143,16791.398466,0.138889,0.000937
9312098,9312098,,0,1,1,0,1,1,0,0,0,25124,22,0.00001,1,1,1,0,0,0
9312105,9312105,,2,1,3,2,1,3,0,0,0,2531,6,0.000014,1,1,1,0,0.333333,0.000477
9208003,9208003,,3,0,3,3,0,3,0,0,0,2530,6,0.000028,0,0,0,0,0.333333,0.000709
9312109,9312109,,0,1,1,0,1,1,0,0,0,25125,22,0.00001,1,1,1,0,0,0
9312120,9312120,,0,2,2,0,2,2,0,0.000021,0,25126,5,0.00001,1,1,1,0,0,0
9312124,9312124,,0,1,1,0,1,1,0,0,63,25128,84,0.00001,1,1,1,0,0,0
9202019,9202019,,1,0,1,1,0,1,0,0,63,25127,84,0.000019,0,0,0,0,0,0.000219
9312125,9312125,,2,1,3,2,1,3,0,0.000005,0,18033,15,0.000012,1,1,1,0.5,0.333333,0.000465
9312134,9312134,,0,1,1,0,1,1,0,0.000002,0,25129,15,0.00001,1,1,1,0,0,0
9312136,9312136,,0,1,1,0,1,1,0,0.000018,0,25130,5,0.00001,1,1,1,0,0,0
9312139,9312139,,1,2,3,1,2,3,0,0.000005,0,3088,15,0.000011,1,1,1,0,0.333333,0.000233
9312140,9312140,,0,4,4,0,4,4,0,0.000005,0,25131,15,0.00001,1,1,1,0,0,0
9312148,9312148,,1,1,2,1,1,2,0,0,0,25133,0,0.000014,1,1,1,0,0.5,0.000226
9306062,9306062,,2,0,2,2,0,2,0,0,0,25132,0,0.000027,0,0,0,0,0.5,0.000451
9312151,9312151,,1,2,3,1,2,3,0,0.000001,0,8397,22,0.000022,2,0.625,0.7,5,0,0.000239
9312160,9312160,,2,4,6,2,4,6,0.000001,0.000045,0,25134,26,0.00002,2,0.7,0.785714,24.5,0.066667,0.000445
9312163,9312163,,0,1,1,0,1,1,0,0,0,25135,15,0.00001,1,1,1,0,0,0
9312176,9312176,,0,1,1,0,1,1,0,0.000112,0,25136,1,0.00001,3,0.416667,0.5,0,0,0
9312177,9312177,,0,2,2,0,2,2,0,0.000007,0,25137,6,0.00001,1,1,1,0,0,0
9312181,9312181,,0,2,2,0,2,2,0,0,0,25139,22,0.00001,1,1,1,0,0,0
9212051,9212051,,5,0,5,5,0,5,0,0,0,25138,22,0.000039,0,0,0,0,0,0.001102
9312201,9312201,,0,2,2,0,2,2,0,0.000022,0,25140,10,0.00001,1,1,1,0,0,0
9312203,9312203,,0,3,3,0,3,3,0,0.000025,0,25141,13,0.00001,4,0.384615,0.433333,0,0,0
9312204,9312204,,2,3,5,2,3,5,0,0,0,12428,22,0.000014,2,0.714286,0.8,4503.665022,0.2,0.000465
9301041,9301041,,3,0,3,3,0,3,0,0,0,12427,22,0.00002,0,0,0,0,0.166667,0.000691
9312205,9312205,,2,4,6,2,4,6,0,0.000011,0,25142,22,0.000014,2,0.833333,0.9,6.333333,0.166667,0.000438
9401002,9401002,,6,2,8,6,2,8,0,0.000004,0,9620,26,0.000035,1,1,1,1.5,0.196429,0.001335
9401005,9401005,,2,3,5,2,3,5,0.000003,0.00004,0,25143,23,0.000019,1,1,1,4.5,0.05,0.000438
9211124,9211124,,1,0,1,1,0,1,0,0,0,4757,23,0.000018,0,0,0,0,0,0.000234
9305186,9305186,,4,0,4,4,0,4,0,0,0,4756,23,0.000024,0,0,0,0,0.083333,0.000911
9401014,9401014,,6,2,8,6,2,8,0.00001,0.000002,0,3472,26,0.000039,2,0.75,0.833333,4269.332585,0.107143,0.001384
9401024,9401024,,0,1,1,0,1,1,0,0.000008,0,25144,28,0.00001,1,1,1,0,0,0
9401026,9401026,,0,2,2,0,2,2,0,0.000004,0,25145,9,0.00001,1,1,1,0,0,0
9401034,9401034,,0,2,2,0,2,2,0,0,0,25147,5,0.00001,1,1,1,0,0,0
9210145,9210145,,3,0,3,3,0,3,0,0,0,18128,5,0.000019,0,0,0,0,0,0.000671
9211086,9211086,,1,0,1,1,0,1,0,0,0,25146,5,0.000014,0,0,0,0,0,0.000219
9401037,9401037,,0,1,1,0,1,1,0,0,0,25148,6,0.00001,1,1,1,0,0,0
9401064,9401064,,0,2,2,0,2,2,0,0.00008,0,25149,0,0.00001,1,1,1,0,0,0
9401074,9401074,,0,1,1,0,1,1,0,0,0,25150,22,0.00001,1,1,1,0,0,0
9401084,9401084,,1,3,4,1,3,4,0,0.00001,0,7929,6,0.000015,2,0.615385,0.6875,256.045145,0.166667,0.000234
9401088,9401088,,1,1,2,1,1,2,0,0,0,25151,30,0.000019,2,0.666667,0.75,2,0,0.000219
9401090,9401090,,0,2,2,0,2,2,0,0.000007,0,25152,22,0.00001,1,1,1,0,0,0
9401094,9401094,,0,6,6,0,6,6,0,0.000002,0,25154,15,0.00001,1,1,1,0,0.1,0
9209061,9209061,,1,0,1,1,0,1,0,0,0,25153,15,0.000011,0,0,0,0,0,0.000219
9401097,9401097,,1,1,2,1,1,2,0.000002,0,0,25155,26,0.00001,1,1,1,0,0.5,0.000226
9401101,9401101,,0,3,3,0,3,3,0,0,0,25159,15,0.00001,1,1,1,0,0,0
9302042,9302042,,1,0,1,1,0,1,0,0,0,25158,15,0.000013,0,0,0,0,0,0.000219
9302043,9302043,,1,0,1,1,0,1,0,0,0,25157,15,0.000013,0,0,0,0,0,0.000219
9305048,9305048,,3,0,3,3,0,3,0,0,0,25156,15,0.000018,0,0,0,0,0.166667,0.000664
9401109,9401109,,0,3,3,0,3,3,0,0.000031,0,25160,5,0.00001,2,0.8,0.875,0,0,0
9401122,9401122,,2,3,5,2,3,5,0,0,0,25161,22,0.000013,2,0.714286,0.8,8,0.1,0.000451
9401126,9401126,,1,3,4,1,3,4,0.000002,0.000027,0,1745,2,0.000013,1,1,1,4.294678,0.083333,0.000242
9401127,9401127,,4,4,8,4,4,8,0,0.000008,0,5117,15,0.000015,2,0.75,0.833333,3,0.267857,0.000899
9401128,9401128,,2,3,5,2,3,5,0,0.000005,0,10317,22,0.000013,4,0.371429,0.480769,1718.990035,0.05,0.000458
9401129,9401129,,2,1,3,2,1,3,0,0,0,10904,26,0.000017,1,1,1,0,0.5,0.000452
9401144,9401144,,1,4,5,1,4,5,0.000003,0.000102,0,6350,26,0.000011,1,1,1,9.904243,0.15,0.000233
9401152,9401152,,1,5,6,1,5,6,0,0.000009,0,20137,15,0.000012,2,0.777778,0.857143,6,0.133333,0.000226
9401156,9401156,,0,2,2,0,2,2,0,0,0,25162,22,0.00001,1,1,1,0,0,0
9401157,9401157,,0,3,3,0,3,3,0,0.000026,0,25163,26,0.00001,1,1,1,0,0.5,0
9401158,9401158,,0,7,7,0,7,7,0,0.000036,0,25164,5,0.00001,4,0.349593,0.45155,0,0.02381,0
9401162,9401162,,0,1,1,0,1,1,0,0,0,25165,22,0.00001,1,1,1,0,0,0
9401164,9401164,,1,13,14,1,13,14,0,0.000015,0,3201,9,0.000011,3,0.6875,0.787879,429.544208,0.087912,0.000233
9402003,9402003,,1,1,2,1,1,2,0,0.000001,0,25166,10,0.000013,1,1,1,1,0,0.000219
9402009,9402009,,0,2,2,0,2,2,0,0.000082,0,25167,13,0.00001,3,0.5,0.611111,0,0,0
9402013,9402013,,0,3,3,0,3,3,0,0.000007,0,25168,22,0.00001,2,0.714286,0.8,0,0.166667,0
9402014,9402014,,1,1,2,1,1,2,0,0,0,8527,15,0.000019,2,0.666667,0.75,6841.38235,0,0.000238
9402019,9402019,,0,1,1,0,1,1,0,0.000003,0,25169,0,0.00001,2,0.666667,0.75,0,0,0
9402024,9402024,,1,5,6,1,5,6,0,0.000006,0,25170,15,0.000011,2,0.857143,0.916667,1,0.133333,0.000219
9402026,9402026,,1,1,2,1,1,2,0,0,0,25171,4,0.000012,1,1,1,0.5,0,0.000219
9402050,9402050,,1,2,3,1,2,3,0,0.000004,0,7470,5,0.000011,1,1,1,0,0.333333,0.000239
9208010,9208010,,2,0,2,2,0,2,0,0,0,3798,15,0.000014,0,0,0,0,0,0.000461
9402062,9402062,,0,1,1,0,1,1,0,0,0,25172,25,0.00001,1,1,1,0,0,0
9402064,9402064,,4,1,5,4,1,5,0,0.00001,0,3213,9,0.000029,1,1,1,1.712179,0.4,0.000965
9402071,9402071,,1,1,2,1,1,2,0,0,0,25173,26,0.000012,1,1,1,0.333333,0,0.000219
9309130,9309130,,6,0,6,6,0,6,0,0,0,3156,26,0.000103,0,0,0,0,0.066667,0.001367
9402076,9402076,,0,3,3,0,3,3,0,0.000001,0,25174,6,0.00001,1,1,1,0,0.166667,0
9303161,9303161,,3,0,3,3,0,3,0,0,0,20541,6,0.000032,0,0,0,0,0,0.000664
9402079,9402079,,2,2,4,2,2,4,0,0,0,2407,26,0.000014,1,1,1,1,0.416667,0.000458
9402082,9402082,,0,3,3,0,3,3,0,0.000019,0,25175,13,0.00001,3,0.380282,0.432099,0,0.166667,0
9402086,9402086,,0,1,1,0,1,1,0,0.000062,0,25176,0,0.00001,1,1,1,0,0,0
9402094,9402094,,0,1,1,0,1,1,0,0,0,25177,6,0.00001,1,1,1,0,0,0
9402105,9402105,,0,3,3,0,3,3,0,0.000051,0,25179,9,0.00001,2,0.8,0.875,0,0,0
9302082,9302082,,2,0,2,2,0,2,0.000001,0,0,25178,9,0.000014,0,0,0,0,0,0.000438
9402109,9402109,,0,1,1,0,1,1,0,0.00001,0,25180,5,0.00001,1,1,1,0,0,0
9402132,9402132,,0,6,6,0,6,6,0,0.000056,0,25182,41,0.00001,3,0.447368,0.5,0,0.033333,0
9209090,9209090,,1,0,1,1,0,1,0.000001,0,0,25181,41,0.000011,0,0,0,0,0,0.000219
9402134,9402134,,0,4,4,0,4,4,0,0.000006,0,25183,15,0.00001,2,0.75,0.833333,0,0.083333,0
9402135,9402135,,0,1,1,0,1,1,0,0.000038,0,25184,4,0.00001,1,1,1,0,0,0
9402140,9402140,,0,1,1,0,1,1,0,0.000038,0,25185,4,0.00001,1,1,1,0,0,0
9402141,9402141,,1,1,2,1,1,2,0,0,0,3982,23,0.000012,1,1,1,0,0.5,0.000247
9402142,9402142,,1,3,4,1,3,4,0,0.000001,0,25187,15,0.000014,2,0.8,0.875,8,0,0.000226
9210042,9210042,,1,0,1,1,0,1,0,0,0,25186,15,0.000014,0,0,0,0,0,0.000226
9402145,9402145,,0,4,4,0,4,4,0,0,0,25190,6,0.00001,2,0.666667,0.75,0,0,0
9211105,9211105,,2,0,2,2,0,2,0,0,0,25189,6,0.000015,0,0,0,0,0,0.000438
9310154,9310154,,2,0,2,2,0,2,0,0,0,25188,6,0.000017,0,0,0,0,0,0.000445
9402146,9402146,,1,1,2,1,1,2,0,0,0,25191,23,0.000011,1,1,1,0,0.5,0.000219
9402149,9402149,,1,6,7,1,6,7,0.000001,0.000136,0,4526,13,0.000013,3,0.40566,0.468992,7.901264,0.190476,0.000233
9402150,9402150,,2,1,3,2,1,3,0,0.000006,0,8720,5,0.00002,1,1,1,2.295238,0,0.000491
9402151,9402151,,1,2,3,1,2,3,0.000008,0,0,25193,9,0.00001,1,1,1,1,0.166667,0.000219
9210058,9210058,,1,0,1,1,0,1,0,0,0,25192,9,0.000014,0,0,0,0,0,0.000226
9403005,9403005,,0,1,1,0,1,1,0,0.000001,0,25194,9,0.00001,1,1,1,0,0,0
9403006,9403006,,0,5,5,0,5,5,0,0.000015,0,25195,15,0.00001,2,0.857143,0.916667,0,0.05,0
9403007,9403007,,0,3,3,0,3,3,0,0,0,25196,10,0.00001,2,0.615385,0.6875,0,0.166667,0
9207068,9207068,,1,0,1,1,0,1,0,0,0,8984,23,0.000033,0,0,0,0,0,0.000244
9207110,9207110,,1,0,1,1,0,1,0,0,0,8983,23,0.000033,0,0,0,0,0,0.000244
9403011,9403011,,0,3,3,0,3,3,0,0,0,25198,6,0.00001,1,1,1,0,0,0
9305144,9305144,,1,0,1,1,0,1,0,0,0,25197,6,0.000013,0,0,0,0,0,0.000219
9403014,9403014,,0,1,1,0,1,1,0,0.000208,0,25199,52,0.00001,1,1,1,0,0,0
9403016,9403016,,0,2,2,0,2,2,0,0.000001,0,25200,6,0.00001,2,0.75,0.833333,0,0,0
9403022,9403022,,1,2,3,1,2,3,0,0,0,25201,6,0.00001,2,0.6,0.666667,3.5,0,0.000219
9403030,9403030,,0,1,1,0,1,1,0,0,0,25202,4,0.00001,2,0.666667,0.75,0,0,0
9403035,9403035,,2,3,5,2,3,5,0,0.000013,0,25203,9,0.000016,2,0.8,0.875,0.666667,0.35,0.000445
9403046,9403046,,0,2,2,0,2,2,0,0.000004,0,25204,26,0.00001,1,1,1,0,0.5,0
9310039,9310039,,1,0,1,1,0,1,0.000016,0,0,2639,13,0.00001,0,0,0,0,0,0.000245
9403052,9403052,,0,5,5,0,5,5,0,0.000015,0,25205,4,0.00001,3,0.611111,0.712121,0,0.2,0
9403057,9403057,,0,2,2,0,2,2,0,0.000002,0,25206,0,0.00001,1,1,1,0,0,0
9403061,9403061,,2,8,10,2,8,10,0,0.000001,0,2411,26,0.000013,1,1,1,44075.942326,0.066667,0.000467
9202033,9202033,,2,0,2,2,0,2,0.000035,0,0,2409,26,0.000014,0,0,0,0,0,0.000485
9403062,9403062,,0,3,3,0,3,3,0,0.00001,0,25207,5,0.00001,1,1,1,0,0,0
9303061,9303061,,3,0,3,3,0,3,0,0,0,5640,5,0.00002,0,0,0,0,0,0.000678
9403065,9403065,,0,1,1,0,1,1,0,0,0,25208,22,0.00001,1,1,1,0,0,0
9403079,9403079,,0,3,3,0,3,3,0,0.000006,0,25210,4,0.00001,1,1,1,0,0,0
9309096,9309096,,1,0,1,1,0,1,0,0,0,25209,4,0.000013,0,0,0,0,0,0.000219
9403083,9403083,,1,1,2,1,1,2,0,0,64,25212,116,0.000014,1,1,1,0,0.5,0.000219
9211099,9211099,,2,0,2,2,0,2,0,0,64,25211,116,0.000027,0,0,0,0,0.5,0.000445
9403085,9403085,,2,3,5,2,3,5,0,0,0,25216,13,0.000013,1,1,1,0,0.3,0.000438
9204066,9204066,,3,0,3,3,0,3,0,0,0,25215,13,0.000017,0,0,0,0,0.333333,0.00067
9205019,9205019,,3,0,3,3,0,3,0,0,0,25214,13,0.000017,0,0,0,0,0.333333,0.00067
9206104,9206104,,3,0,3,3,0,3,0,0,0,25213,13,0.000017,0,0,0,0,0.333333,0.00067
9403093,9403093,,2,1,3,2,1,3,0,0,0,5434,15,0.000014,2,0.6,0.666667,3,0.166667,0.000473
9403097,9403097,,2,2,4,2,2,4,0.000003,0.00001,0,548,13,0.000012,3,0.533333,0.604167,2,0.333333,0.000486
9403128,9403128,,0,1,1,0,1,1,0,0,0,25217,23,0.00001,1,1,1,0,0,0
9403130,9403130,,0,5,5,0,5,5,0,0.000004,0,25220,6,0.00001,1,1,1,0,0,0
9207116,9207116,,1,0,1,1,0,1,0,0,0,25219,6,0.000012,0,0,0,0,0,0.000219
9312197,9312197,,1,0,1,1,0,1,0,0,0,25218,6,0.000012,0,0,0,0,0,0.000219
9403139,9403139,,0,14,14,0,14,14,0,0.00008,0,25221,5,0.00001,3,0.714286,0.833333,0,0.06044,0
9403140,9403140,,0,2,2,0,2,2,0,0,0,25222,15,0.00001,1,1,1,0,0,0
9403145,9403145,,0,2,2,0,2,2,0,0.000004,0,25223,26,0.00001,1,1,1,0,0.5,0
9403148,9403148,,0,1,1,0,1,1,0,0.000046,0,25224,3,0.00001,2,0.666667,0.75,0,0,0
9403152,9403152,,0,1,1,0,1,1,0,0,65,25226,85,0.00001,1,1,1,0,0,0
9311119,9311119,,1,0,1,1,0,1,0,0,65,25225,85,0.000019,0,0,0,0,0,0.000219
9403153,9403153,,1,2,3,1,2,3,0,0.000003,0,18037,15,0.00001,2,0.75,0.833333,0,0.333333,0.000239
9403154,9403154,,0,11,11,0,11,11,0,0.000008,0,25227,15,0.00001,2,0.72,0.805556,0,0.145455,0
9311096,9311096,,4,0,4,4,0,4,0,0,0,5118,15,0.000015,0,0,0,0,0.083333,0.000899
9403156,9403156,,1,1,2,1,1,2,0,0,0,12426,22,0.000012,1,1,1,0,0.5,0.000226
9403160,9403160,,3,1,4,3,1,4,0.000011,0,0,8398,22,0.000014,3,0.428571,0.5,8004,0,0.000665
9403161,9403161,,0,1,1,0,1,1,0,0,0,25228,41,0.00001,1,1,1,0,0,0
9403165,9403165,,0,1,1,0,1,1,0,0,0,25229,21,0.00001,1,1,1,0,0,0
9403176,9403176,,0,1,1,0,1,1,0,0,0,25230,22,0.00001,2,0.666667,0.75,0,0,0
9403178,9403178,,4,1,5,4,1,5,0,0,0,2775,22,0.000026,1,1,1,13369,0.05,0.000917
9402011,9402011,,2,0,2,2,0,2,0,0,0,2774,22,0.000037,0,0,0,0,0,0.000465
9403194,9403194,,4,1,5,4,1,5,0.000007,0,0,2285,9,0.000017,3,0.416667,0.455556,16088.806139,0.05,0.000966
9404007,9404007,,2,1,3,2,1,3,0,0,0,8513,15,0.00002,1,1,1,2,0,0.00045
9404014,9404014,,0,2,2,0,2,2,0,0.000003,0,25231,26,0.00001,2,0.75,0.833333,0,0,0
9404019,9404019,,0,3,3,0,3,3,0,0.000016,0,25232,15,0.00001,1,1,1,0,0.166667,0
9404021,9404021,,0,3,3,0,3,3,0,0,0,25233,6,0.00001,1,1,1,0,0,0
9404026,9404026,,0,1,1,0,1,1,0,0,56,25234,78,0.00001,1,1,1,0,0,0
9404027,9404027,,0,1,1,0,1,1,0,0.000001,0,25235,22,0.00001,1,1,1,0,0,0
9301011,9301011,,1,0,1,1,0,1,0,0,0,3196,9,0.000012,0,0,0,0,0,0.000274
9404040,9404040,,0,5,5,0,5,5,0,0.000005,0,25236,4,0.00001,4,0.5,0.609375,0,0.05,0
9404041,9404041,,3,10,13,3,10,13,0,0.000088,0,2779,22,0.000014,3,0.625,0.733333,138.569623,0.179487,0.000757
9404049,9404049,,0,1,1,0,1,1,0,0,0,25237,26,0.00001,1,1,1,0,0,0
9311123,9311123,,1,0,1,1,0,1,0,0,0,10815,23,0.000015,0,0,0,0,0,0.000226
9404066,9404066,,0,2,2,0,2,2,0,0.000008,0,25238,5,0.00001,2,0.583333,0.642857,0,0,0
9404068,9404068,,1,5,6,1,5,6,0,0.000005,0,25239,15,0.000011,3,0.642857,0.759259,0,0.3,0.000219
9404076,9404076,,0,8,8,0,8,8,0,0.000149,0,25240,5,0.00001,8,0.258741,0.334813,0,0.285714,0
9404079,9404079,,1,2,3,1,2,3,0.000002,0.000068,0,3863,17,0.000011,4,0.325758,0.379845,0,0.333333,0.000267
9404090,9404090,,0,4,4,0,4,4,0,0.000011,0,25241,22,0.00001,3,0.588235,0.683333,0,0.333333,0
9404099,9404099,,1,2,3,1,2,3,0,0.000194,0,25242,5,0.00001,3,0.512821,0.541667,17.75,0,0.000219
9312092,9312092,,1,0,1,1,0,1,0,0,0,14036,21,0.000022,0,0,0,0,0,0.000258
9404104,9404104,,1,4,5,1,4,5,0,0.000003,0,25243,28,0.000019,1,1,1,4,0.05,0.000219
9404117,9404117,,0,1,1,0,1,1,0,0,66,25245,86,0.00001,1,1,1,0,0,0
9404016,9404016,,2,0,2,2,0,2,0,0,66,25244,86,0.000028,0,0,0,0,0,0.000438
9404123,9404123,,4,1,5,4,1,5,0.000031,0.000005,0,11823,15,0.000029,4,0.282828,0.315476,40.178291,0.15,0.000909
9404127,9404127,,0,1,1,0,1,1,0,0,0,25246,2,0.00001,2,0.555556,0.6,0,0,0
9404130,9404130,,1,1,2,1,1,2,0,0,0,25247,22,0.000013,2,0.6,0.666667,0,0.5,0.000219
9404131,9404131,,1,6,7,1,6,7,0.000001,0.000024,0,1332,9,0.000012,5,0.372414,0.441049,7258.441945,0.285714,0.000316
9404133,9404133,,0,5,5,0,5,5,0,0.000014,0,25248,13,0.00001,2,0.857143,0.916667,0,0.15,0
9404137,9404137,,0,1,1,0,1,1,0,0,67,25250,87,0.00001,1,1,1,0,0,0
9401067,9401067,,1,0,1,1,0,1,0,0,67,25249,87,0.000019,0,0,0,0,0,0.000219
9404139,9404139,,4,9,13,4,9,13,0.000046,0.000027,0,5407,9,0.000015,6,0.294521,0.368475,11451.153968,0.070513,0.000917
9403068,9403068,,1,0,1,1,0,1,0,0,0,5405,9,0.000011,0,0,0,0,0,0.000246
9404141,9404141,,0,4,4,0,4,4,0,0.000001,0,25251,6,0.00001,2,0.75,0.833333,0,0.333333,0
9404148,9404148,,0,2,2,0,2,2,0,0.000024,0,25252,41,0.00001,1,1,1,0,0.5,0
9404160,9404160,,0,1,1,0,1,1,0,0,68,25254,88,0.00001,1,1,1,0,0,0
9212018,9212018,,1,0,1,1,0,1,0,0,68,25253,88,0.000019,0,0,0,0,0,0.000219
9404167,9404167,,0,1,1,0,1,1,0,0,69,25256,89,0.00001,1,1,1,0,0,0
9207047,9207047,,1,0,1,1,0,1,0,0,69,25255,89,0.000019,0,0,0,0,0,0.000219
9404169,9404169,,1,2,3,1,2,3,0,0.000002,0,25257,15,0.000014,1,1,1,2,0,0.000219
9404179,9404179,,1,6,7,1,6,7,0,0,0,25258,6,0.000011,2,0.8,0.875,2,0.095238,0.000219
9301077,9301077,,3,0,3,3,0,3,0,0,0,3220,6,0.000014,0,0,0,0,0,0.000792
9404182,9404182,,0,4,4,0,4,4,0,0.000001,0,25259,22,0.00001,2,0.75,0.833333,0,0.083333,0
9404189,9404189,,0,1,1,0,1,1,0,0,0,25260,26,0.00001,2,0.666667,0.75,0,0,0
9404193,9404193,,2,1,3,2,1,3,0.00002,0.000004,0,5462,15,0.000015,1,1,1,1,0.166667,0.000466
9405015,9405015,,1,5,6,1,5,6,0,0.000008,0,8206,5,0.000011,3,0.533333,0.572917,26.45202,0.1,0.000233
9210051,9210051,,1,0,1,1,0,1,0,0,0,9784,6,0.000012,0,0,0,0,0,0.000233
9405027,9405027,,0,2,2,0,2,2,0,0,54,25262,90,0.00001,2,0.75,0.833333,0,0,0
9307113,9307113,,1,0,1,1,0,1,0,0,54,25261,90,0.000014,0,0,0,0,0,0.000219
9405036,9405036,,0,1,1,0,1,1,0,0.000001,0,25263,20,0.00001,1,1,1,0,0,0
9405037,9405037,,0,1,1,0,1,1,0,0,66,25264,86,0.00001,1,1,1,0,0,0
9405040,9405040,,0,1,1,0,1,1,0,0,0,25265,9,0.00001,1,1,1,0,0,0
9204077,9204077,,1,0,1,1,0,1,0,0,0,2052,6,0.000011,0,0,0,0,0,0.000226
9405042,9405042,,0,1,1,0,1,1,0,0,70,25267,91,0.00001,1,1,1,0,0,0
9404178,9404178,,2,0,2,2,0,2,0,0,70,25266,91,0.000028,0,0,0,0,0,0.000438
9405048,9405048,,0,3,3,0,3,3,0,0,0,25269,22,0.00001,2,0.636364,0.714286,0,0,0
9309061,9309061,,2,0,2,2,0,2,0,0,0,25268,22,0.000016,0,0,0,0,0,0.000438
9405050,9405050,,0,3,3,0,3,3,0,0.000004,0,25271,10,0.00001,5,0.352941,0.488889,0,0,0
9402130,9402130,,1,0,1,1,0,1,0,0,0,25270,10,0.000013,0,0,0,0,0,0.000219
9405052,9405052,,0,12,12,0,12,12,0,0.000042,0,25272,5,0.00001,5,0.365789,0.419305,0,0.143939,0
9405056,9405056,,0,4,4,0,4,4,0,0.000019,0,25273,4,0.00001,3,0.615385,0.729167,0,0,0
9405062,9405062,,0,1,1,0,1,1,0,0,71,25275,92,0.00001,1,1,1,0,0,0
9307132,9307132,,1,0,1,1,0,1,0,0,71,25274,92,0.000019,0,0,0,0,0,0.000219
9405065,9405065,,1,5,6,1,5,6,0.000002,0.000439,0,25276,13,0.000011,3,0.522727,0.586957,12.866667,0.1,0.000219
9405071,9405071,,2,3,5,2,3,5,0.000002,0.000007,0,795,4,0.000013,3,0.5625,0.648148,60.256282,0.1,0.00046
9311075,9311075,,1,0,1,1,0,1,0,0,0,5438,15,0.000048,0,0,0,0,0,0.000241
9301032,9301032,,1,0,1,1,0,1,0,0,0,5082,4,0.000011,0,0,0,0,0,0.000267
9405081,9405081,,0,8,8,0,8,8,0,0.000163,0,25278,9,0.00001,2,0.9,0.944444,0,0.017857,0
9203034,9203034,,2,0,2,2,0,2,0.000002,0,0,25277,2,0.000015,0,0,0,0,0,0.000438
9405085,9405085,,0,2,2,0,2,2,0,0,0,25279,6,0.00001,1,1,1,0,0,0
9405088,9405088,,0,5,5,0,5,5,0,0.000002,0,25280,23,0.00001,4,0.407767,0.468254,0,0.2,0
9405089,9405089,,4,8,12,4,8,12,0,0.000001,0,6767,9,0.000019,4,0.45679,0.542793,4992.433758,0.136364,0.000951
9405091,9405091,,1,1,2,1,1,2,0.000406,0.000007,0,10251,26,0.00001,1,1,1,35.557601,0,0.000227
9405092,9405092,,0,2,2,0,2,2,0,0,0,25281,22,0.00001,2,0.75,0.833333,0,0,0
9405099,9405099,,1,5,6,1,5,6,0,0.000003,0,25282,15,0.000012,2,0.666667,0.75,1.333333,0.2,0.000219
9405101,9405101,,1,1,2,1,1,2,0,0,0,25283,6,0.000027,1,1,1,2,0,0.000226
9405115,9405115,,0,2,2,0,2,2,0,0.00001,0,25284,9,0.00001,3,0.4375,0.547619,0,0,0
9405122,9405122,,0,2,2,0,2,2,0,0.000002,0,25285,4,0.00001,1,1,1,0,0,0
9405130,9405130,,2,12,14,2,12,14,0,0.000025,0,25286,5,0.000012,2,0.875,0.928571,15.666667,0.082418,0.000438
9405131,9405131,,1,2,3,1,2,3,0,0.000003,0,25288,6,0.000011,1,1,1,2,0,0.000219
9311029,9311029,,2,0,2,2,0,2,0,0,0,25287,10,0.000017,0,0,0,0,0,0.000451
9405134,9405134,,1,8,9,1,8,9,0,0.000007,0,25289,17,0.00001,6,0.241379,0.325595,1.907576,0.208333,0.000226
9405142,9405142,,0,3,3,0,3,3,0,0,0,25290,6,0.00001,1,1,1,0,0,0
9301087,9301087,,5,0,5,5,0,5,0,0,0,6755,6,0.000022,0,0,0,0,0,0.001109
9405159,9405159,,0,8,8,0,8,8,0,0.000068,0,25291,3,0.00001,2,0.722222,0.807692,0,0.053571,0
9210022,9210022,,6,0,6,6,0,6,0.000002,0,0,4741,26,0.000031,0,0,0,0,0.1,0.001364
9405167,9405167,,0,1,1,0,1,1,0,0,0,25292,4,0.00001,1,1,1,0,0,0
9405169,9405169,,1,1,2,1,1,2,0,0,0,13397,22,0.000011,1,1,1,3.5,0,0.000226
9405172,9405172,,2,3,5,2,3,5,0.000033,0.000075,0,5408,9,0.000011,7,0.251121,0.296882,0,0.35,0.000458
9405175,9405175,,0,4,4,0,4,4,0,0.00005,0,25293,0,0.00001,4,0.44186,0.535088,0,0.333333,0
9405182,9405182,,0,3,3,0,3,3,0,0,0,25294,22,0.00001,4,0.416667,0.558333,0,0.166667,0
9405185,9405185,,2,7,9,2,7,9,0.000052,0.000246,0,13923,5,0.000016,5,0.371622,0.459394,236.955723,0.069444,0.000458
9405186,9405186,,0,2,2,0,2,2,0,0,0,25295,9,0.00001,2,0.75,0.833333,0,0,0
9405189,9405189,,0,1,1,0,1,1,0,0.00001,0,25296,41,0.00001,2,0.666667,0.75,0,0,0
9405192,9405192,,1,2,3,1,2,3,0.000001,0.000051,0,10848,13,0.000011,1,1,1,2.74359,0.166667,0.000226
9405199,9405199,,0,1,1,0,1,1,0,0.000022,0,25297,8,0.00001,3,0.428571,0.5,0,0,0
9406007,9406007,,3,3,6,3,3,6,0,0.000006,0,25298,3,0.00002,1,1,1,4.25,0.166667,0.000658
9406014,9406014,,0,3,3,0,3,3,0,0,0,25299,28,0.00001,2,0.714286,0.8,0,0.333333,0
9406016,9406016,,1,12,13,1,12,13,0,0.000073,0,25300,9,0.000013,5,0.302632,0.461957,8.666667,0.211538,0.000226
9406022,9406022,,4,4,8,4,4,8,0.000002,0.000054,0,4479,3,0.000018,4,0.434783,0.525,11291.573331,0.267857,0.000897
9406035,9406035,,0,5,5,0,5,5,0,0.000009,0,25301,3,0.00001,4,0.4375,0.539683,0,0.2,0
9406038,9406038,,0,1,1,0,1,1,0,0,0,25302,22,0.00001,2,0.6,0.666667,0,0,0
9406043,9406043,,1,1,2,1,1,2,0.000033,0,0,13206,22,0.00001,1,1,1,13.5,0,0.000226
9406044,9406044,,0,4,4,0,4,4,0,0.000013,0,25303,22,0.00001,1,1,1,0,0.083333,0
9406064,9406064,,0,1,1,0,1,1,0,0.000002,0,25304,0,0.00001,1,1,1,0,0,0
9406065,9406065,,0,1,1,0,1,1,0,0,0,25305,15,0.00001,1,1,1,0,0,0
9406066,9406066,,0,4,4,0,4,4,0,0,0,25307,22,0.00001,3,0.6,0.703704,0,0,0
9303142,9303142,,3,0,3,3,0,3,0,0,0,25306,22,0.000015,0,0,0,0,0,0.000658
9406072,9406072,,0,1,1,0,1,1,0,0,0,25308,9,0.00001,2,0.555556,0.6,0,0,0
9406084,9406084,,0,5,5,0,5,5,0,0.000009,0,25310,22,0.00001,2,0.727273,0.8125,0,0.2,0
9402090,9402090,,1,0,1,1,0,1,0,0,0,25309,22,0.000012,0,0,0,0,0,0.000219
9406085,9406085,,0,4,4,0,4,4,0,0.00006,0,25311,5,0.00001,5,0.306748,0.363667,0,0.25,0
9406087,9406087,,0,1,1,0,1,1,0,0,0,25312,22,0.00001,1,1,1,0,0,0
9406099,9406099,,0,6,6,0,6,6,0,0.000002,0,25313,22,0.00001,3,0.575758,0.649123,0,0,0
9406102,9406102,,0,4,4,0,4,4,0,0.000216,0,25314,13,0.00001,2,0.833333,0.9,0,0,0
9406106,9406106,,0,2,2,0,2,2,0,0.000001,0,25316,23,0.00001,1,1,1,0,0,0
9302062,9302062,,3,0,3,3,0,3,0.000006,0,0,25315,23,0.000017,0,0,0,0,0,0.000658
9406113,9406113,,0,2,2,0,2,2,0,0,0,25318,15,0.00001,2,0.625,0.7,0,0,0
9404168,9404168,,1,0,1,1,0,1,0,0,0,25317,15,0.000014,0,0,0,0,0,0.000219
9406121,9406121,,2,4,6,2,4,6,0.000002,0.000039,0,11533,22,0.000012,2,0.833333,0.9,1.333333,0.266667,0.000465
9406123,9406123,,2,2,4,2,2,4,0,0,0,25319,22,0.000016,4,0.391304,0.509259,0,0.416667,0.000445
9406131,9406131,,3,6,9,3,6,9,0,0.000028,0,11527,9,0.000015,3,0.608696,0.702381,64.642857,0.083333,0.000671
9301085,9301085,,2,0,2,2,0,2,0.000001,0,0,11525,5,0.000015,0,0,0,0,0,0.000458
9406137,9406137,,0,1,1,0,1,1,0,0,0,25320,15,0.00001,1,1,1,0,0,0
9406138,9406138,,1,4,5,1,4,5,0.000012,0.000001,0,5423,15,0.00001,2,0.833333,0.9,11322.745582,0.1,0.000226
9405068,9405068,,3,0,3,3,0,3,0.000012,0,0,5421,15,0.000017,0,0,0,0,0.166667,0.000671
9406139,9406139,,0,11,11,0,11,11,0,0.000005,0,25321,17,0.00001,3,0.535714,0.644444,0,0.081818,0
9406141,9406141,,0,3,3,0,3,3,0,0,0,25322,6,0.00001,2,0.714286,0.8,0,0.5,0
9406142,9406142,,0,1,1,0,1,1,0,0,72,25324,93,0.00001,1,1,1,0,0,0
9310065,9310065,,1,0,1,1,0,1,0,0,72,25323,93,0.000019,0,0,0,0,0,0.000219
9406153,9406153,,1,7,8,1,7,8,0,0.000004,0,3009,17,0.000011,6,0.237569,0.312597,23919.452835,0.178571,0.000292
9406157,9406157,,0,5,5,0,5,5,0,0.000005,0,25325,15,0.00001,1,1,1,0,0.1,0
9406159,9406159,,0,1,1,0,1,1,0,0.000008,0,25326,0,0.00001,1,1,1,0,0,0
9406167,9406167,,0,1,1,0,1,1,0,0.000001,0,25327,22,0.00001,1,1,1,0,0,0
9406169,9406169,,0,2,2,0,2,2,0,0,0,25328,22,0.00001,2,0.666667,0.75,0,0,0
9406171,9406171,,1,7,8,1,7,8,0,0.000028,0,25329,4,0.000011,5,0.322289,0.389097,58,0.125,0.000219
9406181,9406181,,0,3,3,0,3,3,0,0.00011,0,25330,0,0.00001,4,0.364964,0.403333,0,0,0
9406182,9406182,,1,2,3,1,2,3,0,0.000001,0,9166,23,0.000028,1,1,1,575.997461,0,0.000226
9403107,9403107,,2,0,2,2,0,2,0,0,0,2475,6,0.000016,0,0,0,0,0,0.00046
9406186,9406186,,0,7,7,0,7,7,0,0.000005,0,25331,15,0.00001,2,0.769231,0.85,0,0.214286,0
9406187,9406187,,0,5,5,0,5,5,0,0.000004,0,25332,22,0.00001,3,0.625,0.733333,0,0.05,0
9406190,9406190,,1,1,2,1,1,2,0,0.000008,0,25333,52,0.000011,2,0.666667,0.75,2,0,0.000219
9406194,9406194,,0,1,1,0,1,1,0,0,0,25334,6,0.00001,2,0.666667,0.75,0,0,0
9308078,9308078,,1,0,1,1,0,1,0,0,0,7299,26,0.000014,0,0,0,0,0,0.000242
9406200,9406200,,0,1,1,0,1,1,0,0,0,25335,15,0.00001,2,0.666667,0.75,0,0,0
9406204,9406204,,3,1,4,3,1,4,0,0,0,5450,15,0.000019,1,1,1,5558.5,0.166667,0.000677
9406205,9406205,,0,10,10,0,10,10,0,0.000012,0,25336,15,0.00001,3,0.666667,0.768519,0,0.144444,0
9407006,9407006,,1,2,3,1,2,3,0,0.000001,0,5553,23,0.000014,4,0.362637,0.411616,0,0.5,0.000235
9407024,9407024,,0,1,1,0,1,1,0,0,73,25338,94,0.00001,1,1,1,0,0,0
9305085,9305085,,1,0,1,1,0,1,0,0,73,25337,94,0.000019,0,0,0,0,0,0.000219
9407030,9407030,,0,3,3,0,3,3,0,0.000002,0,25339,22,0.00001,1,1,1,0,0.166667,0
9407033,9407033,,4,6,10,4,6,10,0.000002,0.000041,0,11535,22,0.000014,3,0.727273,0.854167,175.242492,0.177778,0.000937
9407034,9407034,,0,12,12,0,12,12,0,0.000021,0,25340,17,0.00001,3,0.703704,0.807018,0,0.05303,0
9407035,9407035,,0,1,1,0,1,1,0,0.000001,0,25341,26,0.00001,1,1,1,0,0,0
9407040,9407040,,0,2,2,0,2,2,0,0,0,25343,22,0.00001,1,1,1,0,0,0
9403110,9403110,,1,0,1,1,0,1,0,0,0,25342,22,0.000014,0,0,0,0,0,0.000219
9407048,9407048,,1,6,7,1,6,7,0,0,0,12429,22,0.000012,2,0.8,0.875,8978.665022,0.142857,0.000239
9407062,9407062,,0,5,5,0,5,5,0,0,0,25344,6,0.00001,2,0.857143,0.916667,0,0.05,0
9407063,9407063,,0,3,3,0,3,3,0,0.000004,0,25345,5,0.00001,4,0.306306,0.372549,0,0.166667,0
9407066,9407066,,0,1,1,0,1,1,0,0,0,25346,15,0.00001,2,0.666667,0.75,0,0,0
9407082,9407082,,0,1,1,0,1,1,0,0.000001,0,25347,9,0.00001,1,1,1,0,0,0
9407083,9407083,,0,2,2,0,2,2,0,0.000001,0,25348,15,0.00001,2,0.583333,0.642857,0,0.5,0
9407086,9407086,,0,1,1,0,1,1,0,0,74,25350,95,0.00001,1,1,1,0,0,0
9303151,9303151,,3,0,3,3,0,3,0,0,74,25349,95,0.000044,0,0,0,0,0.166667,0.00067
9407090,9407090,,3,2,5,3,2,5,0,0,0,5896,22,0.000015,1,1,1,4889.822745,0.2,0.000665
9407097,9407097,,1,1,2,1,1,2,0,0.000012,0,6036,15,0.000012,2,0.666667,0.75,1.666667,0,0.000241
9407107,9407107,,0,4,4,0,4,4,0,0.000007,0,25351,22,0.00001,2,0.75,0.833333,0,0.166667,0
9407110,9407110,,0,4,4,0,4,4,0,0,0,25352,15,0.00001,2,0.7,0.785714,0,0.083333,0
9407127,9407127,,0,2,2,0,2,2,0,0,0,25353,22,0.00001,1,1,1,0,0,0
9210094,9210094,,2,0,2,2,0,2,0.000005,0,0,551,13,0.00002,0,0,0,0,0.5,0.000528
9407132,9407132,,1,3,4,1,3,4,0,0,0,25354,6,0.000012,2,0.714286,0.8,3.083333,0,0.000219
9407133,9407133,,0,2,2,0,2,2,0,0.000004,0,25355,13,0.00001,3,0.47619,0.55,0,0,0
9407136,9407136,,1,12,13,1,12,13,0.00003,0.000267,0,5413,9,0.00001,7,0.290824,0.375185,10043.115182,0.089744,0.000233
9306104,9306104,,2,0,2,2,0,2,0.000033,0,0,5410,9,0.000011,0,0,0,0,0.5,0.000458
9407138,9407138,,0,1,1,0,1,1,0,0,75,25357,96,0.00001,1,1,1,0,0,0
9312196,9312196,,1,0,1,1,0,1,0,0,75,25356,96,0.000019,0,0,0,0,0,0.000219
9407144,9407144,,0,3,3,0,3,3,0,0.000024,0,25358,5,0.00001,1,1,1,0,0.333333,0
9407145,9407145,,0,1,1,0,1,1,0,0.000003,0,25359,15,0.00001,1,1,1,0,0,0
9407146,9407146,,3,1,4,3,1,4,0,0,0,25360,6,0.000016,1,1,1,0.5,0.25,0.000664
9407157,9407157,,2,3,5,2,3,5,0,0,0,5453,15,0.000014,2,0.8,0.875,1,0.25,0.000445
9309112,9309112,,2,0,2,2,0,2,0,0,0,5452,15,0.000016,0,0,0,0,0.5,0.000458
9407162,9407162,,1,1,2,1,1,2,0,0.000001,0,25361,22,0.000012,1,1,1,0,0.5,0.000219
9407163,9407163,,1,13,14,1,13,14,0.000002,0.000117,0,7907,9,0.000013,6,0.304651,0.398473,775.264658,0.076923,0.000252
9407164,9407164,,1,4,5,1,4,5,0.000001,0.000001,0,1558,5,0.000013,3,0.533333,0.6875,370.685129,0.25,0.000262
9407165,9407165,,0,1,1,0,1,1,0,0,62,25362,102,0.00001,1,1,1,0,0,0
9407171,9407171,,0,1,1,0,1,1,0,0,62,25363,102,0.00001,1,1,1,0,0,0
9407172,9407172,,0,2,2,0,2,2,0,0,62,25365,102,0.00001,1,1,1,0,0,0
9311160,9311160,,2,0,2,2,0,2,0,0,62,25364,102,0.000019,0,0,0,0,0,0.000438
9203032,9203032,,1,0,1,1,0,1,0.000001,0,0,19588,4,0.000016,0,0,0,0,0,0.000232
9407178,9407178,,0,1,1,0,1,1,0,0.000001,0,25366,26,0.00001,1,1,1,0,0,0
9407184,9407184,,0,1,1,0,1,1,0,0,76,25368,97,0.00001,1,1,1,0,0,0
9304076,9304076,,1,0,1,1,0,1,0,0,76,25367,97,0.000019,0,0,0,0,0,0.000219
9407187,9407187,,1,6,7,1,6,7,0.000001,0.000102,0,25370,13,0.000012,4,0.508197,0.572581,2,0.142857,0.000219
9406148,9406148,,1,0,1,1,0,1,0.000001,0,0,25369,13,0.000012,0,0,0,0,0,0.000226
9407195,9407195,,3,6,9,3,6,9,0.00002,0.000013,0,5460,15,0.000014,2,0.636364,0.714286,23915.135467,0.055556,0.000692
9407197,9407197,,0,1,1,0,1,1,0,0.000004,0,25371,13,0.00001,1,1,1,0,0,0
9408011,9408011,,0,3,3,0,3,3,0,0,0,25372,22,0.00001,2,0.8,0.875,0,0.333333,0
9408012,9408012,,1,1,2,1,1,2,0,0.000001,0,25373,15,0.000011,1,1,1,0,0.5,0.000219
9408015,9408015,,0,1,1,0,1,1,0,0.00001,0,25374,41,0.00001,2,0.666667,0.75,0,0,0
9408018,9408018,,0,6,6,0,6,6,0,0.000036,0,25375,26,0.00001,6,0.285383,0.342141,0,0.1,0
9408021,9408021,,0,4,4,0,4,4,0,0,0,25377,15,0.00001,2,0.75,0.833333,0,0.166667,0
9309113,9309113,,1,0,1,1,0,1,0,0,0,25376,15,0.000012,0,0,0,0,0,0.000219
9408024,9408024,,1,3,4,1,3,4,0.000024,0.000117,0,19397,28,0.000012,3,0.5,0.6,0,0.25,0.000232
9408026,9408026,,0,4,4,0,4,4,0,0.000577,0,25378,41,0.00001,4,0.321053,0.368852,0,0.083333,0
9408030,9408030,,2,10,12,2,10,12,0,0.000081,0,25379,23,0.000015,2,0.8125,0.884615,16,0.159091,0.000438
9408031,9408031,,1,10,11,1,10,11,0,0.000008,0,10551,15,0.000011,2,0.916667,0.954545,7064.273397,0.181818,0.000232
9408042,9408042,,0,1,1,0,1,1,0,0.000001,0,25380,9,0.00001,1,1,1,0,0,0
9408047,9408047,,1,2,3,1,2,3,0,0.000001,0,1655,23,0.000013,2,0.666667,0.75,0,0.5,0.000277
9408050,9408050,,0,1,1,0,1,1,0,0,0,25381,20,0.00001,1,1,1,0,0,0
9408051,9408051,,0,1,1,0,1,1,0,0.000001,0,25382,4,0.00001,1,1,1,0,0,0
9408055,9408055,,0,3,3,0,3,3,0,0,0,25384,26,0.00001,1,1,1,0,0,0
9208014,9208014,,2,0,2,2,0,2,0,0,0,25383,26,0.000014,0,0,0,0,0,0.000438
9408059,9408059,,1,1,2,1,1,2,0,0,0,10549,15,0.000011,1,1,1,0,0.5,0.000232
9408063,9408063,,0,6,6,0,6,6,0,0.000055,0,25385,0,0.00001,6,0.277879,0.333882,0,0.2,0
9408069,9408069,,0,6,6,0,6,6,0,0.000013,0,25386,52,0.00001,1,1,1,0,0.166667,0
9211128,9211128,,1,0,1,1,0,1,0,0,0,3216,9,0.000011,0,0,0,0,0,0.000242
9408084,9408084,,1,2,3,1,2,3,0.000002,0.000075,0,25387,13,0.000011,1,1,1,0,0.333333,0.000219
9408094,9408094,,0,3,3,0,3,3,0,0.000042,0,25388,0,0.00001,6,0.27459,0.322886,0,0.5,0
9408108,9408108,,1,2,3,1,2,3,0,0,0,25389,26,0.000019,3,0.48,0.541667,19.5,0,0.000226
9408110,9408110,,0,1,1,0,1,1,0,0.000068,0,25390,0,0.00001,2,0.555556,0.6,0,0,0
9408111,9408111,,0,1,1,0,1,1,0,0.000003,0,25391,30,0.00001,1,1,1,0,0,0
9408123,9408123,,0,1,1,0,1,1,0,0,0,25392,15,0.00001,2,0.666667,0.75,0,0,0
9408130,9408130,,0,6,6,0,6,6,0,0.00001,0,25393,6,0.00001,4,0.578947,0.734848,0,0.133333,0
9408131,9408131,,0,5,5,0,5,5,0,0,0,25394,6,0.00001,1,1,1,0,0.1,0
9408138,9408138,,1,1,2,1,1,2,0,0,0,8895,6,0.000012,1,1,1,14.355455,0,0.000226
9408139,9408139,,0,2,2,0,2,2,0,0,0,25395,6,0.00001,1,1,1,0,0,0
9408140,9408140,,0,7,7,0,7,7,0,0.000197,0,25396,26,0.00001,4,0.388889,0.485714,0,0.238095,0
9408142,9408142,,0,5,5,0,5,5,0,0.000043,0,25397,41,0.00001,6,0.293814,0.363158,0,0.1,0
9408143,9408143,,0,1,1,0,1,1,0,0.000002,0,25398,6,0.00001,2,0.666667,0.75,0,0,0
9408144,9408144,,1,7,8,1,7,8,0,0.000056,0,6578,13,0.000013,4,0.538462,0.702381,25.288315,0.125,0.00024
9408150,9408150,,1,1,2,1,1,2,0,0,0,25399,26,0.000012,1,1,1,1,0,0.000219
9408153,9408153,,0,1,1,0,1,1,0,0,0,25400,15,0.00001,1,1,1,0,0,0
9408154,9408154,,0,1,1,0,1,1,0,0,0,25401,28,0.00001,1,1,1,0,0,0
9408157,9408157,,0,1,1,0,1,1,0,0,0,25402,30,0.00001,1,1,1,0,0,0
9408165,9408165,,1,1,2,1,1,2,0,0,0,25403,22,0.000019,1,1,1,1,0,0.000219
9408170,9408170,,0,2,2,0,2,2,0,0.000005,0,25404,15,0.00001,2,0.75,0.833333,0,0,0
9408171,9408171,,0,6,6,0,6,6,0,0.000122,0,25405,0,0.00001,2,0.666667,0.75,0,0.2,0
9408174,9408174,,0,1,1,0,1,1,0,0,0,25406,26,0.00001,1,1,1,0,0,0
9408179,9408179,,0,8,8,0,8,8,0,0.000011,0,25407,15,0.00001,3,0.625,0.744444,0,0.053571,0
9409002,9409002,,0,2,2,0,2,2,0,0,0,25408,23,0.00001,1,1,1,0,0.5,0
9409005,9409005,,2,1,3,2,1,3,0.000001,0,0,4392,41,0.000019,1,1,1,119.218158,0.166667,0.000452
9409007,9409007,,0,3,3,0,3,3,0,0.000025,0,25409,10,0.00001,5,0.359375,0.41087,0,0,0
9409008,9409008,,0,1,1,0,1,1,0,0,0,25410,28,0.00001,1,1,1,0,0,0
9409017,9409017,,0,4,4,0,4,4,0,0.000035,0,25411,10,0.00001,5,0.370968,0.428261,0,0,0
9409031,9409031,,1,6,7,1,6,7,0,0.000022,0,3606,26,0.000011,1,1,1,46.792083,0.142857,0.000239
9409032,9409032,,0,2,2,0,2,2,0,0,0,25412,5,0.00001,3,0.545455,0.638889,0,0,0
9409038,9409038,,1,1,2,1,1,2,0,0,0,25413,23,0.000014,1,1,1,0,0.5,0.000219
9409040,9409040,,0,4,4,0,4,4,0,0.000008,0,25414,15,0.00001,2,0.75,0.833333,0,0,0
9409045,9409045,,0,1,1,0,1,1,0,0.000003,0,25415,30,0.00001,1,1,1,0,0,0
9409056,9409056,,0,5,5,0,5,5,0,0.000008,0,25416,15,0.00001,1,1,1,0,0,0
9409057,9409057,,0,5,5,0,5,5,0,0.000005,0,25417,15,0.00001,1,1,1,0,0.1,0
9409059,9409059,,0,3,3,0,3,3,0,0.000007,0,25418,22,0.00001,1,1,1,0,0,0
9409061,9409061,,0,6,6,0,6,6,0,0.000107,0,25419,13,0.00001,5,0.32493,0.37227,0,0.1,0
9409063,9409063,,0,3,3,0,3,3,0,0.000039,0,25420,4,0.00001,1,1,1,0,0.166667,0
9409073,9409073,,0,1,1,0,1,1,0,0,0,25421,26,0.00001,2,0.666667,0.75,0,0,0
9409077,9409077,,0,1,1,0,1,1,0,0.000031,0,25422,13,0.00001,4,0.309677,0.329861,0,0,0
9409079,9409079,,0,19,19,0,19,19,0,0.000006,0,25426,6,0.00001,3,0.66,0.772727,0,0.011696,0
9212039,9212039,,1,0,1,1,0,1,0,0,0,25425,6,0.00001,0,0,0,0,0,0.000219
9305180,9305180,,1,0,1,1,0,1,0,0,0,25424,6,0.00001,0,0,0,0,0,0.000219
9307032,9307032,,1,0,1,1,0,1,0,0,0,25423,6,0.00001,0,0,0,0,0,0.000219
9409090,9409090,,0,3,3,0,3,3,0,0,0,25428,6,0.00001,2,0.714286,0.8,0,0,0
9409036,9409036,,2,0,2,2,0,2,0,0,0,25427,6,0.000015,0,0,0,0,0,0.000438
9409092,9409092,,0,1,1,0,1,1,0,0.000208,0,25429,52,0.00001,1,1,1,0,0,0
9409095,9409095,,0,19,19,0,19,19,0,0.003646,0,25430,0,0.00001,6,0.330128,0.412298,0,0.093567,0
9409097,9409097,,2,2,4,2,2,4,0,0.000003,0,11034,6,0.000015,4,0.392857,0.492424,79.313293,0.25,0.000446
9409100,9409100,,0,4,4,0,4,4,0,0.000003,0,25432,15,0.00001,2,0.666667,0.75,0,0,0
9401114,9401114,,1,0,1,1,0,1,0,0,0,25431,15,0.000012,0,0,0,0,0,0.000219
9409118,9409118,,0,2,2,0,2,2,0,0.000094,0,25433,52,0.00001,5,0.363636,0.470833,0,0,0
9409121,9409121,,0,3,3,0,3,3,0,0.000058,0,25434,0,0.00001,4,0.37931,0.418182,0,0.166667,0
9409122,9409122,,3,6,9,3,6,9,0.000002,0,0,6769,9,0.000016,5,0.346774,0.42907,1598.799716,0.25,0.000726
9409123,9409123,,0,2,2,0,2,2,0,0,0,25435,21,0.00001,1,1,1,0,0.5,0
9409124,9409124,,2,5,7,2,5,7,0.000058,0.00015,0,25436,0,0.000012,3,0.512821,0.591667,4.083333,0.214286,0.000458
9409125,9409125,,0,4,4,0,4,4,0,0.000001,0,25437,9,0.00001,3,0.517241,0.6,0,0.166667,0
9409126,9409126,,1,7,8,1,7,8,0,0.000006,0,25438,9,0.000011,3,0.483333,0.568966,17,0.178571,0.000219
9409127,9409127,,0,3,3,0,3,3,0,0,0,25439,6,0.00001,1,1,1,0,0,0
9409132,9409132,,0,3,3,0,3,3,0,0.000003,0,25440,15,0.00001,1,1,1,0,0,0
9409136,9409136,,0,3,3,0,3,3,0,0.000005,0,25441,15,0.00001,2,0.714286,0.8,0,0,0
9409140,9409140,,0,3,3,0,3,3,0,0.00001,0,25442,22,0.00001,2,0.8,0.875,0,0.166667,0
9409146,9409146,,0,1,1,0,1,1,0,0,0,25443,23,0.00001,2,0.571429,0.625,0,0,0
9409150,9409150,,0,1,1,0,1,1,0,0,70,25444,91,0.00001,1,1,1,0,0,0
9409155,9409155,,0,2,2,0,2,2,0,0.000004,0,25445,22,0.00001,2,0.666667,0.75,0,0,0
9409156,9409156,,0,2,2,0,2,2,0,0,0,25447,22,0.00001,1,1,1,0,0,0
9207076,9207076,,2,0,2,2,0,2,0,0,0,25446,22,0.000019,0,0,0,0,0,0.000438
9409157,9409157,,0,10,10,0,10,10,0,0.000077,0,25448,17,0.00001,8,0.265027,0.371723,0,0.255556,0
9409163,9409163,,0,4,4,0,4,4,0,0.000003,0,25449,22,0.00001,3,0.571429,0.708333,0,0,0
9310171,9310171,,4,0,4,4,0,4,0.000001,0,0,10313,22,0.000018,0,0,0,0,0.083333,0.000916
9310189,9310189,,4,0,4,4,0,4,0.000001,0,0,10312,22,0.000018,0,0,0,0,0.083333,0.000916
9409166,9409166,,2,9,11,2,9,11,0.000028,0.000132,0,25450,4,0.000011,3,0.578947,0.681818,10,0.127273,0.000438
9409170,9409170,,3,5,8,3,5,8,0.000002,0,0,6770,9,0.000016,5,0.338462,0.407955,974.816928,0.321429,0.000706
9409174,9409174,,0,1,1,0,1,1,0,0,0,25451,26,0.00001,1,1,1,0,0,0
9409175,9409175,,0,3,3,0,3,3,0,0.000025,0,25452,28,0.00001,5,0.323308,0.378295,0,0,0
9409180,9409180,,4,4,8,4,4,8,0.000001,0,0,10315,22,0.000016,1,1,1,3259,0.107143,0.000905
9409186,9409186,,3,11,14,3,11,14,0.000008,0.000011,0,3190,9,0.000012,5,0.425,0.537908,1065.889704,0.131868,0.000711
9409189,9409189,,1,4,5,1,4,5,0.00002,0,0,5454,15,0.00001,2,0.833333,0.9,55570,0.15,0.000247
9409191,9409191,,0,2,2,0,2,2,0,0.000004,0,25453,22,0.00001,2,0.571429,0.625,0,0,0
9409200,9409200,,0,8,8,0,8,8,0,0.000001,0,25454,21,0.00001,4,0.4,0.538462,0,0.142857,0
9410001,9410001,,0,2,2,0,2,2,0,0,0,25455,22,0.00001,1,1,1,0,0,0
9410004,9410004,,2,10,12,2,10,12,0.000015,0.000233,0,3603,26,0.000011,6,0.29932,0.379735,12377.71058,0.174242,0.000458
9410006,9410006,,0,3,3,0,3,3,0,0.000034,0,25456,2,0.00001,6,0.299652,0.351163,0,0,0
9410007,9410007,,1,1,2,1,1,2,0,0,0,9167,23,0.00002,2,0.6,0.666667,6079.997461,0,0.000226
9410013,9410013,,2,9,11,2,9,11,0,0.000004,0,6762,9,0.000013,5,0.377273,0.448594,9458.243869,0.218182,0.000473
9405116,9405116,,2,0,2,2,0,2,0,0,0,6761,9,0.000013,0,0,0,0,0,0.000452
9410018,9410018,,0,3,3,0,3,3,0,0.000466,0,25457,0,0.00001,5,0.32,0.373363,0,0.5,0
9410021,9410021,,0,4,4,0,4,4,0,0,0,25458,6,0.00001,2,0.833333,0.9,0,0.166667,0
9410028,9410028,,0,2,2,0,2,2,0,0,0,25459,5,0.00001,2,0.75,0.833333,0,0.5,0
9410030,9410030,,0,3,3,0,3,3,0,0.000251,0,25460,5,0.00001,3,0.52381,0.560606,0,0,0
9410039,9410039,,0,2,2,0,2,2,0,0.000003,0,25461,15,0.00001,1,1,1,0,0,0
9410044,9410044,,0,2,2,0,2,2,0,0,0,25462,6,0.00001,1,1,1,0,0.5,0
9410075,9410075,,0,1,1,0,1,1,0,0.000029,0,25463,5,0.00001,2,0.666667,0.75,0,0,0
9410076,9410076,,1,2,3,1,2,3,0,0.000007,0,25464,25,0.000013,1,1,1,1,0.166667,0.000219
9410086,9410086,,0,6,6,0,6,6,0,0,0,25465,17,0.00001,2,0.75,0.833333,0,0.066667,0
9410059,9410059,,3,0,3,3,0,3,0.000002,0,0,12717,26,0.000015,0,0,0,0,0,0.000678
9410088,9410088,,2,8,10,2,8,10,0.000002,0.000082,0,7850,22,0.000014,4,0.355556,0.458333,8716.442538,0.111111,0.000458
9410090,9410090,,1,3,4,1,3,4,0,0,0,25466,22,0.000012,4,0.416667,0.558333,0,0.416667,0.000219
9410096,9410096,,1,2,3,1,2,3,0.000127,0,0,25467,22,0.00001,2,0.625,0.7,10,0,0.000226
9410097,9410097,,0,2,2,0,2,2,0,0.000007,0,25468,22,0.00001,1,1,1,0,0,0
9410102,9410102,,0,1,1,0,1,1,0,0,0,25469,4,0.00001,1,1,1,0,0,0
9410108,9410108,,1,2,3,1,2,3,0.000001,0.000055,0,4483,3,0.000011,2,0.666667,0.75,0,0.333333,0.000252
9410111,9410111,,0,1,1,0,1,1,0,0,77,25471,98,0.00001,1,1,1,0,0,0
9310059,9310059,,1,0,1,1,0,1,0,0,77,25470,98,0.000019,0,0,0,0,0,0.000219
9410113,9410113,,3,2,5,3,2,5,0.000002,0,0,4521,5,0.000017,2,0.75,0.833333,10111.856113,0.25,0.000697
9410116,9410116,,0,3,3,0,3,3,0,0.000001,0,25472,23,0.00001,3,0.5,0.583333,0,0.166667,0
9410120,9410120,,0,1,1,0,1,1,0,0.000005,0,25473,5,0.00001,2,0.666667,0.75,0,0,0
9410124,9410124,,0,5,5,0,5,5,0,0.000018,0,25474,30,0.00001,1,1,1,0,0.1,0
9410127,9410127,,0,1,1,0,1,1,0,0.000013,0,25475,4,0.00001,2,0.6,0.666667,0,0,0
9410135,9410135,,1,3,4,1,3,4,0,0.000005,0,25476,15,0.000012,1,1,1,0,0.25,0.000219
9410139,9410139,,0,1,1,0,1,1,0,0,0,25477,2,0.00001,2,0.555556,0.6,0,0,0
9410145,9410145,,1,1,2,1,1,2,0,0,0,25478,22,0.000011,1,1,1,0,0.5,0.000219
9410148,9410148,,0,5,5,0,5,5,0,0.000216,0,25479,0,0.00001,4,0.362069,0.480159,0,0,0
9410154,9410154,,0,2,2,0,2,2,0,0.000001,0,25480,2,0.00001,1,1,1,0,0,0
9410155,9410155,,0,2,2,0,2,2,0,0.000014,0,25481,5,0.00001,3,0.44186,0.491228,0,0.5,0
9410156,9410156,,0,11,11,0,11,11,0,0.000001,0,25482,9,0.00001,4,0.5,0.607143,0,0.090909,0
9410159,9410159,,0,1,1,0,1,1,0,0.000001,0,25483,20,0.00001,1,1,1,0,0,0
9410161,9410161,,0,1,1,0,1,1,0,0,78,25485,99,0.00001,1,1,1,0,0,0
9401054,9401054,,2,0,2,2,0,2,0,0,78,25484,99,0.000028,0,0,0,0,0,0.000438
9410170,9410170,,0,6,6,0,6,6,0,0.000011,0,25486,9,0.00001,5,0.353659,0.406322,0,0.166667,0
9410171,9410171,,0,4,4,0,4,4,0,0,0,25487,6,0.00001,2,0.833333,0.9,0,0.083333,0
9410179,9410179,,2,1,3,2,1,3,0.000033,0.000004,0,25488,2,0.000011,2,0.6,0.666667,0.866667,0.333333,0.000451
9410182,9410182,,0,2,2,0,2,2,0,0,0,25489,28,0.00001,2,0.75,0.833333,0,0,0
9410183,9410183,,1,3,4,1,3,4,0,0.000002,0,25490,23,0.000011,7,0.199405,0.240441,0,0.25,0.000219
9410186,9410186,,1,1,2,1,1,2,0,0,0,25491,15,0.000014,3,0.5,0.611111,3,0,0.000219
9410193,9410193,,1,3,4,1,3,4,0,0,0,25493,6,0.000014,3,0.583333,0.690476,7,0,0.000219
9407050,9407050,,1,0,1,1,0,1,0,0,0,25492,6,0.000014,0,0,0,0,0,0.000226
9410194,9410194,,1,1,2,1,1,2,0.000003,0,0,25494,26,0.00001,4,0.342105,0.391026,8.5,0,0.000219
9410195,9410195,,2,2,4,2,2,4,0,0.000001,0,25495,15,0.000045,1,1,1,8,0.25,0.000471
9410196,9410196,,0,7,7,0,7,7,0,0.000005,0,25496,17,0.00001,4,0.53125,0.661765,0,0.142857,0
9410198,9410198,,0,1,1,0,1,1,0,0,0,25497,8,0.00001,1,1,1,0,0,0
9410200,9410200,,2,1,3,2,1,3,0.00003,0.000004,0,25498,2,0.000014,2,0.6,0.666667,3,0.166667,0.000451
9410204,9410204,,0,2,2,0,2,2,0,0,0,25499,5,0.00001,1,1,1,0,0,0
9410207,9410207,,0,5,5,0,5,5,0,0,0,25504,26,0.00001,1,1,1,0,0,0
9410058,9410058,,3,0,3,3,0,3,0,0,0,25503,26,0.000023,0,0,0,0,0.166667,0.000664
9410060,9410060,,2,0,2,2,0,2,0,0,0,25502,26,0.000013,0,0,0,0,0,0.000438
9410061,9410061,,2,0,2,2,0,2,0,0,0,25501,26,0.000013,0,0,0,0,0,0.000438
9410062,9410062,,2,0,2,2,0,2,0,0,0,25500,26,0.000013,0,0,0,0,0,0.000438
9410222,9410222,,0,3,3,0,3,3,0,0.000094,0,25505,13,0.00001,5,0.377778,0.479412,0,0,0
9410224,9410224,,0,6,6,0,6,6,0,0.000002,0,25506,9,0.00001,5,0.323944,0.421377,0,0.133333,0
9410226,9410226,,1,1,2,1,1,2,0.000004,0.000004,0,25507,2,0.000011,2,0.6,0.666667,0.866667,0,0.000219
9410232,9410232,,0,2,2,0,2,2,0,0.000001,0,25508,2,0.00001,1,1,1,0,0,0
9410233,9410233,,2,6,8,2,6,8,0.000001,0.000011,0,11528,4,0.000013,5,0.3125,0.390889,278.810818,0.089286,0.000446
9410235,9410235,,3,9,12,3,9,12,0.000002,0.0002,0,25509,26,0.000013,5,0.300493,0.404098,114.219034,0.143939,0.000671
9410240,9410240,,0,1,1,0,1,1,0,0.000009,0,25510,26,0.00001,2,0.571429,0.625,0,0,0
9410242,9410242,,0,2,2,0,2,2,0,0.000001,0,25511,3,0.00001,2,0.666667,0.75,0,0.5,0
9410243,9410243,,1,2,3,1,2,3,0,0,0,25512,26,0.000013,2,0.666667,0.75,4,0,0.000219
9411006,9411006,,0,5,5,0,5,5,0,0.000007,0,25513,15,0.00001,3,0.446809,0.539683,0,0.2,0
9411014,9411014,,0,7,7,0,7,7,0,0.000001,0,25514,5,0.00001,2,0.652174,0.733333,0,0.214286,0
9411023,9411023,,1,2,3,1,2,3,0,0,0,3724,22,0.000022,1,1,1,12190,0.166667,0.00026
9307094,9307094,,1,0,1,1,0,1,0,0,0,3722,22,0.00002,0,0,0,0,0,0.000226
9411024,9411024,,4,5,9,4,5,9,0.000129,0.00032,0,2008,5,0.000012,4,0.402439,0.472222,19469.758464,0.152778,0.00099
9411034,9411034,,0,1,1,0,1,1,0,0,0,25515,15,0.00001,1,1,1,0,0,0
9411035,9411035,,1,1,2,1,1,2,0,0.000004,0,25516,22,0.000014,1,1,1,1,0,0.000219
9411036,9411036,,0,2,2,0,2,2,0,0.000004,0,25517,6,0.00001,2,0.6,0.666667,0,0,0
9411038,9411038,,0,6,6,0,6,6,0,0,0,25520,6,0.00001,3,0.526316,0.616667,0,0,0
9311142,9311142,,1,0,1,1,0,1,0,0,0,25519,6,0.000011,0,0,0,0,0,0.000219
9405150,9405150,,1,0,1,1,0,1,0,0,0,25518,6,0.000011,0,0,0,0,0,0.000219
9411043,9411043,,1,1,2,1,1,2,0,0.000001,0,25521,22,0.000012,1,1,1,1,0,0.000219
9411046,9411046,,0,7,7,0,7,7,0,0.000001,0,25522,9,0.00001,6,0.323944,0.397343,0,0.142857,0
9411056,9411056,,0,7,7,0,7,7,0,0.000041,0,25523,4,0.00001,6,0.313846,0.376634,0,0.095238,0
9411059,9411059,,0,3,3,0,3,3,0,0,0,25525,9,0.00001,2,0.8,0.875,0,0,0
9305149,9305149,,1,0,1,1,0,1,0,0,0,25524,9,0.000013,0,0,0,0,0,0.000219
9411060,9411060,,0,1,1,0,1,1,0,0,0,25527,15,0.00001,1,1,1,0,0,0
9410110,9410110,,2,0,2,2,0,2,0,0,0,25526,15,0.00002,0,0,0,0,0,0.000438
9411063,9411063,,4,2,6,4,2,6,0,0.000003,0,11933,10,0.000025,4,0.378378,0.452381,5.833333,0.333333,0.000903
9411067,9411067,,1,1,2,1,1,2,0,0.000002,0,25528,22,0.000014,1,1,1,0,0.5,0.000219
9411071,9411071,,0,2,2,0,2,2,0,0.000002,0,25529,22,0.00001,1,1,1,0,0.5,0
9411075,9411075,,0,5,5,0,5,5,0,0.00002,0,25530,30,0.00001,1,1,1,0,0.1,0
9411082,9411082,,1,8,9,1,8,9,0,0.000017,0,7080,22,0.000011,2,0.75,0.833333,2.666667,0.305556,0.000227
9411097,9411097,,0,7,7,0,7,7,0,0.001427,0,25531,5,0.00001,6,0.307692,0.364167,0,0.095238,0
9411098,9411098,,0,1,1,0,1,1,0,0,79,25533,100,0.00001,1,1,1,0,0,0
9305183,9305183,,1,0,1,1,0,1,0,0,79,25532,100,0.000019,0,0,0,0,0,0.000219
9411107,9411107,,0,6,6,0,6,6,0,0.00002,0,25534,9,0.00001,2,0.714286,0.8,0,0.033333,0
9411121,9411121,,2,9,11,2,9,11,0,0.000006,0,3091,15,0.000014,3,0.653846,0.754902,101993.232395,0.109091,0.00049
9411123,9411123,,0,5,5,0,5,5,0,0.000006,0,25535,22,0.00001,6,0.244344,0.32963,0,0.05,0
9411133,9411133,,0,6,6,0,6,6,0,0.000023,0,25537,22,0.00001,2,0.875,0.928571,0,0.133333,0
9308044,9308044,,2,0,2,2,0,2,0,0,0,25536,22,0.000013,0,0,0,0,0,0.000445
9411137,9411137,,4,1,5,4,1,5,0,0,0,3979,23,0.000023,1,1,1,25.558679,0.3,0.000985
9411141,9411141,,4,1,5,4,1,5,0,0,0,25538,15,0.000037,2,0.6,0.666667,9,0.15,0.000896
9411142,9411142,,3,3,6,3,3,6,0,0.000008,0,11787,23,0.000023,6,0.248394,0.284339,1524.834059,0.1,0.000684
9409194,9409194,,1,0,1,1,0,1,0,0,0,11786,23,0.000017,0,0,0,0,0,0.000239
9411143,9411143,,3,5,8,3,5,8,0.000009,0.000181,0,2514,26,0.000012,6,0.265918,0.324178,0.445953,0.339286,0.000742
9411147,9411147,,0,1,1,0,1,1,0,0.000002,0,25539,6,0.00001,2,0.666667,0.75,0,0,0
9411151,9411151,,1,2,3,1,2,3,0,0,0,25540,30,0.000011,2,0.625,0.7,2.5,0,0.000219
9411156,9411156,,4,14,18,4,14,18,0.000008,0.000033,0,3195,9,0.000014,5,0.426901,0.516895,6248.428327,0.179739,0.000931
9411158,9411158,,0,1,1,0,1,1,0,0.000003,0,25541,30,0.00001,2,0.666667,0.75,0,0,0
9411159,9411159,,0,2,2,0,2,2,0,0.000002,0,25542,22,0.00001,1,1,1,0,0.5,0
9411161,9411161,,0,1,1,0,1,1,0,0,0,25543,22,0.00001,2,0.666667,0.75,0,0,0
9411162,9411162,,0,1,1,0,1,1,0,0,0,25544,22,0.00001,2,0.666667,0.75,0,0,0
9411165,9411165,,1,3,4,1,3,4,0.000001,0.000005,0,25545,3,0.000012,5,0.328125,0.415873,0.5,0.333333,0.000219
9408008,9408008,,1,0,1,1,0,1,0.000007,0,0,2369,6,0.000011,0,0,0,0,0,0.000347
9411181,9411181,,0,2,2,0,2,2,0,0,0,25546,6,0.00001,1,1,1,0,0,0
9411182,9411182,,2,1,3,2,1,3,0,0,0,3842,23,0.00002,1,1,1,0,0.5,0.000459
9212056,9212056,,3,0,3,3,0,3,0,0,0,3841,23,0.000037,0,0,0,0,0.5,0.000691
9411186,9411186,,0,5,5,0,5,5,0,0.000007,0,25547,15,0.00001,2,0.692308,0.777778,0,0,0
9411189,9411189,,1,1,2,1,1,2,0,0,0,25548,22,0.000019,1,1,1,1,0,0.000219
9411192,9411192,,0,5,5,0,5,5,0,0.000005,0,25549,4,0.00001,6,0.279487,0.343272,0,0.05,0
9411193,9411193,,0,2,2,0,2,2,0,0.000012,0,25550,5,0.00001,5,0.403922,0.440291,0,0.5,0
9411196,9411196,,0,1,1,0,1,1,0,0,0,25551,15,0.00001,1,1,1,0,0,0
9411197,9411197,,0,2,2,0,2,2,0,0,6,25553,24,0.00001,1,1,1,0,0,0
9304008,9304008,,1,0,1,1,0,1,0,0,6,25552,24,0.000014,0,0,0,0,0,0.000219
9411199,9411199,,0,3,3,0,3,3,0,0.000001,0,25554,23,0.00001,1,1,1,0,0.333333,0
9411206,9411206,,0,3,3,0,3,3,0,0,0,25555,0,0.00001,4,0.425926,0.492754,0,0.166667,0
9411207,9411207,,0,3,3,0,3,3,0,0,0,25556,6,0.00001,1,1,1,0,0,0
9411213,9411213,,0,4,4,0,4,4,0,0.000058,0,25557,5,0.00001,5,0.283582,0.357018,0,0.25,0
9303028,9303028,,2,0,2,2,0,2,0,0,0,7895,5,0.000015,0,0,0,0,0,0.000446
9411215,9411215,,0,2,2,0,2,2,0,0,0,25559,20,0.00001,1,1,1,0,0,0
9401079,9401079,,1,0,1,1,0,1,0,0,0,25558,20,0.000014,0,0,0,0,0,0.000219
9411217,9411217,,1,6,7,1,6,7,0.000002,0.000048,0,25560,13,0.00001,6,0.27907,0.362778,16.5,0.238095,0.000219
9411220,9411220,,0,4,4,0,4,4,0,0.000005,0,25561,26,0.00001,1,1,1,0,0.416667,0
9411222,9411222,,0,1,1,0,1,1,0,0.000062,0,25562,0,0.00001,1,1,1,0,0,0
9312128,9312128,,2,0,2,2,0,2,0,0,0,3901,26,0.000024,0,0,0,0,0,0.000446
9411237,9411237,,0,3,3,0,3,3,0,0.000001,0,25563,25,0.00001,2,0.714286,0.8,0,0,0
9308085,9308085,,2,0,2,2,0,2,0,0,0,9780,25,0.000018,0,0,0,0,0,0.000451
9411240,9411240,,0,1,1,0,1,1,0,0,0,25564,22,0.00001,2,0.666667,0.75,0,0,0
9411241,9411241,,0,3,3,0,3,3,0,0,0,25565,6,0.00001,4,0.360656,0.44697,0,0.5,0
9412003,9412003,,3,8,11,3,8,11,0.000011,0.000146,0,4593,5,0.000017,8,0.259084,0.313248,711.935933,0.1,0.000728
9412004,9412004,,1,1,2,1,1,2,0,0.000002,0,25566,28,0.000014,1,1,1,1,0,0.000219
9412005,9412005,,0,2,2,0,2,2,0,0,0,25567,9,0.00001,5,0.287356,0.330333,0,0.5,0
9412010,9412010,,2,3,5,2,3,5,0,0.000001,0,9782,25,0.000017,2,0.714286,0.8,12575.20217,0,0.000445
9412013,9412013,,0,3,3,0,3,3,0,0.000002,0,25568,6,0.00001,2,0.8,0.875,0,0,0
9412016,9412016,,0,2,2,0,2,2,0,0.000006,0,25569,15,0.00001,4,0.29,0.33908,0,0.5,0
9412023,9412023,,2,5,7,2,5,7,0.000001,0.000019,0,21058,4,0.000013,3,0.571429,0.680556,39.428571,0.119048,0.000445
9412025,9412025,,0,1,1,0,1,1,0,0.000058,0,25570,4,0.00001,7,0.215088,0.239623,0,0,0
9412029,9412029,,0,5,5,0,5,5,0,0.000005,0,25571,15,0.00001,1,1,1,0,0.15,0
9412035,9412035,,0,8,8,0,8,8,0,0.000052,0,25573,9,0.00001,4,0.349315,0.444444,0,0.071429,0
9212156,9212156,,2,0,2,2,0,2,0.000001,0,0,25572,9,0.000014,0,0,0,0,0,0.000438
9412039,9412039,,2,1,3,2,1,3,0,0,0,6760,6,0.000013,2,0.666667,0.75,9254.727204,0.166667,0.000473
9412041,9412041,,0,2,2,0,2,2,0,0,0,25574,25,0.00001,6,0.261905,0.305303,0,0,0
9412043,9412043,,0,7,7,0,7,7,0,0.000019,0,25576,5,0.00001,5,0.335052,0.406923,0,0.095238,0
9404055,9404055,,2,0,2,2,0,2,0,0,0,25575,28,0.000015,0,0,0,0,0,0.000445
9412044,9412044,,0,14,14,0,14,14,0,0.00021,0,25577,13,0.00001,5,0.345238,0.404813,0,0.186813,0
9412052,9412052,,2,2,4,2,2,4,0,0.000001,0,25579,20,0.000027,1,1,1,4,0.083333,0.000445
9301095,9301095,,1,0,1,1,0,1,0,0,0,25578,20,0.000022,0,0,0,0,0,0.000232
9412057,9412057,,0,1,1,0,1,1,0,0,80,25581,101,0.00001,1,1,1,0,0,0
9211004,9211004,,1,0,1,1,0,1,0,0,80,25580,101,0.000019,0,0,0,0,0,0.000219
9412060,9412060,,0,5,5,0,5,5,0,0,0,25582,22,0.00001,2,0.777778,0.857143,0,0.1,0
9412067,9412067,,0,2,2,0,2,2,0,0,62,25584,102,0.00001,1,1,1,0,0,0
9406143,9406143,,1,0,1,1,0,1,0,0,62,25583,102,0.000014,0,0,0,0,0,0.000219
9412070,9412070,,0,4,4,0,4,4,0,0.000085,0,25585,0,0.00001,1,1,1,0,0,0
9412080,9412080,,1,5,6,1,5,6,0,0.000166,0,25586,26,0.000019,2,0.727273,0.8125,8,0.066667,0.000219
9412082,9412082,,0,1,1,0,1,1,0,0,0,25587,15,0.00001,1,1,1,0,0,0
9412087,9412087,,0,3,3,0,3,3,0,0.000001,0,25589,1,0.00001,3,0.583333,0.690476,0,0,0
9207113,9207113,,1,0,1,1,0,1,0,0,0,25588,1,0.000013,0,0,0,0,0,0.000219
9412091,9412091,,1,2,3,1,2,3,0,0,0,8894,6,0.000012,1,1,1,6450.355455,0,0.000226
9411001,9411001,,2,0,2,2,0,2,0,0,0,8893,6,0.000024,0,0,0,0,0,0.000445
9412096,9412096,,0,2,2,0,2,2,0,0.000001,0,25590,17,0.00001,2,0.583333,0.642857,0,0.5,0
9412098,9412098,,0,1,1,0,1,1,0,0.000002,0,25591,15,0.00001,2,0.666667,0.75,0,0,0
9412099,9412099,,0,2,2,0,2,2,0,0.000001,0,25592,15,0.00001,3,0.555556,0.666667,0,0,0
9412103,9412103,,1,1,2,1,1,2,0,0,0,25593,26,0.000011,1,1,1,0,0.5,0.000219
9412105,9412105,,0,1,1,0,1,1,0,0,0,25594,15,0.00001,1,1,1,0,0,0
9412107,9412107,,0,2,2,0,2,2,0,0.000002,0,25595,26,0.00001,2,0.75,0.833333,0,0.5,0
9412112,9412112,,0,8,8,0,8,8,0,0.000243,0,25596,0,0.00001,2,0.681818,0.766667,0,0.142857,0
9412116,9412116,,1,1,2,1,1,2,0,0,0,3076,6,0.000013,2,0.666667,0.75,0,0.5,0.00027
9412118,9412118,,0,4,4,0,4,4,0,0.000005,0,25597,52,0.00001,2,0.666667,0.75,0,0.166667,0
9412121,9412121,,0,1,1,0,1,1,0,0,0,25599,28,0.00001,1,1,1,0,0,0
9407174,9407174,,3,0,3,3,0,3,0,0,0,25598,28,0.000038,0,0,0,0,0,0.000664
9412123,9412123,,0,2,2,0,2,2,0,0.000017,0,25600,52,0.00001,4,0.428571,0.494444,0,0.5,0
9412126,9412126,,0,3,3,0,3,3,0,0.000005,0,25601,52,0.00001,3,0.435897,0.509804,0,0.166667,0
9412135,9412135,,0,9,9,0,9,9,0,0.000112,0,25602,4,0.00001,3,0.575,0.673913,0,0.152778,0
9412137,9412137,,0,1,1,0,1,1,0,0.000003,0,25603,22,0.00001,1,1,1,0,0,0
9412150,9412150,,0,4,4,0,4,4,0,0.000219,0,25604,13,0.00001,4,0.4,0.488636,0,0.416667,0
9412151,9412151,,0,2,2,0,2,2,0,0.000001,0,25605,26,0.00001,1,1,1,0,0.5,0
9412155,9412155,,2,8,10,2,8,10,0.000001,0.000036,0,25606,1,0.000017,3,0.684211,0.794872,38,0.088889,0.000445
9412160,9412160,,1,7,8,1,7,8,0.000001,0.00001,0,25607,9,0.000011,3,0.516129,0.583333,8.785714,0.035714,0.000219
9412168,9412168,,0,6,6,0,6,6,0,0.000007,0,25608,52,0.00001,3,0.489796,0.576389,0,0.066667,0
9412171,9412171,,3,2,5,3,2,5,0.000026,0.000001,0,3819,23,0.000013,2,0.75,0.833333,564.184292,0.3,0.000708
9412172,9412172,,0,1,1,0,1,1,0,0.000128,0,25609,13,0.00001,3,0.419355,0.461538,0,0,0
9412183,9412183,,0,1,1,0,1,1,0,0.00001,0,25610,41,0.00001,2,0.666667,0.75,0,0,0
9412186,9412186,,0,1,1,0,1,1,0,0.000001,0,25611,23,0.00001,1,1,1,0,0,0
9307141,9307141,,1,0,1,1,0,1,0.000003,0,0,4079,0,0.000011,0,0,0,0,0,0.000255
9412189,9412189,,0,19,19,0,19,19,0,0.000461,0,25612,5,0.00001,8,0.31028,0.405651,0,0.084795,0
9412190,9412190,,0,1,1,0,1,1,0,0,0,25613,6,0.00001,1,1,1,0,0,0
9412191,9412191,,0,4,4,0,4,4,0,0,0,25614,6,0.00001,2,0.75,0.833333,0,0.083333,0
9412197,9412197,,0,1,1,0,1,1,0,0,0,25615,6,0.00001,1,1,1,0,0,0
9412206,9412206,,1,4,5,1,4,5,0.000001,0.001963,0,11955,4,0.000011,6,0.269618,0.313308,22.957614,0.3,0.000246
9412215,9412215,,0,4,4,0,4,4,0,0,0,25616,22,0.00001,4,0.44,0.598485,0,0.416667,0
9412217,9412217,,1,1,2,1,1,2,0,0,0,8248,2,0.000024,1,1,1,0,0.5,0.000245
9412219,9412219,,0,1,1,0,1,1,0,0.000006,0,25617,0,0.00001,1,1,1,0,0,0
9412221,9412221,,1,5,6,1,5,6,0,0.000018,0,7078,22,0.000019,3,0.571429,0.680556,714.270304,0.1,0.000242
9412235,9412235,,1,10,11,1,10,11,0.000018,0.001008,0,5344,13,0.000011,3,0.566038,0.65,6.075,0.163636,0.000239
9412241,9412241,,1,4,5,1,4,5,0,0.000036,0,25618,26,0.000019,7,0.263158,0.323226,155,0.05,0.000219
9409078,9409078,,1,0,1,1,0,1,0,0,0,17882,23,0.000015,0,0,0,0,0,0.000226
9501008,9501008,,0,1,1,0,1,1,0,0,0,25619,23,0.00001,1,1,1,0,0,0
9501009,9501009,,3,1,4,3,1,4,0.000006,0,0,25620,26,0.000015,3,0.5,0.583333,4,0.25,0.000664
9501010,9501010,,1,1,2,1,1,2,0.000006,0,0,25621,26,0.000011,3,0.5,0.583333,0,0.5,0.000219
9501011,9501011,,0,7,7,0,7,7,0,0.000034,0,25622,5,0.00001,2,0.612903,0.684211,0,0.047619,0
9308035,9308035,,2,0,2,2,0,2,0,0,0,3962,9,0.00002,0,0,0,0,0,0.00048
9501033,9501033,,1,4,5,1,4,5,0,0.000003,0,25623,6,0.000011,2,0.75,0.833333,2,0.2,0.000219
9501046,9501046,,0,1,1,0,1,1,0,0.000006,0,25624,26,0.00001,1,1,1,0,0,0
9501051,9501051,,0,7,7,0,7,7,0,0.000004,0,25625,5,0.00001,3,0.666667,0.816667,0,0.095238,0
9501060,9501060,,0,5,5,0,5,5,0,0.000002,0,25626,4,0.00001,1,1,1,0,0,0
9410049,9410049,,4,0,4,4,0,4,0,0,0,1839,6,0.000028,0,0,0,0,0.166667,0.000969
9501074,9501074,,0,4,4,0,4,4,0,0.000046,0,25627,2,0.00001,2,0.666667,0.75,0,0.166667,0
9501076,9501076,,0,7,7,0,7,7,0,0.000001,0,25628,6,0.00001,2,0.769231,0.85,0,0.214286,0
9501082,9501082,,0,5,5,0,5,5,0,0.000054,0,25629,3,0.00001,4,0.44898,0.545455,0,0.35,0
9501086,9501086,,0,1,1,0,1,1,0,0,0,25630,26,0.00001,1,1,1,0,0,0
9501090,9501090,,3,25,28,3,25,28,0.000126,0.000617,0,2004,5,0.000011,6,0.307836,0.359327,7959.249793,0.112434,0.000721
9501091,9501091,,1,8,9,1,8,9,0.000001,0.000514,0,25631,13,0.000011,5,0.363107,0.409804,45.889755,0.055556,0.000219
9501094,9501094,,1,2,3,1,2,3,0.000019,0.000132,0,2102,13,0.000011,7,0.253343,0.275241,36.137132,0,0.000352
9501100,9501100,,3,1,4,3,1,4,0,0,0,3214,9,0.000015,2,0.666667,0.75,0,0.5,0.000725
9501108,9501108,,1,1,2,1,1,2,0.00002,0.000001,0,5432,15,0.00001,5,0.241135,0.279412,79.218229,0,0.000247
9501109,9501109,,0,12,12,0,12,12,0,0.000006,0,25632,6,0.00001,6,0.297872,0.409184,0,0.037879,0
9501116,9501116,,1,4,5,1,4,5,0,0,0,25633,22,0.000011,1,1,1,4,0.05,0.000219
9501120,9501120,,2,5,7,2,5,7,0.000024,0.000011,0,10477,4,0.000012,2,0.666667,0.75,0.583333,0.285714,0.000458
9501123,9501123,,3,1,4,3,1,4,0,0,0,15985,17,0.000018,2,0.666667,0.75,0.833333,0.25,0.000678
9501125,9501125,,1,6,7,1,6,7,0,0,0,9786,6,0.000015,3,0.555556,0.666667,31685.635304,0.047619,0.000227
9411225,9411225,,1,0,1,1,0,1,0,0,0,9783,6,0.000012,0,0,0,0,0,0.000226
9501126,9501126,,0,6,6,0,6,6,0,0.000053,0,25634,9,0.00001,3,0.488372,0.587302,0,0.1,0
9501128,9501128,,1,2,3,1,2,3,0,0,0,25635,6,0.000011,2,0.666667,0.75,4,0,0.000219
9501129,9501129,,0,2,2,0,2,2,0,0.000008,0,25636,23,0.00001,1,1,1,0,0,0
9605123,9605123,,0,2,2,0,2,2,0,0,0,25637,6,0.00001,1,1,1,0,0,0
9501139,9501139,,0,1,1,0,1,1,0,0,0,25638,23,0.00001,1,1,1,0,0,0
9501143,9501143,,5,4,9,5,4,9,0,0.000011,0,18031,15,0.000017,6,0.3,0.357143,468.664313,0.194444,0.001149
9502005,9502005,,0,1,1,0,1,1,0,0,0,25639,23,0.00001,1,1,1,0,0,0
9502020,9502020,,0,2,2,0,2,2,0,0.000004,0,25640,22,0.00001,3,0.538462,0.619048,0,0,0
9502023,9502023,,0,4,4,0,4,4,0,0.000004,0,25641,5,0.00001,4,0.46,0.532609,0,0.083333,0
9502026,9502026,,0,3,3,0,3,3,0,0,0,25642,15,0.00001,3,0.529412,0.62963,0,0,0
9502027,9502027,,0,1,1,0,1,1,0,0,0,25643,5,0.00001,1,1,1,0,0,0
9502036,9502036,,2,5,7,2,5,7,0,0,0,25644,17,0.000011,6,0.26257,0.314894,4.866667,0.309524,0.000451
9502037,9502037,,0,6,6,0,6,6,0,0,0,25645,26,0.00001,1,1,1,0,0.033333,0
9502039,9502039,,0,4,4,0,4,4,0,0.000001,0,25646,6,0.00001,2,0.75,0.833333,0,0.333333,0
9502043,9502043,,0,2,2,0,2,2,0,0.000015,0,25647,26,0.00001,2,0.625,0.7,0,0,0
9502050,9502050,,0,14,14,0,14,14,0,0.000034,0,25648,22,0.00001,4,0.522388,0.65,0,0.203297,0
9502052,9502052,,1,2,3,1,2,3,0.000061,0.000002,0,25649,26,0.00001,2,0.75,0.833333,3,0.166667,0.000219
9502059,9502059,,0,10,10,0,10,10,0,0.000001,0,25650,22,0.00001,2,0.8125,0.884615,0,0.166667,0
9502062,9502062,,0,5,5,0,5,5,0,0.000038,0,25651,5,0.00001,4,0.333333,0.426768,0,0.05,0
9305108,9305108,,1,0,1,1,0,1,0,0,0,6915,6,0.000021,0,0,0,0,0,0.000227
9502064,9502064,,0,2,2,0,2,2,0,0.000003,0,25653,10,0.00001,1,1,1,0,0,0
9207023,9207023,,1,0,1,1,0,1,0,0,0,25652,10,0.000014,0,0,0,0,0,0.000219
9502086,9502086,,0,3,3,0,3,3,0,0.000013,0,25654,13,0.00001,6,0.343137,0.42,0,0.333333,0
9502090,9502090,,0,5,5,0,5,5,0,0.000005,0,25655,9,0.00001,6,0.26626,0.317812,0,0.2,0
9502093,9502093,,0,2,2,0,2,2,0,0.000058,0,25656,0,0.00001,4,0.409091,0.509259,0,0.5,0
9502101,9502101,,3,3,6,3,3,6,0,0,0,25657,5,0.000016,4,0.45283,0.510417,93,0.133333,0.000664
9502105,9502105,,1,6,7,1,6,7,0,0.000006,0,3746,22,0.000013,3,0.512195,0.603175,4903.531104,0.095238,0.000233
9502108,9502108,,4,11,15,4,11,15,0.000001,0.000025,0,3193,9,0.000014,5,0.459677,0.54152,20359.011731,0.1,0.000938
9502112,9502112,,0,1,1,0,1,1,0,0,81,25659,103,0.00001,1,1,1,0,0,0
9308070,9308070,,1,0,1,1,0,1,0,0,81,25658,103,0.000019,0,0,0,0,0,0.000219
9502121,9502121,,3,4,7,3,4,7,0,0.000004,0,18032,15,0.000013,7,0.247104,0.302753,6.782332,0.285714,0.000684
9502123,9502123,,0,3,3,0,3,3,0,0,0,25660,17,0.00001,1,1,1,0,0,0
9502127,9502127,,2,6,8,2,6,8,0,0.000001,0,3823,23,0.000013,4,0.5,0.654762,20450.217542,0.232143,0.000465
9502131,9502131,,1,5,6,1,5,6,0,0.00001,0,25661,5,0.000011,2,0.727273,0.8125,6.5,0.1,0.000219
9502134,9502134,,1,2,3,1,2,3,0,0,0,25662,6,0.000014,1,1,1,0.5,0.333333,0.000219
9502142,9502142,,1,1,2,1,1,2,0,0,0,25663,28,0.00002,1,1,1,2,0,0.000226
9502147,9502147,,1,11,12,1,11,12,0,0.000002,0,12517,23,0.000012,3,0.678571,0.780702,2828.9127,0.136364,0.000227
9203015,9203015,,1,0,1,1,0,1,0,0,0,12516,23,0.000011,0,0,0,0,0,0.000226
9502150,9502150,,0,12,12,0,12,12,0,0.000204,0,25664,41,0.00001,6,0.304858,0.357967,0,0.212121,0
9502152,9502152,,4,1,5,4,1,5,0,0,0,5044,23,0.000024,3,0.4375,0.5,17628.06343,0.1,0.000933
9502153,9502153,,0,1,1,0,1,1,0,0,0,25665,0,0.00001,6,0.244009,0.270685,0,0,0
9502154,9502154,,0,4,4,0,4,4,0,0.000002,0,25666,22,0.00001,1,1,1,0,0,0
9502159,9502159,,0,4,4,0,4,4,0,0,0,25668,21,0.00001,2,0.666667,0.75,0,0.25,0
9306144,9306144,,1,0,1,1,0,1,0,0,0,25667,21,0.000012,0,0,0,0,0,0.000219
9502160,9502160,,1,6,7,1,6,7,0,0.000014,0,6758,9,0.00001,5,0.366972,0.46,1385.536349,0.095238,0.000253
9503008,9503008,,0,1,1,0,1,1,0,0.000001,0,25669,26,0.00001,1,1,1,0,0,0
9503009,9503009,,3,3,6,3,3,6,0.000049,0.000469,0,13924,5,0.000018,9,0.221384,0.261461,599.032467,0.066667,0.000671
9503013,9503013,,0,6,6,0,6,6,0,0.000062,0,25670,26,0.00001,7,0.238223,0.289037,0,0.066667,0
9503026,9503026,,0,1,1,0,1,1,0,0,0,25671,15,0.00001,1,1,1,0,0,0
9503031,9503031,,0,3,3,0,3,3,0,0.000021,0,25672,9,0.00001,2,0.8,0.875,0,0,0
9503037,9503037,,1,4,5,1,4,5,0,0,0,25673,6,0.000011,1,1,1,0,0.3,0.000219
9503039,9503039,,0,3,3,0,3,3,0,0.001918,0,25674,4,0.00001,6,0.268537,0.308333,0,0.5,0
9503047,9503047,,0,14,14,0,14,14,0,0.000024,0,25675,9,0.00001,6,0.279926,0.356798,0,0.032967,0
9503048,9503048,,0,17,17,0,17,17,0,0.000277,0,25676,26,0.00001,5,0.377119,0.479588,0,0.106618,0
9503049,9503049,,0,4,4,0,4,4,0,0.001029,0,25677,17,0.00001,6,0.267748,0.31048,0,0.166667,0
9503058,9503058,,2,1,3,2,1,3,0,0.000001,0,8967,23,0.00002,1,1,1,8.25,0.333333,0.000513
9503066,9503066,,0,3,3,0,3,3,0,0.000001,0,25678,6,0.00001,2,0.8,0.875,0,0,0
9503067,9503067,,0,4,4,0,4,4,0,0.000008,0,25679,22,0.00001,3,0.666667,0.805556,0,0.25,0
9503103,9503103,,1,5,6,1,5,6,0,0.000014,0,25680,30,0.000011,1,1,1,1.583333,0.2,0.000219
9503107,9503107,,1,8,9,1,8,9,0,0.000006,0,6311,6,0.00001,3,0.586207,0.705882,14198.780671,0.069444,0.000226
9210100,9210100,,2,0,2,2,0,2,0,0,0,6310,52,0.000012,0,0,0,0,0,0.000445
9503111,9503111,,0,3,3,0,3,3,0,0.000002,0,25681,28,0.00001,2,0.714286,0.8,0,0.166667,0
9503118,9503118,,6,7,13,6,7,13,0.000001,0.00001,0,3198,9,0.000017,6,0.346939,0.401634,348.335662,0.237179,0.001382
9503122,9503122,,0,9,9,0,9,9,0,0.002477,0,25682,4,0.00001,7,0.257939,0.301968,0,0.166667,0
9503123,9503123,,0,1,1,0,1,1,0,0,0,25683,23,0.00001,1,1,1,0,0,0
9503129,9503129,,1,9,10,1,9,10,0,0.000048,0,2952,0,0.000015,4,0.438776,0.527132,3614.620338,0.111111,0.000229
9503130,9503130,,0,18,18,0,18,18,0,0.000222,0,25684,5,0.00001,7,0.249339,0.290169,0,0.127451,0
9503131,9503131,,0,1,1,0,1,1,0,0,0,25685,23,0.00001,2,0.666667,0.75,0,0,0
9503139,9503139,,1,3,4,1,3,4,0,0.000001,0,5068,6,0.000012,3,0.454545,0.516667,22547.207436,0.166667,0.000236
9503144,9503144,,0,5,5,0,5,5,0,0.000014,0,25686,13,0.00001,2,0.857143,0.916667,0,0.15,0
9503158,9503158,,0,10,10,0,10,10,0,0.000007,0,25687,9,0.00001,7,0.364532,0.459588,0,0.122222,0
9503159,9503159,,1,12,13,1,12,13,0,0.000007,0,3211,9,0.000011,6,0.365559,0.433333,17909.352838,0.166667,0.000227
9503164,9503164,,0,6,6,0,6,6,0,0.000011,0,25688,6,0.00001,4,0.410256,0.5,0,0.166667,0
9503166,9503166,,0,8,8,0,8,8,0,0.00001,0,25689,9,0.00001,7,0.29703,0.346619,0,0.196429,0
9503167,9503167,,0,9,9,0,9,9,0,0.000121,0,25690,17,0.00001,4,0.359649,0.433943,0,0.111111,0
9503169,9503169,,0,1,1,0,1,1,0,0,0,25691,26,0.00001,8,0.209396,0.239248,0,0,0
9503174,9503174,,1,6,7,1,6,7,0.000004,0.000034,0,6599,52,0.000011,3,0.551724,0.65625,545.285359,0.095238,0.00024
9503191,9503191,,2,6,8,2,6,8,0.000002,0.000014,0,7525,6,0.000012,5,0.304469,0.358716,256.414026,0.160714,0.000446
9503196,9503196,,0,1,1,0,1,1,0,0,82,25693,104,0.00001,1,1,1,0,0,0
9304145,9304145,,1,0,1,1,0,1,0,0,82,25692,104,0.000019,0,0,0,0,0,0.000219
9503199,9503199,,0,4,4,0,4,4,0,0.000001,0,25694,22,0.00001,1,1,1,0,0,0
9502128,9502128,,3,0,3,3,0,3,0,0,0,10820,22,0.000041,0,0,0,0,0,0.000664
9503200,9503200,,1,4,5,1,4,5,0.000002,0.000097,0,4393,41,0.00001,8,0.253247,0.302829,8460.988246,0,0.000227
9503202,9503202,,8,4,12,8,4,12,0.000091,0.000161,0,7261,5,0.000028,8,0.236162,0.282422,690.171171,0.090909,0.001816
9503206,9503206,,2,4,6,2,4,6,0,0.000006,0,5723,13,0.000016,3,0.555556,0.666667,7005.935383,0.133333,0.000471
9503215,9503215,,1,3,4,1,3,4,0,0,0,5042,23,0.000013,3,0.5,0.611111,19700.17142,0.083333,0.000233
9503223,9503223,,0,1,1,0,1,1,0,0,0,25695,4,0.00001,1,1,1,0,0,0
9503231,9503231,,2,13,15,2,13,15,0.000004,0.002422,0,25697,2,0.000012,6,0.323529,0.389305,434.927175,0.042857,0.000445
9404074,9404074,,2,0,2,2,0,2,0.000033,0,0,25696,2,0.000011,0,0,0,0,0.5,0.000451
9503233,9503233,,1,2,3,1,2,3,0,0,0,25698,22,0.000015,2,0.75,0.833333,4,0.166667,0.000226
9504003,9504003,,1,4,5,1,4,5,0,0.000002,0,25699,9,0.00001,4,0.411765,0.503968,0.333333,0.3,0.000219
9504004,9504004,,2,9,11,2,9,11,0.000004,0.000209,0,25700,26,0.000013,4,0.436782,0.548246,33.529412,0.327273,0.000438
9504008,9504008,,0,2,2,0,2,2,0,0,0,25702,6,0.00001,4,0.428571,0.527778,0,0,0
9410144,9410144,,1,0,1,1,0,1,0,0,0,25701,6,0.000014,0,0,0,0,0,0.000219
9504016,9504016,,0,3,3,0,3,3,0,0,0,25703,23,0.00001,1,1,1,0,0.5,0
9504023,9504023,,0,12,12,0,12,12,0,0.000104,0,25704,9,0.00001,7,0.356784,0.410765,0,0.045455,0
9504035,9504035,,1,2,3,1,2,3,0,0,0,25705,6,0.000011,1,1,1,0,0.333333,0.000219
9504040,9504040,,1,4,5,1,4,5,0,0,0,25706,10,0.000011,4,0.361702,0.480392,0,0.45,0.000219
9504041,9504041,,1,2,3,1,2,3,0,0.000001,0,25707,6,0.000014,6,0.243542,0.294192,66,0,0.000219
9504043,9504043,,1,2,3,1,2,3,0,0.000014,0,4726,23,0.000012,5,0.260116,0.310741,939.828883,0.166667,0.000227
9504044,9504044,,0,2,2,0,2,2,0,0,0,25708,23,0.00001,1,1,1,0,0,0
9504058,9504058,,0,1,1,0,1,1,0,0,83,25710,105,0.00001,1,1,1,0,0,0
9401082,9401082,,1,0,1,1,0,1,0,0,83,25709,105,0.000019,0,0,0,0,0,0.000219
9504062,9504062,,0,1,1,0,1,1,0,0,84,25712,106,0.00001,1,1,1,0,0,0
9308117,9308117,,1,0,1,1,0,1,0,0,84,25711,106,0.000019,0,0,0,0,0,0.000219
9504068,9504068,,0,2,2,0,2,2,0,0.000007,0,25714,26,0.00001,7,0.195572,0.254897,0,0,0
9210154,9210154,,1,0,1,1,0,1,0,0,0,25713,26,0.000014,0,0,0,0,0,0.000219
9504069,9504069,,0,11,11,0,11,11,0,0.000003,0,25715,6,0.00001,4,0.485714,0.605392,0,0.154545,0
9504076,9504076,,2,2,4,2,2,4,0.000007,0,0,10905,26,0.000012,1,1,1,4996.759368,0.25,0.000465
9504079,9504079,,1,2,3,1,2,3,0,0.000003,0,25716,26,0.000014,3,0.571429,0.708333,1,0.166667,0.000219
9504092,9504092,,1,3,4,1,3,4,0,0.000001,0,25717,20,0.000011,2,0.8,0.875,2.4,0,0.000219
9504093,9504093,,1,23,24,1,23,24,0,0.000152,0,7465,5,0.000011,4,0.520833,0.617778,147.470198,0.057971,0.000239
9504096,9504096,,0,4,4,0,4,4,0,0.000001,0,25719,9,0.00001,3,0.6,0.703704,0,0,0
9404069,9404069,,1,0,1,1,0,1,0,0,0,25718,9,0.000012,0,0,0,0,0,0.000219
9504110,9504110,,1,4,5,1,4,5,0.000001,0.000003,0,14521,15,0.00001,1,1,1,2279.284129,0.15,0.000246
9504112,9504112,,1,8,9,1,8,9,0,0.000065,0,4480,3,0.000011,5,0.372973,0.450725,30.906664,0.277778,0.000226
9504119,9504119,,1,3,4,1,3,4,0,0,0,25720,6,0.000011,1,1,1,0,0.333333,0.000219
9504126,9504126,,0,3,3,0,3,3,0,0.000009,0,25721,5,0.00001,3,0.533333,0.645833,0,0,0
9504133,9504133,,1,6,7,1,6,7,0,0.000016,0,5928,3,0.000027,5,0.363128,0.432308,1301.16522,0.238095,0.000226
9504135,9504135,,0,2,2,0,2,2,0,0.00004,0,25722,26,0.00001,8,0.252063,0.297027,0,0,0
9504136,9504136,,5,2,7,5,2,7,0,0,0,13396,22,0.00002,1,1,1,10,0.261905,0.001122
9407142,9407142,,5,0,5,5,0,5,0,0,0,13395,22,0.000028,0,0,0,0,0.35,0.001148
9411066,9411066,,6,0,6,6,0,6,0,0,0,13394,22,0.000037,0,0,0,0,0.233333,0.001367
9504149,9504149,,2,31,33,2,31,33,0.000033,0.002548,0,5416,9,0.000011,7,0.328006,0.394647,58079.721682,0.053977,0.000473
9504156,9504156,,0,1,1,0,1,1,0,0.000068,0,25723,4,0.00001,4,0.308333,0.351351,0,0,0
9504161,9504161,,1,23,24,1,23,24,0.000042,0.005472,0,6575,13,0.00001,8,0.253507,0.316829,99.549286,0.108696,0.000242
9504163,9504163,,0,1,1,0,1,1,0,0,54,25724,90,0.00001,1,1,1,0,0,0
9505001,9505001,,2,1,3,2,1,3,0,0,0,25725,26,0.000016,1,1,1,0,0.333333,0.000438
9505002,9505002,,1,1,2,1,1,2,0,0,0,4788,28,0.00002,1,1,1,11560,0,0.000227
9502151,9502151,,1,0,1,1,0,1,0,0,0,4787,28,0.000028,0,0,0,0,0,0.000226
9505007,9505007,,0,10,10,0,10,10,0,0,0,25727,6,0.00001,2,0.857143,0.916667,0,0.133333,0
9410066,9410066,,1,0,1,1,0,1,0,0,0,25726,6,0.000011,0,0,0,0,0,0.000219
9505008,9505008,,2,2,4,2,2,4,0,0,0,25728,6,0.000014,3,0.538462,0.619048,8.833333,0.25,0.000438
9505011,9505011,,2,6,8,2,6,8,0,0.000019,0,2777,22,0.000014,3,0.608696,0.702381,28831.706007,0.142857,0.000491
9412233,9412233,,5,0,5,5,0,5,0,0,0,8968,23,0.000031,0,0,0,0,0,0.001163
9505026,9505026,,1,5,6,1,5,6,0,0,0,25729,26,0.000012,2,0.647059,0.727273,11,0.133333,0.000219
9505028,9505028,,0,6,6,0,6,6,0,0.000006,0,25730,30,0.00001,1,1,1,0,0.1,0
9505033,9505033,,0,12,12,0,12,12,0,0.00007,0,25731,5,0.00001,5,0.346093,0.393011,0,0.037879,0
9505034,9505034,,2,3,5,2,3,5,0,0.000003,0,25732,13,0.000013,8,0.224409,0.251634,1.5,0.3,0.000451
9505036,9505036,,1,4,5,1,4,5,0,0,0,25733,28,0.000019,3,0.615385,0.729167,8,0,0.000219
9505043,9505043,,1,7,8,1,7,8,0.000002,0.000001,0,4391,22,0.00001,3,0.590909,0.730769,19700.896296,0.089286,0.000227
9404015,9404015,,1,0,1,1,0,1,0,0,0,4390,22,0.000011,0,0,0,0,0,0.000226
9505044,9505044,,1,8,9,1,8,9,0,0,0,25734,21,0.000019,7,0.232358,0.296861,135,0.222222,0.000219
9505048,9505048,,1,1,2,1,1,2,0,0,0,25735,26,0.000012,1,1,1,0.333333,0,0.000219
9505056,9505056,,2,5,7,2,5,7,0,0,0,25736,9,0.000011,5,0.347826,0.42875,14.666667,0.238095,0.000445
9505057,9505057,,0,2,2,0,2,2,0,0.000049,0,25737,0,0.00001,8,0.225455,0.25512,0,0.5,0
9505066,9505066,,0,1,1,0,1,1,0,0,0,25738,2,0.00001,2,0.666667,0.75,0,0,0
9505071,9505071,,2,5,7,2,5,7,0,0.000008,0,11023,22,0.000014,2,0.857143,0.916667,3018.022992,0.142857,0.00046
9505076,9505076,,1,2,3,1,2,3,0,0,0,25739,17,0.000019,1,1,1,2,0,0.000219
9505079,9505079,,1,1,2,1,1,2,0,0.000001,0,25740,4,0.000011,1,1,1,0,0.5,0.000219
9410037,9410037,,1,0,1,1,0,1,0,0,0,9290,6,0.000016,0,0,0,0,0,0.000247
9505089,9505089,,1,22,23,1,22,23,0.00002,0.001058,0,5430,15,0.00001,7,0.292128,0.342894,112991.503708,0.043478,0.000247
9307078,9307078,,2,0,2,2,0,2,0.000033,0,0,5428,15,0.000011,0,0,0,0,0.5,0.000473
9401150,9401150,,2,0,2,2,0,2,0.000033,0,0,5424,15,0.000011,0,0,0,0,0.5,0.000473
9406145,9406145,,1,0,1,1,0,1,0.000012,0,0,5420,15,0.00001,0,0,0,0,0,0.000226
9504118,9504118,,2,0,2,2,0,2,0.000033,0,0,5417,15,0.000011,0,0,0,0,0.5,0.000473
9505090,9505090,,0,2,2,0,2,2,0,0.000017,0,25741,13,0.00001,5,0.312195,0.346615,0,0.5,0
9505094,9505094,,1,3,4,1,3,4,0,0,0,15986,17,0.000013,5,0.377778,0.477451,0,0.333333,0.000233
9505103,9505103,,0,9,9,0,9,9,0,0.000149,0,25742,41,0.00001,6,0.343537,0.386056,0,0.222222,0
9505108,9505108,,1,6,7,1,6,7,0,0.000005,0,25743,22,0.000011,2,0.875,0.928571,2,0.190476,0.000219
9505109,9505109,,1,1,2,1,1,2,0,0,0,20389,23,0.000014,1,1,1,0,0.5,0.000233
9505110,9505110,,1,1,2,1,1,2,0,0.000001,0,25744,41,0.000014,1,1,1,0,0.5,0.000219
9405123,9405123,,4,0,4,4,0,4,0.00007,0,0,11753,41,0.000029,0,0,0,0,0.083333,0.00089
9505114,9505114,,0,1,1,0,1,1,0,0,0,25745,17,0.00001,1,1,1,0,0,0
9505118,9505118,,0,1,1,0,1,1,0,0,0,25746,6,0.00001,1,1,1,0,0,0
9505130,9505130,,4,1,5,4,1,5,0,0,0,25747,6,0.000018,1,1,1,0,0.5,0.000916
9505132,9505132,,3,12,15,3,12,15,0.000001,0.000026,0,7472,5,0.000014,5,0.381119,0.455199,34312.434872,0.152381,0.000665
9505137,9505137,,0,1,1,0,1,1,0,0,0,25748,26,0.00001,3,0.45,0.5,0,0,0
9505142,9505142,,3,6,9,3,6,9,0,0.00001,0,3215,9,0.000018,5,0.356322,0.467204,8913.48281,0.180556,0.000718
9505155,9505155,,0,7,7,0,7,7,0,0.000012,0,25749,9,0.00001,3,0.590909,0.730769,0,0.02381,0
9505163,9505163,,0,3,3,0,3,3,0,0.00014,0,25750,2,0.00001,3,0.5,0.625,0,0,0
9505191,9505191,,0,1,1,0,1,1,0,0,85,25752,107,0.00001,1,1,1,0,0,0
9409171,9409171,,1,0,1,1,0,1,0,0,85,25751,107,0.000019,0,0,0,0,0,0.000219
9506012,9506012,,0,2,2,0,2,2,0,0.000317,0,25753,13,0.00001,4,0.433333,0.477564,0,0,0
9506013,9506013,,0,2,2,0,2,2,0,0.000005,0,25754,13,0.00001,2,0.666667,0.75,0,0.5,0
9506025,9506025,,2,2,4,2,2,4,0,0.000002,0,13925,23,0.000015,10,0.184772,0.211896,407.844331,0.083333,0.000445
9506028,9506028,,0,2,2,0,2,2,0,0.000011,0,25755,0,0.00001,3,0.48,0.541667,0,0.5,0
9506029,9506029,,1,1,2,1,1,2,0,0,0,14912,23,0.000019,2,0.666667,0.75,4,0,0.000232
9506034,9506034,,1,3,4,1,3,4,0.000022,0.001343,0,25756,13,0.000013,6,0.275862,0.324479,8.108547,0.25,0.000219
9506039,9506039,,0,1,1,0,1,1,0,0.000001,0,25757,9,0.00001,1,1,1,0,0,0
9506045,9506045,,0,12,12,0,12,12,0,0.00018,0,25758,0,0.00001,7,0.295515,0.336713,0,0.083333,0
9506046,9506046,,0,4,4,0,4,4,0,0.000007,0,25760,26,0.00001,7,0.236686,0.321994,0,0.166667,0
9409084,9409084,,1,0,1,1,0,1,0,0,0,25759,26,0.000012,0,0,0,0,0,0.000219
9506047,9506047,,1,6,7,1,6,7,0,0.00007,0,25761,9,0.000019,5,0.37551,0.43279,92,0.02381,0.000219
9506051,9506051,,0,2,2,0,2,2,0,0.00186,0,25762,4,0.00001,6,0.263804,0.29832,0,0.5,0
9506053,9506053,,1,4,5,1,4,5,0,0.000017,0,25764,9,0.000014,5,0.290909,0.376736,47,0.15,0.000219
9410025,9410025,,2,0,2,2,0,2,0,0,0,25763,9,0.000017,0,0,0,0,0.5,0.000445
9506054,9506054,,0,3,3,0,3,3,0,0,0,25765,6,0.00001,6,0.270886,0.315421,0,0.5,0
9506055,9506055,,0,2,2,0,2,2,0,0.000001,0,25766,26,0.00001,1,1,1,0,0,0
9506068,9506068,,0,1,1,0,1,1,0,0,0,25767,23,0.00001,1,1,1,0,0,0
9506070,9506070,,0,3,3,0,3,3,0,0.000343,0,25768,4,0.00001,6,0.280423,0.32044,0,0,0
9506080,9506080,,0,6,6,0,6,6,0,0.000003,0,25769,10,0.00001,4,0.439024,0.574074,0,0.4,0
9506088,9506088,,2,3,5,2,3,5,0,0.000002,0,24265,9,0.000017,2,0.666667,0.75,31.5,0.1,0.000451
9506092,9506092,,0,1,1,0,1,1,0,0,86,25771,108,0.00001,1,1,1,0,0,0
9409003,9409003,,1,0,1,1,0,1,0,0,86,25770,108,0.000019,0,0,0,0,0,0.000219
9410094,9410094,,2,0,2,2,0,2,0,0,0,6731,0,0.000023,0,0,0,0,0,0.000485
9506096,9506096,,1,17,18,1,17,18,0,0.000002,0,25772,9,0.000011,6,0.267882,0.341361,3.803571,0.199346,0.000219
9506103,9506103,,1,9,10,1,9,10,0,0.000073,0,25773,17,0.000019,5,0.330275,0.411574,72,0.333333,0.000219
9506124,9506124,,2,10,12,2,10,12,0.000163,0.000021,0,1309,4,0.000015,8,0.259036,0.316663,332159.708655,0.075758,0.000759
9506127,9506127,,0,2,2,0,2,2,0,0.000007,0,25774,5,0.00001,2,0.75,0.833333,0,0,0
9506130,9506130,,1,4,5,1,4,5,0,0.000003,0,18129,5,0.000015,4,0.457143,0.557292,74.083333,0.05,0.000239
9411120,9411120,,1,0,1,1,0,1,0,0,0,18127,5,0.000013,0,0,0,0,0,0.000226
9505178,9505178,,4,0,4,4,0,4,0,0,0,18126,5,0.000022,0,0,0,0,0.25,0.000916
9506133,9506133,,5,25,30,5,25,30,0.000015,0.000051,0,15775,9,0.000016,6,0.328542,0.401146,1072.063073,0.073563,0.001103
9506134,9506134,,3,1,4,3,1,4,0,0,87,25776,109,0.000027,1,1,1,0,0.416667,0.000677
9412001,9412001,,4,0,4,4,0,4,0,0,87,25775,109,0.000051,0,0,0,0,0.416667,0.000916
9506149,9506149,,0,5,5,0,5,5,0,0.000018,0,25777,0,0.00001,4,0.5,0.675,0,0.2,0
9506155,9506155,,1,9,10,1,9,10,0,0.000008,0,25778,22,0.000019,3,0.553191,0.647436,26,0.088889,0.000219
9506161,9506161,,2,1,3,2,1,3,0,0.000001,0,13351,8,0.000014,1,1,1,2,0.166667,0.000498
9506162,9506162,,0,5,5,0,5,5,0,0.001183,0,25779,4,0.00001,7,0.246767,0.28978,0,0,0
9506165,9506165,,0,1,1,0,1,1,0,0,88,25781,110,0.00001,1,1,1,0,0,0
9302105,9302105,,1,0,1,1,0,1,0,0,88,25780,110,0.000019,0,0,0,0,0,0.000219
9307069,9307069,,1,0,1,1,0,1,0.00002,0,0,5473,15,0.00001,0,0,0,0,0,0.000247
9307112,9307112,,1,0,1,1,0,1,0.00002,0,0,5472,15,0.00001,0,0,0,0,0,0.000247
9412102,9412102,,1,0,1,1,0,1,0.00002,0,0,5437,15,0.00001,0,0,0,0,0,0.000247
9506173,9506173,,0,2,2,0,2,2,0,0.000011,0,25782,0,0.00001,3,0.48,0.541667,0,0.5,0
9506197,9506197,,0,4,4,0,4,4,0,0.002043,0,25783,4,0.00001,8,0.239014,0.286414,0,0.416667,0
9506201,9506201,,0,4,4,0,4,4,0,0,0,25784,6,0.00001,5,0.381818,0.477778,0,0,0
9506202,9506202,,1,4,5,1,4,5,0,0.000021,0,25785,5,0.000011,7,0.231794,0.257617,23.306811,0.3,0.000219
9506208,9506208,,0,1,1,0,1,1,0,0.000001,0,25786,23,0.00001,1,1,1,0,0,0
9506213,9506213,,3,13,16,3,13,16,0.000115,0.001522,0,5345,13,0.000012,5,0.354938,0.447681,10674.540285,0.1875,0.000699
9304002,9304002,,2,0,2,2,0,2,0,0,0,6699,41,0.000012,0,0,0,0,0,0.000445
9507004,9507004,,2,10,12,2,10,12,0,0.000029,0,25787,13,0.000014,9,0.233968,0.269893,2375.587764,0.106061,0.000451
9507019,9507019,,0,4,4,0,4,4,0,0.000018,0,25788,4,0.00001,6,0.274359,0.330997,0,0.333333,0
9412094,9412094,,1,0,1,1,0,1,0,0,0,13317,52,0.000014,0,0,0,0,0,0.000233
9507031,9507031,,0,1,1,0,1,1,0,0,89,25790,111,0.00001,1,1,1,0,0,0
9404048,9404048,,1,0,1,1,0,1,0,0,89,25789,111,0.000019,0,0,0,0,0,0.000219
9507033,9507033,,4,2,6,4,2,6,0.000017,0,0,8249,2,0.000031,1,1,1,8170.250168,0.1,0.000896
9507034,9507034,,1,4,5,1,4,5,0,0.000001,0,25791,22,0.000012,3,0.5,0.583333,7.166667,0.1,0.000219
9507054,9507054,,0,3,3,0,3,3,0,0.000021,0,25792,5,0.00001,2,0.714286,0.8,0,0,0
9507061,9507061,,4,6,10,4,6,10,0.000028,0.000313,0,25793,5,0.000022,9,0.206677,0.275528,65.416667,0.133333,0.000883
9507065,9507065,,0,2,2,0,2,2,0,0.000001,0,25794,26,0.00001,1,1,1,0,0,0
9507075,9507075,,2,7,9,2,7,9,0.000076,0.000254,0,25795,0,0.000011,4,0.464286,0.538462,8.580528,0.236111,0.000445
9507078,9507078,,0,3,3,0,3,3,0,0.000008,0,25796,22,0.00001,1,1,1,0,0.5,0
9507080,9507080,,0,1,1,0,1,1,0,0,0,25797,28,0.00001,4,0.409091,0.472222,0,0,0
9507081,9507081,,0,1,1,0,1,1,0,0,0,25798,22,0.00001,2,0.666667,0.75,0,0,0
9412038,9412038,,1,0,1,1,0,1,0,0,0,2320,52,0.000012,0,0,0,0,0,0.000239
9507086,9507086,,0,1,1,0,1,1,0,0,90,25800,112,0.00001,1,1,1,0,0,0
9501025,9501025,,1,0,1,1,0,1,0,0,90,25799,112,0.000019,0,0,0,0,0,0.000219
9507102,9507102,,0,5,5,0,5,5,0,0.001894,0,25801,4,0.00001,10,0.166094,0.19992,0,0.15,0
9507108,9507108,,0,12,12,0,12,12,0,0.000208,0,25802,0,0.00001,6,0.289979,0.370343,0,0.098485,0
9507116,9507116,,0,3,3,0,3,3,0,0.000003,0,25803,30,0.00001,2,0.8,0.875,0,0.166667,0
9507117,9507117,,0,2,2,0,2,2,0,0.000046,0,25804,4,0.00001,8,0.252063,0.297027,0,0,0
9507119,9507119,,1,2,3,1,2,3,0,0,0,25805,22,0.000012,3,0.571429,0.708333,4,0.166667,0.000219
9507120,9507120,,0,3,3,0,3,3,0,0.00186,0,25806,4,0.00001,6,0.266393,0.305641,0,0.333333,0
9507122,9507122,,1,7,8,1,7,8,0.000001,0.000067,0,25807,26,0.000011,5,0.290909,0.377344,16.5,0.285714,0.000219
9507123,9507123,,0,3,3,0,3,3,0,0.000002,0,25808,6,0.00001,4,0.408163,0.4875,0,0,0
9507126,9507126,,2,6,8,2,6,8,0.000001,0.000015,0,5296,5,0.000017,4,0.482759,0.642857,2196.831037,0.285714,0.000484
9507127,9507127,,0,5,5,0,5,5,0,0.000131,0,25809,3,0.00001,8,0.244515,0.282117,0,0.3,0
9507128,9507128,,0,2,2,0,2,2,0,0,0,25811,2,0.00001,2,0.75,0.833333,0,0,0
9306116,9306116,,2,0,2,2,0,2,0,0,0,25810,2,0.000016,0,0,0,0,0,0.000438
9507129,9507129,,0,4,4,0,4,4,0,0.000042,0,25812,0,0.00001,8,0.260192,0.2967,0,0.083333,0
9507134,9507134,,2,1,3,2,1,3,0,0,0,10396,22,0.000029,1,1,1,1,0.166667,0.000452
9507138,9507138,,0,4,4,0,4,4,0,0.000009,0,25813,22,0.00001,4,0.432432,0.541667,0,0.083333,0
9507142,9507142,,0,2,2,0,2,2,0,0.000003,0,25814,5,0.00001,1,1,1,0,0,0
9507146,9507146,,0,5,5,0,5,5,0,0.000002,0,25815,15,0.00001,2,0.631579,0.708333,0,0.15,0
9507149,9507149,,0,1,1,0,1,1,0,0.00002,0,25816,22,0.00001,2,0.538462,0.571429,0,0,0
9507154,9507154,,2,1,3,2,1,3,0.00014,0.00002,0,10901,22,0.00001,2,0.538462,0.571429,38.666667,0.166667,0.000458
9507157,9507157,,0,4,4,0,4,4,0,0.001769,0,25817,3,0.00001,8,0.215322,0.244128,0,0.083333,0
9508007,9508007,,0,7,7,0,7,7,0,0.000007,0,25818,6,0.00001,10,0.183214,0.230196,0,0.214286,0
9508014,9508014,,0,3,3,0,3,3,0,0.000022,0,25819,1,0.00001,4,0.454545,0.538889,0,0.166667,0
9508018,9508018,,0,4,4,0,4,4,0,0.000006,0,25820,17,0.00001,2,0.833333,0.9,0,0.083333,0
9508019,9508019,,0,2,2,0,2,2,0,0,0,25821,15,0.00001,2,0.75,0.833333,0,0.5,0
9508022,9508022,,0,2,2,0,2,2,0,0.00002,0,25822,22,0.00001,2,0.571429,0.625,0,0,0
9508023,9508023,,1,2,3,1,2,3,0,0.000004,0,10493,8,0.000017,1,1,1,46.993646,0.166667,0.000226
9508024,9508024,,0,9,9,0,9,9,0,0.000008,0,25823,23,0.00001,7,0.248366,0.350783,0,0.138889,0
9508026,9508026,,0,8,8,0,8,8,0,0.000116,0,25824,4,0.00001,11,0.191025,0.248173,0,0.214286,0
9508027,9508027,,0,5,5,0,5,5,0,0.000026,0,25825,23,0.00001,2,0.666667,0.75,0,0,0
9508029,9508029,,0,8,8,0,8,8,0,0.000166,0,25826,0,0.00001,5,0.318182,0.402381,0,0.071429,0
9508037,9508037,,0,1,1,0,1,1,0,0,91,25828,113,0.00001,1,1,1,0,0,0
9405177,9405177,,1,0,1,1,0,1,0,0,91,25827,113,0.000019,0,0,0,0,0,0.000219
9508039,9508039,,5,8,13,5,8,13,0.000179,0.000877,0,2933,28,0.000015,10,0.187212,0.213271,4338.561392,0.160256,0.001298
9508054,9508054,,1,14,15,1,14,15,0,0.00001,0,25829,9,0.00001,5,0.363636,0.459583,40.166667,0.133333,0.000219
9508057,9508057,,1,1,2,1,1,2,0.00001,0,0,25830,15,0.000012,5,0.226562,0.258621,0,0.5,0.000219
9508059,9508059,,0,3,3,0,3,3,0,0,0,25831,17,0.00001,5,0.341463,0.405952,0,0.166667,0
9508060,9508060,,0,3,3,0,3,3,0,0.000001,0,25832,5,0.00001,5,0.341463,0.405952,0,0.166667,0
9508067,9508067,,0,4,4,0,4,4,0,0.000042,0,25833,4,0.00001,8,0.254123,0.303248,0,0.083333,0
9508092,9508092,,1,7,8,1,7,8,0.000006,0.000719,0,25834,13,0.000011,10,0.216609,0.268743,341.937013,0.196429,0.000219
9508093,9508093,,1,1,2,1,1,2,0.000043,0,0,2899,28,0.000011,1,1,1,108.569576,0,0.000326
9508095,9508095,,0,11,11,0,11,11,0,0.000944,0,25835,13,0.00001,9,0.21363,0.257589,0,0.181818,0
9508106,9508106,,1,3,4,1,3,4,0,0,0,25836,22,0.000011,3,0.428571,0.511111,1,0.333333,0.000219
9508109,9508109,,0,7,7,0,7,7,0,0.000001,0,25837,6,0.00001,5,0.368889,0.429116,0,0.214286,0
9508115,9508115,,1,2,3,1,2,3,0,0.000001,0,25838,22,0.000014,3,0.404762,0.460784,8,0.333333,0.000219
9508118,9508118,,1,4,5,1,4,5,0,0.000007,0,25839,22,0.000027,9,0.172646,0.203058,687,0,0.000226
9508120,9508120,,0,1,1,0,1,1,0,0,0,25840,5,0.00001,1,1,1,0,0,0
9508121,9508121,,0,2,2,0,2,2,0,0,0,25841,5,0.00001,1,1,1,0,0,0
9508122,9508122,,0,1,1,0,1,1,0,0,0,25842,5,0.00001,1,1,1,0,0,0
9508123,9508123,,0,1,1,0,1,1,0,0,0,25843,5,0.00001,1,1,1,0,0,0
9508126,9508126,,0,5,5,0,5,5,0,0.000011,0,25844,9,0.00001,3,0.545455,0.62037,0,0.1,0
9508127,9508127,,1,3,4,1,3,4,0,0.000007,0,25845,22,0.000011,3,0.484848,0.552083,8.571429,0.083333,0.000219
9508130,9508130,,0,3,3,0,3,3,0,0.000003,0,25846,6,0.00001,6,0.352113,0.414,0,0.333333,0
9508145,9508145,,2,3,5,2,3,5,0,0,0,2772,6,0.000012,4,0.342342,0.39693,1075.658224,0.35,0.000503
9508146,9508146,,1,1,2,1,1,2,0,0,0,25847,2,0.000013,2,0.6,0.666667,6,0,0.000226
9508147,9508147,,0,4,4,0,4,4,0,0.000006,0,25848,15,0.00001,3,0.666667,0.805556,0,0,0
9508152,9508152,,0,9,9,0,9,9,0,0.000066,0,25849,28,0.00001,8,0.213628,0.273255,0,0.222222,0
9508157,9508157,,0,1,1,0,1,1,0,0,0,25850,20,0.00001,2,0.666667,0.75,0,0,0
9508169,9508169,,0,1,1,0,1,1,0,0,0,25851,9,0.00001,1,1,1,0,0,0
9508179,9508179,,1,3,4,1,3,4,0.000006,0.000013,0,25852,23,0.000011,6,0.246187,0.281563,1,0.333333,0.000219
9509001,9509001,,1,9,10,1,9,10,0.000019,0.00004,0,6170,4,0.000011,2,0.909091,0.95,176.428765,0.1,0.000227
9509010,9509010,,0,2,2,0,2,2,0,0.000003,0,25853,26,0.00001,3,0.555556,0.666667,0,0.5,0
9509014,9509014,,0,3,3,0,3,3,0,0.000018,0,25854,0,0.00001,6,0.258675,0.300305,0,0.333333,0
9509018,9509018,,1,1,2,1,1,2,0,0,0,5929,3,0.000019,6,0.269388,0.3,11350.16522,0,0.000234
9509025,9509025,,1,19,20,1,19,20,0.000002,0.000125,0,25855,5,0.00001,6,0.307202,0.351107,5.75,0.076316,0.000219
9509039,9509039,,1,4,5,1,4,5,0,0,0,25856,6,0.000012,4,0.426471,0.491379,6.5,0.3,0.000219
9404072,9404072,,1,0,1,1,0,1,0,0,0,9346,9,0.000019,0,0,0,0,0,0.000239
9509046,9509046,,0,2,2,0,2,2,0,0,0,25857,28,0.00001,2,0.75,0.833333,0,0,0
9509051,9509051,,0,1,1,0,1,1,0,0.000027,0,25858,0,0.00001,4,0.324675,0.353333,0,0,0
9509055,9509055,,1,2,3,1,2,3,0.000003,0.00001,0,25859,17,0.00001,5,0.344828,0.418333,5,0.333333,0.000219
9509061,9509061,,0,6,6,0,6,6,0,0.000021,0,25860,9,0.00001,4,0.52,0.592949,0,0.066667,0
9509063,9509063,,0,1,1,0,1,1,0,0,0,25861,25,0.00001,1,1,1,0,0,0
9403034,9403034,,2,0,2,2,0,2,0,0,0,13768,25,0.000044,0,0,0,0,0,0.000446
9509064,9509064,,0,13,13,0,13,13,0,0.000066,0,25862,5,0.00001,5,0.424658,0.523387,0,0.064103,0
9509065,9509065,,0,9,9,0,9,9,0,0.000036,0,25864,5,0.00001,4,0.488636,0.565891,0,0.152778,0
9308074,9308074,,2,0,2,2,0,2,0,0,0,25863,17,0.000014,0,0,0,0,0,0.000445
9509069,9509069,,2,6,8,2,6,8,0,0.000003,0,5045,23,0.000019,5,0.316602,0.371748,43947.433871,0.035714,0.000476
9503195,9503195,,2,0,2,2,0,2,0,0,0,5043,23,0.000017,0,0,0,0,0.5,0.000482
9509071,9509071,,1,6,7,1,6,7,0.000002,0.000118,0,3860,6,0.000011,7,0.276284,0.343321,15675.879552,0.214286,0.000267
9509087,9509087,,0,9,9,0,9,9,0,0.00006,0,25865,17,0.00001,9,0.192714,0.262333,0,0.333333,0
9509089,9509089,,1,1,2,1,1,2,0.000241,0,0,9168,23,0.000011,3,0.444444,0.541667,11581.997461,0,0.000258
9509093,9509093,,3,4,7,3,4,7,0.000114,0.000235,0,5193,13,0.000012,9,0.224884,0.254083,12.484497,0.261905,0.000684
9509094,9509094,,0,2,2,0,2,2,0,0,0,25866,9,0.00001,3,0.5,0.551282,0,0,0
9509100,9509100,,0,1,1,0,1,1,0,0,92,25868,114,0.00001,1,1,1,0,0,0
9507174,9507174,,1,0,1,1,0,1,0,0,92,25867,114,0.000019,0,0,0,0,0,0.000219
9509103,9509103,,1,9,10,1,9,10,0,0.000038,0,7516,9,0.000011,5,0.309677,0.427778,210.027019,0.144444,0.000232
9508101,9508101,,1,0,1,1,0,1,0,0,0,4371,28,0.000022,0,0,0,0,0,0.000234
9509111,9509111,,1,5,6,1,5,6,0,0.000001,0,25869,23,0.000011,3,0.571429,0.680556,4.25,0.233333,0.000219
9509112,9509112,,3,16,19,3,16,19,0.000004,0.000097,0,6248,5,0.000012,6,0.314233,0.38902,1351.905667,0.096491,0.000689
9509113,9509113,,1,6,7,1,6,7,0,0.000001,0,25870,15,0.000012,1,1,1,3,0.261905,0.000219
9509116,9509116,,0,1,1,0,1,1,0,0,0,25871,21,0.00001,3,0.5,0.611111,0,0,0
9509120,9509120,,2,6,8,2,6,8,0,0.000004,0,25872,6,0.000012,3,0.514286,0.62037,0,0.392857,0.000445
9509121,9509121,,0,11,11,0,11,11,0,0.000049,0,25873,9,0.00001,8,0.26383,0.360359,0,0.163636,0
9509122,9509122,,0,1,1,0,1,1,0,0,0,25874,30,0.00001,3,0.5,0.611111,0,0,0
9509126,9509126,,0,11,11,0,11,11,0,0.000049,0,25875,9,0.00001,8,0.264392,0.361703,0,0.172727,0
9509128,9509128,,0,1,1,0,1,1,0,0,0,25876,22,0.00001,1,1,1,0,0,0
9509129,9509129,,1,3,4,1,3,4,0.000002,0.000001,0,25877,13,0.000012,5,0.330435,0.382456,20.992857,0.083333,0.000219
9509134,9509134,,0,13,13,0,13,13,0,0.000053,0,25878,9,0.00001,8,0.266811,0.374129,0,0.153846,0
9509138,9509138,,0,2,2,0,2,2,0,0,0,25879,22,0.00001,4,0.391304,0.509259,0,0,0
9509154,9509154,,1,1,2,1,1,2,0,0,0,25880,20,0.000014,2,0.6,0.666667,0,0.5,0.000219
9504100,9504100,,1,0,1,1,0,1,0,0,0,8456,1,0.000073,0,0,0,0,0,0.000226
9509164,9509164,,0,4,4,0,4,4,0,0.000003,0,25882,22,0.00001,3,0.578947,0.666667,0,0.166667,0
9503015,9503015,,2,0,2,2,0,2,0,0,0,25881,22,0.000021,0,0,0,0,0,0.000438
9510010,9510010,,1,4,5,1,4,5,0,0,0,8898,6,0.000011,2,0.75,0.833333,32217.066365,0.05,0.000227
9510012,9510012,,0,9,9,0,9,9,0,0.000059,0,25883,17,0.00001,5,0.298893,0.388683,0,0.138889,0
9510015,9510015,,0,2,2,0,2,2,0,0,0,25884,15,0.00001,4,0.461538,0.597222,0,0,0
9510020,9510020,,0,6,6,0,6,6,0,0.000003,0,25885,5,0.00001,3,0.527778,0.622807,0,0.233333,0
9510024,9510024,,0,1,1,0,1,1,0,0,0,25886,17,0.00001,1,1,1,0,0,0
9510025,9510025,,0,2,2,0,2,2,0,0.000028,0,25887,4,0.00001,3,0.555556,0.666667,0,0,0
9510031,9510031,,0,1,1,0,1,1,0,0.000001,0,25888,26,0.00001,8,0.182841,0.202857,0,0,0
9510032,9510032,,0,1,1,0,1,1,0,0.000001,0,25889,6,0.00001,2,0.666667,0.75,0,0,0
9510040,9510040,,1,5,6,1,5,6,0,0.000025,0,10624,17,0.000015,5,0.327869,0.393167,500.386215,0.166667,0.000252
9510043,9510043,,0,3,3,0,3,3,0,0.000001,0,25890,17,0.00001,2,0.615385,0.6875,0,0.166667,0
9510048,9510048,,0,2,2,0,2,2,0,0.000004,0,25891,8,0.00001,3,0.555556,0.666667,0,0,0
9510049,9510049,,0,2,2,0,2,2,0,0.000004,0,25892,8,0.00001,3,0.555556,0.666667,0,0,0
9510058,9510058,,0,1,1,0,1,1,0,0.000002,0,25893,9,0.00001,2,0.666667,0.75,0,0,0
9510061,9510061,,1,14,15,1,14,15,0.000003,0.000022,0,8922,9,0.000011,7,0.308703,0.369732,22051.022197,0.190476,0.000251
9503128,9503128,,1,0,1,1,0,1,0,0,0,11324,4,0.00002,0,0,0,0,0,0.000226
9510064,9510064,,1,7,8,1,7,8,0,0.000103,0,25894,4,0.000011,5,0.345622,0.412444,62.7,0.196429,0.000226
9510057,9510057,,1,0,1,1,0,1,0,0,0,17339,22,0.000032,0,0,0,0,0,0.000232
9510067,9510067,,4,9,13,4,9,13,0,0.000004,0,3984,23,0.000025,1,1,1,65690.393928,0.115385,0.000989
9207014,9207014,,1,0,1,1,0,1,0,0,0,3983,23,0.000012,0,0,0,0,0,0.000247
9510072,9510072,,1,13,14,1,13,14,0.000005,0.000011,0,3212,9,0.000011,6,0.349265,0.40614,147471.868963,0.197802,0.000305
9510075,9510075,,0,10,10,0,10,10,0,0.000001,0,25896,9,0.00001,7,0.259438,0.306413,0,0.266667,0
9406124,9406124,,1,0,1,1,0,1,0,0,0,25895,9,0.000011,0,0,0,0,0,0.000219
9510076,9510076,,1,9,10,1,9,10,0,0.000001,0,19969,22,0.000011,5,0.413043,0.529386,23.366667,0.155556,0.000226
9510088,9510088,,0,5,5,0,5,5,0,0.000051,0,25897,0,0.00001,8,0.195903,0.253564,0,0.2,0
9510102,9510102,,0,2,2,0,2,2,0,0,93,25900,164,0.00001,1,1,1,0,0,0
9308012,9308012,,2,0,2,2,0,2,0,0,93,25899,164,0.000019,0,0,0,0,0,0.000438
9308063,9308063,,2,0,2,2,0,2,0,0,93,25898,164,0.000019,0,0,0,0,0,0.000438
9510113,9510113,,0,2,2,0,2,2,0,0.000019,0,25901,3,0.00001,3,0.466667,0.571429,0,0.5,0
9510118,9510118,,0,4,4,0,4,4,0,0.001814,0,25902,13,0.00001,8,0.22823,0.255104,0,0.083333,0
9510120,9510120,,0,3,3,0,3,3,0,0.000011,0,25903,5,0.00001,2,0.636364,0.714286,0,0,0
9510122,9510122,,1,3,4,1,3,4,0.000038,0.000008,0,5280,5,0.000011,4,0.31,0.379032,920.023842,0,0.000282
9510125,9510125,,0,3,3,0,3,3,0,0.000075,0,25904,23,0.00001,8,0.177778,0.227216,0,0,0
9510126,9510126,,0,5,5,0,5,5,0,0.00009,0,25905,5,0.00001,8,0.188776,0.265669,0,0,0
9510139,9510139,,2,6,8,2,6,8,0,0.000002,0,3931,26,0.000014,7,0.250726,0.295128,2420.104141,0.321429,0.000479
9510146,9510146,,1,2,3,1,2,3,0,0.000002,0,13354,0,0.000011,2,0.75,0.833333,0,0.5,0.000246
9510160,9510160,,1,1,2,1,1,2,0,0,0,25906,8,0.000014,1,1,1,0,0.5,0.000219
9510163,9510163,,0,1,1,0,1,1,0,0,0,25907,4,0.00001,1,1,1,0,0,0
9510164,9510164,,0,3,3,0,3,3,0,0.000094,0,25908,0,0.00001,7,0.24382,0.271549,0,0.5,0
9510172,9510172,,1,1,2,1,1,2,0,0,0,25909,22,0.00002,10,0.147771,0.16542,458,0,0.000226
9510174,9510174,,2,2,4,2,2,4,0.000028,0.000007,0,10682,6,0.000011,2,0.6,0.666667,0,0.416667,0.000459
9510176,9510176,,1,4,5,1,4,5,0.000043,0.000004,0,2188,0,0.000011,4,0.414414,0.463768,10995.541471,0.15,0.000339
9412056,9412056,,2,0,2,2,0,2,0.000001,0,0,7375,0,0.000012,0,0,0,0,0.5,0.000465
9510194,9510194,,1,10,11,1,10,11,0,0.000023,0,25910,0,0.000014,12,0.182252,0.214024,915,0.090909,0.000219
9510198,9510198,,0,3,3,0,3,3,0,0.000016,0,25911,28,0.00001,3,0.518519,0.583333,0,0.166667,0
9510211,9510211,,1,3,4,1,3,4,0,0.000005,0,25912,22,0.000011,4,0.402597,0.456989,0,0.416667,0.000219
9510212,9510212,,0,5,5,0,5,5,0,0.000817,0,25913,15,0.00001,4,0.327684,0.385057,0,0.1,0
9510219,9510219,,1,1,2,1,1,2,0,0,0,25914,28,0.000012,2,0.666667,0.75,2,0,0.000219
9510230,9510230,,1,1,2,1,1,2,0,0.00002,0,25915,22,0.000019,2,0.538462,0.571429,7,0,0.000219
9510233,9510233,,1,26,27,1,26,27,0.000091,0.003629,0,3150,0,0.00001,13,0.205765,0.253431,31353.897346,0.096866,0.000397
9510236,9510236,,0,2,2,0,2,2,0,0.000892,0,25916,4,0.00001,7,0.227504,0.266365,0,0.5,0
9507067,9507067,,1,0,1,1,0,1,0,0,0,14026,21,0.000014,0,0,0,0,0,0.000246
9510238,9510238,,0,1,1,0,1,1,0,0,0,25917,21,0.00001,8,0.189679,0.220623,0,0,0
9511001,9511001,,0,2,2,0,2,2,0,0,0,25918,23,0.00001,3,0.555556,0.666667,0,0.5,0
9511003,9511003,,1,3,4,1,3,4,0,0.000001,0,13688,23,0.000011,2,0.8,0.875,56.75,0.333333,0.000233
9511016,9511016,,1,6,7,1,6,7,0,0.000092,0,25919,0,0.000012,8,0.209103,0.238027,392.4,0.166667,0.000219
9511017,9511017,,0,24,24,0,24,24,0,0.004658,0,25920,0,0.00001,13,0.205671,0.258651,0,0.210145,0
9511018,9511018,,1,7,8,1,7,8,0,0.000004,0,25921,15,0.00001,7,0.255725,0.333973,3.25,0.178571,0.000219
9511019,9511019,,0,7,7,0,7,7,0,0.002557,0,25922,0,0.00001,10,0.205193,0.241154,0,0.452381,0
9511034,9511034,,1,1,2,1,1,2,0,0,0,25923,26,0.000013,1,1,1,0,0.5,0.000226
9511036,9511036,,0,3,3,0,3,3,0,0.000021,0,25924,0,0.00001,7,0.218266,0.258696,0,0.333333,0
9511041,9511041,,2,4,6,2,4,6,0,0.00001,0,25925,26,0.000013,1,1,1,0.75,0.333333,0.000445
9511044,9511044,,1,3,4,1,3,4,0,0.000001,0,25926,15,0.000019,2,0.6,0.666667,9,0,0.000219
9511050,9511050,,0,9,9,0,9,9,0,0.000008,0,25927,9,0.00001,7,0.298535,0.352994,0,0.138889,0
9511074,9511074,,0,4,4,0,4,4,0,0.000002,0,25928,22,0.00001,2,0.75,0.833333,0,0,0
9511076,9511076,,0,4,4,0,4,4,0,0.000002,0,25929,9,0.00001,2,0.666667,0.75,0,0.083333,0
9511083,9511083,,0,10,10,0,10,10,0,0.00002,0,25930,4,0.00001,7,0.242116,0.293888,0,0.055556,0
9511084,9511084,,0,1,1,0,1,1,0,0,0,25931,9,0.00001,4,0.380952,0.458333,0,0,0
9511086,9511086,,0,10,10,0,10,10,0,0.002258,0,25932,4,0.00001,7,0.265306,0.326589,0,0.2,0
9511089,9511089,,0,2,2,0,2,2,0,0.000005,0,25933,52,0.00001,3,0.461538,0.527778,0,0.5,0
9511114,9511114,,0,3,3,0,3,3,0,0.000873,0,25935,4,0.00001,7,0.225473,0.266103,0,0,0
9504042,9504042,,2,0,2,2,0,2,0.00001,0,0,25934,6,0.000017,0,0,0,0,0,0.000438
9511121,9511121,,0,1,1,0,1,1,0,0,0,25936,28,0.00001,2,0.555556,0.6,0,0,0
9511123,9511123,,0,4,4,0,4,4,0,0.000021,0,25937,0,0.00001,9,0.17882,0.202684,0,0.416667,0
9511127,9511127,,0,8,8,0,8,8,0,0.000251,0,25938,4,0.00001,14,0.191932,0.23716,0,0.125,0
9511132,9511132,,0,1,1,0,1,1,0,0.000002,0,25939,23,0.00001,3,0.5,0.611111,0,0,0
9511137,9511137,,0,4,4,0,4,4,0,0,0,25940,22,0.00001,3,0.483871,0.577778,0,0.416667,0
9511144,9511144,,0,2,2,0,2,2,0,0,0,25941,8,0.00001,1,1,1,0,0.5,0
9511146,9511146,,0,1,1,0,1,1,0,0.000001,0,25942,23,0.00001,1,1,1,0,0,0
9511147,9511147,,1,5,6,1,5,6,0,0.000035,0,10602,5,0.000013,6,0.301305,0.344291,1467.567671,0.133333,0.00024
9511149,9511149,,1,4,5,1,4,5,0.00002,0.000032,0,2885,0,0.000012,5,0.265625,0.328105,13349.150105,0.1,0.000248
9511150,9511150,,0,1,1,0,1,1,0,0,94,25944,115,0.00001,1,1,1,0,0,0
9209069,9209069,,1,0,1,1,0,1,0,0,94,25943,115,0.000019,0,0,0,0,0,0.000219
9511155,9511155,,0,1,1,0,1,1,0,0,0,25945,22,0.00001,2,0.666667,0.75,0,0,0
9511161,9511161,,0,1,1,0,1,1,0,0.000008,0,25946,10,0.00001,1,1,1,0,0,0
9511177,9511177,,0,4,4,0,4,4,0,0.000009,0,25947,23,0.00001,2,0.833333,0.9,0,0.166667,0
9511181,9511181,,1,1,2,1,1,2,0,0,0,17200,15,0.000025,1,1,1,8,0,0.000232
9511182,9511182,,1,1,2,1,1,2,0,0,0,25948,6,0.000019,2,0.666667,0.75,2,0,0.000219
9511183,9511183,,0,2,2,0,2,2,0,0.000005,0,25949,9,0.00001,3,0.52381,0.575758,0,0,0
9511186,9511186,,0,11,11,0,11,11,0,0.000026,0,25950,9,0.00001,6,0.293869,0.373501,0,0.1,0
9511199,9511199,,2,6,8,2,6,8,0.000002,0.000051,0,11534,22,0.000012,7,0.25196,0.298042,100.986202,0.285714,0.000459
9511200,9511200,,0,4,4,0,4,4,0,0.000004,0,25951,9,0.00001,7,0.310924,0.35547,0,0.166667,0
9511214,9511214,,1,31,32,1,31,32,0.000102,0.00189,0,2009,5,0.00001,7,0.297784,0.351214,8173.129423,0.105847,0.000275
9511216,9511216,,0,1,1,0,1,1,0,0,0,25952,6,0.00001,1,1,1,0,0,0
9511225,9511225,,0,7,7,0,7,7,0,0.000004,0,25953,6,0.00001,7,0.250429,0.308529,0,0.333333,0
9512009,9512009,,0,17,17,0,17,17,0,0.000263,0,25954,26,0.00001,10,0.19531,0.251587,0,0.264706,0
9512014,9512014,,0,4,4,0,4,4,0,0.000002,0,25955,13,0.00001,10,0.193752,0.2158,0,0.416667,0
9512027,9512027,,1,1,2,1,1,2,0,0.000004,0,2851,9,0.000011,2,0.571429,0.625,38.687731,0,0.000233
9512035,9512035,,1,5,6,1,5,6,0,0.001028,0,25956,28,0.000014,6,0.271084,0.318395,68.5,0.166667,0.000219
9512037,9512037,,0,1,1,0,1,1,0,0.000009,0,25957,26,0.00001,2,0.571429,0.625,0,0,0
9512039,9512039,,0,15,15,0,15,15,0,0.000461,0,25958,9,0.00001,11,0.196489,0.232862,0,0.138095,0
9512051,9512051,,2,2,4,2,2,4,0,0,0,25959,22,0.000013,3,0.529412,0.592593,1.5,0.333333,0.000445
9512055,9512055,,2,4,6,2,4,6,0,0.00001,0,25960,9,0.000012,6,0.258333,0.314247,28.833333,0.166667,0.000445
9512058,9512058,,2,2,4,2,2,4,0,0,0,25961,23,0.000014,4,0.36,0.472222,9,0.166667,0.000438
9512063,9512063,,2,17,19,2,17,19,0.000178,0.003484,0,2761,4,0.000012,10,0.198301,0.257146,977.10101,0.163743,0.000874
9512072,9512072,,0,1,1,0,1,1,0,0,0,25962,28,0.00001,1,1,1,0,0,0
9512087,9512087,,1,3,4,1,3,4,0.000002,0.000001,0,25963,6,0.000013,2,0.8,0.875,4,0.083333,0.000219
9512093,9512093,,0,1,1,0,1,1,0,0,0,25964,6,0.00001,1,1,1,0,0,0
9512111,9512111,,1,2,3,1,2,3,0,0.000001,0,6332,52,0.000016,2,0.75,0.833333,7531.926076,0,0.00026
9512119,9512119,,0,6,6,0,6,6,0,0.000017,0,25965,9,0.00001,7,0.227986,0.273923,0,0.4,0
9512122,9512122,,0,2,2,0,2,2,0,0,0,25967,1,0.00001,1,1,1,0,0,0
9504106,9504106,,1,0,1,1,0,1,0,0,0,25966,1,0.000014,0,0,0,0,0,0.000219
9512132,9512132,,0,1,1,0,1,1,0,0,0,25968,23,0.00001,1,1,1,0,0,0
9509131,9509131,,2,0,2,2,0,2,0,0,0,11234,23,0.000046,0,0,0,0,0,0.000451
9512133,9512133,,0,1,1,0,1,1,0,0.000001,0,25969,9,0.00001,5,0.263158,0.314583,0,0,0
9512134,9512134,,0,3,3,0,3,3,0,0.000008,0,25970,10,0.00001,5,0.351852,0.444737,0,0.5,0
9512136,9512136,,0,3,3,0,3,3,0,0.000033,0,25971,13,0.00001,6,0.291971,0.368333,0,0,0
9512144,9512144,,0,2,2,0,2,2,0,0,0,25972,20,0.00001,2,0.666667,0.75,0,0.5,0
9512146,9512146,,0,1,1,0,1,1,0,0,0,25973,23,0.00001,1,1,1,0,0,0
9512149,9512149,,0,16,16,0,16,16,0,0.002287,0,25974,4,0.00001,13,0.199721,0.239381,0,0.116667,0
9512160,9512160,,0,10,10,0,10,10,0,0.00001,0,25975,22,0.00001,4,0.492958,0.592857,0,0.288889,0
9512167,9512167,,0,2,2,0,2,2,0,0,0,25977,9,0.00001,2,0.75,0.833333,0,0,0
9407156,9407156,,2,0,2,2,0,2,0,0,0,25976,9,0.000016,0,0,0,0,0,0.000438
9512169,9512169,,0,7,7,0,7,7,0,0.001733,0,25978,13,0.00001,7,0.249746,0.286953,0,0.285714,0
9512176,9512176,,2,1,3,2,1,3,0,0,0,25979,15,0.000019,3,0.444444,0.541667,0,0.333333,0.000438
9512192,9512192,,0,10,10,0,10,10,0,0.001726,0,25980,0,0.00001,9,0.223209,0.259216,0,0.244444,0
9512194,9512194,,0,3,3,0,3,3,0,0.000002,0,25981,28,0.00001,7,0.306358,0.366532,0,0.166667,0
9512195,9512195,,0,2,2,0,2,2,0,0.000118,0,25982,0,0.00001,2,0.75,0.833333,0,0,0
9512198,9512198,,1,4,5,1,4,5,0,0.000011,0,25983,6,0.000012,1,1,1,3.333333,0.05,0.000219
9512202,9512202,,0,3,3,0,3,3,0,0.000008,0,25984,28,0.00001,1,1,1,0,0.5,0
9512206,9512206,,1,5,6,1,5,6,0.000046,0.000195,0,25985,5,0.000011,9,0.226131,0.273291,14.351823,0.133333,0.000219
9512207,9512207,,0,10,10,0,10,10,0,0.000217,0,25986,13,0.00001,6,0.301242,0.364089,0,0.1,0
9512213,9512213,,0,2,2,0,2,2,0,0.000009,0,25987,0,0.00001,2,0.75,0.833333,0,0,0
9512214,9512214,,0,6,6,0,6,6,0,0.00001,0,25988,9,0.00001,7,0.275556,0.314567,0,0.3,0
9512221,9512221,,0,1,1,0,1,1,0,0.000002,0,25989,9,0.00001,1,1,1,0,0,0
9601001,9601001,,0,3,3,0,3,3,0,0,0,25990,9,0.00001,5,0.323741,0.374815,0,0.5,0
9601005,9601005,,0,2,2,0,2,2,0,0,64,25991,116,0.00001,1,1,1,0,0.5,0
9601008,9601008,,0,1,1,0,1,1,0,0,95,25993,117,0.00001,1,1,1,0,0,0
9401142,9401142,,1,0,1,1,0,1,0,0,95,25992,117,0.000019,0,0,0,0,0,0.000219
9601018,9601018,,0,5,5,0,5,5,0,0.000003,0,25994,22,0.00001,4,0.473684,0.578704,0,0.3,0
9601021,9601021,,0,1,1,0,1,1,0,0,0,25995,21,0.00001,1,1,1,0,0,0
9601052,9601052,,3,5,8,3,5,8,0.000082,0.000002,0,3753,22,0.000013,5,0.419753,0.501961,124158.359174,0.053571,0.000753
9503090,9503090,,3,0,3,3,0,3,0,0,0,1837,23,0.00007,0,0,0,0,0,0.00076
9601054,9601054,,3,4,7,3,4,7,0.000014,0.000016,0,10738,15,0.000024,3,0.526316,0.65,24,0.119048,0.000685
9601061,9601061,,0,8,8,0,8,8,0,0.000021,0,25996,5,0.00001,6,0.310924,0.384384,0,0.303571,0
9601063,9601063,,0,2,2,0,2,2,0,0,0,25997,9,0.00001,6,0.230047,0.282653,0,0.5,0
9601066,9601066,,0,1,1,0,1,1,0,0,0,25998,15,0.00001,2,0.666667,0.75,0,0,0
9601071,9601071,,1,2,3,1,2,3,0,0,0,26000,22,0.000014,1,1,1,1,0.166667,0.000219
9307067,9307067,,2,0,2,2,0,2,0,0,0,11541,22,0.000018,0,0,0,0,0,0.000452
9512159,9512159,,2,0,2,2,0,2,0,0,0,25999,22,0.000021,0,0,0,0,0.5,0.000445
9601074,9601074,,0,6,6,0,6,6,0,0.000502,0,26001,5,0.00001,8,0.252747,0.297597,0,0.166667,0
9601079,9601079,,0,9,9,0,9,9,0,0.000055,0,26002,13,0.00001,9,0.195987,0.23333,0,0.069444,0
9601084,9601084,,1,3,4,1,3,4,0.000053,0.000001,0,26004,30,0.000011,5,0.377778,0.477451,12.166667,0.083333,0.000219
9410231,9410231,,2,0,2,2,0,2,0.000053,0,0,26003,30,0.000014,0,0,0,0,0.5,0.000445
9601101,9601101,,0,3,3,0,3,3,0,0,0,26005,5,0.00001,3,0.416667,0.5,0,0.166667,0
9601103,9601103,,2,1,3,2,1,3,0,0,96,26007,131,0.000023,1,1,1,1,0.166667,0.000438
9508051,9508051,,2,0,2,2,0,2,0,0,96,26006,131,0.000035,0,0,0,0,0.5,0.000451
9601110,9601110,,0,5,5,0,5,5,0,0.000033,0,26008,9,0.00001,8,0.191432,0.236389,0,0.2,0
9410089,9410089,,1,0,1,1,0,1,0,0,0,7819,52,0.000015,0,0,0,0,0,0.000247
9601119,9601119,,0,3,3,0,3,3,0,0.000001,0,26009,22,0.00001,2,0.8,0.875,0,0,0
9601121,9601121,,0,1,1,0,1,1,0,0,0,26010,15,0.00001,3,0.4,0.45,0,0,0
9601130,9601130,,0,7,7,0,7,7,0,0.00052,0,26011,13,0.00001,11,0.189515,0.241401,0,0.142857,0
9601142,9601142,,5,1,6,5,1,6,0,0,0,5158,20,0.000065,1,1,1,11232,0.033333,0.001171
9411191,9411191,,1,0,1,1,0,1,0,0,0,5157,20,0.000068,0,0,0,0,0,0.000252
9601145,9601145,,0,10,10,0,10,10,0,0.001941,0,26012,0,0.00001,13,0.197676,0.244218,0,0.344444,0
9601149,9601149,,0,1,1,0,1,1,0,0,97,26014,118,0.00001,1,1,1,0,0,0
9308096,9308096,,1,0,1,1,0,1,0,0,97,26013,118,0.000019,0,0,0,0,0,0.000219
9202066,9202066,,1,0,1,1,0,1,0,0,0,10186,22,0.000014,0,0,0,0,0,0.000226
9601178,9601178,,1,7,8,1,7,8,0,0.000015,0,26016,10,0.000013,7,0.253788,0.297074,95.027175,0.017857,0.000219
9503189,9503189,,1,0,1,1,0,1,0,0,0,26015,10,0.000011,0,0,0,0,0,0.000226
9602028,9602028,,1,16,17,1,16,17,0,0.000005,0,26017,17,0.000011,5,0.323171,0.421855,24.483333,0.121324,0.000226
9602034,9602034,,0,3,3,0,3,3,0,0.000009,0,26018,25,0.00001,2,0.714286,0.8,0,0.166667,0
9602039,9602039,,0,7,7,0,7,7,0,0.000007,0,26019,20,0.00001,2,0.769231,0.85,0,0.214286,0
9602040,9602040,,0,1,1,0,1,1,0,0,0,26020,9,0.00001,5,0.276316,0.330952,0,0,0
9602041,9602041,,2,5,7,2,5,7,0,0,0,2770,6,0.000012,6,0.274112,0.327932,13862.202591,0.261905,0.000468
9410221,9410221,,4,0,4,4,0,4,0,0,0,2769,6,0.000016,0,0,0,0,0.25,0.000903
9602056,9602056,,1,4,5,1,4,5,0.000001,0.000094,0,5521,28,0.000011,5,0.282051,0.343939,12.921225,0.35,0.000243
9602069,9602069,,1,8,9,1,8,9,0.000004,0.000263,0,26021,26,0.000011,10,0.177305,0.219413,3,0.069444,0.000219
9602076,9602076,,0,2,2,0,2,2,0,0,0,26022,22,0.00001,2,0.75,0.833333,0,0,0
9602079,9602079,,0,9,9,0,9,9,0,0.00006,0,26023,28,0.00001,8,0.209464,0.256368,0,0.180556,0
9602090,9602090,,1,1,2,1,1,2,0,0,0,10821,22,0.00003,1,1,1,160,0,0.000226
9602094,9602094,,3,12,15,3,12,15,0,0.000013,0,18034,15,0.000012,7,0.275472,0.388715,2695.146136,0.114286,0.000685
9602095,9602095,,0,3,3,0,3,3,0,0.000001,0,26024,22,0.00001,1,1,1,0,0,0
9602099,9602099,,0,8,8,0,8,8,0,0.00069,0,26025,28,0.00001,10,0.202672,0.228066,0,0.071429,0
9602100,9602100,,2,1,3,2,1,3,0,0,0,26026,26,0.000016,1,1,1,0,0.333333,0.000438
9602103,9602103,,1,12,13,1,12,13,0,0.000023,0,26027,5,0.000011,9,0.24267,0.272948,568.284811,0.057692,0.000219
9602116,9602116,,2,4,6,2,4,6,0,0.000008,0,6309,52,0.000015,4,0.408163,0.504167,34.75,0.066667,0.000445
9602124,9602124,,0,7,7,0,7,7,0,0.000193,0,26028,5,0.00001,11,0.208625,0.237469,0,0.166667,0
9602125,9602125,,0,10,10,0,10,10,0,0.001076,0,26029,5,0.00001,11,0.188504,0.222019,0,0.111111,0
9602130,9602130,,4,1,5,4,1,5,0,0,0,9333,23,0.000029,1,1,1,0,0.2,0.000913
9602131,9602131,,0,1,1,0,1,1,0,0,0,26030,23,0.00001,1,1,1,0,0,0
9602132,9602132,,0,13,13,0,13,13,0,0.000179,0,26031,0,0.00001,10,0.204149,0.243909,0,0.198718,0
9602133,9602133,,0,5,5,0,5,5,0,0.000015,0,26032,22,0.00001,2,0.857143,0.916667,0,0.05,0
9602141,9602141,,1,9,10,1,9,10,0.000001,0.000075,0,14527,26,0.000011,7,0.271028,0.340134,36.776241,0.322222,0.000226
9602142,9602142,,0,2,2,0,2,2,0,0,0,26033,23,0.00001,1,1,1,0,0.5,0
9602143,9602143,,0,2,2,0,2,2,0,0,0,26034,23,0.00001,1,1,1,0,0.5,0
9602150,9602150,,0,15,15,0,15,15,0,0.00013,0,26035,5,0.00001,9,0.253208,0.305792,0,0.128571,0
9602152,9602152,,0,5,5,0,5,5,0,0.000002,0,26036,23,0.00001,3,0.583333,0.666667,0,0.35,0
9602153,9602153,,0,29,29,0,29,29,0,0.010049,0,26037,0,0.00001,10,0.224759,0.267344,0,0.20936,0
9602158,9602158,,0,1,1,0,1,1,0,0,0,26038,22,0.00001,2,0.666667,0.75,0,0,0
9602164,9602164,,1,2,3,1,2,3,0,0,0,26039,23,0.000013,3,0.545455,0.638889,2,0.333333,0.000219
9603007,9603007,,0,5,5,0,5,5,0,0.000005,0,26040,13,0.00001,6,0.255018,0.283025,0,0.25,0
9603008,9603008,,0,8,8,0,8,8,0,0.000633,0,26041,13,0.00001,4,0.357447,0.421627,0,0.214286,0
9603017,9603017,,0,21,21,0,21,21,0,0.000085,0,26042,5,0.00001,8,0.282728,0.363568,0,0.083333,0
9603018,9603018,,2,2,4,2,2,4,0.000008,0,0,16069,23,0.000014,2,0.75,0.833333,542.666667,0.166667,0.000451
9603022,9603022,,0,1,1,0,1,1,0,0,78,26043,99,0.00001,1,1,1,0,0,0
9603027,9603027,,0,2,2,0,2,2,0,0.000018,0,26044,13,0.00001,5,0.302326,0.362821,0,0.5,0
9603032,9603032,,0,1,1,0,1,1,0,0,0,26045,22,0.00001,2,0.6,0.666667,0,0,0
9603038,9603038,,0,1,1,0,1,1,0,0,0,26046,17,0.00001,6,0.250859,0.284703,0,0,0
9603041,9603041,,3,2,5,3,2,5,0.000008,0.000589,0,11245,23,0.000016,6,0.280566,0.311697,2086.97485,0.15,0.000678
9603046,9603046,,0,2,2,0,2,2,0,0,0,26047,6,0.00001,2,0.75,0.833333,0,0,0
9603048,9603048,,1,1,2,1,1,2,0.000012,0.000004,0,26048,13,0.000011,5,0.295455,0.337179,5,0,0.000219
9603050,9603050,,0,3,3,0,3,3,0,0.000008,0,26049,22,0.00001,5,0.333333,0.427778,0,0.5,0
9603058,9603058,,0,1,1,0,1,1,0,0,0,26050,4,0.00001,7,0.222812,0.241204,0,0,0
9603059,9603059,,0,23,23,0,23,23,0,0.006524,0,26051,0,0.00001,11,0.216851,0.259441,0,0.258893,0
9603063,9603063,,0,2,2,0,2,2,0,0.000002,0,26052,0,0.00001,2,0.75,0.833333,0,0.5,0
9603066,9603066,,0,7,7,0,7,7,0,0.000079,0,26053,4,0.00001,3,0.526316,0.633333,0,0.166667,0
9603079,9603079,,0,1,1,0,1,1,0,0,0,26054,13,0.00001,1,1,1,0,0,0
9603085,9603085,,2,8,10,2,8,10,0.000026,0.000525,0,4571,0,0.000012,6,0.310406,0.372348,66.702369,0.177778,0.000493
9603091,9603091,,0,1,1,0,1,1,0,0,98,26056,119,0.00001,1,1,1,0,0,0
9512164,9512164,,1,0,1,1,0,1,0,0,98,26055,119,0.000019,0,0,0,0,0,0.000219
9603105,9603105,,1,3,4,1,3,4,0,0.000001,0,10949,6,0.000015,6,0.246914,0.298542,10.308333,0,0.000246
9603110,9603110,,0,16,16,0,16,16,0,0.003214,0,26057,13,0.00001,11,0.20091,0.254438,0,0.1875,0
9603114,9603114,,1,2,3,1,2,3,0.000026,0,0,26059,15,0.00001,3,0.461538,0.583333,5,0,0.000219
9405097,9405097,,1,0,1,1,0,1,0,0,0,26058,15,0.000015,0,0,0,0,0,0.000226
9603118,9603118,,0,20,20,0,20,20,0,0.005386,0,26060,0,0.00001,11,0.213425,0.253548,0,0.239474,0
9603120,9603120,,0,1,1,0,1,1,0,0,99,26062,120,0.00001,1,1,1,0,0,0
9510056,9510056,,1,0,1,1,0,1,0,0,99,26061,120,0.000019,0,0,0,0,0,0.000219
9603121,9603121,,0,6,6,0,6,6,0,0.000001,0,26063,30,0.00001,3,0.590909,0.705128,0,0.1,0
9603124,9603124,,1,1,2,1,1,2,0,0,0,26064,23,0.000014,1,1,1,1,0,0.000219
9603130,9603130,,0,3,3,0,3,3,0,0,0,26065,22,0.00001,1,1,1,0,0.333333,0
9603131,9603131,,1,6,7,1,6,7,0,0.001869,0,7576,4,0.000012,7,0.276786,0.319747,11031.334171,0.047619,0.000233
9502055,9502055,,1,0,1,1,0,1,0.000022,0,0,7575,4,0.000012,0,0,0,0,0,0.000226
9603132,9603132,,0,2,2,0,2,2,0,0,0,26066,22,0.00001,2,0.75,0.833333,0,0,0
9603137,9603137,,1,2,3,1,2,3,0,0.000055,0,26067,13,0.000012,2,0.583333,0.642857,7,0,0.000219
9603138,9603138,,2,6,8,2,6,8,0,0.000004,0,26069,6,0.000012,10,0.192298,0.216062,1086.427129,0.107143,0.000438
9503110,9503110,,3,0,3,3,0,3,0,0,0,26068,6,0.000013,0,0,0,0,0.333333,0.00067
9401085,9401085,,1,0,1,1,0,1,0,0,0,9580,15,0.000011,0,0,0,0,0,0.00024
9603144,9603144,,3,8,11,3,8,11,0.000001,0.000008,0,3824,23,0.000013,7,0.268215,0.318237,55223.842616,0.209091,0.000681
9603153,9603153,,0,1,1,0,1,1,0,0,0,26070,22,0.00001,2,0.6,0.666667,0,0,0
9603171,9603171,,0,1,1,0,1,1,0,0,0,26071,2,0.00001,1,1,1,0,0,0
9410197,9410197,,2,0,2,2,0,2,0.000013,0,0,5078,26,0.000014,0,0,0,0,0,0.000559
9509150,9509150,,3,0,3,3,0,3,0,0,0,10310,22,0.000022,0,0,0,0,0.5,0.000721
9603182,9603182,,1,8,9,1,8,9,0.000006,0.000068,0,26072,13,0.000011,4,0.348315,0.431452,6.033333,0.25,0.000219
9603184,9603184,,0,9,9,0,9,9,0,0.000574,0,26073,13,0.00001,12,0.190132,0.21798,0,0.263889,0
9603192,9603192,,0,1,1,0,1,1,0,0,0,26074,23,0.00001,1,1,1,0,0,0
9603196,9603196,,0,3,3,0,3,3,0,0,0,26075,23,0.00001,11,0.158798,0.186032,0,0.166667,0
9603197,9603197,,0,1,1,0,1,1,0,0,0,26076,10,0.00001,1,1,1,0,0,0
9603198,9603198,,1,7,8,1,7,8,0,0.000175,0,26077,13,0.000019,10,0.179875,0.223397,404,0.071429,0.000219
9509023,9509023,,3,0,3,3,0,3,0.00001,0,0,7089,9,0.000016,0,0,0,0,0.333333,0.000695
9603201,9603201,,0,4,4,0,4,4,0,0.000006,0,26078,5,0.00001,3,0.466667,0.571429,0,0.416667,0
9604001,9604001,,1,2,3,1,2,3,0.000009,0.000005,0,26079,4,0.000011,10,0.172698,0.198185,33.675,0.333333,0.000219
9604010,9604010,,1,7,8,1,7,8,0.000001,0.000018,0,4482,3,0.000011,5,0.371728,0.442723,33810.479995,0.303571,0.000252
9604016,9604016,,0,14,14,0,14,14,0,0.000021,0,26080,6,0.00001,8,0.285714,0.38719,0,0.148352,0
9604020,9604020,,0,4,4,0,4,4,0,0.000005,0,26081,26,0.00001,2,0.75,0.833333,0,0.25,0
9408052,9408052,,1,0,1,1,0,1,0,0,0,5298,5,0.000016,0,0,0,0,0,0.000264
9604049,9604049,,0,2,2,0,2,2,0,0,100,26084,121,0.00001,1,1,1,0,0,0
9408105,9408105,,1,0,1,1,0,1,0,0,100,26083,121,0.000014,0,0,0,0,0,0.000219
9408145,9408145,,1,0,1,1,0,1,0,0,100,26082,121,0.000014,0,0,0,0,0,0.000219
9604050,9604050,,0,2,2,0,2,2,0,0,0,26085,23,0.00001,8,0.255263,0.278578,0,0.5,0
9604060,9604060,,0,2,2,0,2,2,0,0,0,26086,22,0.00001,3,0.5,0.633333,0,0,0
9604061,9604061,,3,11,14,3,11,14,0.000001,0.000058,0,22750,23,0.000014,10,0.213121,0.273363,1098.126671,0.076923,0.000677
9208060,9208060,,1,0,1,1,0,1,0.000002,0,0,6513,5,0.000011,0,0,0,0,0,0.000226
9604066,9604066,,0,3,3,0,3,3,0,0.000117,0,26087,13,0.00001,5,0.256705,0.300498,0,0.166667,0
9604067,9604067,,3,14,17,3,14,17,0.000002,0.000066,0,8073,17,0.000013,5,0.413793,0.528611,7715.171648,0.264706,0.000698
9604073,9604073,,0,17,17,0,17,17,0,0.000073,0,26088,17,0.00001,6,0.284431,0.420702,0,0.165441,0
9604079,9604079,,0,4,4,0,4,4,0,0.000001,0,26089,6,0.00001,4,0.423077,0.511364,0,0.166667,0
9604082,9604082,,0,1,1,0,1,1,0,0,0,26090,22,0.00001,2,0.666667,0.75,0,0,0
9604086,9604086,,0,1,1,0,1,1,0,0,0,26091,30,0.00001,1,1,1,0,0,0
9604088,9604088,,0,9,9,0,9,9,0,0.000024,0,26092,23,0.00001,10,0.206462,0.245974,0,0.138889,0
9604092,9604092,,0,1,1,0,1,1,0,0,101,26094,122,0.00001,1,1,1,0,0,0
9603039,9603039,,1,0,1,1,0,1,0,0,101,26093,122,0.000019,0,0,0,0,0,0.000219
9604093,9604093,,1,10,11,1,10,11,0,0.000016,0,26095,5,0.000011,7,0.254866,0.299074,77.777522,0.154545,0.000219
9604100,9604100,,3,1,4,3,1,4,0,0,0,9292,6,0.000027,8,0.206704,0.248391,3026.477661,0,0.000671
9604101,9604101,,2,11,13,2,11,13,0.000112,0.002956,0,3479,4,0.000011,15,0.181353,0.22093,104.36043,0.391026,0.000493
9604106,9604106,,0,1,1,0,1,1,0,0,0,26096,5,0.00001,1,1,1,0,0,0
9604107,9604107,,0,5,5,0,5,5,0,0.00162,0,26097,0,0.00001,11,0.185861,0.210607,0,0.25,0
9604109,9604109,,0,4,4,0,4,4,0,0.000024,0,26098,22,0.00001,5,0.358621,0.419231,0,0.166667,0
9604110,9604110,,0,8,8,0,8,8,0,0.002582,0,26099,0,0.00001,10,0.207741,0.235347,0,0.25,0
9604116,9604116,,0,4,4,0,4,4,0,0.000003,0,26100,10,0.00001,4,0.414634,0.519608,0,0.416667,0
9604137,9604137,,1,1,2,1,1,2,0,0,0,26102,30,0.000011,1,1,1,0,0.5,0.000219
9306115,9306115,,2,0,2,2,0,2,0,0,0,26101,30,0.000022,0,0,0,0,0.5,0.000445
9604145,9604145,,1,4,5,1,4,5,0,0.000001,0,26103,22,0.000011,1,1,1,4,0.2,0.000219
9604153,9604153,,4,2,6,4,2,6,0.000033,0.000002,0,4089,6,0.000014,6,0.251497,0.295437,6047.978696,0.2,0.00092
9604160,9604160,,0,5,5,0,5,5,0,0.000001,0,26104,5,0.00001,4,0.555556,0.708333,0,0.35,0
9604170,9604170,,2,5,7,2,5,7,0,0.00002,0,26105,5,0.000016,5,0.340541,0.394444,10,0.119048,0.000438
9604172,9604172,,0,2,2,0,2,2,0,0.000003,0,26107,23,0.00001,1,1,1,0,0,0
9503075,9503075,,2,0,2,2,0,2,0,0,0,26106,23,0.000015,0,0,0,0,0,0.000438
9604173,9604173,,0,2,2,0,2,2,0,0.000001,0,26108,41,0.00001,1,1,1,0,0.5,0
9604174,9604174,,0,28,28,0,28,28,0,0.000027,0,26109,6,0.00001,8,0.280124,0.374597,0,0.062169,0
9604187,9604187,,0,2,2,0,2,2,0,0,0,26110,22,0.00001,8,0.176966,0.21147,0,0,0
9604188,9604188,,0,1,1,0,1,1,0,0.000001,0,26111,4,0.00001,7,0.213953,0.235939,0,0,0
9604194,9604194,,0,2,2,0,2,2,0,0,0,26112,5,0.00001,4,0.308511,0.359195,0,0.5,0
9604201,9604201,,1,2,3,1,2,3,0,0.001495,0,26113,2,0.000012,8,0.219039,0.242644,474,0,0.000219
9605002,9605002,,0,7,7,0,7,7,0,0.000051,0,26114,22,0.00001,7,0.253813,0.301543,0,0.238095,0
9605010,9605010,,1,15,16,1,15,16,0.000044,0.00412,0,4339,13,0.000011,10,0.218795,0.25148,574.828823,0.1,0.000249
9605014,9605014,,0,1,1,0,1,1,0,0,0,26115,8,0.00001,1,1,1,0,0,0
9605015,9605015,,0,1,1,0,1,1,0,0.000001,0,26116,22,0.00001,1,1,1,0,0,0
9605025,9605025,,0,3,3,0,3,3,0,0.000001,0,26117,5,0.00001,5,0.335079,0.37526,0,0.5,0
9605029,9605029,,0,21,21,0,21,21,0,0.002206,0,26118,9,0.00001,7,0.282154,0.329609,0,0.02381,0
9605041,9605041,,1,2,3,1,2,3,0,0,0,26119,6,0.000013,2,0.75,0.833333,1.5,0,0.000219
9605052,9605052,,1,9,10,1,9,10,0,0.000006,0,26120,6,0.000012,3,0.534884,0.652174,6.522222,0.277778,0.000219
9605055,9605055,,2,4,6,2,4,6,0,0.000001,0,17352,15,0.000011,1,1,1,0,0.333333,0.000452
9605057,9605057,,0,3,3,0,3,3,0,0.000001,0,26121,5,0.00001,5,0.335079,0.37526,0,0.5,0
9605063,9605063,,0,6,6,0,6,6,0,0.000031,0,26122,5,0.00001,7,0.254634,0.295995,0,0.166667,0
9605064,9605064,,2,9,11,2,9,11,0,0.000009,0,10318,22,0.000014,5,0.4,0.574359,4956.990035,0.109091,0.000454
9605068,9605068,,0,2,2,0,2,2,0,0,0,26125,26,0.00001,1,1,1,0,0,0
9407170,9407170,,2,0,2,2,0,2,0.000003,0,0,26124,26,0.000015,0,0,0,0,0,0.000438
9507124,9507124,,1,0,1,1,0,1,0,0,0,26123,26,0.000014,0,0,0,0,0,0.000219
9605070,9605070,,1,18,19,1,18,19,0.000016,0.000732,0,5840,13,0.00001,10,0.207743,0.255806,200.997799,0.201754,0.000247
9605076,9605076,,0,2,2,0,2,2,0,0,0,26126,15,0.00001,3,0.5,0.633333,0,0.5,0
9605078,9605078,,0,1,1,0,1,1,0,0,0,26127,5,0.00001,1,1,1,0,0,0
9605083,9605083,,0,9,9,0,9,9,0,0.001035,0,26129,22,0.00001,6,0.296124,0.351571,0,0.097222,0
9603070,9603070,,2,0,2,2,0,2,0.000012,0,0,26128,22,0.00002,0,0,0,0,0,0.000438
9605095,9605095,,0,5,5,0,5,5,0,0.000021,0,26130,4,0.00001,3,0.571429,0.680556,0,0.25,0
9605098,9605098,,0,8,8,0,8,8,0,0.000025,0,26131,26,0.00001,5,0.384615,0.476667,0,0.142857,0
9605117,9605117,,0,14,14,0,14,14,0,0.000828,0,26132,13,0.00001,9,0.239105,0.286403,0,0.159341,0
9605122,9605122,,1,3,4,1,3,4,0,0,0,26133,26,0.000012,1,1,1,2.333333,0.166667,0.000219
9605125,9605125,,0,1,1,0,1,1,0,0,0,26134,6,0.00001,4,0.369863,0.410494,0,0,0
9605130,9605130,,0,4,4,0,4,4,0,0,0,26135,6,0.00001,4,0.5,0.608974,0,0.083333,0
9605133,9605133,,1,5,6,1,5,6,0,0.000005,0,26136,15,0.000013,6,0.256522,0.34548,8.833333,0.166667,0.000219
9605138,9605138,,1,6,7,1,6,7,0,0,0,26137,23,0.000012,5,0.416667,0.604444,7.166667,0.285714,0.000219
9605164,9605164,,0,9,9,0,9,9,0,0.000029,0,26138,22,0.00001,3,0.75,0.861111,0,0.111111,0
9605165,9605165,,0,1,1,0,1,1,0,0,102,26140,123,0.00001,1,1,1,0,0,0
9602003,9602003,,2,0,2,2,0,2,0,0,102,26139,123,0.000028,0,0,0,0,0,0.000438
9610200,9610200,,0,1,1,0,1,1,0,0,0,26141,15,0.00001,9,0.177893,0.21956,0,0,0
9605177,9605177,,1,3,4,1,3,4,0,0,0,26142,22,0.000011,3,0.526316,0.616667,0,0.416667,0.000219
9605179,9605179,,0,3,3,0,3,3,0,0,0,26143,15,0.00001,2,0.615385,0.6875,0,0.166667,0
9605185,9605185,,1,4,5,1,4,5,0.000002,0.000003,0,26144,17,0.00001,3,0.464286,0.576923,0.5,0.25,0.000219
9605188,9605188,,3,2,5,3,2,5,0,0,87,26145,109,0.000025,1,1,1,2,0.25,0.000658
9605189,9605189,,1,2,3,1,2,3,0,0,103,26148,124,0.000013,1,1,1,0,0.333333,0.000219
9604029,9604029,,2,0,2,2,0,2,0,0,103,26147,124,0.000019,0,0,0,0,0.5,0.000445
9604036,9604036,,2,0,2,2,0,2,0,0,103,26146,124,0.000019,0,0,0,0,0.5,0.000445
9605190,9605190,,0,1,1,0,1,1,0,0,104,26150,125,0.00001,1,1,1,0,0,0
9605132,9605132,,1,0,1,1,0,1,0,0,104,26149,125,0.000019,0,0,0,0,0,0.000219
9605193,9605193,,0,9,9,0,9,9,0,0.000006,0,26151,9,0.00001,7,0.24,0.308676,0,0.055556,0
9605196,9605196,,0,3,3,0,3,3,0,0.000007,0,26152,22,0.00001,4,0.34375,0.424242,0,0.166667,0
9605197,9605197,,1,7,8,1,7,8,0.000001,0.000589,0,16070,23,0.000013,6,0.282883,0.321921,795.208874,0.089286,0.000226
9605198,9605198,,0,1,1,0,1,1,0,0,0,26154,8,0.00001,1,1,1,0,0,0
9507037,9507037,,2,0,2,2,0,2,0,0,0,26153,8,0.000022,0,0,0,0,0,0.000438
9605202,9605202,,0,4,4,0,4,4,0,0.000009,0,26155,2,0.00001,9,0.180924,0.198344,0,0.166667,0
9605205,9605205,,0,2,2,0,2,2,0,0,0,26156,9,0.00001,5,0.318182,0.384127,0,0,0
9605210,9605210,,0,9,9,0,9,9,0,0.00004,0,26157,26,0.00001,7,0.244582,0.369319,0,0.180556,0
9605230,9605230,,0,3,3,0,3,3,0,0,103,26158,124,0.00001,1,1,1,0,0.333333,0
9605235,9605235,,0,13,13,0,13,13,0,0.000003,0,26160,6,0.00001,7,0.234097,0.344695,0,0.070513,0
9412178,9412178,,1,0,1,1,0,1,0,0,0,26159,6,0.000011,0,0,0,0,0,0.000219
9606005,9606005,,0,4,4,0,4,4,0,0,0,26161,23,0.00001,9,0.188298,0.213777,0,0.333333,0
9606006,9606006,,0,3,3,0,3,3,0,0.000017,0,26162,15,0.00001,8,0.225059,0.253163,0,0,0
9606010,9606010,,0,5,5,0,5,5,0,0.004854,0,26163,0,0.00001,10,0.19395,0.232041,0,0.2,0
9606019,9606019,,1,3,4,1,3,4,0,0.000002,0,26164,15,0.000012,1,1,1,0.5,0.083333,0.000219
9606021,9606021,,1,2,3,1,2,3,0,0.000003,0,26165,22,0.000013,4,0.419355,0.49359,13,0.166667,0.000219
9606035,9606035,,0,11,11,0,11,11,0,0.003918,0,26166,13,0.00001,10,0.211583,0.243587,0,0.127273,0
9606038,9606038,,0,1,1,0,1,1,0,0,0,26167,22,0.00001,4,0.364865,0.401235,0,0,0
9606048,9606048,,0,3,3,0,3,3,0,0,0,26168,22,0.00001,2,0.8,0.875,0,0.5,0
9606057,9606057,,3,9,12,3,9,12,0.000029,0.00518,0,2818,0,0.000025,11,0.20141,0.231996,1731.289969,0.204545,0.000693
9606060,9606060,,1,5,6,1,5,6,0,0.000047,0,2553,23,0.000012,7,0.288136,0.34176,742.859075,0.133333,0.000242
9606065,9606065,,0,8,8,0,8,8,0,0.00002,0,26169,23,0.00001,6,0.256506,0.308816,0,0.142857,0
9606069,9606069,,0,9,9,0,9,9,0,0.000054,0,26170,25,0.00001,1,1,1,0,0.083333,0
9606070,9606070,,0,12,12,0,12,12,0,0.00105,0,26171,4,0.00001,10,0.201041,0.251108,0,0.227273,0
9606074,9606074,,0,2,2,0,2,2,0,0,0,26172,26,0.00001,3,0.571429,0.708333,0,0.5,0
9606075,9606075,,1,2,3,1,2,3,0,0.000003,0,26174,20,0.000014,2,0.625,0.7,4,0.166667,0.000219
9404102,9404102,,2,0,2,2,0,2,0,0,0,26173,20,0.000021,0,0,0,0,0.5,0.000445
9312020,9312020,,1,0,1,1,0,1,0.000043,0,0,2902,28,0.000011,0,0,0,0,0,0.000326
9606083,9606083,,0,6,6,0,6,6,0,0.000012,0,26175,22,0.00001,4,0.425926,0.543478,0,0.1,0
9606085,9606085,,0,2,2,0,2,2,0,0,0,26176,22,0.00001,2,0.75,0.833333,0,0.5,0
9606088,9606088,,1,5,6,1,5,6,0,0.000002,0,18042,6,0.000011,5,0.327869,0.473333,52.212454,0.066667,0.000226
9606094,9606094,,0,5,5,0,5,5,0,0.000002,0,26177,6,0.00001,4,0.413793,0.513889,0,0.35,0
9606096,9606096,,0,13,13,0,13,13,0,0.002801,0,26178,4,0.00001,12,0.170886,0.207878,0,0.25,0
9606103,9606103,,0,1,1,0,1,1,0,0,0,26179,28,0.00001,4,0.44,0.492424,0,0,0
9606106,9606106,,4,6,10,4,6,10,0.000263,0.001784,0,11824,5,0.000014,10,0.209614,0.236019,6377.817165,0.1,0.000891
9606110,9606110,,2,1,3,2,1,3,0,0,0,11235,23,0.00003,1,1,1,2375,0,0.000452
9606119,9606119,,0,11,11,0,11,11,0,0.000798,0,26180,0,0.00001,7,0.266871,0.307115,0,0.2,0
9606123,9606123,,0,21,21,0,21,21,0,0.004713,0,26181,17,0.00001,9,0.231236,0.277047,0,0.109524,0
9606127,9606127,,0,1,1,0,1,1,0,0,0,26182,23,0.00001,1,1,1,0,0,0
9606128,9606128,,0,1,1,0,1,1,0,0,0,26183,6,0.00001,3,0.5,0.611111,0,0,0
9606129,9606129,,3,7,10,3,7,10,0,0.000015,0,7311,26,0.000015,8,0.230898,0.267644,7921.551098,0.2,0.000718
9606140,9606140,,1,6,7,1,6,7,0,0.000019,0,5567,26,0.000012,8,0.191238,0.218818,0,0.309524,0.000245
9606147,9606147,,1,7,8,1,7,8,0.000092,0.000091,0,5683,2,0.00001,9,0.221351,0.24928,8102.939031,0.178571,0.000267
9606151,9606151,,1,6,7,1,6,7,0.000006,0.000014,0,10903,52,0.000011,6,0.301205,0.449333,0,0.404762,0.000246
9606152,9606152,,2,24,26,2,24,26,0.00003,0.000342,0,26184,5,0.000012,10,0.216143,0.265375,483.378397,0.110769,0.000445
9606158,9606158,,1,3,4,1,3,4,0.000001,0.000044,0,26185,52,0.000012,4,0.444444,0.526042,0,0.333333,0.000219
9606161,9606161,,0,10,10,0,10,10,0,0.000147,0,26186,0,0.00001,2,0.857143,0.916667,0,0.2,0
9606170,9606170,,0,1,1,0,1,1,0,0,0,26187,15,0.00001,3,0.444444,0.5,0,0,0
9606179,9606179,,0,3,3,0,3,3,0,0.00015,0,26188,5,0.00001,9,0.205975,0.263883,0,0.333333,0
9306084,9306084,,1,0,1,1,0,1,0.000002,0,0,12665,23,0.000012,0,0,0,0,0,0.000255
9606197,9606197,,1,2,3,1,2,3,0,0,0,26189,28,0.000011,2,0.75,0.833333,0,0.333333,0.000219
9606198,9606198,,1,3,4,1,3,4,0,0,0,26190,5,0.000011,2,0.8,0.875,1.5,0.333333,0.000219
9607006,9607006,,0,7,7,0,7,7,0,0.000182,0,26191,13,0.00001,9,0.220535,0.252217,0,0.285714,0
9607008,9607008,,1,5,6,1,5,6,0,0.000003,0,17351,15,0.00001,1,1,1,145.563492,0.166667,0.000226
9607012,9607012,,0,1,1,0,1,1,0,0.000002,0,26192,6,0.00001,4,0.333333,0.372024,0,0,0
9607016,9607016,,0,4,4,0,4,4,0,0.000008,0,26193,52,0.00001,4,0.440678,0.512821,0,0,0
9607018,9607018,,0,4,4,0,4,4,0,0.000025,0,26194,13,0.00001,8,0.239837,0.274933,0,0.25,0
9607028,9607028,,1,1,2,1,1,2,0.00002,0.000149,0,26195,5,0.000011,3,0.5,0.517544,0,0.5,0.000219
9607031,9607031,,0,4,4,0,4,4,0,0.000002,0,26196,6,0.00001,6,0.270992,0.331925,0,0,0
9607035,9607035,,2,4,6,2,4,6,0,0.000005,0,11019,22,0.000014,4,0.441176,0.55,648.881873,0.133333,0.00046
9607042,9607042,,0,1,1,0,1,1,0,0,0,26197,20,0.00001,2,0.666667,0.75,0,0,0
9607047,9607047,,1,6,7,1,6,7,0,0.000018,0,2768,22,0.000011,5,0.259259,0.378095,23692.145114,0.119048,0.000249
9607055,9607055,,1,5,6,1,5,6,0,0,0,26198,6,0.000013,6,0.328467,0.40963,12,0.066667,0.000219
9607059,9607059,,0,2,2,0,2,2,0,0.000001,0,26199,5,0.00001,1,1,1,0,0,0
9607068,9607068,,0,1,1,0,1,1,0,0,0,26200,22,0.00001,1,1,1,0,0,0
9607069,9607069,,1,5,6,1,5,6,0,0.000001,0,26201,30,0.000011,11,0.159303,0.17879,0,0.366667,0.000232
9607072,9607072,,1,11,12,1,11,12,0.000001,0.000076,0,26202,26,0.000011,7,0.293869,0.349683,94.770238,0.159091,0.000219
9607075,9607075,,0,1,1,0,1,1,0,0,105,26204,126,0.00001,1,1,1,0,0,0
9411239,9411239,,2,0,2,2,0,2,0,0,105,26203,126,0.000028,0,0,0,0,0,0.000438
9607079,9607079,,1,4,5,1,4,5,0,0,0,26205,2,0.000014,3,0.571429,0.708333,5.5,0.15,0.000219
9607080,9607080,,2,1,3,2,1,3,0,0.000007,0,26206,6,0.000015,6,0.246753,0.313158,19,0.166667,0.000438
9607084,9607084,,1,6,7,1,6,7,0.000002,0.000084,0,26207,13,0.000011,7,0.263245,0.32625,17.985317,0.142857,0.000219
9607097,9607097,,0,2,2,0,2,2,0,0.000019,0,26208,3,0.00001,3,0.466667,0.571429,0,0.5,0
9607098,9607098,,0,2,2,0,2,2,0,0.000019,0,26209,3,0.00001,3,0.466667,0.571429,0,0.5,0
9607100,9607100,,0,2,2,0,2,2,0,0,0,26211,28,0.00001,3,0.555556,0.666667,0,0,0
9307193,9307193,,1,0,1,1,0,1,0,0,0,26210,28,0.000014,0,0,0,0,0,0.000219
9607111,9607111,,2,1,3,2,1,3,0.000029,0,0,2819,0,0.000013,12,0.167737,0.183741,0,0.333333,0.00046
9607130,9607130,,0,1,1,0,1,1,0,0,0,26212,15,0.00001,3,0.421053,0.479167,0,0,0
9607136,9607136,,1,9,10,1,9,10,0.000002,0.000001,0,26213,17,0.00001,6,0.29805,0.367913,6.166667,0.233333,0.000219
9607142,9607142,,0,3,3,0,3,3,0,0.000001,0,26214,6,0.00001,5,0.3125,0.376667,0,0,0
9607162,9607162,,1,3,4,1,3,4,0,0.000001,0,21361,4,0.000011,7,0.245575,0.296761,0,0.416667,0.000232
9410077,9410077,,1,0,1,1,0,1,0,0,0,14640,6,0.000011,0,0,0,0,0,0.000226
9607166,9607166,,0,2,2,0,2,2,0,0.000004,0,26215,5,0.00001,7,0.252327,0.286739,0,0.5,0
9607169,9607169,,0,9,9,0,9,9,0,0.002332,0,26216,4,0.00001,13,0.182952,0.217317,0,0.402778,0
9607178,9607178,,0,3,3,0,3,3,0,0.000019,0,26217,5,0.00001,12,0.152291,0.169112,0,0.166667,0
9607179,9607179,,0,1,1,0,1,1,0,0.000025,0,26218,2,0.00001,11,0.167957,0.182076,0,0,0
9607180,9607180,,0,10,10,0,10,10,0,0.001921,0,26219,0,0.00001,10,0.214498,0.246554,0,0.077778,0
9607191,9607191,,0,2,2,0,2,2,0,0,0,26220,26,0.00001,1,1,1,0,0,0
9607225,9607225,,0,9,9,0,9,9,0,0.000049,0,26222,52,0.00001,5,0.337607,0.41519,0,0.069444,0
9212142,9212142,,1,0,1,1,0,1,0.000001,0,0,26221,52,0.000011,0,0,0,0,0,0.000219
9607228,9607228,,0,5,5,0,5,5,0,0.00013,0,26223,26,0.00001,1,1,1,0,0.05,0
9607237,9607237,,1,6,7,1,6,7,0,0.000012,0,26224,30,0.000011,3,0.555556,0.613333,1.333333,0.333333,0.000219
9607241,9607241,,0,1,1,0,1,1,0,0,0,26225,22,0.00001,1,1,1,0,0,0
9607242,9607242,,5,1,6,5,1,6,0.000001,0,0,9635,26,0.000023,5,0.3125,0.363333,0,0.266667,0.001177
9608001,9608001,,0,1,1,0,1,1,0,0.000008,0,26226,41,0.00001,6,0.218947,0.240224,0,0,0
9608002,9608002,,0,4,4,0,4,4,0,0,0,26227,6,0.00001,5,0.375,0.462222,0,0.333333,0
9608004,9608004,,1,3,4,1,3,4,0.000042,0.000014,0,26228,41,0.00001,5,0.29078,0.328252,13.166667,0,0.000219
9608007,9608007,,2,1,3,2,1,3,0,0.000002,0,14942,5,0.000023,1,1,1,3,0.166667,0.000452
9608021,9608021,,0,10,10,0,10,10,0,0.000004,0,26229,17,0.00001,6,0.262899,0.339564,0,0.133333,0
9608032,9608032,,0,2,2,0,2,2,0,0.000428,0,26230,2,0.00001,10,0.193182,0.213247,0,0.5,0
9608036,9608036,,0,6,6,0,6,6,0,0.000015,0,26231,9,0.00001,10,0.213546,0.24362,0,0.266667,0
9608044,9608044,,0,22,22,0,22,22,0,0.00318,0,26232,13,0.00001,10,0.239627,0.278265,0,0.168831,0
9608049,9608049,,1,9,10,1,9,10,0,0.000025,0,26233,5,0.000011,10,0.229079,0.256369,246.47381,0.177778,0.000219
9608051,9608051,,0,1,1,0,1,1,0,0,0,26234,23,0.00001,2,0.666667,0.75,0,0,0
9608052,9608052,,0,1,1,0,1,1,0,0,0,26235,23,0.00001,3,0.5,0.566667,0,0,0
9608062,9608062,,0,7,7,0,7,7,0,0.000022,0,26236,26,0.00001,9,0.199494,0.234746,0,0.285714,0
9608065,9608065,,1,8,9,1,8,9,0,0.000441,0,26237,9,0.000019,12,0.208139,0.2472,2051,0.125,0.000219
9608067,9608067,,0,1,1,0,1,1,0,0.000007,0,26238,5,0.00001,1,1,1,0,0,0
9608069,9608069,,0,4,4,0,4,4,0,0,0,26239,22,0.00001,1,1,1,0,0,0
9608073,9608073,,0,6,6,0,6,6,0,0.000865,0,26240,9,0.00001,12,0.190709,0.218589,0,0.166667,0
9608075,9608075,,2,6,8,2,6,8,0.000026,0.000453,0,4570,0,0.000012,12,0.178511,0.208396,5.228874,0.25,0.000493
9608080,9608080,,0,1,1,0,1,1,0,0,106,26242,127,0.00001,1,1,1,0,0,0
9412068,9412068,,1,0,1,1,0,1,0,0,106,26241,127,0.000019,0,0,0,0,0,0.000219
9608081,9608081,,0,1,1,0,1,1,0,0,107,26244,128,0.00001,1,1,1,0,0,0
9512088,9512088,,1,0,1,1,0,1,0,0,107,26243,128,0.000019,0,0,0,0,0,0.000219
9608087,9608087,,0,2,2,0,2,2,0,0.000001,0,26245,23,0.00001,2,0.75,0.833333,0,0,0
9608098,9608098,,0,2,2,0,2,2,0,0.000002,0,26246,0,0.00001,1,1,1,0,0,0
9608100,9608100,,2,2,4,2,2,4,0,0,0,26247,23,0.00002,9,0.181818,0.20421,285,0.083333,0.000438
9608112,9608112,,0,3,3,0,3,3,0,0.001037,0,26248,4,0.00001,9,0.199535,0.227654,0,0.166667,0
9608114,9608114,,0,13,13,0,13,13,0,0.000533,0,26249,4,0.00001,12,0.15911,0.179908,0,0.314103,0
9608115,9608115,,0,1,1,0,1,1,0,0,102,26250,123,0.00001,1,1,1,0,0,0
9608119,9608119,,1,1,2,1,1,2,0,0,0,26251,2,0.000014,2,0.6,0.666667,3,0,0.000219
9608120,9608120,,1,1,2,1,1,2,0,0,108,26253,137,0.000014,1,1,1,0,0.5,0.000219
9507039,9507039,,2,0,2,2,0,2,0,0,108,26252,137,0.000027,0,0,0,0,0.5,0.000445
9608123,9608123,,1,3,4,1,3,4,0,0.000015,0,12037,26,0.000011,8,0.225934,0.254607,0,0.416667,0.000246
9608132,9608132,,0,8,8,0,8,8,0,0.000064,0,26254,26,0.00001,7,0.24,0.295194,0,0.357143,0
9608133,9608133,,0,7,7,0,7,7,0,0,0,26255,23,0.00001,8,0.221445,0.261174,0,0.333333,0
9608141,9608141,,1,1,2,1,1,2,0,0.000004,0,4518,5,0.000011,4,0.363636,0.4375,462.340799,0,0.000237
9608146,9608146,,0,1,1,0,1,1,0,0,109,26257,129,0.00001,1,1,1,0,0,0
9408126,9408126,,1,0,1,1,0,1,0,0,109,26256,129,0.000019,0,0,0,0,0,0.000219
9608149,9608149,,0,1,1,0,1,1,0,0,0,26258,2,0.00001,8,0.247593,0.264134,0,0,0
9608152,9608152,,2,4,6,2,4,6,0,0.000022,0,9850,26,0.000012,6,0.261006,0.335743,73.430527,0.266667,0.000465
9608158,9608158,,0,2,2,0,2,2,0,0.000017,0,26259,3,0.00001,9,0.188226,0.212054,0,0,0
9608164,9608164,,0,1,1,0,1,1,0,0.000004,0,26260,1,0.00001,5,0.298701,0.339855,0,0,0
9608165,9608165,,1,3,4,1,3,4,0,0.000069,0,26261,4,0.000014,4,0.319672,0.384615,222,0.166667,0.000239
9608166,9608166,,1,2,3,1,2,3,0,0,0,8909,9,0.000011,8,0.223404,0.272789,2,0.333333,0.000246
9608168,9608168,,2,10,12,2,10,12,0,0.000014,0,26262,30,0.000016,11,0.159959,0.183607,1536,0.143939,0.000445
9608170,9608170,,0,5,5,0,5,5,0,0.000171,0,26263,5,0.00001,11,0.177325,0.197539,0,0.1,0
9608184,9608184,,0,5,5,0,5,5,0,0.000779,0,26264,0,0.00001,9,0.207462,0.237308,0,0.45,0
9609007,9609007,,0,12,12,0,12,12,0,0.000081,0,26265,26,0.00001,6,0.292453,0.343967,0,0.378788,0
9609009,9609009,,1,1,2,1,1,2,0,0,0,26266,15,0.000012,4,0.366667,0.431818,5,0,0.000219
9609011,9609011,,0,4,4,0,4,4,0,0.000005,0,26267,26,0.00001,1,1,1,0,0.416667,0
9609012,9609012,,1,1,2,1,1,2,0,0,0,26268,15,0.000014,1,1,1,0,0.5,0.000219
9609015,9609015,,0,13,13,0,13,13,0,0.004087,0,26269,0,0.00001,9,0.228807,0.260871,0,0.224359,0
9312028,9312028,,2,0,2,2,0,2,0,0,0,11813,15,0.000012,0,0,0,0,0,0.000465
9312029,9312029,,2,0,2,2,0,2,0,0,0,11812,15,0.000012,0,0,0,0,0,0.000465
9609036,9609036,,2,1,3,2,1,3,0,0.000025,0,26270,4,0.000017,5,0.287554,0.334328,39.916667,0.166667,0.000438
9609044,9609044,,1,1,2,1,1,2,0,0,0,26272,6,0.000014,1,1,1,1,0,0.000219
9607053,9607053,,1,0,1,1,0,1,0,0,0,26271,6,0.000023,0,0,0,0,0,0.000226
9609054,9609054,,1,5,6,1,5,6,0,0.000003,0,11406,22,0.000011,2,0.727273,0.8125,4.366667,0.4,0.000226
9609058,9609058,,0,1,1,0,1,1,0,0,0,26273,22,0.00001,1,1,1,0,0,0
9609060,9609060,,1,3,4,1,3,4,0.000001,0.000022,0,26274,0,0.000014,11,0.168445,0.182742,758.843845,0.083333,0.000219
9609067,9609067,,0,5,5,0,5,5,0,0.000003,0,26275,26,0.00001,3,0.578947,0.69697,0,0.1,0
9609072,9609072,,0,1,1,0,1,1,0,0,0,26276,8,0.00001,2,0.666667,0.75,0,0,0
9609078,9609078,,0,13,13,0,13,13,0,0.000301,0,26277,13,0.00001,6,0.310751,0.369273,0,0.089744,0
9609088,9609088,,0,2,2,0,2,2,0,0.000469,0,26278,28,0.00001,1,1,1,0,0,0
9609091,9609091,,0,4,4,0,4,4,0,0.000008,0,26279,15,0.00001,5,0.265306,0.332372,0,0.166667,0
9609093,9609093,,0,2,2,0,2,2,0,0,0,26281,15,0.00001,2,0.666667,0.75,0,0,0
9205112,9205112,,1,0,1,1,0,1,0,0,0,26280,15,0.000014,0,0,0,0,0,0.000219
9609096,9609096,,0,1,1,0,1,1,0,0,0,26283,28,0.00001,1,1,1,0,0,0
9602042,9602042,,4,0,4,4,0,4,0,0,0,26282,28,0.000027,0,0,0,0,0.083333,0.000883
9609097,9609097,,1,4,5,1,4,5,0,0.000002,0,26284,28,0.000014,7,0.24689,0.284644,257,0.1,0.000219
9609098,9609098,,0,7,7,0,7,7,0,0.00006,0,26285,26,0.00001,4,0.389262,0.452586,0,0.142857,0
9609106,9609106,,0,2,2,0,2,2,0,0.000001,0,26286,15,0.00001,2,0.75,0.833333,0,0,0
9609110,9609110,,2,1,3,2,1,3,0,0,110,26288,138,0.000021,1,1,1,0.5,0.333333,0.000445
9601100,9601100,,2,0,2,2,0,2,0,0,110,26287,138,0.000035,0,0,0,0,0.5,0.000458
9609120,9609120,,2,1,3,2,1,3,0.000043,0.00001,0,6990,9,0.000013,1,1,1,2.4,0,0.000452
9609129,9609129,,0,1,1,0,1,1,0,0,0,26289,20,0.00001,1,1,1,0,0,0
9609134,9609134,,1,4,5,1,4,5,0,0.000001,0,26290,6,0.000013,3,0.636364,0.761905,4.5,0.1,0.000219
9605040,9605040,,3,0,3,3,0,3,0.000062,0,0,3555,6,0.000016,0,0,0,0,0.166667,0.000705
9609144,9609144,,0,10,10,0,10,10,0,0.000001,0,26291,21,0.00001,8,0.207921,0.287221,0,0.233333,0
9609156,9609156,,0,1,1,0,1,1,0,0.001027,0,26292,4,0.00001,6,0.262295,0.292839,0,0,0
9609158,9609158,,0,4,4,0,4,4,0,0.000003,0,26293,22,0.00001,3,0.5625,0.685185,0,0.083333,0
9609163,9609163,,1,9,10,1,9,10,0.00006,0.000275,0,26294,0,0.00001,14,0.166407,0.194782,2.392002,0.288889,0.000219
9609164,9609164,,0,3,3,0,3,3,0,0.000002,0,26295,41,0.00001,3,0.538462,0.666667,0,0,0
9609165,9609165,,0,8,8,0,8,8,0,0.000061,0,26297,6,0.00001,10,0.20527,0.234603,0,0.071429,0
9604046,9604046,,1,0,1,1,0,1,0.000001,0,0,26296,6,0.000011,0,0,0,0,0,0.000219
9609170,9609170,,2,3,5,2,3,5,0,0.000003,0,26298,26,0.000016,2,0.8,0.875,6.166667,0.15,0.000438
9408072,9408072,,2,0,2,2,0,2,0.000004,0,0,3470,26,0.000013,0,0,0,0,0,0.000475
9609179,9609179,,0,7,7,0,7,7,0,0.00007,0,26300,52,0.00001,8,0.233956,0.267382,0,0.02381,0
9608016,9608016,,1,0,1,1,0,1,0.000001,0,0,26299,52,0.000011,0,0,0,0,0,0.000219
9609182,9609182,,2,10,12,2,10,12,0.000002,0.00001,0,7521,28,0.000012,9,0.187661,0.219614,47400.385938,0.090909,0.000446
9609184,9609184,,1,3,4,1,3,4,0,0.000013,0,26301,9,0.000012,2,0.714286,0.8,0,0.416667,0.000219
9609186,9609186,,1,3,4,1,3,4,0,0.000025,0,26302,23,0.000013,5,0.293617,0.353623,67,0.25,0.000219
9609187,9609187,,0,1,1,0,1,1,0,0,0,26303,5,0.00001,1,1,1,0,0,0
9609189,9609189,,0,2,2,0,2,2,0,0,0,26305,20,0.00001,3,0.545455,0.638889,0,0,0
9609121,9609121,,1,0,1,1,0,1,0,0,0,26304,20,0.000014,0,0,0,0,0,0.000219
9704046,9704046,,0,3,3,0,3,3,0,0.000009,0,26306,23,0.00001,11,0.176439,0.194273,0,0.333333,0
9609199,9609199,,0,2,2,0,2,2,0,0,0,26307,15,0.00001,3,0.5,0.633333,0,0.5,0
9609200,9609200,,0,1,1,0,1,1,0,0,0,26308,23,0.00001,10,0.179885,0.193959,0,0,0
9609215,9609215,,0,6,6,0,6,6,0,0.000111,0,26309,0,0.00001,4,0.431579,0.504065,0,0.2,0
9609227,9609227,,0,4,4,0,4,4,0,0.000001,0,26310,15,0.00001,2,0.7,0.785714,0,0.416667,0
9609237,9609237,,0,14,14,0,14,14,0,0.000058,0,26311,4,0.00001,5,0.364341,0.44279,0,0.065934,0
9610004,9610004,,0,3,3,0,3,3,0,0,0,26312,28,0.00001,1,1,1,0,0.5,0
9610010,9610010,,0,1,1,0,1,1,0,0,111,26314,130,0.00001,1,1,1,0,0,0
9607150,9607150,,1,0,1,1,0,1,0,0,111,26313,130,0.000019,0,0,0,0,0,0.000219
9610015,9610015,,0,3,3,0,3,3,0,0.000002,0,26315,6,0.00001,4,0.390805,0.443627,0,0,0
9610033,9610033,,0,1,1,0,1,1,0,0,0,26316,15,0.00001,1,1,1,0,0,0
9610042,9610042,,0,18,18,0,18,18,0,0.005735,0,26317,0,0.00001,11,0.218925,0.258329,0,0.147059,0
9412193,9412193,,2,0,2,2,0,2,0,0,0,12034,26,0.000014,0,0,0,0,0.5,0.000492
9412240,9412240,,1,0,1,1,0,1,0,0,0,12030,26,0.000012,0,0,0,0,0,0.000246
9610047,9610047,,0,4,4,0,4,4,0,0,0,26318,21,0.00001,3,0.483871,0.577778,0,0.25,0
9610063,9610063,,0,14,14,0,14,14,0,0.000023,0,26319,41,0.00001,5,0.333333,0.414216,0,0.06044,0
9610072,9610072,,0,2,2,0,2,2,0,0.000082,0,26320,30,0.00001,13,0.152818,0.179805,0,0,0
9610073,9610073,,0,1,1,0,1,1,0,0,0,26321,30,0.00001,3,0.5,0.611111,0,0,0
9610075,9610075,,0,3,3,0,3,3,0,0,0,26322,5,0.00001,4,0.319588,0.384409,0,0.5,0
9610078,9610078,,0,7,7,0,7,7,0,0.000007,0,26323,2,0.00001,3,0.566667,0.676471,0,0.261905,0
9610083,9610083,,0,8,8,0,8,8,0,0.000007,0,26324,23,0.00001,10,0.195926,0.244742,0,0.232143,0
9610085,9610085,,0,33,33,0,33,33,0,0.010792,0,26325,0,0.00001,12,0.227697,0.273633,0,0.122159,0
9610086,9610086,,1,11,12,1,11,12,0,0.001115,0,26326,5,0.000019,12,0.192806,0.224368,2262,0.05303,0.000219
9610088,9610088,,1,6,7,1,6,7,0.000002,0.000021,0,8212,5,0.00001,7,0.235678,0.25993,68.350922,0.238095,0.000232
9610093,9610093,,0,6,6,0,6,6,0,0.000018,0,26327,30,0.00001,3,0.5,0.564516,0,0.066667,0
9610096,9610096,,1,2,3,1,2,3,0,0,0,26329,26,0.000013,1,1,1,0,0.333333,0.000219
9607133,9607133,,2,0,2,2,0,2,0,0,0,26328,26,0.000019,0,0,0,0,0.5,0.000445
9610097,9610097,,1,5,6,1,5,6,0,0.000009,0,4997,22,0.000011,8,0.192308,0.280881,13706.492747,0.3,0.00024
9610110,9610110,,0,7,7,0,7,7,0,0.001727,0,26330,2,0.00001,10,0.207891,0.235326,0,0.214286,0
9203011,9203011,,1,0,1,1,0,1,0.000001,0,0,6823,30,0.000013,0,0,0,0,0,0.000239
9610115,9610115,,0,1,1,0,1,1,0,0,96,26331,131,0.00001,2,0.666667,0.75,0,0,0
9610116,9610116,,0,2,2,0,2,2,0,0,96,26332,131,0.00001,1,1,1,0,0.5,0
9610119,9610119,,0,22,22,0,22,22,0,0.006727,0,26333,0,0.00001,13,0.203899,0.24526,0,0.261905,0
9610127,9610127,,0,3,3,0,3,3,0,0.000001,0,26335,23,0.00001,8,0.185133,0.214935,0,0,0
9412049,9412049,,1,0,1,1,0,1,0,0,0,26334,23,0.000013,0,0,0,0,0,0.000219
9610130,9610130,,0,2,2,0,2,2,0,0,0,26336,28,0.00001,7,0.21485,0.241859,0,0.5,0
9610133,9610133,,0,4,4,0,4,4,0,0,0,26337,5,0.00001,10,0.185921,0.228321,0,0.083333,0
9610135,9610135,,1,1,2,1,1,2,0,0.000007,0,26338,1,0.000014,1,1,1,0,0.5,0.000219
9610137,9610137,,0,5,5,0,5,5,0,0.000069,0,26339,4,0.00001,6,0.256471,0.31896,0,0.1,0
9610146,9610146,,0,3,3,0,3,3,0,0,0,26340,22,0.00001,2,0.8,0.875,0,0.333333,0
9610147,9610147,,1,3,4,1,3,4,0,0.000165,0,14887,26,0.000011,1,1,1,4.35,0,0.000226
9610158,9610158,,0,3,3,0,3,3,0,0.000003,0,26341,22,0.00001,2,0.666667,0.75,0,0,0
9610159,9610159,,0,9,9,0,9,9,0,0.002123,0,26342,4,0.00001,12,0.202502,0.238429,0,0.152778,0
9610161,9610161,,0,2,2,0,2,2,0,0,0,26343,6,0.00001,6,0.346939,0.399346,0,0,0
9610164,9610164,,2,4,6,2,4,6,0,0,0,26344,22,0.000013,1,1,1,0,0.366667,0.000445
9309073,9309073,,1,0,1,1,0,1,0,0,0,3708,0,0.00002,0,0,0,0,0,0.000231
9610174,9610174,,0,15,15,0,15,15,0,0.004099,0,26345,0,0.00001,13,0.227147,0.267023,0,0.157143,0
9610181,9610181,,0,13,13,0,13,13,0,0.004492,0,26346,2,0.00001,13,0.199304,0.235413,0,0.102564,0
9610184,9610184,,0,1,1,0,1,1,0,0,112,26348,132,0.00001,1,1,1,0,0,0
9601032,9601032,,1,0,1,1,0,1,0,0,112,26347,132,0.000019,0,0,0,0,0,0.000219
9610185,9610185,,0,2,2,0,2,2,0,0.000006,0,26349,28,0.00001,2,0.666667,0.75,0,0,0
9610186,9610186,,0,9,9,0,9,9,0,0.001446,0,26350,13,0.00001,11,0.20217,0.231525,0,0.097222,0
9610188,9610188,,0,2,2,0,2,2,0,0.000001,0,26351,6,0.00001,1,1,1,0,0,0
9508171,9508171,,2,0,2,2,0,2,0,0,0,9537,28,0.000033,0,0,0,0,0.5,0.000459
9610203,9610203,,0,1,1,0,1,1,0,0,113,26353,133,0.00001,1,1,1,0,0,0
9209026,9209026,,1,0,1,1,0,1,0,0,113,26352,133,0.000019,0,0,0,0,0,0.000219
9610206,9610206,,0,8,8,0,8,8,0,0.000065,0,26354,26,0.00001,8,0.25,0.286927,0,0.125,0
9309158,9309158,,1,0,1,1,0,1,0,0,0,7194,2,0.00002,0,0,0,0,0,0.000227
9610210,9610210,,0,1,1,0,1,1,0,0,0,26355,15,0.00001,1,1,1,0,0,0
9610212,9610212,,0,4,4,0,4,4,0,0.000013,0,26356,9,0.00001,2,0.75,0.833333,0,0.416667,0
9610217,9610217,,0,1,1,0,1,1,0,0,0,26357,6,0.00001,2,0.571429,0.625,0,0,0
9610218,9610218,,0,2,2,0,2,2,0,0.000034,0,26358,28,0.00001,8,0.252434,0.29763,0,0,0
9610228,9610228,,0,1,1,0,1,1,0,0,0,26359,25,0.00001,1,1,1,0,0,0
9610231,9610231,,1,2,3,1,2,3,0,0.000001,0,26360,5,0.000014,9,0.2,0.237801,131,0.166667,0.000219
9610233,9610233,,0,1,1,0,1,1,0,0.001027,0,26361,4,0.00001,6,0.262295,0.292839,0,0,0
9610235,9610235,,0,10,10,0,10,10,0,0.001296,0,26363,0,0.00001,13,0.195026,0.22192,0,0.077778,0
9604122,9604122,,1,0,1,1,0,1,0.000015,0,0,26362,0,0.000011,0,0,0,0,0,0.000219
9611009,9611009,,1,3,4,1,3,4,0.00006,0.00012,0,26364,9,0.000011,12,0.172282,0.189959,249.318453,0.25,0.000219
9611018,9611018,,0,21,21,0,21,21,0,0.000064,0,26366,9,0.00001,13,0.17452,0.203712,0,0.102381,0
9304049,9304049,,1,0,1,1,0,1,0.000001,0,0,26365,9,0.00001,0,0,0,0,0,0.000219
9611021,9611021,,1,1,2,1,1,2,0,0,0,26368,23,0.000013,1,1,1,0,0.5,0.000219
9509144,9509144,,2,0,2,2,0,2,0,0,0,26367,23,0.000024,0,0,0,0,0.5,0.000445
9611028,9611028,,0,7,7,0,7,7,0,0.000021,0,26369,5,0.00001,4,0.432099,0.52619,0,0.333333,0
9611032,9611032,,0,2,2,0,2,2,0,0.000007,0,26370,1,0.00001,1,1,1,0,0.5,0
9611035,9611035,,0,4,4,0,4,4,0,0.000047,0,26371,0,0.00001,6,0.276231,0.328424,0,0.166667,0
9611037,9611037,,0,1,1,0,1,1,0,0,0,26372,23,0.00001,1,1,1,0,0,0
9611044,9611044,,0,12,12,0,12,12,0,0.000065,0,26373,28,0.00001,15,0.169521,0.202745,0,0.242424,0
9611048,9611048,,0,1,1,0,1,1,0,0,0,26374,22,0.00001,5,0.318182,0.371429,0,0,0
9611057,9611057,,0,6,6,0,6,6,0,0.000004,0,26375,41,0.00001,2,0.875,0.928571,0,0.266667,0
9611059,9611059,,0,2,2,0,2,2,0,0,0,26376,26,0.00001,1,1,1,0,0,0
9611069,9611069,,0,5,5,0,5,5,0,0,0,26377,22,0.00001,3,0.666667,0.791667,0,0,0
9611073,9611073,,1,1,2,1,1,2,0,0,0,26378,22,0.000011,11,0.129229,0.142179,227,0,0.000219
9611076,9611076,,0,15,15,0,15,15,0,0.006145,0,26379,13,0.00001,12,0.214544,0.249164,0,0.195238,0
9611080,9611080,,1,3,4,1,3,4,0.000005,0.000011,0,26380,30,0.000011,1,1,1,2.666667,0,0.000226
9611085,9611085,,0,1,1,0,1,1,0,0,0,26381,23,0.00001,7,0.200342,0.221022,0,0,0
9611089,9611089,,0,2,2,0,2,2,0,0.000468,0,26382,5,0.00001,1,1,1,0,0,0
9611091,9611091,,0,3,3,0,3,3,0,0,0,26383,25,0.00001,6,0.322581,0.495,0,0,0
9611093,9611093,,0,16,16,0,16,16,0,0.000802,0,26384,0,0.00001,8,0.242759,0.297306,0,0.116667,0
9611098,9611098,,1,5,6,1,5,6,0,0,0,8975,23,0.000011,9,0.208111,0.237444,1119.819567,0.233333,0.000226
9611109,9611109,,0,2,2,0,2,2,0,0.000006,0,26385,26,0.00001,2,0.625,0.7,0,0.5,0
9611121,9611121,,0,6,6,0,6,6,0,0.000026,0,26386,5,0.00001,7,0.233333,0.256272,0,0.066667,0
9611128,9611128,,0,2,2,0,2,2,0,0.000001,0,26387,20,0.00001,3,0.5,0.633333,0,0,0
9611130,9611130,,3,14,17,3,14,17,0.000051,0.000334,0,6600,0,0.000012,10,0.2026,0.231682,17174.485184,0.209559,0.000762
9611131,9611131,,0,2,2,0,2,2,0,0,0,26388,6,0.00001,4,0.377778,0.441176,0,0.5,0
9611135,9611135,,0,5,5,0,5,5,0,0.001019,0,26389,2,0.00001,10,0.199888,0.228454,0,0.3,0
9512114,9512114,,1,0,1,1,0,1,0,0,0,10093,28,0.000011,0,0,0,0,0,0.000226
9611139,9611139,,0,1,1,0,1,1,0,0.000001,0,26390,52,0.00001,1,1,1,0,0,0
9611141,9611141,,0,3,3,0,3,3,0,0,0,26391,23,0.00001,1,1,1,0,0.166667,0
9611144,9611144,,0,3,3,0,3,3,0,0.000001,0,26392,15,0.00001,6,0.247934,0.314722,0,0.333333,0
9611148,9611148,,2,7,9,2,7,9,0,0.000001,0,26393,9,0.000012,10,0.180451,0.209837,166.900144,0.25,0.000445
9611153,9611153,,0,3,3,0,3,3,0,0.000002,0,26394,22,0.00001,6,0.298077,0.367204,0,0.166667,0
9611154,9611154,,2,3,5,2,3,5,0,0,0,8974,23,0.000015,8,0.169565,0.19711,1119.819567,0.2,0.000445
9611156,9611156,,2,1,3,2,1,3,0,0,0,26395,23,0.000022,2,0.6,0.666667,6,0,0.000438
9611168,9611168,,0,3,3,0,3,3,0,0.000002,0,26396,23,0.00001,3,0.5,0.571429,0,0.333333,0
9611177,9611177,,1,2,3,1,2,3,0,0.000001,0,26397,4,0.000013,15,0.149928,0.16747,0,0.5,0.000219
9611178,9611178,,2,8,10,2,8,10,0.000054,0.000492,0,5542,5,0.000012,6,0.28605,0.318265,36321.583638,0.111111,0.000456
9611191,9611191,,0,12,12,0,12,12,0,0.00018,0,26399,26,0.00001,7,0.288998,0.350054,0,0.045455,0
9504103,9504103,,1,0,1,1,0,1,0.000002,0,0,26398,26,0.000011,0,0,0,0,0,0.000219
9611192,9611192,,0,1,1,0,1,1,0,0.000001,0,26400,4,0.00001,7,0.212625,0.232391,0,0,0
9611206,9611206,,0,1,1,0,1,1,0,0,0,26401,5,0.00001,1,1,1,0,0,0
9611217,9611217,,0,1,1,0,1,1,0,0,0,26402,23,0.00001,1,1,1,0,0,0
9611218,9611218,,0,16,16,0,16,16,0,0.007694,0,26403,0,0.00001,11,0.218729,0.256116,0,0.241667,0
9611220,9611220,,0,4,4,0,4,4,0,0.000009,0,26404,2,0.00001,11,0.17474,0.21139,0,0.25,0
9611221,9611221,,0,5,5,0,5,5,0,0.000009,0,26405,2,0.00001,11,0.174968,0.213452,0,0.2,0
9611226,9611226,,0,1,1,0,1,1,0,0,0,26406,22,0.00001,1,1,1,0,0,0
9611231,9611231,,1,5,6,1,5,6,0,0.000003,0,26407,52,0.000011,2,0.692308,0.777778,0.5,0.3,0.000219
9611234,9611234,,0,2,2,0,2,2,0,0.001027,0,26409,4,0.00001,6,0.263804,0.29832,0,0,0
9610169,9610169,,1,0,1,1,0,1,0.000012,0,0,26408,4,0.000014,0,0,0,0,0,0.000219
9611235,9611235,,0,20,20,0,20,20,0,0.002336,0,26410,26,0.00001,7,0.281659,0.337991,0,0.155263,0
9612001,9612001,,0,1,1,0,1,1,0,0,0,26411,28,0.00001,3,0.470588,0.520833,0,0,0
9612003,9612003,,0,7,7,0,7,7,0,0.000085,0,26412,9,0.00001,16,0.189565,0.219817,0,0.119048,0
9612016,9612016,,0,5,5,0,5,5,0,0.000008,0,26413,6,0.00001,2,0.666667,0.75,0,0,0
9612020,9612020,,0,1,1,0,1,1,0,0,0,26414,23,0.00001,2,0.666667,0.75,0,0,0
9612023,9612023,,0,2,2,0,2,2,0,0.000002,0,26415,13,0.00001,16,0.157509,0.182914,0,0.5,0
9612024,9612024,,0,2,2,0,2,2,0,0,0,26417,23,0.00001,4,0.4375,0.559524,0,0,0
9604033,9604033,,1,0,1,1,0,1,0,0,0,26416,23,0.000014,0,0,0,0,0,0.000219
9612026,9612026,,1,2,3,1,2,3,0,0,0,26418,4,0.000012,6,0.228477,0.264734,0,0.333333,0.000226
9612042,9612042,,3,12,15,3,12,15,0.000243,0.000016,0,3844,23,0.000012,9,0.230552,0.274236,297981.784537,0.114286,0.001011
9612043,9612043,,1,8,9,1,8,9,0,0.000199,0,26419,0,0.000011,11,0.197284,0.221552,643.916279,0.069444,0.000219
9612044,9612044,,0,3,3,0,3,3,0,0,0,26420,26,0.00001,4,0.380952,0.440104,0,0,0
9612047,9612047,,0,3,3,0,3,3,0,0,0,26421,26,0.00001,2,0.8,0.875,0,0.333333,0
9612050,9612050,,0,1,1,0,1,1,0,0.000001,0,26422,26,0.00001,1,1,1,0,0,0
9612056,9612056,,1,11,12,1,11,12,0.000048,0.004832,0,26423,2,0.00001,14,0.211203,0.246795,82.108895,0.272727,0.000219
9612057,9612057,,0,4,4,0,4,4,0,0.002049,0,26424,4,0.00001,6,0.265432,0.307364,0,0.333333,0
9612067,9612067,,1,15,16,1,15,16,0.000023,0.000491,0,6601,0,0.00001,10,0.202242,0.233522,145.554776,0.275,0.000279
9612071,9612071,,0,11,11,0,11,11,0,0.000026,0,26425,9,0.00001,7,0.244681,0.278181,0,0.209091,0
9612072,9612072,,0,1,1,0,1,1,0,0,0,26426,21,0.00001,6,0.26,0.332051,0,0,0
9612075,9612075,,0,5,5,0,5,5,0,0.000826,0,26427,0,0.00001,6,0.234797,0.273861,0,0.1,0
9612079,9612079,,3,5,8,3,5,8,0,0.000001,0,26430,28,0.000023,5,0.259259,0.340873,206,0.107143,0.000671
9507130,9507130,,4,0,4,4,0,4,0,0,0,26429,28,0.000024,0,0,0,0,0.166667,0.000896
9507131,9507131,,4,0,4,4,0,4,0,0,0,26428,28,0.000024,0,0,0,0,0.166667,0.000896
9612092,9612092,,1,5,6,1,5,6,0.000001,0.000003,0,26431,22,0.000011,5,0.375,0.491358,10,0.166667,0.000219
9612094,9612094,,0,3,3,0,3,3,0,0.000011,0,26432,4,0.00001,6,0.229075,0.262019,0,0.333333,0
9612098,9612098,,0,8,8,0,8,8,0,0.000026,0,26433,9,0.00001,13,0.187108,0.210636,0,0.267857,0
9612106,9612106,,0,1,1,0,1,1,0,0,0,26434,23,0.00001,1,1,1,0,0,0
9510046,9510046,,2,0,2,2,0,2,0.000001,0,0,16071,23,0.000022,0,0,0,0,0,0.000445
9612123,9612123,,1,3,4,1,3,4,0.000057,0.00134,0,3731,4,0.000011,7,0.246575,0.282876,84.717323,0.166667,0.000289
9612132,9612132,,0,5,5,0,5,5,0,0.000003,0,26435,22,0.00001,10,0.168959,0.19836,0,0.3,0
9509030,9509030,,1,0,1,1,0,1,0,0,0,18043,15,0.000011,0,0,0,0,0,0.000226
9612147,9612147,,1,2,3,1,2,3,0,0.000021,0,26436,1,0.000013,2,0.75,0.833333,0,0.5,0.000219
9612151,9612151,,0,1,1,0,1,1,0,0.000003,0,26437,41,0.00001,7,0.220441,0.23619,0,0,0
9612152,9612152,,0,15,15,0,15,15,0,0.000182,0,26438,26,0.00001,7,0.291118,0.359376,0,0.038095,0
9612158,9612158,,1,12,13,1,12,13,0,0.000002,0,26439,20,0.000011,8,0.232251,0.287365,249.421874,0.134615,0.000219
9612165,9612165,,3,4,7,3,4,7,0,0,0,26440,20,0.000032,2,0.625,0.7,30,0.142857,0.000677
9612166,9612166,,0,1,1,0,1,1,0,0.000002,0,26441,26,0.00001,7,0.244231,0.275347,0,0,0
9612167,9612167,,0,17,17,0,17,17,0,0.00115,0,26442,26,0.00001,13,0.187241,0.215806,0,0.139706,0
9612169,9612169,,0,6,6,0,6,6,0,0.000005,0,26445,28,0.00001,2,0.75,0.833333,0,0.133333,0
9402087,9402087,,1,0,1,1,0,1,0,0,0,26444,28,0.000011,0,0,0,0,0,0.000219
9407120,9407120,,1,0,1,1,0,1,0,0,0,26443,28,0.000011,0,0,0,0,0,0.000219
9612177,9612177,,0,1,1,0,1,1,0,0,0,26446,26,0.00001,5,0.296296,0.346875,0,0,0
9612179,9612179,,0,8,8,0,8,8,0,0.000338,0,26447,13,0.00001,11,0.209372,0.238597,0,0.232143,0
9612184,9612184,,0,1,1,0,1,1,0,0.000327,0,26448,4,0.00001,6,0.266106,0.292982,0,0,0
9612185,9612185,,0,2,2,0,2,2,0,0,0,26449,15,0.00001,10,0.184006,0.204258,0,0.5,0
9612189,9612189,,0,2,2,0,2,2,0,0,0,26450,22,0.00001,1,1,1,0,0,0
9612190,9612190,,0,14,14,0,14,14,0,0.000012,0,26451,28,0.00001,9,0.222011,0.261242,0,0.115385,0
9407153,9407153,,2,0,2,2,0,2,0.000005,0,0,3882,0,0.000017,0,0,0,0,0.5,0.000502
9612209,9612209,,0,5,5,0,5,5,0,0.000074,0,26452,4,0.00001,8,0.253021,0.302889,0,0.3,0
9608159,9608159,,3,0,3,3,0,3,0,0,0,9151,28,0.000026,0,0,0,0,0.333333,0.000684
9612230,9612230,,0,2,2,0,2,2,0,0,0,26453,10,0.00001,1,1,1,0,0.5,0
9612232,9612232,,0,7,7,0,7,7,0,0.000552,0,26454,13,0.00001,12,0.182218,0.210742,0,0.333333,0
9612235,9612235,,2,7,9,2,7,9,0,0.000004,0,4090,6,0.000012,10,0.215474,0.277105,6078.727381,0.194444,0.000462
9612239,9612239,,1,25,26,1,25,26,0.000021,0.004689,0,26455,0,0.00001,12,0.221934,0.260077,127.427738,0.149231,0.000219
9612243,9612243,,1,3,4,1,3,4,0.000002,0.000124,0,26456,0,0.000011,12,0.191988,0.219544,0,0.5,0.000219
9612244,9612244,,1,6,7,1,6,7,0,0.000002,0,26457,22,0.000012,4,0.433333,0.504274,23.666667,0.166667,0.000219
9612245,9612245,,0,6,6,0,6,6,0,0.000011,0,26458,9,0.00001,12,0.185056,0.213996,0,0.233333,0
9612247,9612247,,0,2,2,0,2,2,0,0.000024,0,26459,22,0.00001,4,0.395833,0.45614,0,0,0
9612253,9612253,,0,4,4,0,4,4,0,0.000009,0,26460,22,0.00001,5,0.375,0.492593,0,0.5,0
9701001,9701001,,0,2,2,0,2,2,0,0,0,26461,6,0.00001,7,0.20059,0.240371,0,0,0
9701002,9701002,,0,5,5,0,5,5,0,0,0,26462,22,0.00001,5,0.35,0.42619,0,0.25,0
9701006,9701006,,0,7,7,0,7,7,0,0.000059,0,26463,26,0.00001,5,0.286275,0.367808,0,0.190476,0
9701016,9701016,,0,4,4,0,4,4,0,0.000004,0,26464,6,0.00001,7,0.280098,0.341917,0,0.166667,0
9701036,9701036,,0,3,3,0,3,3,0,0.000004,0,26465,5,0.00001,5,0.326923,0.398529,0,0.166667,0
9701056,9701056,,0,7,7,0,7,7,0,0.000001,0,26466,22,0.00001,4,0.466667,0.595238,0,0.333333,0
9701059,9701059,,0,3,3,0,3,3,0,0.000013,0,26467,13,0.00001,11,0.173451,0.19394,0,0.166667,0
9701066,9701066,,0,2,2,0,2,2,0,0,0,26468,6,0.00001,1,1,1,0,0.5,0
9701068,9701068,,0,1,1,0,1,1,0,0,0,26469,23,0.00001,2,0.666667,0.75,0,0,0
9701070,9701070,,0,1,1,0,1,1,0,0,0,26470,23,0.00001,3,0.5,0.547619,0,0,0
9701071,9701071,,0,3,3,0,3,3,0,0,0,26471,6,0.00001,6,0.306667,0.366667,0,0.333333,0
9701074,9701074,,1,5,6,1,5,6,0,0.00001,0,26472,26,0.000011,1,1,1,0.75,0.333333,0.000219
9607192,9607192,,2,0,2,2,0,2,0,0,0,10085,26,0.000061,0,0,0,0,0,0.000492
9701090,9701090,,0,2,2,0,2,2,0,0,114,26475,134,0.00001,1,1,1,0,0,0
9405191,9405191,,1,0,1,1,0,1,0,0,114,26474,134,0.000014,0,0,0,0,0,0.000219
9701044,9701044,,1,0,1,1,0,1,0,0,114,26473,134,0.000014,0,0,0,0,0,0.000219
9701094,9701094,,2,23,25,2,23,25,0.000155,0.005064,0,10902,0,0.00001,12,0.214337,0.255802,5161.108798,0.213333,0.000471
9701098,9701098,,0,2,2,0,2,2,0,0,0,26476,28,0.00001,1,1,1,0,0,0
9701108,9701108,,1,4,5,1,4,5,0,0,0,26477,22,0.000011,4,0.478261,0.621212,11,0.15,0.000219
9412148,9412148,,1,0,1,1,0,1,0,0,0,11051,28,0.000025,0,0,0,0,0,0.000232
9510019,9510019,,2,0,2,2,0,2,0,0,0,7416,10,0.000032,0,0,0,0,0.5,0.000452
9701114,9701114,,0,4,4,0,4,4,0,0,0,26478,22,0.00001,4,0.521739,0.631944,0,0,0
9701121,9701121,,0,27,27,0,27,27,0,0.003568,0,26480,13,0.00001,12,0.22567,0.265269,0,0.052707,0
9206022,9206022,,1,0,1,1,0,1,0.000042,0,0,26479,13,0.00001,0,0,0,0,0,0.000219
9701126,9701126,,0,5,5,0,5,5,0,0.001902,0,26481,0,0.00001,11,0.193912,0.218092,0,0.15,0
9701132,9701132,,1,10,11,1,10,11,0,0.000003,0,12434,22,0.000013,9,0.197948,0.235309,12640.539008,0.209091,0.000227
9701133,9701133,,0,3,3,0,3,3,0,0.001028,0,26482,6,0.00001,6,0.268924,0.308519,0,0.166667,0
9701145,9701145,,0,3,3,0,3,3,0,0.000004,0,26483,26,0.00001,12,0.164876,0.187332,0,0.333333,0
9701153,9701153,,0,14,14,0,14,14,0,0.003567,0,26484,13,0.00001,12,0.197095,0.232703,0,0.17033,0
9701161,9701161,,0,12,12,0,12,12,0,0.00003,0,26485,5,0.00001,8,0.2229,0.2522,0,0.159091,0
9701174,9701174,,0,8,8,0,8,8,0,0.000035,0,26486,1,0.00001,12,0.16773,0.189274,0,0.125,0
9701176,9701176,,0,3,3,0,3,3,0,0,0,26487,5,0.00001,4,0.319588,0.384409,0,0.5,0
9701181,9701181,,0,2,2,0,2,2,0,0.000001,0,26488,26,0.00001,1,1,1,0,0,0
9607189,9607189,,5,0,5,5,0,5,0.000116,0,0,8492,26,0.000023,0,0,0,0,0,0.001118
9701183,9701183,,0,5,5,0,5,5,0,0,0,26489,23,0.00001,3,0.56,0.654762,0,0.25,0
9701189,9701189,,0,1,1,0,1,1,0,0,0,26490,22,0.00001,1,1,1,0,0,0
9701192,9701192,,0,1,1,0,1,1,0,0.000003,0,26491,15,0.00001,1,1,1,0,0,0
9701193,9701193,,0,1,1,0,1,1,0,0,115,26493,135,0.00001,1,1,1,0,0,0
9503219,9503219,,1,0,1,1,0,1,0,0,115,26492,135,0.000019,0,0,0,0,0,0.000219
9702001,9702001,,0,2,2,0,2,2,0,0,0,26494,22,0.00001,4,0.305085,0.37037,0,0.5,0
9702004,9702004,,0,1,1,0,1,1,0,0.000001,0,26495,22,0.00001,4,0.375,0.472222,0,0,0
9702011,9702011,,0,2,2,0,2,2,0,0.000004,0,26496,0,0.00001,8,0.188679,0.216498,0,0.5,0
9702013,9702013,,0,3,3,0,3,3,0,0.000003,0,26497,15,0.00001,2,0.714286,0.8,0,0,0
9702016,9702016,,1,1,2,1,1,2,0,0,0,26498,6,0.000014,1,1,1,1,0,0.000219
9702020,9702020,,0,4,4,0,4,4,0,0.000011,0,26499,22,0.00001,17,0.135797,0.153603,0,0.166667,0
9702022,9702022,,1,1,2,1,1,2,0,0.000002,0,26500,26,0.000014,2,0.666667,0.75,2,0,0.000219
9702028,9702028,,1,4,5,1,4,5,0,0,0,6756,6,0.000012,2,0.833333,0.9,17804.47067,0.1,0.000234
9702032,9702032,,0,3,3,0,3,3,0,0,0,26501,28,0.00001,2,0.714286,0.8,0,0.333333,0
9702040,9702040,,0,3,3,0,3,3,0,0.000004,0,26502,23,0.00001,3,0.6,0.722222,0,0,0
9702051,9702051,,0,13,13,0,13,13,0,0.000059,0,26503,9,0.00001,6,0.278383,0.342737,0,0.230769,0
9702063,9702063,,0,3,3,0,3,3,0,0.000198,0,26504,4,0.00001,10,0.176846,0.213647,0,0,0
9702070,9702070,,0,3,3,0,3,3,0,0.000005,0,26505,10,0.00001,13,0.155143,0.178154,0,0,0
9702071,9702071,,0,1,1,0,1,1,0,0,116,26507,136,0.00001,1,1,1,0,0,0
9410131,9410131,,1,0,1,1,0,1,0,0,116,26506,136,0.000019,0,0,0,0,0,0.000219
9702074,9702074,,1,12,13,1,12,13,0,0.000086,0,26508,9,0.00001,13,0.182595,0.211682,80.629362,0.230769,0.000219
9702078,9702078,,0,7,7,0,7,7,0,0.000069,0,26509,13,0.00001,9,0.236688,0.274309,0,0.238095,0
9702080,9702080,,0,5,5,0,5,5,0,0.000002,0,26510,15,0.00001,2,0.777778,0.857143,0,0.15,0
9506209,9506209,,1,0,1,1,0,1,0,0,0,16365,26,0.000013,0,0,0,0,0,0.000226
9702090,9702090,,0,6,6,0,6,6,0,0.000001,0,26511,9,0.00001,7,0.243451,0.298373,0,0.066667,0
9702091,9702091,,0,4,4,0,4,4,0,0.000063,0,26512,26,0.00001,4,0.444444,0.546875,0,0.083333,0
9702112,9702112,,0,6,6,0,6,6,0,0.000002,0,26513,4,0.00001,10,0.186869,0.225651,0,0.066667,0
9702116,9702116,,0,2,2,0,2,2,0,0.000233,0,26514,0,0.00001,13,0.184635,0.204276,0,0.5,0
9702124,9702124,,0,1,1,0,1,1,0,0,0,26515,22,0.00001,2,0.6,0.666667,0,0,0
9612206,9612206,,4,0,4,4,0,4,0,0,0,12049,23,0.000064,0,0,0,0,0.166667,0.000923
9702127,9702127,,1,16,17,1,16,17,0,0.000003,0,17358,15,0.00001,2,0.863636,0.921053,495.96596,0.161765,0.000226
9702128,9702128,,0,2,2,0,2,2,0,0.000004,0,26516,28,0.00001,1,1,1,0,0,0
9702129,9702129,,0,2,2,0,2,2,0,0,0,26517,26,0.00001,5,0.376471,0.429167,0,0,0
9702131,9702131,,0,1,1,0,1,1,0,0,0,26518,15,0.00001,1,1,1,0,0,0
9702132,9702132,,0,10,10,0,10,10,0,0.000537,0,26519,13,0.00001,11,0.207436,0.243226,0,0.2,0
9702137,9702137,,2,1,3,2,1,3,0,0,74,26520,95,0.000023,1,1,1,1,0.166667,0.000438
9702140,9702140,,0,2,2,0,2,2,0,0,0,26521,26,0.00001,5,0.309091,0.384314,0,0,0
9702142,9702142,,3,14,17,3,14,17,0.000114,0.003785,0,6574,13,0.000012,13,0.201249,0.235449,714.494823,0.1875,0.000687
9702146,9702146,,0,1,1,0,1,1,0,0.000001,0,26522,20,0.00001,2,0.666667,0.75,0,0,0
9702149,9702149,,0,5,5,0,5,5,0,0.000003,0,26523,20,0.00001,2,0.692308,0.777778,0,0.3,0
9702150,9702150,,1,2,3,1,2,3,0,0.000001,0,26524,5,0.000012,5,0.25,0.302083,0,0.5,0.000219
9702158,9702158,,0,7,7,0,7,7,0,0.000082,0,26525,3,0.00001,8,0.225,0.270976,0,0.190476,0
9702159,9702159,,1,24,25,1,24,25,0.000014,0.00499,0,26526,13,0.000011,14,0.194411,0.235182,131.33323,0.111667,0.000219
9702181,9702181,,1,4,5,1,4,5,0,0,0,26527,4,0.000011,6,0.233553,0.285446,1,0.25,0.000219
9702183,9702183,,0,6,6,0,6,6,0,0.000011,0,26529,9,0.00001,4,0.466667,0.587302,0,0.033333,0
9402058,9402058,,1,0,1,1,0,1,0,0,0,26528,9,0.000011,0,0,0,0,0,0.000219
9702185,9702185,,0,3,3,0,3,3,0,0.000022,0,26530,41,0.00001,7,0.223975,0.267673,0,0.333333,0
9702193,9702193,,0,7,7,0,7,7,0,0.000498,0,26531,23,0.00001,7,0.275168,0.331672,0,0.095238,0
9703004,9703004,,0,10,10,0,10,10,0,0.000698,0,26532,13,0.00001,13,0.182698,0.217909,0,0.244444,0
9703011,9703011,,0,1,1,0,1,1,0,0,0,26533,26,0.00001,1,1,1,0,0,0
9703015,9703015,,1,2,3,1,2,3,0,0,0,26534,5,0.000014,9,0.224885,0.26229,731,0.166667,0.000219
9703021,9703021,,0,6,6,0,6,6,0,0.000051,0,26535,10,0.00001,10,0.181365,0.206053,0,0.233333,0
9703032,9703032,,0,1,1,0,1,1,0,0.000001,0,26536,0,0.00001,1,1,1,0,0,0
9703033,9703033,,0,2,2,0,2,2,0,0.000035,0,26537,13,0.00001,12,0.177247,0.203542,0,0.5,0
9703034,9703034,,0,1,1,0,1,1,0,0,0,26538,28,0.00001,3,0.5,0.583333,0,0,0
9703043,9703043,,1,12,13,1,12,13,0,0.00005,0,26539,30,0.000012,11,0.163798,0.181416,1722.961707,0.115385,0.000226
9703047,9703047,,0,14,14,0,14,14,0,0.006357,0,26540,2,0.00001,12,0.22074,0.255129,0,0.203297,0
9703054,9703054,,0,19,19,0,19,19,0,0.00017,0,26541,23,0.00001,10,0.198171,0.264863,0,0.172515,0
9703058,9703058,,0,2,2,0,2,2,0,0.000004,0,26542,4,0.00001,12,0.171856,0.192743,0,0.5,0
9703061,9703061,,0,2,2,0,2,2,0,0,108,26543,137,0.00001,1,1,1,0,0.5,0
9703064,9703064,,0,4,4,0,4,4,0,0.000552,0,26544,0,0.00001,7,0.270011,0.312761,0,0.25,0
9703065,9703065,,2,12,14,2,12,14,0,0.000021,0,26545,6,0.000012,6,0.326667,0.412925,32.333333,0.115385,0.000438
9703088,9703088,,0,4,4,0,4,4,0,0.00002,0,26546,5,0.00001,11,0.175437,0.195323,0,0.25,0
9703091,9703091,,0,8,8,0,8,8,0,0.000013,0,26547,52,0.00001,5,0.394366,0.533929,0,0.178571,0
9703095,9703095,,0,15,15,0,15,15,0,0.000063,0,26548,4,0.00001,6,0.292208,0.366296,0,0.128571,0
9703108,9703108,,0,15,15,0,15,15,0,0.000154,0,26549,26,0.00001,12,0.162692,0.185284,0,0.242857,0
9703113,9703113,,0,1,1,0,1,1,0,0.000291,0,26550,0,0.00001,9,0.192087,0.21174,0,0,0
9703116,9703116,,0,4,4,0,4,4,0,0.000005,0,26551,28,0.00001,6,0.233846,0.277851,0,0.333333,0
9703117,9703117,,0,4,4,0,4,4,0,0,0,26552,22,0.00001,3,0.482759,0.583333,0,0,0
9703119,9703119,,0,10,10,0,10,10,0,0.000078,0,26553,4,0.00001,10,0.172279,0.235052,0,0.111111,0
9703120,9703120,,0,3,3,0,3,3,0,0.000002,0,26554,26,0.00001,5,0.34,0.443137,0,0.166667,0
9703138,9703138,,2,23,25,2,23,25,0.000167,0.006797,0,7983,2,0.000012,13,0.19908,0.241351,1806.062598,0.191667,0.000534
9703140,9703140,,0,5,5,0,5,5,0,0,0,26555,6,0.00001,2,0.692308,0.777778,0,0.1,0
9703151,9703151,,0,8,8,0,8,8,0,0.000006,0,26556,15,0.00001,4,0.490566,0.599359,0,0.089286,0
9703153,9703153,,0,9,9,0,9,9,0,0.000012,0,26557,26,0.00001,11,0.192588,0.230339,0,0.152778,0
9703155,9703155,,1,3,4,1,3,4,0,0.002037,0,26558,13,0.000019,10,0.197654,0.223725,2039,0,0.000219
9703161,9703161,,0,2,2,0,2,2,0,0.000025,0,26559,4,0.00001,5,0.290598,0.344118,0,0.5,0
9703169,9703169,,0,3,3,0,3,3,0,0,87,26560,109,0.00001,1,1,1,0,0.5,0
9703170,9703170,,0,15,15,0,15,15,0,0,0,26561,9,0.00001,6,0.322086,0.424127,0,0.1,0
9703199,9703199,,0,12,12,0,12,12,0,0.000003,0,26562,23,0.00001,10,0.184807,0.245214,0,0.310606,0
9703203,9703203,,0,1,1,0,1,1,0,0,0,26563,9,0.00001,13,0.17235,0.192569,0,0,0
9703207,9703207,,0,4,4,0,4,4,0,0.000004,0,26564,6,0.00001,13,0.168271,0.198284,0,0.083333,0
9703212,9703212,,0,1,1,0,1,1,0,0,0,26565,6,0.00001,9,0.17321,0.202291,0,0,0
9703220,9703220,,0,3,3,0,3,3,0,0,0,26566,23,0.00001,2,0.8,0.875,0,0.166667,0
9703225,9703225,,0,5,5,0,5,5,0,0,0,26567,15,0.00001,3,0.5,0.592593,0,0.35,0
9703227,9703227,,1,7,8,1,7,8,0.000005,0.002056,0,8087,4,0.000011,10,0.183492,0.22847,12.100851,0.196429,0.000249
9704001,9704001,,0,3,3,0,3,3,0,0,0,26570,30,0.00001,1,1,1,0,0,0
9603119,9603119,,1,0,1,1,0,1,0,0,0,26569,30,0.000013,0,0,0,0,0,0.000219
9604081,9604081,,1,0,1,1,0,1,0,0,0,26568,30,0.000013,0,0,0,0,0,0.000219
9704004,9704004,,0,4,4,0,4,4,0,0.000468,0,26571,4,0.00001,13,0.17595,0.196516,0,0.166667,0
9704007,9704007,,0,15,15,0,15,15,0,0.0041,0,26572,2,0.00001,14,0.181491,0.220844,0,0.238095,0
9704015,9704015,,0,10,10,0,10,10,0,0.000001,0,26573,6,0.00001,10,0.187678,0.218966,0,0.122222,0
9704020,9704020,,0,5,5,0,5,5,0,0.000007,0,26574,26,0.00001,9,0.192939,0.219289,0,0.3,0
9704024,9704024,,0,12,12,0,12,12,0,0.000006,0,26575,6,0.00001,11,0.173564,0.219725,0,0.181818,0
9704031,9704031,,0,17,17,0,17,17,0,0.002231,0,26576,15,0.00001,13,0.207951,0.239677,0,0.055147,0
9704033,9704033,,2,1,3,2,1,3,0,0.000025,0,26577,2,0.000021,11,0.167957,0.182076,781,0.333333,0.000445
9704038,9704038,,0,2,2,0,2,2,0,0,0,26578,20,0.00001,3,0.461538,0.583333,0,0.5,0
9704048,9704048,,0,1,1,0,1,1,0,0,0,26579,18,0.00001,1,1,1,0,0,0
9704060,9704060,,0,1,1,0,1,1,0,0,0,26580,22,0.00001,4,0.393443,0.427083,0,0,0
9704062,9704062,,1,1,2,1,1,2,0.000012,0.001027,0,26581,4,0.000014,6,0.262295,0.292839,0,0.5,0.000219
9704066,9704066,,0,9,9,0,9,9,0,0.002615,0,26582,4,0.00001,6,0.294256,0.343137,0,0.25,0
9704077,9704077,,0,13,13,0,13,13,0,0.005096,0,26583,2,0.00001,12,0.207617,0.238963,0,0.134615,0
9704091,9704091,,0,7,7,0,7,7,0,0.000003,0,26584,28,0.00001,5,0.371429,0.512179,0,0.166667,0
9704099,9704099,,0,1,1,0,1,1,0,0,0,26586,21,0.00001,1,1,1,0,0,0
9410236,9410236,,4,0,4,4,0,4,0,0,0,26585,21,0.000022,0,0,0,0,0,0.000877
9704100,9704100,,1,5,6,1,5,6,0,0,0,26587,22,0.000011,1,1,1,0,0.366667,0.000219
9704105,9704105,,2,1,3,2,1,3,0,0,0,26588,20,0.000017,3,0.407407,0.454545,0,0.5,0.000445
9704107,9704107,,0,5,5,0,5,5,0,0.000001,0,26589,6,0.00001,10,0.17093,0.206054,0,0.25,0
9704121,9704121,,0,2,2,0,2,2,0,0,0,26590,15,0.00001,1,1,1,0,0.5,0
9704122,9704122,,0,1,1,0,1,1,0,0,0,26591,23,0.00001,4,0.375,0.458333,0,0,0
9704126,9704126,,0,13,13,0,13,13,0,0.000002,0,26592,9,0.00001,6,0.256342,0.321354,0,0.25,0
9704130,9704130,,1,10,11,1,10,11,0,0.000003,0,26593,9,0.000011,14,0.163365,0.197099,1314.104257,0.163636,0.000219
9704138,9704138,,1,1,2,1,1,2,0,0,0,26594,52,0.000014,1,1,1,1,0,0.000219
9704141,9704141,,2,7,9,2,7,9,0.000001,0.000016,0,26595,3,0.000012,11,0.174647,0.228833,104.291667,0.388889,0.000458
9704152,9704152,,1,5,6,1,5,6,0,0,0,13225,6,0.000014,5,0.385965,0.508333,133.881818,0.1,0.000226
9704180,9704180,,1,2,3,1,2,3,0,0.000025,0,26596,2,0.000014,11,0.168046,0.182599,781,0.333333,0.000219
9704181,9704181,,1,2,3,1,2,3,0,0.000001,0,26597,22,0.000014,2,0.75,0.833333,2,0.166667,0.000219
9704182,9704182,,1,7,8,1,7,8,0,0.000003,0,26598,22,0.00001,7,0.297468,0.420618,2.542857,0.214286,0.000219
9704183,9704183,,0,6,6,0,6,6,0,0.000002,0,26600,9,0.00001,5,0.305085,0.402778,0,0.066667,0
9412134,9412134,,1,0,1,1,0,1,0,0,0,26599,9,0.000011,0,0,0,0,0,0.000219
9704187,9704187,,0,6,6,0,6,6,0,0.004559,0,26602,4,0.00001,11,0.184671,0.207499,0,0.066667,0
9511215,9511215,,1,0,1,1,0,1,0.000054,0,0,26601,4,0.000011,0,0,0,0,0,0.000219
9704196,9704196,,1,9,10,1,9,10,0,0.00195,0,26603,4,0.000013,12,0.179506,0.205418,1785.544739,0.166667,0.000219
9704200,9704200,,0,1,1,0,1,1,0,0,0,26604,30,0.00001,1,1,1,0,0,0
9704211,9704211,,2,7,9,2,7,9,0.000025,0.000041,0,8033,26,0.000012,6,0.273616,0.365079,62.20496,0.236111,0.000451
9704215,9704215,,9,9,18,9,9,18,0.000001,0.000025,0,6261,26,0.000026,7,0.244382,0.359113,2590.459001,0.133987,0.002126
9609100,9609100,,1,0,1,1,0,1,0,0,0,24681,4,0.000013,0,0,0,0,0,0.000226
9705012,9705012,,0,14,14,0,14,14,0,0.001799,0,26605,0,0.00001,12,0.216672,0.250193,0,0.296703,0
9601015,9601015,,1,0,1,1,0,1,0,0,0,9044,52,0.000015,0,0,0,0,0,0.000233
9705026,9705026,,0,5,5,0,5,5,0,0.000053,0,26606,26,0.00001,6,0.24812,0.328535,0,0.2,0
9705039,9705039,,0,2,2,0,2,2,0,0,0,26607,6,0.00001,5,0.304348,0.346259,0,0,0
9705045,9705045,,2,11,13,2,11,13,0.000064,0.002144,0,8034,26,0.000012,15,0.166461,0.19048,18245.837033,0.115385,0.000445
9705051,9705051,,0,2,2,0,2,2,0,0.000045,0,26608,0,0.00001,11,0.16816,0.188323,0,0,0
9705066,9705066,,0,7,7,0,7,7,0,0.001652,0,26609,2,0.00001,15,0.181304,0.204953,0,0.238095,0
9705067,9705067,,0,15,15,0,15,15,0,0.003789,0,26610,13,0.00001,13,0.200492,0.230183,0,0.147619,0
9705071,9705071,,0,27,27,0,27,27,0,0.003694,0,26611,4,0.00001,12,0.19542,0.229103,0,0.139601,0
9705072,9705072,,3,3,6,3,3,6,0,0,0,6268,26,0.000014,7,0.232673,0.296378,0,0.366667,0.000696
9705082,9705082,,0,2,2,0,2,2,0,0.000004,0,26612,22,0.00001,2,0.583333,0.642857,0,0.5,0
9705083,9705083,,0,1,1,0,1,1,0,0.000001,0,26613,41,0.00001,1,1,1,0,0,0
9705086,9705086,,0,2,2,0,2,2,0,0,0,26614,22,0.00001,3,0.571429,0.708333,0,0.5,0
9705109,9705109,,0,6,6,0,6,6,0,0.00107,0,26615,2,0.00001,12,0.18034,0.209173,0,0.1,0
9705114,9705114,,0,15,15,0,15,15,0,0.001965,0,26616,4,0.00001,15,0.171393,0.201326,0,0.119048,0
9705115,9705115,,0,6,6,0,6,6,0,0.001687,0,26617,5,0.00001,10,0.210125,0.236954,0,0.166667,0
9705119,9705119,,0,6,6,0,6,6,0,0.000008,0,26619,26,0.00001,11,0.177222,0.196762,0,0.133333,0
9607023,9607023,,2,0,2,2,0,2,0,0,0,26618,26,0.000016,0,0,0,0,0,0.000438
9705121,9705121,,0,3,3,0,3,3,0,0.000001,0,26620,4,0.00001,15,0.150022,0.168082,0,0.5,0
9705125,9705125,,0,1,1,0,1,1,0,0.000003,0,26621,22,0.00001,2,0.571429,0.625,0,0,0
9705133,9705133,,1,1,2,1,1,2,0,0,0,4974,26,0.000021,1,1,1,6997.095832,0,0.000233
9705134,9705134,,0,4,4,0,4,4,0,0.000006,0,26622,8,0.00001,7,0.232604,0.252935,0,0.166667,0
9705135,9705135,,1,2,3,1,2,3,0,0.000004,0,26623,5,0.000016,2,0.75,0.833333,8,0,0.000232
9705140,9705140,,1,3,4,1,3,4,0,0.000001,0,10936,6,0.000018,3,0.6,0.722222,2474.639985,0.083333,0.000234
9705143,9705143,,0,22,22,0,22,22,0,0.005169,0,26624,0,0.00001,14,0.203595,0.23908,0,0.251082,0
9705164,9705164,,1,16,17,1,16,17,0.000023,0.000579,0,16470,4,0.00001,12,0.162822,0.187534,89.800039,0.242647,0.000232
9705168,9705168,,2,2,4,2,2,4,0,0,0,26625,28,0.000015,6,0.213592,0.269318,86,0.25,0.000445
9705170,9705170,,1,13,14,1,13,14,0.000038,0.001412,0,8250,13,0.00001,12,0.203031,0.23594,16326.506417,0.093407,0.000241
9705171,9705171,,2,1,3,2,1,3,0,0,0,26626,22,0.000019,2,0.666667,0.75,1,0.333333,0.000445
9705177,9705177,,0,1,1,0,1,1,0,0.000002,0,26627,26,0.00001,3,0.444444,0.541667,0,0,0
9705178,9705178,,1,2,3,1,2,3,0,0,110,26628,138,0.000014,1,1,1,0.5,0.333333,0.000219
9705191,9705191,,1,1,2,1,1,2,0,0,0,26629,23,0.000011,1,1,1,1,0,0.000219
9705195,9705195,,1,4,5,1,4,5,0,0.000013,0,26630,30,0.000013,12,0.138128,0.153073,1.5,0.25,0.000219
9705196,9705196,,1,3,4,1,3,4,0,0,0,26631,22,0.000012,7,0.275229,0.363651,20,0.416667,0.000219
9705203,9705203,,0,11,11,0,11,11,0,0.000008,0,26632,23,0.00001,12,0.179669,0.247566,0,0.063636,0
9705204,9705204,,0,4,4,0,4,4,0,0.000023,0,26633,30,0.00001,11,0.164138,0.179428,0,0.25,0
9705207,9705207,,1,2,3,1,2,3,0.000001,0.000025,0,26634,5,0.000011,12,0.166998,0.185338,0,0.5,0.000219
9705217,9705217,,0,7,7,0,7,7,0,0.000001,0,26635,22,0.00001,7,0.318182,0.45932,0,0.309524,0
9705227,9705227,,0,4,4,0,4,4,0,0.000003,0,26636,15,0.00001,5,0.302857,0.389937,0,0.166667,0
9705228,9705228,,1,7,8,1,7,8,0,0.000001,0,26637,23,0.000011,3,0.75,0.87037,2.916667,0.232143,0.000219
9705238,9705238,,0,26,26,0,26,26,0,0.004508,0,26638,0,0.00001,12,0.213309,0.251128,0,0.118462,0
9706003,9706003,,0,1,1,0,1,1,0,0,117,26640,139,0.00001,1,1,1,0,0,0
9609081,9609081,,1,0,1,1,0,1,0,0,117,26639,139,0.000019,0,0,0,0,0,0.000219
9706008,9706008,,0,1,1,0,1,1,0,0.000468,0,26641,1,0.00001,1,1,1,0,0,0
9706011,9706011,,0,4,4,0,4,4,0,0.001543,0,26642,26,0.00001,11,0.179928,0.198502,0,0,0
9706034,9706034,,0,2,2,0,2,2,0,0,0,26643,22,0.00001,3,0.444444,0.541667,0,0,0
9706028,9706028,,1,0,1,1,0,1,0.000014,0,0,7669,0,0.000012,0,0,0,0,0,0.000234
9706037,9706037,,0,2,2,0,2,2,0,0,0,26644,17,0.00001,4,0.368421,0.452381,0,0,0
9706052,9706052,,1,1,2,1,1,2,0,0,0,26645,26,0.000012,3,0.428571,0.5,6,0,0.000219
9706055,9706055,,0,5,5,0,5,5,0,0.000009,0,26646,26,0.00001,7,0.236318,0.312556,0,0.4,0
9706058,9706058,,1,3,4,1,3,4,0,0.000004,0,26647,0,0.000013,4,0.357143,0.43,12,0.25,0.000219
9706063,9706063,,0,11,11,0,11,11,0,0.000006,0,26648,26,0.00001,14,0.140805,0.165092,0,0.154545,0
9706067,9706067,,0,5,5,0,5,5,0,0.000006,0,26649,22,0.00001,5,0.363636,0.4625,0,0.2,0
9706080,9706080,,2,5,7,2,5,7,0.000001,0,0,26650,5,0.000012,9,0.185115,0.205643,162.276021,0.071429,0.000438
9706106,9706106,,0,1,1,0,1,1,0,0,0,26651,23,0.00001,1,1,1,0,0,0
9706111,9706111,,0,9,9,0,9,9,0,0.003401,0,26652,2,0.00001,11,0.221791,0.253427,0,0.236111,0
9706113,9706113,,1,2,3,1,2,3,0,0.000008,0,26653,6,0.000012,6,0.253333,0.348246,0,0.5,0.000219
9706116,9706116,,0,5,5,0,5,5,0,0.000045,0,26654,52,0.00001,8,0.193878,0.239834,0,0.2,0
9706118,9706118,,0,4,4,0,4,4,0,0.00001,0,26655,9,0.00001,7,0.361644,0.408784,0,0.166667,0
9706122,9706122,,0,5,5,0,5,5,0,0.000072,0,26656,0,0.00001,12,0.197656,0.221053,0,0.1,0
9706128,9706128,,2,7,9,2,7,9,0.000004,0.000062,0,26657,3,0.000012,11,0.174863,0.229105,138.742208,0.375,0.000445
9706134,9706134,,0,8,8,0,8,8,0,0.002672,0,26658,26,0.00001,6,0.306233,0.351844,0,0.071429,0
9706135,9706135,,0,4,4,0,4,4,0,0,0,26659,26,0.00001,2,0.666667,0.75,0,0,0
9706136,9706136,,0,5,5,0,5,5,0,0.000018,0,26660,23,0.00001,8,0.215054,0.247486,0,0.15,0
9706137,9706137,,0,2,2,0,2,2,0,0,0,26661,23,0.00001,1,1,1,0,0,0
9706138,9706138,,0,3,3,0,3,3,0,0.000147,0,26662,41,0.00001,1,1,1,0,0,0
9706146,9706146,,1,8,9,1,8,9,0.000063,0.002432,0,26663,2,0.00001,15,0.170488,0.19492,64.056102,0.097222,0.000219
9706149,9706149,,1,1,2,1,1,2,0,0.000009,0,9849,26,0.000011,2,0.571429,0.625,0,0.5,0.000232
9706160,9706160,,0,2,2,0,2,2,0,0.000008,0,26664,23,0.00001,14,0.146306,0.164727,0,0.5,0
9706161,9706161,,0,8,8,0,8,8,0,0.000193,0,26665,6,0.00001,15,0.192099,0.233143,0,0.089286,0
9706162,9706162,,1,1,2,1,1,2,0,0,0,26666,20,0.000014,3,0.470588,0.520833,10,0,0.000226
9706164,9706164,,0,5,5,0,5,5,0,0,0,26667,22,0.00001,6,0.24898,0.294672,0,0.1,0
9706178,9706178,,1,4,5,1,4,5,0,0.000041,0,26669,15,0.000019,1,1,1,4,0,0.000219
9411174,9411174,,1,0,1,1,0,1,0,0,0,26668,15,0.000014,0,0,0,0,0,0.000226
9706183,9706183,,0,23,23,0,23,23,0,0.00037,0,26670,26,0.00001,12,0.176834,0.219904,0,0.142292,0
9706191,9706191,,0,13,13,0,13,13,0,0.00006,0,26671,5,0.00001,12,0.175329,0.20346,0,0.211538,0
9710108,9710108,,0,1,1,0,1,1,0,0,0,26672,22,0.00001,1,1,1,0,0,0
9706202,9706202,,0,3,3,0,3,3,0,0,0,26675,23,0.00001,2,0.8,0.875,0,0,0
9704085,9704085,,1,0,1,1,0,1,0,0,0,26674,23,0.000013,0,0,0,0,0,0.000219
9704140,9704140,,1,0,1,1,0,1,0,0,0,26673,23,0.000013,0,0,0,0,0,0.000219
9706209,9706209,,0,1,1,0,1,1,0,0,118,26677,140,0.00001,1,1,1,0,0,0
9705235,9705235,,1,0,1,1,0,1,0,0,118,26676,140,0.000019,0,0,0,0,0,0.000219
9706222,9706222,,1,6,7,1,6,7,0,0.001238,0,26678,4,0.000013,13,0.178786,0.203381,2911.992521,0.119048,0.000219
9706224,9706224,,0,9,9,0,9,9,0,0.000568,0,26679,13,0.00001,10,0.224458,0.266919,0,0.138889,0
9707006,9707006,,0,4,4,0,4,4,0,0.000008,0,26680,13,0.00001,1,1,1,0,0.5,0
9707010,9707010,,0,2,2,0,2,2,0,0,0,26681,6,0.00001,11,0.164191,0.208544,0,0.5,0
9707022,9707022,,1,50,51,1,50,51,0.00006,0.006813,0,26682,4,0.00001,11,0.221879,0.264781,445.058419,0.167059,0.000219
9707026,9707026,,0,3,3,0,3,3,0,0,0,26683,22,0.00001,2,0.8,0.875,0,0.5,0
9707032,9707032,,0,8,8,0,8,8,0,0.000061,0,26684,2,0.00001,11,0.189897,0.260099,0,0.267857,0
9707036,9707036,,0,9,9,0,9,9,0,0.000805,0,26685,4,0.00001,18,0.127622,0.16833,0,0.194444,0
9707037,9707037,,0,7,7,0,7,7,0,0.000072,0,26687,23,0.00001,13,0.153004,0.17069,0,0.071429,0
9206062,9206062,,1,0,1,1,0,1,0.000001,0,0,26686,23,0.000011,0,0,0,0,0,0.000219
9707038,9707038,,0,3,3,0,3,3,0,0,0,26688,23,0.00001,1,1,1,0,0,0
9707050,9707050,,0,6,6,0,6,6,0,0.000003,0,26689,6,0.00001,8,0.240929,0.280099,0,0.1,0
9707065,9707065,,0,7,7,0,7,7,0,0.000002,0,26690,9,0.00001,10,0.178552,0.205507,0,0.190476,0
9707076,9707076,,3,39,42,3,39,42,0.000054,0.001537,0,5530,4,0.000011,13,0.169722,0.197129,952.383033,0.263647,0.00073
9707078,9707078,,0,13,13,0,13,13,0,0.000037,0,26691,28,0.00001,8,0.263617,0.33996,0,0.025641,0
9707089,9707089,,0,29,29,0,29,29,0,0.009874,0,26692,0,0.00001,14,0.198334,0.238006,0,0.147783,0
9707103,9707103,,0,2,2,0,2,2,0,0,0,26693,22,0.00001,1,1,1,0,0,0
9707104,9707104,,0,3,3,0,3,3,0,0,0,26694,26,0.00001,1,1,1,0,0.333333,0
9707107,9707107,,2,1,3,2,1,3,0.000003,0.000023,0,26695,28,0.000015,11,0.190519,0.213578,334.946255,0,0.000438
9707114,9707114,,0,2,2,0,2,2,0,0.000039,0,26696,4,0.00001,7,0.219089,0.247808,0,0.5,0
9707116,9707116,,0,2,2,0,2,2,0,0.000001,0,26697,23,0.00001,7,0.219758,0.237516,0,0.5,0
9707127,9707127,,1,3,4,1,3,4,0,0,0,26698,9,0.000011,3,0.473684,0.592593,0,0.333333,0.000226
9707132,9707132,,1,24,25,1,24,25,0.000521,0.00959,0,26699,2,0.00001,12,0.213143,0.24526,68.943292,0.181667,0.000219
9707138,9707138,,0,2,2,0,2,2,0,0.000001,0,26700,5,0.00001,4,0.316832,0.367188,0,0.5,0
9707145,9707145,,0,3,3,0,3,3,0,0.000639,0,26701,4,0.00001,14,0.165379,0.186717,0,0.333333,0
9707146,9707146,,1,17,18,1,17,18,0.000036,0.005465,0,8035,2,0.000011,12,0.202805,0.230296,34228.606013,0.150327,0.000241
9707151,9707151,,0,5,5,0,5,5,0,0.000008,0,26702,6,0.00001,6,0.282051,0.437121,0,0.2,0
9707152,9707152,,0,2,2,0,2,2,0,0.000009,0,26703,26,0.00001,10,0.161857,0.180548,0,0.5,0
9707161,9707161,,1,3,4,1,3,4,0,0,0,26704,20,0.000013,4,0.409091,0.486111,6,0.25,0.000219
9707055,9707055,,1,0,1,1,0,1,0.000043,0,0,6176,15,0.00001,0,0,0,0,0,0.000254
9707172,9707172,,0,7,7,0,7,7,0,0,0,26705,22,0.00001,2,0.733333,0.818182,0,0.261905,0
9707173,9707173,,1,7,8,1,7,8,0.000006,0.000001,0,26706,9,0.000012,13,0.146403,0.1614,2014,0.160714,0.000219
9707177,9707177,,2,2,4,2,2,4,0.000279,0,0,26707,5,0.000013,3,0.555556,0.666667,9,0,0.000438
9707191,9707191,,0,13,13,0,13,13,0,0.000018,0,26708,23,0.00001,8,0.250083,0.288057,0,0.179487,0
9707193,9707193,,0,2,2,0,2,2,0,0.000028,0,26709,2,0.00001,13,0.167944,0.184164,0,0,0
9707195,9707195,,1,18,19,1,18,19,0.000279,0.007141,0,26710,0,0.00001,13,0.220207,0.255581,514.828785,0.137427,0.000219
9707196,9707196,,0,1,1,0,1,1,0,0,0,26711,13,0.00001,11,0.152773,0.176418,0,0,0
9707206,9707206,,0,4,4,0,4,4,0,0.000022,0,26712,5,0.00001,8,0.242125,0.287312,0,0.083333,0
9707213,9707213,,0,3,3,0,3,3,0,0.000002,0,26713,4,0.00001,9,0.210125,0.243023,0,0.166667,0
9707216,9707216,,0,7,7,0,7,7,0,0.000017,0,26714,15,0.00001,15,0.132334,0.151013,0,0.357143,0
9707238,9707238,,0,1,1,0,1,1,0,0,0,26715,23,0.00001,2,0.571429,0.625,0,0,0
9707240,9707240,,0,25,25,0,25,25,0,0.000661,0,26716,9,0.00001,14,0.185987,0.21477,0,0.103333,0
9707252,9707252,,0,9,9,0,9,9,0,0.000001,0,26717,26,0.00001,9,0.187103,0.215849,0,0.152778,0
9707255,9707255,,0,4,4,0,4,4,0,0,0,26718,9,0.00001,3,0.526316,0.65,0,0.25,0
9707256,9707256,,1,10,11,1,10,11,0.000067,0.000032,0,5526,9,0.00001,9,0.200907,0.243567,3841.819608,0.181818,0.000233
9708013,9708013,,1,7,8,1,7,8,0.000002,0.000545,0,26719,2,0.000011,12,0.179685,0.206965,814.111748,0.232143,0.000219
9708014,9708014,,2,6,8,2,6,8,0.000287,0.001251,0,26720,13,0.000011,11,0.200957,0.228547,30.234277,0.178571,0.000438
9708018,9708018,,0,1,1,0,1,1,0,0.000003,0,26721,5,0.00001,7,0.218971,0.234003,0,0,0
9708024,9708024,,0,6,6,0,6,6,0,0.000015,0,26722,41,0.00001,12,0.179441,0.197599,0,0.166667,0
9708026,9708026,,0,8,8,0,8,8,0,0.000843,0,26723,9,0.00001,15,0.190921,0.218215,0,0.107143,0
9708028,9708028,,0,1,1,0,1,1,0,0,119,26725,141,0.00001,1,1,1,0,0,0
9501133,9501133,,1,0,1,1,0,1,0,0,119,26724,141,0.000019,0,0,0,0,0,0.000219
9708038,9708038,,0,6,6,0,6,6,0,0.000004,0,26726,23,0.00001,3,0.514286,0.62037,0,0.233333,0
9708043,9708043,,0,1,1,0,1,1,0,0,120,26728,142,0.00001,1,1,1,0,0,0
9310195,9310195,,1,0,1,1,0,1,0,0,120,26727,142,0.000019,0,0,0,0,0,0.000219
9708050,9708050,,0,8,8,0,8,8,0,0.000039,0,26729,52,0.00001,6,0.298458,0.34262,0,0.232143,0
9708057,9708057,,0,2,2,0,2,2,0,0,0,26730,28,0.00001,2,0.625,0.7,0,0.5,0
9708058,9708058,,0,1,1,0,1,1,0,0.000007,0,26731,6,0.00001,6,0.246753,0.313158,0,0,0
9708066,9708066,,3,3,6,3,3,6,0,0,0,26732,8,0.000021,1,1,1,2.5,0.266667,0.00067
9708070,9708070,,0,8,8,0,8,8,0,0.00051,0,26733,2,0.00001,16,0.170899,0.191819,0,0.232143,0
9708071,9708071,,0,6,6,0,6,6,0,0.000011,0,26734,30,0.00001,3,0.553191,0.608974,0,0.4,0
9708079,9708079,,0,6,6,0,6,6,0,0,0,26735,23,0.00001,7,0.233083,0.31211,0,0,0
9708084,9708084,,0,5,5,0,5,5,0,0.000085,0,26736,3,0.00001,13,0.169206,0.186117,0,0.1,0
9708088,9708088,,0,2,2,0,2,2,0,0,0,26738,52,0.00001,1,1,1,0,0,0
9706215,9706215,,1,0,1,1,0,1,0,0,0,26737,52,0.000014,0,0,0,0,0,0.000219
9708092,9708092,,1,3,4,1,3,4,0,0,0,26739,22,0.000014,2,0.8,0.875,2,0.166667,0.000219
9708095,9708095,,4,2,6,4,2,6,0,0,0,26740,6,0.000018,11,0.14735,0.166109,0,0.5,0.000916
9708096,9708096,,2,2,4,2,2,4,0,0,0,26741,8,0.000014,2,0.666667,0.75,0,0.416667,0.000438
9708105,9708105,,0,12,12,0,12,12,0,0.007541,0,26742,0,0.00001,11,0.216116,0.24771,0,0.189394,0
9708107,9708107,,0,3,3,0,3,3,0,0.000001,0,26743,6,0.00001,4,0.473684,0.601852,0,0.166667,0
9708111,9708111,,0,6,6,0,6,6,0,0.000005,0,26744,20,0.00001,3,0.555556,0.633333,0,0.133333,0
9708125,9708125,,2,2,4,2,2,4,0,0.000001,0,26745,23,0.000019,2,0.666667,0.75,6,0.25,0.000445
9708128,9708128,,0,5,5,0,5,5,0,0.000002,0,26746,5,0.00001,16,0.137497,0.156231,0,0.3,0
9708132,9708132,,0,2,2,0,2,2,0,0,0,26747,6,0.00001,5,0.341463,0.402381,0,0,0
9708133,9708133,,1,7,8,1,7,8,0,0.003379,0,7397,5,0.000013,13,0.181323,0.205753,19647.881066,0.089286,0.000226
9708142,9708142,,0,11,11,0,11,11,0,0.005552,0,26748,13,0.00001,11,0.21886,0.254107,0,0.209091,0
9708143,9708143,,0,6,6,0,6,6,0,0.001885,0,26749,4,0.00001,13,0.180572,0.207271,0,0.3,0
9708144,9708144,,1,2,3,1,2,3,0,0,0,26750,23,0.000013,3,0.5,0.633333,0,0.5,0.000219
9708156,9708156,,0,1,1,0,1,1,0,0,121,26752,143,0.00001,1,1,1,0,0,0
9508069,9508069,,1,0,1,1,0,1,0,0,121,26751,143,0.000019,0,0,0,0,0,0.000219
9708158,9708158,,0,7,7,0,7,7,0,0.000015,0,26753,5,0.00001,9,0.23149,0.279116,0,0.214286,0
9708161,9708161,,0,2,2,0,2,2,0,0,0,26754,2,0.00001,12,0.143962,0.153267,0,0.5,0
9708162,9708162,,1,4,5,1,4,5,0.000041,0.001009,0,26756,0,0.000011,10,0.2,0.222755,0,0.35,0.000219
9410122,9410122,,2,0,2,2,0,2,0.000053,0,0,26755,0,0.000013,0,0,0,0,0.5,0.000445
9708167,9708167,,0,8,8,0,8,8,0,0.000003,0,26757,9,0.00001,6,0.283702,0.349291,0,0.089286,0
9708169,9708169,,1,23,24,1,23,24,0.000459,0.003141,0,26758,13,0.00001,13,0.195512,0.24518,18.924764,0.146739,0.000219
9709008,9709008,,0,10,10,0,10,10,0,0.000118,0,26759,13,0.00001,12,0.163869,0.186975,0,0.277778,0
9709016,9709016,,1,5,6,1,5,6,0,0.000001,0,26760,6,0.000012,8,0.194631,0.267091,83.916667,0.066667,0.000219
9709018,9709018,,0,3,3,0,3,3,0,0,0,26761,20,0.00001,5,0.372549,0.462281,0,0.5,0
9709026,9709026,,0,2,2,0,2,2,0,0.001085,0,26762,4,0.00001,6,0.268,0.304602,0,0.5,0
9709031,9709031,,2,6,8,2,6,8,0,0.000008,0,26763,26,0.000011,14,0.164296,0.189904,3.666667,0.285714,0.000438
9709041,9709041,,0,1,1,0,1,1,0,0,0,26764,5,0.00001,13,0.161701,0.178621,0,0,0
9709045,9709045,,0,6,6,0,6,6,0,0.000066,0,26765,1,0.00001,2,0.8,0.875,0,0.433333,0
9709046,9709046,,0,1,1,0,1,1,0,0,105,26766,126,0.00001,1,1,1,0,0,0
9709052,9709052,,0,3,3,0,3,3,0,0,0,26767,23,0.00001,3,0.545455,0.694444,0,0.5,0
9709056,9709056,,0,5,5,0,5,5,0,0.000206,0,26768,0,0.00001,12,0.203071,0.229292,0,0.35,0
9709057,9709057,,1,2,3,1,2,3,0,0.000001,0,26769,22,0.000019,4,0.359223,0.400901,37,0,0.000219
9709073,9709073,,0,6,6,0,6,6,0,0.001036,0,26770,4,0.00001,15,0.157618,0.184228,0,0.1,0
9709075,9709075,,2,5,7,2,5,7,0,0.00002,0,12618,26,0.000014,12,0.185233,0.213683,6208.328867,0.142857,0.000452
9709076,9709076,,0,8,8,0,8,8,0,0.000005,0,26772,52,0.00001,3,0.666667,0.77381,0,0.160714,0
9211069,9211069,,1,0,1,1,0,1,0,0,0,26771,52,0.000011,0,0,0,0,0,0.000219
9709083,9709083,,1,3,4,1,3,4,0,0.000004,0,26773,2,0.000013,3,0.583333,0.690476,1.5,0.416667,0.000219
9709085,9709085,,0,6,6,0,6,6,0,0.000001,0,26774,23,0.00001,10,0.155996,0.183614,0,0.266667,0
9709086,9709086,,0,1,1,0,1,1,0,0,0,26775,22,0.00001,3,0.5,0.611111,0,0,0
9611225,9611225,,1,0,1,1,0,1,0.000066,0,0,6207,2,0.000011,0,0,0,0,0,0.000301
9709112,9709112,,1,1,2,1,1,2,0,0,122,26777,144,0.000014,1,1,1,0,0.5,0.000219
9709051,9709051,,2,0,2,2,0,2,0,0,122,26776,144,0.000027,0,0,0,0,0.5,0.000445
9709117,9709117,,0,1,1,0,1,1,0,0.00002,0,26778,22,0.00001,2,0.538462,0.571429,0,0,0
9709120,9709120,,0,9,9,0,9,9,0,0,0,26779,21,0.00001,7,0.229508,0.293401,0,0.263889,0
9709121,9709121,,0,11,11,0,11,11,0,0,0,26780,21,0.00001,7,0.236797,0.312299,0,0.254545,0
9709124,9709124,,0,14,14,0,14,14,0,0.005112,0,26781,13,0.00001,10,0.212823,0.250885,0,0.17033,0
9709125,9709125,,1,1,2,1,1,2,0,0,0,19908,26,0.000012,1,1,1,4,0,0.000226
9709126,9709126,,1,8,9,1,8,9,0.000003,0.00006,0,26782,3,0.00001,12,0.155875,0.209289,0.5,0.402778,0.000219
9709128,9709128,,0,1,1,0,1,1,0,0,0,26783,5,0.00001,7,0.233151,0.253925,0,0,0
9709136,9709136,,0,2,2,0,2,2,0,0,0,26784,6,0.00001,2,0.75,0.833333,0,0.5,0
9709140,9709140,,2,1,3,2,1,3,0,0,0,7774,23,0.000021,2,0.6,0.666667,15512.154932,0,0.000454
9709153,9709153,,0,2,2,0,2,2,0,0,0,26785,23,0.00001,2,0.75,0.833333,0,0,0
9709156,9709156,,0,1,1,0,1,1,0,0.000001,0,26786,8,0.00001,2,0.6,0.666667,0,0,0
9709164,9709164,,0,4,4,0,4,4,0,0.000015,0,26787,23,0.00001,5,0.359375,0.424275,0,0.083333,0
9709168,9709168,,0,3,3,0,3,3,0,0.000001,0,26788,6,0.00001,4,0.372093,0.46875,0,0.333333,0
9709169,9709169,,0,14,14,0,14,14,0,0.001449,0,26789,5,0.00001,12,0.206387,0.242389,0,0.087912,0
9709170,9709170,,0,1,1,0,1,1,0,0,0,26790,26,0.00001,3,0.4375,0.5,0,0,0
9709172,9709172,,0,99,99,0,99,99,0,0.023774,0,26791,13,0.00001,11,0.235392,0.284612,0,0.080808,0
9709176,9709176,,0,6,6,0,6,6,0,0.000004,0,26792,15,0.00001,14,0.154296,0.170523,0,0.4,0
9709179,9709179,,0,1,1,0,1,1,0,0,0,26793,28,0.00001,1,1,1,0,0,0
9709183,9709183,,0,4,4,0,4,4,0,0.000494,0,26794,9,0.00001,14,0.128135,0.138557,0,0,0
9709185,9709185,,0,4,4,0,4,4,0,0.000003,0,26795,20,0.00001,2,0.625,0.7,0,0.083333,0
9709190,9709190,,0,9,9,0,9,9,0,0.000747,0,26796,2,0.00001,11,0.196074,0.219733,0,0.319444,0
9709191,9709191,,0,7,7,0,7,7,0,0.001713,0,26797,13,0.00001,11,0.203253,0.234383,0,0.119048,0
9709197,9709197,,0,1,1,0,1,1,0,0,0,26798,28,0.00001,1,1,1,0,0,0
9709204,9709204,,0,3,3,0,3,3,0,0,0,26800,6,0.00001,4,0.384615,0.525,0,0,0
9706147,9706147,,1,0,1,1,0,1,0,0,0,26799,6,0.000013,0,0,0,0,0,0.000219
9709215,9709215,,0,17,17,0,17,17,0,0.000278,0,26801,3,0.00001,13,0.170103,0.190851,0,0.169118,0
9709218,9709218,,0,2,2,0,2,2,0,0.001027,0,26802,4,0.00001,6,0.263804,0.29832,0,0.5,0
9709223,9709223,,0,1,1,0,1,1,0,0,0,26803,20,0.00001,2,0.6,0.666667,0,0,0
9710003,9710003,,2,2,4,2,2,4,0,0,0,26804,26,0.000017,8,0.209536,0.229676,302.988095,0,0.000445
9710008,9710008,,0,4,4,0,4,4,0,0.000498,0,26805,2,0.00001,12,0.195105,0.221109,0,0.083333,0
9612124,9612124,,2,0,2,2,0,2,0.000237,0,0,8491,2,0.000011,0,0,0,0,0,0.000463
9710012,9710012,,0,1,1,0,1,1,0,0,0,26806,23,0.00001,1,1,1,0,0,0
9710013,9710013,,0,18,18,0,18,18,0,0.00258,0,26809,4,0.00001,13,0.176021,0.203009,0,0.267974,0
9406006,9406006,,1,0,1,1,0,1,0.00003,0,0,26808,4,0.00001,0,0,0,0,0,0.000219
9611010,9611010,,1,0,1,1,0,1,0.00003,0,0,26807,4,0.00001,0,0,0,0,0,0.000219
9710017,9710017,,0,1,1,0,1,1,0,0.000001,0,26810,6,0.00001,10,0.152272,0.172961,0,0,0
9710043,9710043,,0,4,4,0,4,4,0,0,0,26811,26,0.00001,9,0.190029,0.209842,0,0.5,0
9710044,9710044,,0,7,7,0,7,7,0,0.000023,0,26812,26,0.00001,14,0.167222,0.199008,0,0.357143,0
9710045,9710045,,0,4,4,0,4,4,0,0.000001,0,26813,9,0.00001,7,0.220207,0.267815,0,0.083333,0
9710055,9710055,,0,2,2,0,2,2,0,0,0,26815,23,0.00001,4,0.473684,0.564815,0,0,0
9505031,9505031,,3,0,3,3,0,3,0,0,0,26814,23,0.00002,0,0,0,0,0.166667,0.000664
9710056,9710056,,0,1,1,0,1,1,0,0,0,26816,22,0.00001,5,0.269504,0.29693,0,0,0
9710052,9710052,,1,0,1,1,0,1,0.000069,0,0,4972,2,0.000011,0,0,0,0,0,0.000281
9710059,9710059,,0,14,14,0,14,14,0,0.005395,0,26817,2,0.00001,12,0.187979,0.213603,0,0.181319,0
9710081,9710081,,0,1,1,0,1,1,0,0.000002,0,26818,30,0.00001,1,1,1,0,0,0
9710083,9710083,,0,1,1,0,1,1,0,0,123,26820,145,0.00001,1,1,1,0,0,0
9703093,9703093,,1,0,1,1,0,1,0,0,123,26819,145,0.000019,0,0,0,0,0,0.000219
9710089,9710089,,1,1,2,1,1,2,0.000014,0,0,26822,26,0.000011,1,1,1,1,0,0.000219
9510110,9510110,,1,0,1,1,0,1,0,0,0,26821,26,0.00002,0,0,0,0,0,0.000226
9608029,9608029,,1,0,1,1,0,1,0,0,0,20756,23,0.000018,0,0,0,0,0,0.000226
9710094,9710094,,3,4,7,3,4,7,0,0,0,26823,6,0.000015,11,0.147846,0.169392,0,0.452381,0.000677
9710106,9710106,,0,4,4,0,4,4,0,0,0,26824,6,0.00001,9,0.169145,0.229915,0,0.166667,0
9710111,9710111,,0,2,2,0,2,2,0,0,0,26825,22,0.00001,3,0.555556,0.666667,0,0.5,0
9710113,9710113,,0,2,2,0,2,2,0,0.000001,0,26826,22,0.00001,6,0.316456,0.388667,0,0.5,0
9710115,9710115,,0,1,1,0,1,1,0,0,0,26827,22,0.00001,3,0.380952,0.4375,0,0,0
9710117,9710117,,0,1,1,0,1,1,0,0,124,26829,146,0.00001,1,1,1,0,0,0
9704103,9704103,,1,0,1,1,0,1,0,0,124,26828,146,0.000019,0,0,0,0,0,0.000219
9710118,9710118,,0,10,10,0,10,10,0,0.000002,0,26830,9,0.00001,15,0.144034,0.172784,0,0.322222,0
9710143,9710143,,0,3,3,0,3,3,0,0,87,26831,109,0.00001,1,1,1,0,0.5,0
9710154,9710154,,0,9,9,0,9,9,0,0.001614,0,26832,15,0.00001,13,0.189761,0.215956,0,0.111111,0
9710156,9710156,,0,2,2,0,2,2,0,0.000009,0,26833,6,0.00001,6,0.35443,0.426786,0,0,0
9710160,9710160,,0,29,29,0,29,29,0,0.0032,0,26834,4,0.00001,14,0.184472,0.219024,0,0.17734,0
9710164,9710164,,1,1,2,1,1,2,0.000001,0,0,26836,23,0.000012,1,1,1,0,0.5,0.000219
9709070,9709070,,2,0,2,2,0,2,0.000001,0,0,26835,23,0.000022,0,0,0,0,0.5,0.000445
9710170,9710170,,0,4,4,0,4,4,0,0.000001,0,26837,28,0.00001,4,0.425532,0.5125,0,0.416667,0
9710173,9710173,,0,3,3,0,3,3,0,0,0,26838,20,0.00001,6,0.323529,0.495455,0,0.166667,0
9710177,9710177,,1,17,18,1,17,18,0.000007,0.000724,0,26839,10,0.000012,12,0.194367,0.221727,1899.353592,0.104575,0.000219
9710182,9710182,,0,1,1,0,1,1,0,0,0,26840,4,0.00001,16,0.157303,0.175117,0,0,0
9710184,9710184,,0,3,3,0,3,3,0,0.000001,0,26841,9,0.00001,5,0.330677,0.377108,0,0,0
9710193,9710193,,1,10,11,1,10,11,0,0.000009,0,11734,28,0.00001,13,0.135079,0.153765,12488.757902,0.081818,0.000226
9710194,9710194,,1,4,5,1,4,5,0,0.000007,0,26842,23,0.000011,15,0.131714,0.14456,0.5,0.3,0.000219
9710195,9710195,,0,2,2,0,2,2,0,0.000003,0,26843,28,0.00001,14,0.134125,0.143383,0,0.5,0
9710200,9710200,,0,6,6,0,6,6,0,0.000003,0,26844,22,0.00001,7,0.271084,0.382275,0,0.2,0
9710201,9710201,,0,3,3,0,3,3,0,0.001008,0,26845,2,0.00001,14,0.18138,0.207188,0,0,0
9710202,9710202,,0,2,2,0,2,2,0,0,74,26846,95,0.00001,1,1,1,0,0.5,0
9710211,9710211,,0,1,1,0,1,1,0,0,0,26847,21,0.00001,4,0.361702,0.406863,0,0,0
9710216,9710216,,0,4,4,0,4,4,0,0,0,26848,8,0.00001,2,0.833333,0.9,0,0.333333,0
9710224,9710224,,0,7,7,0,7,7,0,0,0,26849,23,0.00001,4,0.514286,0.648148,0,0.071429,0
9710228,9710228,,2,21,23,2,21,23,0.00016,0.005723,0,5527,2,0.000011,15,0.199932,0.236411,14954.120852,0.118577,0.000511
9710235,9710235,,5,2,7,5,2,7,0.000002,0,0,13309,26,0.000015,4,0.411765,0.547619,3.566667,0.309524,0.001162
9710238,9710238,,0,4,4,0,4,4,0,0.000012,0,26850,5,0.00001,7,0.230907,0.256115,0,0.333333,0
9711018,9711018,,1,7,8,1,7,8,0.000004,0.001509,0,26851,2,0.000013,15,0.17797,0.208409,2281.393683,0.071429,0.000219
9711019,9711019,,2,21,23,2,21,23,0.000029,0.000041,0,26852,26,0.000012,11,0.198805,0.245757,753.232384,0.059289,0.000438
9711050,9711050,,1,1,2,1,1,2,0,0.000008,0,26853,23,0.000011,2,0.666667,0.75,0,0.5,0.000219
9711060,9711060,,0,1,1,0,1,1,0,0,0,26854,21,0.00001,3,0.5,0.583333,0,0,0
9711062,9711062,,0,12,12,0,12,12,0,0.000005,0,26855,22,0.00001,8,0.242268,0.367047,0,0.068182,0
9711066,9711066,,0,1,1,0,1,1,0,0.000005,0,26856,6,0.00001,1,1,1,0,0,0
9711075,9711075,,1,4,5,1,4,5,0,0.000001,0,26857,17,0.000013,6,0.285714,0.390278,11.5,0.15,0.000219
9711079,9711079,,0,3,3,0,3,3,0,0.000007,0,26858,26,0.00001,12,0.121825,0.131432,0,0.5,0
9711101,9711101,,1,6,7,1,6,7,0,0.000171,0,26859,26,0.000011,3,0.692308,0.814815,5,0.02381,0.000226
9711114,9711114,,0,18,18,0,18,18,0,0.006368,0,26860,0,0.00001,15,0.196506,0.232564,0,0.124183,0
9711118,9711118,,0,1,1,0,1,1,0,0,0,26861,22,0.00001,1,1,1,0,0,0
9711119,9711119,,0,1,1,0,1,1,0,0,0,26862,22,0.00001,1,1,1,0,0,0
9711123,9711123,,1,6,7,1,6,7,0,0.000001,0,26863,22,0.000014,3,0.619048,0.717949,13,0.071429,0.000219
9711125,9711125,,1,12,13,1,12,13,0.00003,0.000567,0,26864,0,0.00001,13,0.176246,0.208343,110.900057,0.179487,0.000219
9711141,9711141,,0,3,3,0,3,3,0,0.001092,0,26865,4,0.00001,6,0.269461,0.309753,0,0.333333,0
9711142,9711142,,1,10,11,1,10,11,0,0.000004,0,26866,23,0.000011,11,0.161149,0.210062,17.166667,0.181818,0.000219
9711148,9711148,,0,28,28,0,28,28,0,0.000013,0,26868,6,0.00001,9,0.22507,0.275623,0,0.14418,0
9505179,9505179,,1,0,1,1,0,1,0,0,0,26867,6,0.00001,0,0,0,0,0,0.000219
9711149,9711149,,0,5,5,0,5,5,0,0.000636,0,26869,10,0.00001,13,0.174371,0.196638,0,0.35,0
9711152,9711152,,0,3,3,0,3,3,0,0.000004,0,26870,5,0.00001,12,0.149437,0.161505,0,0,0
9711154,9711154,,1,1,2,1,1,2,0.000001,0,0,26871,13,0.000011,1,1,1,0,0.5,0.000219
9711164,9711164,,1,3,4,1,3,4,0,0.000001,0,26872,5,0.000013,17,0.121315,0.134668,0.5,0.25,0.000219
9711176,9711176,,0,1,1,0,1,1,0,0,74,26873,95,0.00001,2,0.666667,0.75,0,0,0
9711180,9711180,,0,3,3,0,3,3,0,0.000006,0,26874,23,0.00001,7,0.32879,0.367925,0,0,0
9711192,9711192,,0,8,8,0,8,8,0,0.000189,0,26875,0,0.00001,11,0.206744,0.238983,0,0.339286,0
9711195,9711195,,1,1,2,1,1,2,0,0,0,26876,22,0.000011,3,0.5,0.583333,1.5,0,0.000219
9701130,9701130,,1,0,1,1,0,1,0,0,0,6880,0,0.000019,0,0,0,0,0,0.000226
9711204,9711204,,0,7,7,0,7,7,0,0.000737,0,26877,15,0.00001,16,0.165052,0.184794,0,0.285714,0
9712001,9712001,,0,3,3,0,3,3,0,0.000001,0,26878,5,0.00001,17,0.121375,0.134906,0,0.333333,0
9712002,9712002,,0,3,3,0,3,3,0,0.000298,0,26879,2,0.00001,16,0.158987,0.183999,0,0.166667,0
9712003,9712003,,0,6,6,0,6,6,0,0.000007,0,26880,23,0.00001,14,0.139399,0.154652,0,0.266667,0
9712014,9712014,,0,4,4,0,4,4,0,0.000007,0,26881,23,0.00001,13,0.173291,0.221956,0,0.416667,0
9712016,9712016,,1,2,3,1,2,3,0,0,0,16973,28,0.000017,2,0.625,0.7,50,0.166667,0.000226
9712141,9712141,,0,40,40,0,40,40,0,0.009442,0,26882,0,0.00001,11,0.212558,0.250303,0,0.161538,0
9712027,9712027,,0,3,3,0,3,3,0,0.001433,0,26883,4,0.00001,13,0.170664,0.196173,0,0.333333,0
9712037,9712037,,0,3,3,0,3,3,0,0,0,26884,21,0.00001,7,0.226016,0.269133,0,0.5,0
9712044,9712044,,0,4,4,0,4,4,0,0.000003,0,26885,26,0.00001,5,0.349206,0.452273,0,0.416667,0
9712052,9712052,,0,2,2,0,2,2,0,0,0,26886,21,0.00001,4,0.395833,0.460526,0,0.5,0
9712060,9712060,,0,10,10,0,10,10,0,0.000011,0,26887,5,0.00001,6,0.329177,0.402525,0,0.077778,0
9712069,9712069,,0,4,4,0,4,4,0,0,0,26888,8,0.00001,2,0.833333,0.9,0,0.333333,0
9712076,9712076,,0,15,15,0,15,15,0,0.000005,0,26889,22,0.00001,5,0.405063,0.522396,0,0.066667,0
9712093,9712093,,0,2,2,0,2,2,0,0,0,26890,26,0.00001,3,0.555556,0.666667,0,0.5,0
9712098,9712098,,0,2,2,0,2,2,0,0.000001,0,26891,20,0.00001,1,1,1,0,0,0
9712101,9712101,,1,0,1,1,0,1,0,0,0,6487,2,0.000016,0,0,0,0,0,0.000239
9712107,9712107,,0,12,12,0,12,12,0,0.000005,0,26892,9,0.00001,14,0.149166,0.165609,0,0.136364,0
9712113,9712113,,0,1,1,0,1,1,0,0,0,26893,22,0.00001,2,0.666667,0.75,0,0,0
9712114,9712114,,0,3,3,0,3,3,0,0.000002,0,26894,28,0.00001,11,0.169409,0.202416,0,0.166667,0
9712136,9712136,,0,13,13,0,13,13,0,0.007324,0,26895,2,0.00001,15,0.188929,0.221801,0,0.198718,0
9712138,9712138,,0,3,3,0,3,3,0,0.000003,0,26896,41,0.00001,5,0.323529,0.39798,0,0.166667,0
9712142,9712142,,0,24,24,0,24,24,0,0.004586,0,26897,2,0.00001,14,0.206467,0.239911,0,0.134058,0
9712151,9712151,,0,15,15,0,15,15,0,0.00114,0,26898,28,0.00001,13,0.187795,0.217886,0,0.109524,0
9712152,9712152,,0,13,13,0,13,13,0,0.003194,0,26899,4,0.00001,17,0.181879,0.211925,0,0.269231,0
9712153,9712153,,0,1,1,0,1,1,0,0,125,26901,147,0.00001,1,1,1,0,0,0
9610071,9610071,,1,0,1,1,0,1,0,0,125,26900,147,0.000019,0,0,0,0,0,0.000219
9712154,9712154,,0,3,3,0,3,3,0,0.000086,0,26902,9,0.00001,12,0.183153,0.205396,0,0.166667,0
9601106,9601106,,1,0,1,1,0,1,0,0,0,14884,13,0.000013,0,0,0,0,0,0.000232
9703037,9703037,,1,0,1,1,0,1,0,0,0,14883,13,0.000013,0,0,0,0,0,0.000232
9706045,9706045,,1,0,1,1,0,1,0,0,0,14882,13,0.000013,0,0,0,0,0,0.000232
9712175,9712175,,0,4,4,0,4,4,0,0.000011,0,26903,0,0.00001,9,0.200402,0.227941,0,0.166667,0
9712184,9712184,,0,33,33,0,33,33,0,0.007364,0,26904,4,0.00001,17,0.204654,0.244829,0,0.152462,0
9712190,9712190,,0,3,3,0,3,3,0,0.00214,0,26905,4,0.00001,6,0.276231,0.324548,0,0.5,0
9712192,9712192,,0,3,3,0,3,3,0,0.00214,0,26906,4,0.00001,6,0.276231,0.324548,0,0.5,0
9712196,9712196,,0,19,19,0,19,19,0,0.001336,0,26907,13,0.00001,11,0.196066,0.235494,0,0.192982,0
9712204,9712204,,1,11,12,1,11,12,0,0.000039,0,26908,23,0.000011,14,0.172426,0.213825,1227.861179,0.090909,0.000219
9712207,9712207,,0,4,4,0,4,4,0,0.000073,0,26909,52,0.00001,4,0.345324,0.413194,0,0.333333,0
9712208,9712208,,1,3,4,1,3,4,0.000104,0,0,7398,5,0.00001,14,0.153544,0.167616,41026.375297,0.166667,0.000241
9712217,9712217,,0,2,2,0,2,2,0,0,122,26910,144,0.00001,1,1,1,0,0.5,0
9712224,9712224,,1,12,13,1,12,13,0.000052,0.00268,0,26911,13,0.00001,12,0.199193,0.232545,55.030671,0.230769,0.000219
9712227,9712227,,0,8,8,0,8,8,0,0.000009,0,26912,6,0.00001,12,0.184641,0.219002,0,0.178571,0
9712228,9712228,,0,2,2,0,2,2,0,0.000003,0,26913,26,0.00001,4,0.421053,0.484375,0,0,0
9712233,9712233,,1,24,25,1,24,25,0.00011,0.006169,0,7625,0,0.000011,14,0.203507,0.235535,12758.657952,0.168333,0.000255
9712234,9712234,,0,3,3,0,3,3,0,0,0,26914,23,0.00001,6,0.231023,0.275238,0,0.5,0
9712237,9712237,,0,1,1,0,1,1,0,0,5,26915,19,0.00001,1,1,1,0,0,0
9712255,9712255,,0,3,3,0,3,3,0,0,0,26916,26,0.00001,13,0.156598,0.173551,0,0.5,0
9801005,9801005,,2,5,7,2,5,7,0.000026,0.000318,0,14060,23,0.000013,12,0.195161,0.222716,387.617432,0.119048,0.000465
9709212,9709212,,3,0,3,3,0,3,0.000027,0,0,14058,23,0.000016,0,0,0,0,0.333333,0.000697
9801012,9801012,,0,5,5,0,5,5,0,0.000001,0,26917,28,0.00001,4,0.52,0.647436,0,0.2,0
9801013,9801013,,0,3,3,0,3,3,0,0.000004,0,26918,2,0.00001,4,0.5,0.635417,0,0.5,0
9801015,9801015,,1,6,7,1,6,7,0.000001,0.001652,0,26919,13,0.000012,13,0.201086,0.233121,1996.538086,0.166667,0.000219
9801025,9801025,,0,4,4,0,4,4,0,0.000026,0,26920,5,0.00001,8,0.221679,0.251331,0,0.083333,0
9801028,9801028,,0,1,1,0,1,1,0,0,0,26921,1,0.00001,1,1,1,0,0,0
9801050,9801050,,0,4,4,0,4,4,0,0.000005,0,26922,26,0.00001,9,0.170833,0.2381,0,0.166667,0
9801055,9801055,,0,5,5,0,5,5,0,0.001602,0,26923,23,0.00001,12,0.198405,0.225355,0,0.15,0
9801059,9801059,,0,3,3,0,3,3,0,0,0,26924,21,0.00001,2,0.8,0.875,0,0,0
9801063,9801063,,1,5,6,1,5,6,0.000001,0.000517,0,26925,13,0.000011,1,1,1,2.25,0.133333,0.000219
9801068,9801068,,0,1,1,0,1,1,0,0,0,26926,5,0.00001,1,1,1,0,0,0
9801069,9801069,,0,2,2,0,2,2,0,0.000001,0,26927,8,0.00001,2,0.75,0.833333,0,0.5,0
9801071,9801071,,0,11,11,0,11,11,0,0.002647,0,26928,2,0.00001,14,0.188146,0.215531,0,0.336364,0
9801074,9801074,,0,22,22,0,22,22,0,0.00478,0,26929,13,0.00001,14,0.199926,0.23365,0,0.188312,0
9801086,9801086,,0,4,4,0,4,4,0,0.000002,0,26930,28,0.00001,14,0.149687,0.175088,0,0.25,0
9801089,9801089,,0,6,6,0,6,6,0,0.000003,0,26931,6,0.00001,5,0.339286,0.435526,0,0.066667,0
9801095,9801095,,0,40,40,0,40,40,0,0.007264,0,26932,13,0.00001,12,0.212846,0.255372,0,0.136538,0
9801098,9801098,,0,1,1,0,1,1,0,0,0,26933,26,0.00001,1,1,1,0,0,0
9801103,9801103,,0,1,1,0,1,1,0,0,0,26934,23,0.00001,1,1,1,0,0,0
9801109,9801109,,0,25,25,0,25,25,0,0.006347,0,26935,2,0.00001,14,0.204835,0.235924,0,0.16,0
9801111,9801111,,0,10,10,0,10,10,0,0.002118,0,26936,0,0.00001,13,0.203534,0.234112,0,0.366667,0
9801113,9801113,,0,12,12,0,12,12,0,0.00156,0,26937,13,0.00001,15,0.191491,0.223541,0,0.128788,0
9801116,9801116,,0,35,35,0,35,35,0,0.006994,0,26938,13,0.00001,11,0.217388,0.261633,0,0.193277,0
9801136,9801136,,0,2,2,0,2,2,0,0.000004,0,26939,26,0.00001,2,0.6,0.666667,0,0.5,0
9801138,9801138,,1,8,9,1,8,9,0.000001,0.001983,0,26940,13,0.000012,13,0.201707,0.234294,2093.670115,0.152778,0.000219
9801150,9801150,,0,2,2,0,2,2,0,0.000001,0,26941,17,0.00001,3,0.423077,0.5,0,0,0
9801154,9801154,,1,12,13,1,12,13,0.000238,0.00412,0,5903,2,0.00001,15,0.189629,0.218433,80.036598,0.384615,0.000259
9801156,9801156,,1,12,13,1,12,13,0.000007,0.001766,0,10123,4,0.000011,17,0.185763,0.216212,920.038817,0.301282,0.000227
9801164,9801164,,1,5,6,1,5,6,0.000005,0.000003,0,26942,30,0.000011,12,0.14116,0.152992,55.381945,0.133333,0.000226
9801177,9801177,,0,2,2,0,2,2,0,0.000038,0,26943,13,0.00001,6,0.272727,0.325794,0,0.5,0
9801178,9801178,,1,1,2,1,1,2,0.000123,0.000007,0,26944,2,0.000011,16,0.154369,0.172721,49.190743,0,0.000219
9801198,9801198,,0,2,2,0,2,2,0,0,0,26945,30,0.00001,8,0.188705,0.219256,0,0.5,0
9802002,9802002,,0,4,4,0,4,4,0,0.00138,0,26946,4,0.00001,10,0.182877,0.202389,0,0.25,0
9802006,9802006,,0,3,3,0,3,3,0,0.000005,0,26948,26,0.00001,3,0.52381,0.606061,0,0,0
9501104,9501104,,1,0,1,1,0,1,0,0,0,26947,26,0.000013,0,0,0,0,0,0.000219
9802008,9802008,,1,5,6,1,5,6,0,0.000002,0,26949,23,0.000011,14,0.130723,0.140322,10,0.4,0.000219
9802017,9802017,,3,15,18,3,15,18,0.000067,0.000874,0,26950,4,0.000012,16,0.176522,0.203587,122.937299,0.30719,0.00067
9802021,9802021,,0,1,1,0,1,1,0,0.000001,0,26951,2,0.00001,1,1,1,0,0,0
9802028,9802028,,0,3,3,0,3,3,0,0.000015,0,26952,13,0.00001,13,0.168843,0.187079,0,0.333333,0
9802031,9802031,,0,4,4,0,4,4,0,0.000001,0,26953,20,0.00001,2,0.833333,0.9,0,0.25,0
9802034,9802034,,1,7,8,1,7,8,0.000145,0.004852,0,12840,2,0.00001,15,0.17929,0.205215,0.25,0.375,0.000226
9802035,9802035,,0,1,1,0,1,1,0,0,0,26954,15,0.00001,3,0.421053,0.479167,0,0,0
9802048,9802048,,0,13,13,0,13,13,0,0.00028,0,26955,26,0.00001,12,0.188977,0.21213,0,0.102564,0
9802053,9802053,,0,2,2,0,2,2,0,0,0,26956,28,0.00001,1,1,1,0,0.5,0
9802054,9802054,,0,1,1,0,1,1,0,0,0,26957,5,0.00001,1,1,1,0,0,0
9802059,9802059,,0,2,2,0,2,2,0,0,0,26958,5,0.00001,5,0.290909,0.330556,0,0.5,0
9809206,9809206,,0,3,3,0,3,3,0,0,0,26960,5,0.00001,4,0.5,0.598485,0,0.166667,0
9809198,9809198,,1,0,1,1,0,1,0,0,0,26959,5,0.000013,0,0,0,0,0,0.000219
9802075,9802075,,0,10,10,0,10,10,0,0.000006,0,26961,23,0.00001,13,0.150387,0.1645,0,0.233333,0
9802078,9802078,,0,2,2,0,2,2,0,0.000006,0,26962,6,0.00001,3,0.533333,0.604167,0,0,0
9802079,9802079,,0,4,4,0,4,4,0,0.000038,0,26963,52,0.00001,15,0.175657,0.198523,0,0.25,0
9802089,9802089,,1,10,11,1,10,11,0.000022,0.002499,0,26964,4,0.000013,15,0.190394,0.219759,4842.69062,0.2,0.000219
9802095,9802095,,0,15,15,0,15,15,0,0.00175,0,26965,4,0.00001,15,0.197736,0.226454,0,0.152381,0
9802098,9802098,,0,1,1,0,1,1,0,0,0,26966,23,0.00001,1,1,1,0,0,0
9802104,9802104,,0,1,1,0,1,1,0,0,0,26967,0,0.00001,13,0.161319,0.176107,0,0,0
9802110,9802110,,0,7,7,0,7,7,0,0.000368,0,26968,13,0.00001,10,0.206666,0.236739,0,0.309524,0
9802134,9802134,,0,4,4,0,4,4,0,0.000059,0,26969,23,0.00001,8,0.179894,0.21334,0,0,0
9802153,9802153,,0,15,15,0,15,15,0,0.008769,0,26970,2,0.00001,13,0.205092,0.236575,0,0.17619,0
9802155,9802155,,1,14,15,1,14,15,0.000005,0.001262,0,26971,4,0.00001,14,0.16009,0.185188,68.690115,0.22381,0.000219
9802156,9802156,,1,3,4,1,3,4,0.000005,0.001063,0,26972,4,0.00001,14,0.14931,0.164665,4.721751,0.416667,0.000219
9802157,9802157,,0,1,1,0,1,1,0,0.000001,0,26973,23,0.00001,1,1,1,0,0,0
9802161,9802161,,0,1,1,0,1,1,0,0.000004,0,26974,8,0.00001,1,1,1,0,0,0
9802170,9802170,,0,14,14,0,14,14,0,0.000527,0,26975,0,0.00001,14,0.186449,0.217362,0,0.285714,0
9802171,9802171,,0,2,2,0,2,2,0,0.000003,0,26976,20,0.00001,8,0.190555,0.22663,0,0,0
9802176,9802176,,1,26,27,1,26,27,0.000085,0.012348,0,12841,2,0.00001,14,0.203069,0.239123,4735.13818,0.220798,0.000234
9802177,9802177,,0,3,3,0,3,3,0,0.000003,0,26977,30,0.00001,1,1,1,0,0.333333,0
9802182,9802182,,0,14,14,0,14,14,0,0.00269,0,26978,26,0.00001,15,0.167889,0.19089,0,0.153846,0
9802184,9802184,,0,1,1,0,1,1,0,0,0,26979,6,0.00001,6,0.266667,0.36875,0,0,0
9802192,9802192,,0,4,4,0,4,4,0,0.000001,0,26980,23,0.00001,15,0.147975,0.163962,0,0.083333,0
9802200,9802200,,0,2,2,0,2,2,0,0.000001,0,26981,9,0.00001,6,0.246523,0.280684,0,0,0
9802201,9802201,,1,13,14,1,13,14,0,0.000097,0,26982,9,0.000011,11,0.191668,0.233932,959.666667,0.087912,0.000219
9803016,9803016,,0,2,2,0,2,2,0,0.000074,0,26983,0,0.00001,13,0.15056,0.162301,0,0.5,0
9803017,9803017,,3,5,8,3,5,8,0.000015,0.000007,0,26984,4,0.000012,13,0.18681,0.21303,337.708047,0.125,0.00067
9809031,9809031,,0,10,10,0,10,10,0,0.000012,0,26985,5,0.00001,13,0.150621,0.169211,0,0.177778,0
9803037,9803037,,0,3,3,0,3,3,0,0.000048,0,26986,41,0.00001,6,0.368,0.428986,0,0.166667,0
9803045,9803045,,1,9,10,1,9,10,0,0.000018,0,8976,23,0.000012,9,0.203376,0.234006,15280.198583,0.1,0.000227
9803047,9803047,,0,9,9,0,9,9,0,0.000001,0,26987,6,0.00001,10,0.1887,0.219747,0,0.097222,0
9803055,9803055,,0,3,3,0,3,3,0,0,0,26988,17,0.00001,7,0.233645,0.327048,0,0.333333,0
9803062,9803062,,0,1,1,0,1,1,0,0,126,26990,148,0.00001,1,1,1,0,0,0
9611129,9611129,,1,0,1,1,0,1,0,0,126,26989,148,0.000019,0,0,0,0,0,0.000219
9803070,9803070,,0,1,1,0,1,1,0,0,0,26991,23,0.00001,3,0.444444,0.541667,0,0,0
9803089,9803089,,2,1,3,2,1,3,0,0,0,26992,20,0.000024,1,1,1,1,0.166667,0.000445
9803093,9803093,,0,12,12,0,12,12,0,0.000361,0,26993,2,0.00001,7,0.275789,0.335478,0,0.037879,0
9803095,9803095,,0,8,8,0,8,8,0,0.008621,0,26994,4,0.00001,14,0.190365,0.215991,0,0.196429,0
9803100,9803100,,1,9,10,1,9,10,0.000003,0.000429,0,26995,2,0.000011,16,0.171902,0.201559,517.019066,0.277778,0.000219
9803102,9803102,,0,3,3,0,3,3,0,0.000021,0,26996,1,0.00001,2,0.8,0.875,0,0.5,0
9803110,9803110,,0,10,10,0,10,10,0,0.003592,0,26997,2,0.00001,14,0.195194,0.224976,0,0.188889,0
9803150,9803150,,0,27,27,0,27,27,0,0.003788,0,26998,0,0.00001,11,0.225352,0.261316,0,0.11396,0
9803172,9803172,,0,6,6,0,6,6,0,0.000008,0,26999,23,0.00001,9,0.227175,0.292148,0,0.2,0
9803180,9803180,,0,16,16,0,16,16,0,0.002519,0,27000,2,0.00001,11,0.220763,0.255544,0,0.166667,0
9803190,9803190,,0,5,5,0,5,5,0,0.000001,0,27001,26,0.00001,4,0.425926,0.525362,0,0.1,0
9803195,9803195,,1,9,10,1,9,10,0.0001,0.002341,0,11413,2,0.000011,12,0.199891,0.232202,382.313805,0.122222,0.000226
9803213,9803213,,0,4,4,0,4,4,0,0.000012,0,27002,22,0.00001,5,0.382979,0.501852,0,0.5,0
9803215,9803215,,1,27,28,1,27,28,0.000022,0.002353,0,8572,13,0.00001,12,0.206725,0.241544,28.102005,0.15873,0.000227
9803219,9803219,,1,1,2,1,1,2,0.000003,0,0,27003,5,0.00001,1,1,1,0,0.5,0.000219
9803225,9803225,,2,18,20,2,18,20,0.000035,0.002682,0,27004,4,0.000011,16,0.17581,0.202796,88.033855,0.289474,0.000438
9803236,9803236,,0,6,6,0,6,6,0,0,0,27005,22,0.00001,6,0.365591,0.47598,0,0.133333,0
9803238,9803238,,0,4,4,0,4,4,0,0.000005,0,27006,5,0.00001,7,0.214744,0.2492,0,0.416667,0
9803241,9803241,,0,4,4,0,4,4,0,0.000213,0,27007,0,0.00001,14,0.184962,0.210493,0,0.5,0
9803245,9803245,,1,3,4,1,3,4,0,0,0,27008,6,0.000013,1,1,1,3,0.25,0.000219
9803246,9803246,,0,2,2,0,2,2,0,0.000001,0,27009,41,0.00001,10,0.1725,0.205791,0,0,0
9803256,9803256,,0,3,3,0,3,3,0,0.000133,0,27010,26,0.00001,12,0.200025,0.23126,0,0,0
9803261,9803261,,0,10,10,0,10,10,0,0.00119,0,27011,13,0.00001,15,0.173168,0.200471,0,0.155556,0
9804003,9804003,,1,6,7,1,6,7,0,0.000023,0,27012,41,0.000013,7,0.24024,0.310476,10.5,0.166667,0.000219
9804008,9804008,,0,9,9,0,9,9,0,0.000374,0,27013,26,0.00001,10,0.178161,0.222566,0,0.083333,0
9804017,9804017,,0,3,3,0,3,3,0,0,0,27015,6,0.00001,2,0.666667,0.75,0,0,0
9406104,9406104,,1,0,1,1,0,1,0,0,0,27014,6,0.000013,0,0,0,0,0,0.000219
9804020,9804020,,0,19,19,0,19,19,0,0.002089,0,27016,4,0.00001,12,0.206158,0.236181,0,0.166667,0
9804039,9804039,,0,10,10,0,10,10,0,0.001021,0,27017,13,0.00001,18,0.211251,0.254435,0,0.1,0
9804043,9804043,,0,19,19,0,19,19,0,0.000965,0,27018,4,0.00001,14,0.195847,0.231806,0,0.190058,0
9804044,9804044,,0,4,4,0,4,4,0,0.000001,0,27019,22,0.00001,13,0.166117,0.182428,0,0.25,0
9804046,9804046,,0,3,3,0,3,3,0,0.000035,0,27020,30,0.00001,3,0.5,0.558824,0,0.166667,0
9804055,9804055,,1,30,31,1,30,31,0.00005,0.006195,0,27021,0,0.00001,12,0.206181,0.241325,287.516862,0.166667,0.000219
9804059,9804059,,1,39,40,1,39,40,0.000049,0.003692,0,8567,0,0.00001,15,0.194742,0.235373,249.541107,0.121154,0.000226
9804077,9804077,,0,3,3,0,3,3,0,0,0,27022,26,0.00001,1,1,1,0,0.333333,0
9804078,9804078,,0,6,6,0,6,6,0,0.000002,0,27023,15,0.00001,9,0.23968,0.295505,0,0.1,0
9804082,9804082,,0,11,11,0,11,11,0,0.000347,0,27024,0,0.00001,14,0.191005,0.218024,0,0.263636,0
9804090,9804090,,1,1,2,1,1,2,0,0.000024,0,27025,13,0.000014,11,0.173422,0.186919,0,0.5,0.000219
9804107,9804107,,0,2,2,0,2,2,0,0,0,27026,2,0.00001,4,0.428571,0.537037,0,0.5,0
9804117,9804117,,0,1,1,0,1,1,0,0,0,27027,22,0.00001,1,1,1,0,0,0
9804127,9804127,,0,2,2,0,2,2,0,0.000024,0,27028,13,0.00001,11,0.173512,0.187428,0,0.5,0
9804134,9804134,,0,2,2,0,2,2,0,0.000001,0,27029,28,0.00001,2,0.666667,0.75,0,0.5,0
9804137,9804137,,0,2,2,0,2,2,0,0,0,27030,26,0.00001,5,0.326531,0.403125,0,0,0
9804140,9804140,,0,5,5,0,5,5,0,0.000101,0,27031,13,0.00001,4,0.5,0.554688,0,0.3,0
9804145,9804145,,0,9,9,0,9,9,0,0.001836,0,27032,22,0.00001,15,0.18251,0.214166,0,0.097222,0
9804146,9804146,,0,4,4,0,4,4,0,0.001196,0,27033,2,0.00001,18,0.157306,0.185904,0,0.166667,0
9804150,9804150,,2,24,26,2,24,26,0.000013,0.00015,0,27034,23,0.000011,15,0.169731,0.199149,917.097384,0.053846,0.000438
9804162,9804162,,0,8,8,0,8,8,0,0.000422,0,27035,4,0.00001,18,0.145798,0.165464,0,0.017857,0
9804165,9804165,,0,4,4,0,4,4,0,0.000002,0,27036,22,0.00001,1,1,1,0,0.25,0
9804178,9804178,,0,4,4,0,4,4,0,0.000271,0,27037,0,0.00001,14,0.1756,0.199528,0,0.166667,0
9804183,9804183,,0,22,22,0,22,22,0,0.004223,0,27038,0,0.00001,12,0.199937,0.232912,0,0.225108,0
9804187,9804187,,0,3,3,0,3,3,0,0,0,27039,28,0.00001,6,0.211823,0.275581,0,0.333333,0
9804189,9804189,,0,3,3,0,3,3,0,0.000001,0,27040,8,0.00001,3,0.6,0.722222,0,0.166667,0
9804191,9804191,,0,3,3,0,3,3,0,0,0,27041,22,0.00001,3,0.473684,0.592593,0,0,0
9804194,9804194,,0,3,3,0,3,3,0,0.000006,0,27042,23,0.00001,11,0.177074,0.203297,0,0.5,0
9804195,9804195,,0,1,1,0,1,1,0,0,0,27043,28,0.00001,1,1,1,0,0,0
9804196,9804196,,0,7,7,0,7,7,0,0.003941,0,27044,2,0.00001,12,0.187704,0.214435,0,0.261905,0
9804198,9804198,,0,7,7,0,7,7,0,0.000893,0,27045,2,0.00001,14,0.18024,0.206251,0,0.142857,0
9804203,9804203,,0,7,7,0,7,7,0,0.000034,0,27046,23,0.00001,11,0.167822,0.194038,0,0.309524,0
9805001,9805001,,1,6,7,1,6,7,0.000004,0.000116,0,27047,17,0.000012,7,0.210938,0.263977,5.666667,0.166667,0.000219
9805002,9805002,,1,2,3,1,2,3,0.000001,0.000003,0,12313,5,0.000011,18,0.146271,0.163872,6576.820713,0,0.000232
9805016,9805016,,0,3,3,0,3,3,0,0.000034,0,27048,4,0.00001,12,0.158892,0.173677,0,0.166667,0
9805017,9805017,,0,7,7,0,7,7,0,0.003216,0,27049,2,0.00001,12,0.209364,0.238652,0,0.309524,0
9805033,9805033,,2,2,4,2,2,4,0.000002,0.000002,0,27050,26,0.000011,11,0.140835,0.181478,2.166667,0.333333,0.000445
9802081,9802081,,1,0,1,1,0,1,0,0,0,19482,20,0.000015,0,0,0,0,0,0.000226
9805039,9805039,,0,11,11,0,11,11,0,0.000004,0,27052,28,0.00001,6,0.26276,0.334173,0,0.072727,0
9505013,9505013,,1,0,1,1,0,1,0,0,0,27051,28,0.000011,0,0,0,0,0,0.000219
9805042,9805042,,0,7,7,0,7,7,0,0.000296,0,27053,2,0.00001,16,0.161183,0.183632,0,0.404762,0
9805048,9805048,,0,19,19,0,19,19,0,0.002803,0,27054,4,0.00001,13,0.217034,0.249468,0,0.283626,0
9805053,9805053,,0,11,11,0,11,11,0,0.000707,0,27055,4,0.00001,15,0.161868,0.182031,0,0.336364,0
9805062,9805062,,0,3,3,0,3,3,0,0.000003,0,27056,23,0.00001,13,0.154521,0.171355,0,0.5,0
9805068,9805068,,0,10,10,0,10,10,0,0.000219,0,27057,22,0.00001,16,0.168339,0.18685,0,0.277778,0
9805074,9805074,,1,12,13,1,12,13,0.000459,0.000146,0,27058,13,0.00001,14,0.167252,0.192463,1.123339,0.173077,0.000219
9805075,9805075,,0,23,23,0,23,23,0,0.000028,0,27059,23,0.00001,13,0.150183,0.182174,0,0.067194,0
9805092,9805092,,0,6,6,0,6,6,0,0.000004,0,27060,20,0.00001,16,0.143676,0.15499,0,0.333333,0
9805100,9805100,,0,4,4,0,4,4,0,0,0,27061,9,0.00001,3,0.526316,0.65,0,0.25,0
9805103,9805103,,1,2,3,1,2,3,0,0.000002,0,10098,28,0.000011,7,0.217391,0.280873,38.408534,0.166667,0.000239
9711188,9711188,,4,0,4,4,0,4,0,0,0,9026,22,0.000037,0,0,0,0,0.166667,0.000948
9805135,9805135,,0,3,3,0,3,3,0,0.000029,0,27062,4,0.00001,14,0.128893,0.138962,0,0.333333,0
9805147,9805147,,0,8,8,0,8,8,0,0.000189,0,27063,2,0.00001,13,0.173678,0.200166,0,0.107143,0
9805186,9805186,,0,2,2,0,2,2,0,0.00001,0,27064,22,0.00001,5,0.298103,0.334242,0,0,0
9805196,9805196,,0,1,1,0,1,1,0,0,0,27065,23,0.00001,2,0.666667,0.75,0,0,0
9805202,9805202,,0,7,7,0,7,7,0,0.003828,0,27066,2,0.00001,15,0.168879,0.192739,0,0.261905,0
9805210,9805210,,0,4,4,0,4,4,0,0.000002,0,27067,20,0.00001,19,0.133071,0.167977,0,0.25,0
9806020,9806020,,0,6,6,0,6,6,0,0.000804,0,27068,0,0.00001,16,0.161213,0.186441,0,0.133333,0
9806025,9806025,,0,3,3,0,3,3,0,0,0,27070,26,0.00001,2,0.714286,0.8,0,0,0
9803211,9803211,,1,0,1,1,0,1,0,0,0,27069,26,0.000013,0,0,0,0,0,0.000219
9806029,9806029,,0,6,6,0,6,6,0,0.000001,0,27071,5,0.00001,13,0.154519,0.169828,0,0.066667,0
9806031,9806031,,0,4,4,0,4,4,0,0.001049,0,27072,4,0.00001,14,0.159996,0.187419,0,0.166667,0
9806045,9806045,,0,4,4,0,4,4,0,0,0,27074,26,0.00001,10,0.181714,0.205501,0,0.166667,0
9804100,9804100,,1,0,1,1,0,1,0,0,0,27073,26,0.000012,0,0,0,0,0,0.000219
9806046,9806046,,1,3,4,1,3,4,0.000007,0.000032,0,8516,30,0.000011,11,0.161742,0.173544,0.333333,0.333333,0.000241
9806060,9806060,,0,6,6,0,6,6,0,0.000133,0,27075,13,0.00001,13,0.179873,0.200537,0,0.033333,0
9806063,9806063,,1,6,7,1,6,7,0,0.00001,0,15909,26,0.000012,8,0.207059,0.295022,2555.064003,0.071429,0.000232
9806064,9806064,,0,1,1,0,1,1,0,0.000032,0,27076,0,0.00001,11,0.202594,0.225285,0,0,0
9806067,9806067,,0,2,2,0,2,2,0,0.000002,0,27077,23,0.00001,8,0.179688,0.210835,0,0.5,0
9806076,9806076,,0,13,13,0,13,13,0,0.000683,0,27078,4,0.00001,12,0.18023,0.204083,0,0.307692,0
9806079,9806079,,0,15,15,0,15,15,0,0.002517,0,27079,4,0.00001,16,0.149554,0.172198,0,0.32381,0
9806093,9806093,,0,8,8,0,8,8,0,0.004785,0,27080,0,0.00001,15,0.164882,0.183873,0,0.285714,0
9806101,9806101,,0,2,2,0,2,2,0,0.000438,0,27081,1,0.00001,15,0.166307,0.183513,0,0.5,0
9806102,9806102,,0,1,1,0,1,1,0,0,0,27082,23,0.00001,2,0.666667,0.75,0,0,0
9806105,9806105,,0,10,10,0,10,10,0,0.003085,0,27083,2,0.00001,14,0.190996,0.220288,0,0.4,0
9607024,9607024,,1,0,1,1,0,1,0.000085,0,0,12842,2,0.00001,0,0,0,0,0,0.000234
9806116,9806116,,0,6,6,0,6,6,0,0.000314,0,27084,0,0.00001,12,0.202407,0.230459,0,0.3,0
9806137,9806137,,0,8,8,0,8,8,0,0.000039,0,27085,23,0.00001,13,0.180088,0.20516,0,0.053571,0
9806142,9806142,,0,14,14,0,14,14,0,0.000917,0,27086,4,0.00001,13,0.180295,0.207108,0,0.346154,0
9806145,9806145,,1,2,3,1,2,3,0,0.010451,0,12455,1,0.000015,15,0.176381,0.198175,4447.422931,0,0.000226
9806150,9806150,,1,17,18,1,17,18,0,0.000008,0,13312,26,0.00001,10,0.176979,0.21209,618.743221,0.124183,0.000226
9806179,9806179,,0,29,29,0,29,29,0,0.000231,0,27087,4,0.00001,14,0.164558,0.201838,0,0.041872,0
9806185,9806185,,0,2,2,0,2,2,0,0.000007,0,27088,0,0.00001,1,1,1,0,0,0
9806196,9806196,,1,5,6,1,5,6,0.000023,0.001578,0,15273,26,0.000012,15,0.165144,0.18519,601.855871,0.2,0.000226
9806200,9806200,,0,2,2,0,2,2,0,0,0,27089,26,0.00001,3,0.5,0.633333,0,0.5,0
9806202,9806202,,0,3,3,0,3,3,0,0.000001,0,27090,41,0.00001,12,0.158624,0.17463,0,0.166667,0
9806205,9806205,,0,5,5,0,5,5,0,0.000004,0,27091,23,0.00001,13,0.176267,0.203178,0,0.15,0
9806208,9806208,,0,6,6,0,6,6,0,0.000003,0,27092,28,0.00001,15,0.134961,0.154331,0,0.433333,0
9806209,9806209,,1,6,7,1,6,7,0.000006,0,0,27093,26,0.000011,3,0.6,0.688889,4.166667,0.119048,0.000219
9302045,9302045,,1,0,1,1,0,1,0,0,0,19909,26,0.000012,0,0,0,0,0,0.000226
9806211,9806211,,0,14,14,0,14,14,0,0.000001,0,27094,26,0.00001,11,0.201149,0.239754,0,0.175824,0
9806215,9806215,,0,3,3,0,3,3,0,0,0,27095,30,0.00001,12,0.138233,0.152875,0,0.333333,0
9806218,9806218,,0,5,5,0,5,5,0,0.000002,0,27096,17,0.00001,12,0.165037,0.19293,0,0.45,0
9806219,9806219,,0,5,5,0,5,5,0,0.000007,0,27097,26,0.00001,9,0.192939,0.219289,0,0.3,0
9806229,9806229,,0,16,16,0,16,16,0,0.002666,0,27098,4,0.00001,15,0.179849,0.205554,0,0.316667,0
9806242,9806242,,1,24,25,1,24,25,0.000007,0.010824,0,27099,2,0.000011,13,0.200131,0.231275,644.594451,0.193333,0.000219
9806245,9806245,,0,16,16,0,16,16,0,0.003627,0,27100,2,0.00001,13,0.195026,0.221087,0,0.316667,0
9807001,9807001,,0,5,5,0,5,5,0,0.000025,0,27101,9,0.00001,12,0.187285,0.216925,0,0.1,0
9807002,9807002,,0,12,12,0,12,12,0,0.000047,0,27102,13,0.00001,12,0.158333,0.186446,0,0.136364,0
9807010,9807010,,0,2,2,0,2,2,0,0,0,27104,26,0.00001,1,1,1,0,0,0
9607022,9607022,,1,0,1,1,0,1,0,0,0,27103,26,0.000014,0,0,0,0,0,0.000219
9807020,9807020,,0,2,2,0,2,2,0,0,0,27105,22,0.00001,3,0.571429,0.708333,0,0.5,0
9807027,9807027,,0,3,3,0,3,3,0,0.000003,0,27106,0,0.00001,5,0.313253,0.394872,0,0.5,0
9807032,9807032,,0,4,4,0,4,4,0,0.00001,0,27107,26,0.00001,15,0.139114,0.155193,0,0.25,0
9807036,9807036,,0,2,2,0,2,2,0,0,0,27108,26,0.00001,2,0.666667,0.75,0,0,0
9807045,9807045,,0,6,6,0,6,6,0,0.00001,0,27109,6,0.00001,3,0.540541,0.625,0,0.233333,0
9807047,9807047,,0,1,1,0,1,1,0,0,0,27110,22,0.00001,1,1,1,0,0,0
9807048,9807048,,0,1,1,0,1,1,0,0,0,27111,22,0.00001,1,1,1,0,0,0
9807057,9807057,,1,7,8,1,7,8,0.000055,0.002172,0,10576,0,0.00001,13,0.17964,0.206874,11.147155,0.25,0.000227
9807061,9807061,,0,3,3,0,3,3,0,0,0,27112,26,0.00001,3,0.533333,0.645833,0,0.166667,0
9807062,9807062,,0,44,44,0,44,44,0,0.005141,0,27113,0,0.00001,14,0.198939,0.247793,0,0.130021,0
9807068,9807068,,1,1,2,1,1,2,0,0,0,21178,26,0.000029,1,1,1,3,0,0.000226
9702034,9702034,,1,0,1,1,0,1,0,0,0,21177,26,0.000036,0,0,0,0,0,0.000226
9807074,9807074,,0,3,3,0,3,3,0,0.000001,0,27114,6,0.00001,1,1,1,0,0.166667,0
9807084,9807084,,0,1,1,0,1,1,0,0.000006,0,27115,5,0.00001,7,0.25,0.281288,0,0,0
9807089,9807089,,0,3,3,0,3,3,0,0.000031,0,27116,30,0.00001,4,0.372093,0.46875,0,0.166667,0
9807095,9807095,,0,9,9,0,9,9,0,0.002251,0,27117,0,0.00001,13,0.201822,0.235765,0,0.25,0
9807103,9807103,,0,1,1,0,1,1,0,0,0,27118,17,0.00001,2,0.6,0.666667,0,0,0
9807105,9807105,,0,10,10,0,10,10,0,0.00027,0,27119,4,0.00001,15,0.148778,0.17929,0,0.122222,0
9807110,9807110,,0,3,3,0,3,3,0,0.000071,0,27120,22,0.00001,6,0.307692,0.364951,0,0.5,0
9807114,9807114,,0,5,5,0,5,5,0,0.001464,0,27121,2,0.00001,14,0.179303,0.205351,0,0.3,0
9807118,9807118,,0,1,1,0,1,1,0,0,0,27122,23,0.00001,1,1,1,0,0,0
9807119,9807119,,0,2,2,0,2,2,0,0,0,27123,22,0.00001,1,1,1,0,0.5,0
9807120,9807120,,0,4,4,0,4,4,0,0.000823,0,27124,1,0.00001,13,0.181172,0.200588,0,0.416667,0
9807126,9807126,,0,13,13,0,13,13,0,0.000015,0,27125,5,0.00001,13,0.150681,0.170101,0,0.192308,0
9807141,9807141,,0,2,2,0,2,2,0,0.00001,0,27126,0,0.00001,12,0.149859,0.170641,0,0,0
9807145,9807145,,0,3,3,0,3,3,0,0,0,27128,23,0.00001,3,0.545455,0.694444,0,0,0
9710054,9710054,,2,0,2,2,0,2,0,0,0,27127,23,0.000016,0,0,0,0,0,0.000445
9807152,9807152,,0,5,5,0,5,5,0,0.000001,0,27129,23,0.00001,14,0.130749,0.140399,0,0.2,0
9807154,9807154,,0,19,19,0,19,19,0,0.003785,0,27130,30,0.00001,13,0.19602,0.22266,0,0.119883,0
9807167,9807167,,0,4,4,0,4,4,0,0.000004,0,27131,23,0.00001,4,0.416667,0.533333,0,0.166667,0
9807168,9807168,,0,24,24,0,24,24,0,0.004394,0,27132,13,0.00001,13,0.191155,0.226452,0,0.21558,0
9807174,9807174,,0,15,15,0,15,15,0,0.004497,0,27133,13,0.00001,11,0.213098,0.246928,0,0.27619,0
9807177,9807177,,0,1,1,0,1,1,0,0,0,27134,26,0.00001,1,1,1,0,0,0
9807184,9807184,,0,22,22,0,22,22,0,0.000224,0,27135,5,0.00001,14,0.171061,0.195365,0,0.175325,0
9807193,9807193,,0,6,6,0,6,6,0,0.000001,0,27136,4,0.00001,9,0.220105,0.258345,0,0.166667,0
9807201,9807201,,1,5,6,1,5,6,0,0,0,27137,6,0.000011,4,0.393258,0.471429,1.333333,0.2,0.000219
9807209,9807209,,0,14,14,0,14,14,0,0.002256,0,27138,2,0.00001,14,0.19023,0.21962,0,0.203297,0
9807219,9807219,,0,2,2,0,2,2,0,0,0,27139,6,0.00001,6,0.26087,0.314198,0,0,0
9807220,9807220,,0,4,4,0,4,4,0,0.000008,0,27140,2,0.00001,6,0.275362,0.347368,0,0,0
9807224,9807224,,0,17,17,0,17,17,0,0.000939,0,27141,4,0.00001,13,0.158522,0.179002,0,0.268382,0
9807227,9807227,,0,7,7,0,7,7,0,0.000012,0,27142,6,0.00001,12,0.164787,0.19487,0,0.071429,0
9807228,9807228,,0,3,3,0,3,3,0,0.000002,0,27143,23,0.00001,2,0.8,0.875,0,0.166667,0
9807233,9807233,,1,17,18,1,17,18,0.000001,0.000017,0,27144,26,0.00001,16,0.154474,0.173509,382.456233,0.101307,0.000226
9807237,9807237,,0,5,5,0,5,5,0,0.000098,0,27145,4,0.00001,16,0.177915,0.20002,0,0.2,0
9807238,9807238,,0,2,2,0,2,2,0,0,0,27146,28,0.00001,8,0.198772,0.219553,0,0.5,0
9808007,9808007,,0,15,15,0,15,15,0,0.000024,0,27147,26,0.00001,12,0.159781,0.17957,0,0.171429,0
9808008,9808008,,0,1,1,0,1,1,0,0,0,27148,23,0.00001,10,0.163658,0.17956,0,0,0
9808009,9808009,,0,2,2,0,2,2,0,0,0,27149,17,0.00001,5,0.362069,0.430159,0,0.5,0
9808021,9808021,,0,1,1,0,1,1,0,0,0,27150,26,0.00001,1,1,1,0,0,0
9808028,9808028,,0,5,5,0,5,5,0,0,0,27151,26,0.00001,11,0.139491,0.155088,0,0.35,0
9808044,9808044,,0,5,5,0,5,5,0,0,0,27152,26,0.00001,11,0.139491,0.155088,0,0.35,0
9808046,9808046,,1,13,14,1,13,14,0.000017,0.002269,0,27153,2,0.00001,14,0.194156,0.223795,1024.539491,0.181319,0.000219
9808047,9808047,,1,5,6,1,5,6,0,0.00017,0,27154,23,0.000012,11,0.213011,0.24211,5229.901873,0.2,0.000219
9808063,9808063,,0,7,7,0,7,7,0,0.000139,0,27155,0,0.00001,14,0.161489,0.181543,0,0.47619,0
9808072,9808072,,1,3,4,1,3,4,0.000023,0.000033,0,27156,3,0.000011,15,0.163034,0.179777,372.93587,0.166667,0.000219
9808076,9808076,,1,8,9,1,8,9,0,0.000196,0,27157,23,0.000014,11,0.196025,0.219706,2867,0.125,0.000219
9808077,9808077,,0,6,6,0,6,6,0,0,0,27158,26,0.00001,8,0.219616,0.312436,0,0.266667,0
9808078,9808078,,0,12,12,0,12,12,0,0.000013,0,27160,26,0.00001,14,0.16789,0.199602,0,0.159091,0
9406074,9406074,,2,0,2,2,0,2,0,0,0,27159,26,0.000013,0,0,0,0,0,0.000438
9811158,9811158,,0,4,4,0,4,4,0,0,0,27162,26,0.00001,8,0.208078,0.258207,0,0,0
9809078,9809078,,1,6,7,1,6,7,0,0.00001,0,27161,9,0.000012,6,0.27459,0.351741,67,0.095238,0.000219
9808082,9808082,,2,4,6,2,4,6,0,0.000003,0,27163,26,0.000013,2,0.7,0.785714,1.916667,0.233333,0.000445
9808089,9808089,,1,5,6,1,5,6,0,0.000006,0,27164,26,0.000011,2,0.647059,0.727273,0.916667,0.233333,0.000219
9808091,9808091,,0,2,2,0,2,2,0,0.000001,0,27165,23,0.00001,1,1,1,0,0.5,0
9808098,9808098,,0,13,13,0,13,13,0,0.001617,0,27166,22,0.00001,12,0.177978,0.201505,0,0.147436,0
9808099,9808099,,0,1,1,0,1,1,0,0,0,27167,23,0.00001,2,0.666667,0.75,0,0,0
9808105,9808105,,2,3,5,2,3,5,0.000006,0.000006,0,9489,23,0.000017,14,0.132192,0.141934,3098,0.3,0.000456
9808108,9808108,,0,2,2,0,2,2,0,0.000018,0,27168,26,0.00001,5,0.310924,0.359009,0,0.5,0
9808112,9808112,,0,2,2,0,2,2,0,0,0,27169,5,0.00001,10,0.183848,0.203855,0,0.5,0
9808116,9808116,,0,1,1,0,1,1,0,0,127,27171,149,0.00001,1,1,1,0,0,0
9508066,9508066,,1,0,1,1,0,1,0,0,127,27170,149,0.000019,0,0,0,0,0,0.000219
9808118,9808118,,1,2,3,1,2,3,0,0.000002,0,27172,6,0.000012,1,1,1,4,0,0.000226
9808123,9808123,,0,2,2,0,2,2,0,0,110,27173,138,0.00001,2,0.75,0.833333,0,0.5,0
9808132,9808132,,0,13,13,0,13,13,0,0.015142,0,27174,5,0.00001,15,0.180636,0.207924,0,0.070513,0
9808133,9808133,,0,3,3,0,3,3,0,0.000003,0,27175,26,0.00001,3,0.5,0.625,0,0,0
9808148,9808148,,0,11,11,0,11,11,0,0.000001,0,27176,21,0.00001,7,0.248082,0.309831,0,0.181818,0
9808150,9808150,,0,6,6,0,6,6,0,0.000006,0,27177,6,0.00001,5,0.367188,0.447163,0,0.166667,0
9808152,9808152,,0,1,1,0,1,1,0,0,0,27178,23,0.00001,1,1,1,0,0,0
9808155,9808155,,0,1,1,0,1,1,0,0,0,27179,23,0.00001,1,1,1,0,0,0
9808167,9808167,,0,3,3,0,3,3,0,0.000001,0,27180,23,0.00001,11,0.146816,0.164059,0,0.333333,0
9808170,9808170,,0,2,2,0,2,2,0,0,0,27181,52,0.00001,13,0.154467,0.172398,0,0,0
9808186,9808186,,0,7,7,0,7,7,0,0.001878,0,27182,23,0.00001,14,0.150727,0.177238,0,0.333333,0
9808193,9808193,,0,1,1,0,1,1,0,0,0,27183,15,0.00001,2,0.555556,0.6,0,0,0
9904059,9904059,,0,8,8,0,8,8,0,0.000009,0,27184,6,0.00001,12,0.145801,0.162728,0,0.339286,0
9809003,9809003,,0,11,11,0,11,11,0,0.001221,0,27185,9,0.00001,11,0.221961,0.278594,0,0.118182,0
9809005,9809005,,2,16,18,2,16,18,0,0.000021,0,9851,26,0.000012,7,0.272953,0.409026,111.902871,0.140523,0.000459
9809008,9809008,,0,8,8,0,8,8,0,0.001092,0,27186,4,0.00001,15,0.171601,0.192638,0,0.107143,0
9809010,9809010,,1,2,3,1,2,3,0,0,0,27187,20,0.000013,1,1,1,1,0.333333,0.000219
9809028,9809028,,0,3,3,0,3,3,0,0.000005,0,27188,6,0.00001,7,0.240741,0.297802,0,0.333333,0
9809038,9809038,,0,1,1,0,1,1,0,0,128,27190,150,0.00001,1,1,1,0,0,0
9405179,9405179,,1,0,1,1,0,1,0,0,128,27189,150,0.000019,0,0,0,0,0,0.000219
9809044,9809044,,0,14,14,0,14,14,0,0.00254,0,27191,0,0.00001,13,0.172705,0.200754,0,0.17033,0
9809048,9809048,,1,1,2,1,1,2,0,0,129,27193,151,0.000013,1,1,1,0,0.5,0.000219
9802025,9802025,,2,0,2,2,0,2,0,0,129,27192,151,0.000024,0,0,0,0,0.5,0.000445
9809054,9809054,,0,7,7,0,7,7,0,0,0,27194,21,0.00001,13,0.126771,0.139261,0,0.071429,0
9809058,9809058,,0,8,8,0,8,8,0,0.000003,0,27195,6,0.00001,10,0.15942,0.215665,0,0.178571,0
9809059,9809059,,3,22,25,3,22,25,0.000461,0.020537,0,8470,1,0.000012,13,0.194898,0.224073,6017.391765,0.195,0.000781
9809071,9809071,,0,4,4,0,4,4,0,0,0,27196,22,0.00001,3,0.518519,0.607143,0,0.333333,0
9809075,9809075,,0,17,17,0,17,17,0,0.004725,0,27197,13,0.00001,12,0.18961,0.221452,0,0.275735,0
9809077,9809077,,0,4,4,0,4,4,0,0.000027,0,27198,2,0.00001,2,0.833333,0.9,0,0.333333,0
9809079,9809079,,1,6,7,1,6,7,0.000015,0.000056,0,27199,26,0.000011,17,0.149803,0.165237,132.345061,0.190476,0.000219
9809086,9809086,,0,14,14,0,14,14,0,0.015017,0,27200,26,0.00001,15,0.179129,0.203965,0,0.115385,0
9809087,9809087,,0,9,9,0,9,9,0,0.000144,0,27201,26,0.00001,14,0.161048,0.185873,0,0.222222,0
9809089,9809089,,0,6,6,0,6,6,0,0.005986,0,27202,2,0.00001,14,0.183639,0.20527,0,0.033333,0
9809091,9809091,,0,5,5,0,5,5,0,0.000001,0,27204,26,0.00001,4,0.439024,0.560185,0,0.15,0
9511082,9511082,,1,0,1,1,0,1,0,0,0,27203,26,0.000012,0,0,0,0,0,0.000219
9809092,9809092,,0,5,5,0,5,5,0,0.000001,0,27205,23,0.00001,10,0.156187,0.182477,0,0.25,0
9809094,9809094,,1,3,4,1,3,4,0,0,0,27206,23,0.000012,2,0.8,0.875,1,0.166667,0.000219
9809104,9809104,,0,22,22,0,22,22,0,0.000013,0,27207,22,0.00001,12,0.177294,0.198477,0,0.101732,0
9809115,9809115,,0,1,1,0,1,1,0,0,0,27208,28,0.00001,2,0.6,0.666667,0,0,0
9809116,9809116,,0,3,3,0,3,3,0,0,0,27209,8,0.00001,4,0.5,0.62037,0,0,0
9809120,9809120,,1,2,3,1,2,3,0.000005,0.000449,0,27210,10,0.000013,5,0.312661,0.360882,0,0.333333,0.000219
9809129,9809129,,1,4,5,1,4,5,0,0,0,27211,26,0.000012,9,0.191214,0.212574,589,0,0.000219
9809134,9809134,,1,2,3,1,2,3,0.000002,0.000001,0,27212,26,0.00001,1,1,1,2,0.166667,0.000226
9809138,9809138,,0,2,2,0,2,2,0,0,0,27213,26,0.00001,12,0.131674,0.145837,0,0.5,0
9809139,9809139,,1,9,10,1,9,10,0.000011,0.000944,0,12748,13,0.000011,11,0.198566,0.22428,0,0.2,0.000226
9809143,9809143,,1,9,10,1,9,10,0,0.000009,0,9852,26,0.000011,7,0.260563,0.361047,7.85,0.344444,0.000233
9809146,9809146,,0,2,2,0,2,2,0,0.000022,0,27214,0,0.00001,15,0.162712,0.178576,0,0,0
9809148,9809148,,1,2,3,1,2,3,0.000024,0.000011,0,27215,30,0.00001,13,0.125136,0.134225,0.333333,0.166667,0.000219
9809150,9809150,,0,3,3,0,3,3,0,0.000001,0,27216,52,0.00001,4,0.391304,0.481481,0,0.333333,0
9809155,9809155,,0,1,1,0,1,1,0,0.000001,0,27217,22,0.00001,5,0.304348,0.402381,0,0,0
9809166,9809166,,0,5,5,0,5,5,0,0.002606,0,27218,30,0.00001,16,0.164198,0.185412,0,0.35,0
9809169,9809169,,0,7,7,0,7,7,0,0,0,27219,23,0.00001,4,0.470588,0.640625,0,0.095238,0
9809181,9809181,,0,37,37,0,37,37,0,0.003768,0,27220,4,0.00001,12,0.208736,0.242451,0,0.216967,0
9809186,9809186,,0,7,7,0,7,7,0,0.000055,0,27221,0,0.00001,8,0.205815,0.23546,0,0.119048,0
9809191,9809191,,1,2,3,1,2,3,0,0,0,14783,9,0.000012,1,1,1,3,0.166667,0.000226
9305177,9305177,,1,0,1,1,0,1,0,0,0,14782,9,0.000015,0,0,0,0,0,0.000226
9809200,9809200,,0,1,1,0,1,1,0,0.000001,0,27222,5,0.00001,17,0.121006,0.132929,0,0,0
9809201,9809201,,0,5,5,0,5,5,0,0.000106,0,27223,23,0.00001,10,0.179462,0.198628,0,0.1,0
9809203,9809203,,1,19,20,1,19,20,0,0.000021,0,11732,28,0.00001,13,0.150136,0.177453,34469.190586,0.139474,0.000226
9809205,9809205,,0,1,1,0,1,1,0,0.000027,0,27224,13,0.00001,9,0.219937,0.253098,0,0,0
9809211,9809211,,0,15,15,0,15,15,0,0.000032,0,27225,5,0.00001,12,0.153487,0.174903,0,0.109524,0
9811062,9811062,,0,3,3,0,3,3,0,0.000002,0,27227,9,0.00001,1,1,1,0,0.166667,0
9807162,9807162,,1,0,1,1,0,1,0,0,0,27226,9,0.000013,0,0,0,0,0,0.000219
9809216,9809216,,1,1,2,1,1,2,0,0,0,27228,5,0.000013,1,1,1,0.5,0,0.000219
9810007,9810007,,0,2,2,0,2,2,0,0.000008,0,27229,23,0.00001,3,0.5,0.595238,0,0.5,0
9810009,9810009,,0,2,2,0,2,2,0,0.000002,0,27230,5,0.00001,17,0.121016,0.133256,0,0.5,0
9810016,9810016,,0,8,8,0,8,8,0,0.000007,0,27231,23,0.00001,9,0.209662,0.272933,0,0.232143,0
9810023,9810023,,0,23,23,0,23,23,0,0.005318,0,27232,2,0.00001,14,0.190933,0.220062,0,0.201581,0
9810027,9810027,,0,24,24,0,24,24,0,0.000139,0,27233,17,0.00001,10,0.3,0.410537,0,0.047101,0
9810036,9810036,,0,5,5,0,5,5,0,0.000371,0,27234,17,0.00001,17,0.142126,0.161437,0,0.25,0
9810039,9810039,,0,3,3,0,3,3,0,0.000898,0,27235,13,0.00001,11,0.195099,0.216868,0,0.166667,0
9810045,9810045,,0,3,3,0,3,3,0,0,0,27237,6,0.00001,7,0.222222,0.330519,0,0,0
9707254,9707254,,1,0,1,1,0,1,0,0,0,27236,6,0.000013,0,0,0,0,0,0.000219
9810047,9810047,,0,5,5,0,5,5,0,0.000048,0,27238,2,0.00001,14,0.176746,0.199038,0,0.25,0
9810052,9810052,,0,14,14,0,14,14,0,0.000034,0,27239,26,0.00001,16,0.140186,0.157409,0,0.115385,0
9810054,9810054,,0,2,2,0,2,2,0,0.000004,0,27240,41,0.00001,5,0.265432,0.299419,0,0,0
9810056,9810056,,0,10,10,0,10,10,0,0.000011,0,27241,20,0.00001,20,0.114818,0.141772,0,0.077778,0
9810060,9810060,,0,29,29,0,29,29,0,0.014557,0,27242,2,0.00001,14,0.201023,0.234566,0,0.188424,0
9810071,9810071,,0,8,8,0,8,8,0,0.000005,0,27243,22,0.00001,10,0.157324,0.227773,0,0.071429,0
9810073,9810073,,2,9,11,2,9,11,0.000011,0.000474,0,27244,22,0.000011,6,0.240642,0.328704,2.5,0.254545,0.000438
9810074,9810074,,0,2,2,0,2,2,0,0,0,27245,22,0.00001,3,0.428571,0.518519,0,0,0
9810077,9810077,,0,2,2,0,2,2,0,0.000007,0,27247,5,0.00001,2,0.6,0.666667,0,0,0
9802172,9802172,,1,0,1,1,0,1,0,0,0,27246,5,0.000014,0,0,0,0,0,0.000219
9810079,9810079,,0,1,1,0,1,1,0,0,87,27248,109,0.00001,2,0.6,0.666667,0,0,0
9810082,9810082,,0,5,5,0,5,5,0,0,0,27249,20,0.00001,9,0.163875,0.20612,0,0.1,0
9810083,9810083,,0,28,28,0,28,28,0,0.01448,0,27250,1,0.00001,13,0.201659,0.236645,0,0.210317,0
9810096,9810096,,0,4,4,0,4,4,0,0.000016,0,27251,6,0.00001,16,0.146159,0.162633,0,0.083333,0
9810097,9810097,,0,5,5,0,5,5,0,0.001913,0,27252,2,0.00001,14,0.178103,0.200297,0,0.5,0
9810100,9810100,,0,3,3,0,3,3,0,0.00002,0,27253,15,0.00001,17,0.15451,0.171726,0,0.333333,0
9810108,9810108,,1,1,2,1,1,2,0,0,0,27254,23,0.000013,1,1,1,0,0.5,0.000219
9810111,9810111,,0,2,2,0,2,2,0,0.000033,0,27255,4,0.00001,15,0.17882,0.200871,0,0,0
9810122,9810122,,0,1,1,0,1,1,0,0,130,27257,152,0.00001,1,1,1,0,0,0
9804207,9804207,,1,0,1,1,0,1,0,0,130,27256,152,0.000019,0,0,0,0,0,0.000219
9810124,9810124,,0,2,2,0,2,2,0,0,0,27258,6,0.00001,2,0.6,0.666667,0,0,0
9810133,9810133,,0,1,1,0,1,1,0,0,0,27259,28,0.00001,2,0.666667,0.75,0,0,0
9810143,9810143,,0,5,5,0,5,5,0,0.000027,0,27260,28,0.00001,2,0.857143,0.916667,0,0.45,0
9810162,9810162,,0,3,3,0,3,3,0,0.000001,0,27261,23,0.00001,14,0.152389,0.167647,0,0.333333,0
9810166,9810166,,0,2,2,0,2,2,0,0,0,27262,23,0.00001,1,1,1,0,0.5,0
9810172,9810172,,0,2,2,0,2,2,0,0.000165,0,27263,28,0.00001,13,0.178565,0.198967,0,0,0
9810173,9810173,,0,2,2,0,2,2,0,0,0,27264,28,0.00001,1,1,1,0,0.5,0
9810180,9810180,,0,23,23,0,23,23,0,0.008338,0,27265,13,0.00001,12,0.203074,0.233531,0,0.183794,0
9810197,9810197,,0,1,1,0,1,1,0,0,0,27266,23,0.00001,2,0.6,0.666667,0,0,0
9810208,9810208,,0,4,4,0,4,4,0,0.000013,0,27267,9,0.00001,5,0.330645,0.382724,0,0.416667,0
9810209,9810209,,0,1,1,0,1,1,0,0,0,27268,9,0.00001,6,0.275148,0.299821,0,0,0
9810216,9810216,,0,1,1,0,1,1,0,0.000001,0,27269,4,0.00001,14,0.141084,0.155655,0,0,0
9810217,9810217,,0,7,7,0,7,7,0,0.000002,0,27270,23,0.00001,10,0.171311,0.212254,0,0.333333,0
9810218,9810218,,0,2,2,0,2,2,0,0.000002,0,27271,8,0.00001,2,0.666667,0.75,0,0,0
9810222,9810222,,0,14,14,0,14,14,0,0.000462,0,27272,23,0.00001,15,0.160667,0.177878,0,0.159341,0
9810232,9810232,,0,1,1,0,1,1,0,0,0,27273,28,0.00001,11,0.160979,0.182642,0,0,0
9810247,9810247,,2,1,3,2,1,3,0,0,131,27275,153,0.000022,1,1,1,0,0.5,0.000451
9809170,9809170,,3,0,3,3,0,3,0,0,131,27274,153,0.000043,0,0,0,0,0.5,0.000684
9810249,9810249,,0,2,2,0,2,2,0,0,0,27276,23,0.00001,9,0.19144,0.210892,0,0.5,0
9810252,9810252,,0,2,2,0,2,2,0,0.000006,0,27277,1,0.00001,2,0.75,0.833333,0,0.5,0
9811003,9811003,,0,12,12,0,12,12,0,0.000444,0,27278,22,0.00001,11,0.211746,0.240011,0,0.143939,0
9811009,9811009,,0,9,9,0,9,9,0,0.000154,0,27279,13,0.00001,10,0.186447,0.234732,0,0.111111,0
9811014,9811014,,0,3,3,0,3,3,0,0.000001,0,27280,22,0.00001,17,0.125731,0.136108,0,0.333333,0
9811018,9811018,,2,1,3,2,1,3,0,0,0,27281,23,0.000012,7,0.222812,0.241204,366.590476,0,0.000445
9811020,9811020,,0,1,1,0,1,1,0,0,0,27282,22,0.00001,3,0.380952,0.4375,0,0,0
9811029,9811029,,0,2,2,0,2,2,0,0.000134,0,27283,2,0.00001,14,0.168104,0.183044,0,0,0
9811040,9811040,,0,1,1,0,1,1,0,0.000056,0,27284,4,0.00001,13,0.17612,0.194049,0,0,0
9811046,9811046,,0,2,2,0,2,2,0,0,0,27285,5,0.00001,1,1,1,0,0.5,0
9811061,9811061,,0,1,1,0,1,1,0,0,0,27286,6,0.00001,12,0.141129,0.166989,0,0,0
9811078,9811078,,0,12,12,0,12,12,0,0.001804,0,27287,5,0.00001,13,0.196265,0.226664,0,0.106061,0
9811080,9811080,,0,16,16,0,16,16,0,0.004378,0,27288,0,0.00001,12,0.192284,0.223743,0,0.2625,0
9811085,9811085,,0,2,2,0,2,2,0,0.000001,0,27289,20,0.00001,6,0.320988,0.392949,0,0,0
9811086,9811086,,0,1,1,0,1,1,0,0.001027,0,27290,4,0.00001,6,0.262295,0.292839,0,0,0
9811091,9811091,,0,1,1,0,1,1,0,0,0,27291,28,0.00001,1,1,1,0,0,0
9811093,9811093,,0,86,86,0,86,86,0,0.020804,0,27292,13,0.00001,16,0.215131,0.279254,0,0.095622,0
9811095,9811095,,0,3,3,0,3,3,0,0,0,27294,5,0.00001,11,0.133042,0.150715,0,0,0
9810033,9810033,,1,0,1,1,0,1,0,0,0,27293,5,0.000013,0,0,0,0,0,0.000219
9811104,9811104,,0,2,2,0,2,2,0,0.000001,0,27295,23,0.00001,12,0.163973,0.177083,0,0.5,0
9811115,9811115,,0,7,7,0,7,7,0,0.000004,0,27296,26,0.00001,11,0.142979,0.162648,0,0.238095,0
9811123,9811123,,0,1,1,0,1,1,0,0,0,27297,9,0.00001,1,1,1,0,0,0
9811124,9811124,,0,7,7,0,7,7,0,0.000124,0,27298,4,0.00001,8,0.230908,0.270933,0,0.309524,0
9811125,9811125,,1,2,3,1,2,3,0,0,0,27300,20,0.000012,1,1,1,2,0,0.000219
9508172,9508172,,1,0,1,1,0,1,0,0,0,27299,20,0.000015,0,0,0,0,0,0.000226
9811127,9811127,,0,3,3,0,3,3,0,0.00186,0,27301,4,0.00001,16,0.160472,0.178045,0,0.5,0
9811135,9811135,,0,1,1,0,1,1,0,0,0,27302,30,0.00001,4,0.342105,0.371795,0,0,0
9811136,9811136,,0,2,2,0,2,2,0,0.000016,0,27303,13,0.00001,17,0.128368,0.144748,0,0.5,0
9811137,9811137,,1,1,2,1,1,2,0,0,0,27304,23,0.000028,1,1,1,2,0,0.000232
9811142,9811142,,0,1,1,0,1,1,0,0,132,27306,154,0.00001,1,1,1,0,0,0
9806172,9806172,,1,0,1,1,0,1,0,0,132,27305,154,0.000019,0,0,0,0,0,0.000219
9811153,9811153,,0,1,1,0,1,1,0,0,0,27307,8,0.00001,2,0.666667,0.75,0,0,0
9811190,9811190,,0,2,2,0,2,2,0,0.000001,0,27308,23,0.00001,1,1,1,0,0,0
9811197,9811197,,0,2,2,0,2,2,0,0.000199,0,27309,52,0.00001,17,0.154492,0.175264,0,0.5,0
9811200,9811200,,1,17,18,1,17,18,0.000029,0.000117,0,27310,4,0.00001,16,0.170196,0.194187,356.94188,0.117647,0.000219
9811202,9811202,,0,6,6,0,6,6,0,0.000001,0,27311,21,0.00001,10,0.156516,0.177627,0,0.3,0
9811204,9811204,,0,10,10,0,10,10,0,0.000801,0,27312,2,0.00001,14,0.17498,0.194191,0,0.255556,0
9811205,9811205,,0,12,12,0,12,12,0,0.000064,0,27313,17,0.00001,4,0.358407,0.446502,0,0.166667,0
9811206,9811206,,0,4,4,0,4,4,0,0,0,27314,26,0.00001,10,0.161378,0.17696,0,0,0
9811221,9811221,,1,7,8,1,7,8,0,0.000015,0,27315,28,0.000011,6,0.336364,0.467117,11,0.25,0.000219
9811227,9811227,,0,3,3,0,3,3,0,0,0,27316,6,0.00001,1,1,1,0,0,0
9811242,9811242,,0,5,5,0,5,5,0,0.000001,0,27317,5,0.00001,10,0.169462,0.201664,0,0.25,0
9811247,9811247,,0,2,2,0,2,2,0,0,0,27318,26,0.00001,5,0.326531,0.403125,0,0,0
9811249,9811249,,1,26,27,1,26,27,0.000002,0.000043,0,27319,26,0.00001,15,0.162819,0.182565,1295.298657,0.074074,0.000226
9811250,9811250,,0,1,1,0,1,1,0,0,0,27320,28,0.00001,3,0.5,0.583333,0,0,0
9811253,9811253,,0,6,6,0,6,6,0,0.000001,0,27321,21,0.00001,14,0.137835,0.153457,0,0.266667,0
9811255,9811255,,0,9,9,0,9,9,0,0.000025,0,27322,26,0.00001,16,0.142735,0.159905,0,0.222222,0
9812001,9812001,,0,7,7,0,7,7,0,0.00001,0,27323,23,0.00001,10,0.215496,0.290527,0,0.214286,0
9812018,9812018,,0,4,4,0,4,4,0,0.000099,0,27324,13,0.00001,14,0.172269,0.195151,0,0.25,0
9812020,9812020,,0,4,4,0,4,4,0,0.000002,0,27325,23,0.00001,3,0.481481,0.589744,0,0.083333,0
9812033,9812033,,0,12,12,0,12,12,0,0.000004,0,27326,23,0.00001,7,0.255747,0.359123,0,0.068182,0
9812053,9812053,,0,15,15,0,15,15,0,0.002543,0,27327,2,0.00001,15,0.167802,0.200161,0,0.185714,0
9812058,9812058,,1,8,9,1,8,9,0,0.000009,0,27328,2,0.000011,16,0.139031,0.16172,163.044877,0.166667,0.000219
9812079,9812079,,0,11,11,0,11,11,0,0.013867,0,27329,1,0.00001,13,0.193643,0.22169,0,0.136364,0
9511211,9511211,,1,0,1,1,0,1,0.000006,0,0,11268,23,0.000013,0,0,0,0,0,0.000226
9812102,9812102,,0,3,3,0,3,3,0,0.000001,0,27330,22,0.00001,4,0.4375,0.535714,0,0.166667,0
9812122,9812122,,0,3,3,0,3,3,0,0.000011,0,27331,20,0.00001,20,0.118658,0.150245,0,0.166667,0
9812131,9812131,,1,3,4,1,3,4,0,0.000002,0,27332,23,0.000011,1,1,1,1,0,0.000219
9812134,9812134,,0,8,8,0,8,8,0,0.011337,0,27333,1,0.00001,13,0.195082,0.21639,0,0.160714,0
9812142,9812142,,0,17,17,0,17,17,0,0.002835,0,27334,13,0.00001,12,0.198379,0.225437,0,0.073529,0
9812151,9812151,,0,8,8,0,8,8,0,0.000034,0,27335,6,0.00001,10,0.177753,0.214901,0,0.071429,0
9812152,9812152,,0,7,7,0,7,7,0,0.000087,0,27336,28,0.00001,14,0.172376,0.192867,0,0.214286,0
9812156,9812156,,0,3,3,0,3,3,0,0.000006,0,27337,0,0.00001,5,0.30303,0.362917,0,0.166667,0
9812168,9812168,,1,1,2,1,1,2,0.000003,0.00001,0,27338,2,0.000012,16,0.162734,0.185128,206.81858,0,0.000219
9812176,9812176,,1,2,3,1,2,3,0,0,0,27339,26,0.000011,11,0.157255,0.175683,3,0.166667,0.000219
9812178,9812178,,0,1,1,0,1,1,0,0,0,27340,28,0.00001,3,0.5,0.555556,0,0,0
9812181,9812181,,0,9,9,0,9,9,0,0.001179,0,27341,26,0.00001,14,0.183601,0.214451,0,0.013889,0
9812183,9812183,,0,15,15,0,15,15,0,0.009678,0,27342,26,0.00001,13,0.196187,0.220211,0,0.152381,0
9812185,9812185,,0,4,4,0,4,4,0,0.000006,0,27343,23,0.00001,2,0.833333,0.9,0,0.5,0
9812200,9812200,,1,18,19,1,18,19,0.000039,0.003962,0,27344,2,0.000011,12,0.199577,0.228098,622.364653,0.222222,0.000219
9812201,9812201,,0,10,10,0,10,10,0,0.001784,0,27345,0,0.00001,11,0.215031,0.246007,0,0.077778,0
9812220,9812220,,0,11,11,0,11,11,0,0.016395,0,27346,41,0.00001,13,0.182671,0.205465,0,0.390909,0
9812222,9812222,,0,3,3,0,3,3,0,0,0,27347,8,0.00001,2,0.8,0.875,0,0.166667,0
9812244,9812244,,0,6,6,0,6,6,0,0.000041,0,27348,28,0.00001,16,0.15337,0.174551,0,0.133333,0
9812246,9812246,,1,2,3,1,2,3,0,0,131,27349,153,0.000015,1,1,1,0,0.5,0.000226
9812248,9812248,,0,1,1,0,1,1,0,0,0,27350,20,0.00001,2,0.666667,0.75,0,0,0
9812254,9812254,,1,3,4,1,3,4,0,0,131,27351,153,0.000019,1,1,1,3,0.25,0.000219
9901005,9901005,,0,11,11,0,11,11,0,0.000287,0,27352,0,0.00001,15,0.170945,0.200407,0,0.418182,0
9901013,9901013,,0,1,1,0,1,1,0,0,131,27353,153,0.00001,2,0.571429,0.625,0,0,0
9901015,9901015,,0,1,1,0,1,1,0,0,0,27354,6,0.00001,1,1,1,0,0,0
9901019,9901019,,0,3,3,0,3,3,0,0,0,27355,28,0.00001,6,0.211823,0.275581,0,0.333333,0
9901024,9901024,,1,10,11,1,10,11,0,0.000009,0,27356,26,0.000012,8,0.190231,0.256057,3.4,0.236364,0.000219
9901062,9901062,,0,5,5,0,5,5,0,0.003514,0,27357,2,0.00001,15,0.191362,0.217747,0,0.45,0
9901070,9901070,,3,3,6,3,3,6,0,0.000002,0,11760,26,0.000018,16,0.122543,0.137363,3075.888776,0.2,0.000677
9901127,9901127,,0,4,4,0,4,4,0,0.000034,0,27358,2,0.00001,12,0.155729,0.172288,0,0.083333,0
9901138,9901138,,1,4,5,1,4,5,0,0.000001,0,27359,23,0.000012,13,0.165059,0.18246,114.475452,0.25,0.000219
9901155,9901155,,0,14,14,0,14,14,0,0.00028,0,27360,26,0.00001,12,0.189012,0.212309,0,0.087912,0
9901156,9901156,,0,2,2,0,2,2,0,0.000005,0,27361,17,0.00001,2,0.666667,0.75,0,0,0
9901165,9901165,,2,2,4,2,2,4,0,0.000001,0,27362,23,0.000013,8,0.187632,0.205926,90,0.333333,0.000445
9902009,9902009,,0,1,1,0,1,1,0,0.000087,0,27363,2,0.00001,12,0.175691,0.19362,0,0,0
9902019,9902019,,0,9,9,0,9,9,0,0.000004,0,27364,28,0.00001,10,0.178122,0.219982,0,0.25,0
9902021,9902021,,0,1,1,0,1,1,0,0,133,27366,155,0.00001,1,1,1,0,0,0
9305102,9305102,,1,0,1,1,0,1,0,0,133,27365,155,0.000019,0,0,0,0,0,0.000219
9902025,9902025,,1,4,5,1,4,5,0,0.000004,0,27367,8,0.000011,3,0.521739,0.625,0,0.25,0.000219
9902026,9902026,,0,7,7,0,7,7,0,0.000008,0,27368,22,0.00001,11,0.177563,0.206952,0,0.404762,0
9902036,9902036,,0,12,12,0,12,12,0,0.000002,0,27369,26,0.00001,13,0.167676,0.199436,0,0.128788,0
9902041,9902041,,1,1,2,1,1,2,0.000013,0.000468,0,27370,4,0.000011,1,1,1,1,0,0.000219
9902061,9902061,,0,1,1,0,1,1,0,0,134,27372,156,0.00001,1,1,1,0,0,0
9807073,9807073,,1,0,1,1,0,1,0,0,134,27371,156,0.000019,0,0,0,0,0,0.000219
9902077,9902077,,0,2,2,0,2,2,0,0.000016,0,27373,0,0.00001,3,0.5,0.595238,0,0.5,0
9902078,9902078,,0,6,6,0,6,6,0,0.003429,0,27374,2,0.00001,15,0.173559,0.196291,0,0.433333,0
9902089,9902089,,0,24,24,0,24,24,0,0.002481,0,27375,4,0.00001,15,0.183269,0.213315,0,0.097826,0
9902092,9902092,,0,23,23,0,23,23,0,0.005156,0,27376,0,0.00001,14,0.203097,0.246463,0,0.102767,0
9902096,9902096,,0,1,1,0,1,1,0,0.000001,0,27377,5,0.00001,4,0.4,0.46875,0,0,0
9902103,9902103,,0,21,21,0,21,21,0,0.000032,0,27378,26,0.00001,16,0.144103,0.161245,0,0.138095,0
9902136,9902136,,0,1,1,0,1,1,0,0,0,27379,20,0.00001,2,0.666667,0.75,0,0,0
9902148,9902148,,0,20,20,0,20,20,0,0.002087,0,27380,13,0.00001,16,0.188349,0.222346,0,0.236842,0
9902151,9902151,,0,19,19,0,19,19,0,0.000004,0,27381,6,0.00001,13,0.162225,0.211525,0,0.181287,0
9902159,9902159,,0,2,2,0,2,2,0,0,0,27382,22,0.00001,6,0.284264,0.327679,0,0,0
9902164,9902164,,0,7,7,0,7,7,0,0.000009,0,27383,23,0.00001,15,0.150133,0.180163,0,0.119048,0
9902169,9902169,,0,12,12,0,12,12,0,0.00232,0,27384,2,0.00001,13,0.180413,0.203818,0,0.143939,0
9902174,9902174,,0,1,1,0,1,1,0,0.000002,0,27385,3,0.00001,2,0.666667,0.75,0,0,0
9902185,9902185,,0,2,2,0,2,2,0,0,0,27386,22,0.00001,1,1,1,0,0.5,0
9902198,9902198,,0,4,4,0,4,4,0,0.000052,0,27387,0,0.00001,16,0.139277,0.157026,0,0,0
9811114,9811114,,1,0,1,1,0,1,0,0,0,15071,22,0.000012,0,0,0,0,0,0.000228
9902203,9902203,,0,6,6,0,6,6,0,0.001315,0,27388,4,0.00001,15,0.174736,0.204548,0,0.266667,0
9902206,9902206,,0,14,14,0,14,14,0,0.000753,0,27389,2,0.00001,12,0.213514,0.243463,0,0.307692,0
9903004,9903004,,0,1,1,0,1,1,0,0,0,27390,17,0.00001,1,1,1,0,0,0
9903013,9903013,,0,2,2,0,2,2,0,0.000006,0,27391,4,0.00001,17,0.147307,0.163748,0,0.5,0
9903015,9903015,,1,14,15,1,14,15,0.000017,0.001683,0,27392,13,0.00001,14,0.187646,0.216691,1133.149589,0.17619,0.000219
9903024,9903024,,0,14,14,0,14,14,0,0.000419,0,27393,4,0.00001,14,0.185173,0.208041,0,0.252747,0
9903034,9903034,,0,1,1,0,1,1,0,0,135,27395,157,0.00001,1,1,1,0,0,0
9711147,9711147,,1,0,1,1,0,1,0,0,135,27394,157,0.000019,0,0,0,0,0,0.000219
9903062,9903062,,0,3,3,0,3,3,0,0,129,27397,151,0.00001,1,1,1,0,0.166667,0
9210035,9210035,,1,0,1,1,0,1,0,0,129,27396,151,0.000013,0,0,0,0,0,0.000219
9903063,9903063,,2,4,6,2,4,6,0,0.000015,0,27398,23,0.000013,15,0.128969,0.148851,1047.105744,0.4,0.000445
9903069,9903069,,1,39,40,1,39,40,0,0.000146,0,27399,26,0.000011,13,0.169528,0.191958,5740.595637,0.036538,0.000219
9903071,9903071,,0,3,3,0,3,3,0,0.010453,0,27400,1,0.00001,15,0.176429,0.198378,0,0,0
9903074,9903074,,0,6,6,0,6,6,0,0.000355,0,27401,5,0.00001,14,0.157209,0.176805,0,0.2,0
9903084,9903084,,1,1,2,1,1,2,0,0,136,27403,160,0.000014,1,1,1,0,0.5,0.000219
9803008,9803008,,2,0,2,2,0,2,0,0,136,27402,160,0.000027,0,0,0,0,0.5,0.000445
9903100,9903100,,0,2,2,0,2,2,0,0.000005,0,27404,0,0.00001,12,0.173397,0.194853,0,0.5,0
9903108,9903108,,0,17,17,0,17,17,0,0.001431,0,27405,13,0.00001,13,0.185602,0.216195,0,0.198529,0
9903114,9903114,,0,4,4,0,4,4,0,0.000212,0,27406,28,0.00001,18,0.142522,0.16029,0,0.5,0
9903115,9903115,,1,12,13,1,12,13,0.000016,0.000453,0,27407,30,0.000011,14,0.194169,0.217944,721.316176,0.044872,0.000219
9903141,9903141,,0,15,15,0,15,15,0,0.000022,0,27408,22,0.00001,6,0.379679,0.496009,0,0.133333,0
9903150,9903150,,0,2,2,0,2,2,0,0.000001,0,27409,26,0.00001,2,0.625,0.7,0,0.5,0
9903154,9903154,,0,6,6,0,6,6,0,0.00114,0,27410,13,0.00001,15,0.195519,0.237065,0,0.166667,0
9903159,9903159,,0,5,5,0,5,5,0,0.000679,0,27411,3,0.00001,13,0.175611,0.196871,0,0.3,0
9903175,9903175,,0,3,3,0,3,3,0,0.000002,0,27412,28,0.00001,17,0.15348,0.171454,0,0.333333,0
9903177,9903177,,0,5,5,0,5,5,0,0.001264,0,27413,4,0.00001,14,0.169631,0.194024,0,0.25,0
9903179,9903179,,1,1,2,1,1,2,0,0,137,27415,158,0.000014,1,1,1,0,0.5,0.000219
9903171,9903171,,2,0,2,2,0,2,0,0,137,27414,158,0.000027,0,0,0,0,0.5,0.000445
9903180,9903180,,0,1,1,0,1,1,0,0,0,27416,23,0.00001,10,0.154304,0.168177,0,0,0
9903191,9903191,,0,7,7,0,7,7,0,0.000007,0,27417,6,0.00001,15,0.12115,0.137989,0,0.166667,0
9903197,9903197,,0,10,10,0,10,10,0,0.000008,0,27418,26,0.00001,10,0.186823,0.221502,0,0.177778,0
9903211,9903211,,0,4,4,0,4,4,0,0,0,27419,5,0.00001,3,0.5,0.578431,0,0.083333,0
9903218,9903218,,3,2,5,3,2,5,0.000025,0.000003,0,27420,28,0.000016,16,0.15133,0.166495,131.710633,0.3,0.00067
9903233,9903233,,0,23,23,0,23,23,0,0.006656,0,27421,2,0.00001,14,0.189533,0.217084,0,0.100791,0
9903235,9903235,,1,4,5,1,4,5,0,0,0,27422,23,0.000011,15,0.125436,0.138899,0,0.5,0.000219
9903262,9903262,,0,7,7,0,7,7,0,0.000024,0,27423,52,0.00001,19,0.114046,0.12493,0,0.119048,0
9903265,9903265,,0,3,3,0,3,3,0,0.000122,0,27425,5,0.00001,11,0.20699,0.233578,0,0,0
9207087,9207087,,1,0,1,1,0,1,0.000001,0,0,27424,5,0.000013,0,0,0,0,0,0.000219
9903268,9903268,,0,106,106,0,106,106,0,0.044321,0,27426,2,0.00001,13,0.231756,0.280595,0,0.050045,0
9904006,9904006,,0,1,1,0,1,1,0,0,0,27427,13,0.00001,11,0.165102,0.179382,0,0,0
9703173,9703173,,1,0,1,1,0,1,0,0,0,11315,2,0.00002,0,0,0,0,0,0.000227
9904034,9904034,,0,12,12,0,12,12,0,0.009116,0,27428,1,0.00001,15,0.181278,0.206882,0,0.295455,0
9904046,9904046,,1,1,2,1,1,2,0,0,0,11763,26,0.000015,2,0.6,0.666667,1.5,0,0.000226
9904049,9904049,,0,2,2,0,2,2,0,0,0,27429,6,0.00001,1,1,1,0,0,0
9904051,9904051,,0,7,7,0,7,7,0,0.006775,0,27430,1,0.00001,13,0.180317,0.201267,0,0.071429,0
9904060,9904060,,0,5,5,0,5,5,0,0.001253,0,27431,4,0.00001,13,0.160622,0.17993,0,0.15,0
9904066,9904066,,0,11,11,0,11,11,0,0.002282,0,27432,0,0.00001,19,0.15792,0.188455,0,0.272727,0
9904067,9904067,,0,3,3,0,3,3,0,0.000002,0,27433,28,0.00001,13,0.157107,0.170727,0,0,0
9904099,9904099,,0,5,5,0,5,5,0,0.000257,0,27434,1,0.00001,15,0.180045,0.20279,0,0.1,0
9904111,9904111,,0,13,13,0,13,13,0,0.001238,0,27435,30,0.00001,16,0.18948,0.212281,0,0.282051,0
9910073,9910073,,0,4,4,0,4,4,0,0.000117,0,27437,4,0.00001,8,0.208357,0.233909,0,0.25,0
9408168,9408168,,1,0,1,1,0,1,0.000001,0,0,27436,4,0.000012,0,0,0,0,0,0.000219
9904127,9904127,,0,13,13,0,13,13,0,0.000248,0,27438,0,0.00001,12,0.176609,0.199412,0,0.185897,0
9904128,9904128,,0,7,7,0,7,7,0,0.000628,0,27439,2,0.00001,14,0.177753,0.200902,0,0.261905,0
9904140,9904140,,0,6,6,0,6,6,0,0.00001,0,27440,26,0.00001,16,0.14519,0.162017,0,0.166667,0
9904144,9904144,,1,3,4,1,3,4,0,0,0,27441,26,0.000012,17,0.11216,0.126583,4,0.25,0.000219
9904154,9904154,,0,7,7,0,7,7,0,0.000002,0,27442,22,0.00001,5,0.377358,0.474583,0,0.285714,0
9904156,9904156,,0,2,2,0,2,2,0,0,0,27443,22,0.00001,5,0.32,0.375521,0,0,0
9904161,9904161,,0,2,2,0,2,2,0,0.000005,0,27444,13,0.00001,3,0.545455,0.638889,0,0.5,0
9904163,9904163,,0,2,2,0,2,2,0,0.010451,0,27445,1,0.00001,15,0.176381,0.198175,0,0,0
9904165,9904165,,0,28,28,0,28,28,0,0.014618,0,27446,1,0.00001,12,0.207515,0.238572,0,0.121693,0
9904166,9904166,,0,2,2,0,2,2,0,0.000017,0,27447,52,0.00001,14,0.150858,0.170451,0,0.5,0
9904170,9904170,,0,1,1,0,1,1,0,0,138,27449,159,0.00001,1,1,1,0,0,0
9812036,9812036,,1,0,1,1,0,1,0,0,138,27448,159,0.000019,0,0,0,0,0,0.000219
9904205,9904205,,1,4,5,1,4,5,0,0.000001,0,27450,23,0.000014,2,0.75,0.833333,2,0.25,0.000219
9904216,9904216,,0,6,6,0,6,6,0,0.000876,0,27451,0,0.00001,13,0.175181,0.196922,0,0.133333,0
9904215,9904215,,0,2,2,0,2,2,0,0.000005,0,27452,23,0.00001,5,0.289593,0.332031,0,0.5,0
9905003,9905003,,0,2,2,0,2,2,0,0.000001,0,27453,10,0.00001,1,1,1,0,0.5,0
9905017,9905017,,1,3,4,1,3,4,0,0.000086,0,17236,28,0.000015,15,0.153938,0.169853,30852.431834,0.083333,0.000239
9905021,9905021,,0,1,1,0,1,1,0,0,0,27454,30,0.00001,12,0.139154,0.14629,0,0,0
9905023,9905023,,0,8,8,0,8,8,0,0.000165,0,27455,4,0.00001,12,0.199155,0.231035,0,0.125,0
9905028,9905028,,0,8,8,0,8,8,0,0.000002,0,27456,26,0.00001,14,0.171664,0.198011,0,0.25,0
9905035,9905035,,0,5,5,0,5,5,0,0.000024,0,27457,26,0.00001,18,0.132131,0.145762,0,0.05,0
9905040,9905040,,0,1,1,0,1,1,0,0,0,27458,41,0.00001,1,1,1,0,0,0
9905045,9905045,,0,3,3,0,3,3,0,0.000449,0,27459,10,0.00001,5,0.314433,0.36612,0,0.333333,0
9905052,9905052,,0,6,6,0,6,6,0,0.000355,0,27460,4,0.00001,16,0.140849,0.157503,0,0.366667,0
9905058,9905058,,0,5,5,0,5,5,0,0.000003,0,27461,22,0.00001,14,0.138381,0.159317,0,0.35,0
9905060,9905060,,0,2,2,0,2,2,0,0,137,27462,158,0.00001,1,1,1,0,0.5,0
9905066,9905066,,0,7,7,0,7,7,0,0.000016,0,27463,23,0.00001,13,0.155738,0.179777,0,0.142857,0
9905074,9905074,,0,4,4,0,4,4,0,0.000006,0,27464,23,0.00001,7,0.234043,0.308052,0,0.333333,0
9905082,9905082,,0,3,3,0,3,3,0,0.000001,0,27465,22,0.00001,5,0.340426,0.444792,0,0,0
9905090,9905090,,1,2,3,1,2,3,0,0,0,27466,23,0.000019,3,0.470588,0.5625,8,0,0.000219
9905101,9905101,,0,3,3,0,3,3,0,0,0,27467,21,0.00001,2,0.666667,0.75,0,0.333333,0
9905102,9905102,,0,2,2,0,2,2,0,0.000002,0,27468,6,0.00001,1,1,1,0,0.5,0
9905106,9905106,,0,3,3,0,3,3,0,0,0,27469,26,0.00001,5,0.371429,0.455769,0,0.333333,0
9905107,9905107,,0,5,5,0,5,5,0,0.000001,0,27470,17,0.00001,13,0.144957,0.169566,0,0.45,0
9905120,9905120,,0,6,6,0,6,6,0,0.000004,0,27471,8,0.00001,4,0.47619,0.5875,0,0.266667,0
9905123,9905123,,0,4,4,0,4,4,0,0,0,27472,15,0.00001,2,0.833333,0.9,0,0,0
9905128,9905128,,0,6,6,0,6,6,0,0.000006,0,27473,28,0.00001,14,0.134757,0.146211,0,0.366667,0
9905145,9905145,,0,6,6,0,6,6,0,0.000205,0,27474,23,0.00001,8,0.239487,0.282281,0,0.033333,0
9905160,9905160,,0,19,19,0,19,19,0,0.012377,0,27475,30,0.00001,11,0.242012,0.275582,0,0.157895,0
9905164,9905164,,0,1,1,0,1,1,0,0,0,27476,6,0.00001,2,0.6,0.666667,0,0,0
9905188,9905188,,0,2,2,0,2,2,0,0.000003,0,27477,26,0.00001,9,0.181308,0.19717,0,0.5,0
9905197,9905197,,0,12,12,0,12,12,0,0.000004,0,27478,6,0.00001,6,0.319749,0.41732,0,0.106061,0
9905199,9905199,,0,8,8,0,8,8,0,0.000053,0,27479,26,0.00001,11,0.177992,0.217562,0,0.214286,0
9905207,9905207,,0,2,2,0,2,2,0,0,0,27480,26,0.00001,2,0.75,0.833333,0,0.5,0
9905216,9905216,,0,3,3,0,3,3,0,0.000014,0,27481,9,0.00001,11,0.172678,0.194617,0,0,0
9905231,9905231,,0,5,5,0,5,5,0,0.016341,0,27482,1,0.00001,13,0.182619,0.205519,0,0.4,0
9906014,9906014,,0,4,4,0,4,4,0,0.000002,0,27483,28,0.00001,4,0.370968,0.467391,0,0.25,0
9906015,9906015,,0,2,2,0,2,2,0,0,0,27484,22,0.00001,6,0.257143,0.3,0,0.5,0
9906024,9906024,,0,6,6,0,6,6,0,0.000021,0,27485,5,0.00001,7,0.237202,0.263477,0,0.3,0
9906025,9906025,,0,3,3,0,3,3,0,0.000005,0,27486,41,0.00001,17,0.123044,0.131978,0,0.333333,0
9906028,9906028,,0,16,16,0,16,16,0,0.000602,0,27487,0,0.00001,13,0.186847,0.219135,0,0.0875,0
9906042,9906042,,0,12,12,0,12,12,0,0.000378,0,27488,2,0.00001,13,0.169441,0.192756,0,0.272727,0
9906045,9906045,,1,9,10,1,9,10,0.000009,0.003607,0,27489,0,0.000012,14,0.200464,0.233228,3083.120692,0.2,0.000219
9908167,9908167,,0,11,11,0,11,11,0,0.010344,0,27490,1,0.00001,11,0.227615,0.257113,0,0.236364,0
9906078,9906078,,0,30,30,0,30,30,0,0.020304,0,27491,1,0.00001,13,0.201028,0.232149,0,0.178161,0
9906082,9906082,,0,5,5,0,5,5,0,0.001908,0,27492,4,0.00001,19,0.145451,0.170723,0,0.35,0
9906084,9906084,,0,26,26,0,26,26,0,0.006308,0,27493,2,0.00001,15,0.196887,0.226521,0,0.173846,0
9906086,9906086,,2,1,3,2,1,3,0,0,0,27494,23,0.00002,2,0.666667,0.75,3,0,0.000438
9906088,9906088,,0,1,1,0,1,1,0,0,0,27495,0,0.00001,11,0.164732,0.177733,0,0,0
9906097,9906097,,0,2,2,0,2,2,0,0,136,27496,160,0.00001,1,1,1,0,0.5,0
9906100,9906100,,0,1,1,0,1,1,0,0,0,27497,22,0.00001,4,0.384615,0.483333,0,0,0
9906104,9906104,,0,6,6,0,6,6,0,0.000001,0,27498,5,0.00001,15,0.148677,0.16288,0,0.066667,0
9906107,9906107,,0,2,2,0,2,2,0,0,0,27499,6,0.00001,2,0.75,0.833333,0,0,0
9906110,9906110,,0,1,1,0,1,1,0,0,0,27500,22,0.00001,2,0.666667,0.75,0,0,0
9906117,9906117,,0,3,3,0,3,3,0,0.000001,0,27501,20,0.00001,2,0.8,0.875,0,0.166667,0
9906132,9906132,,0,3,3,0,3,3,0,0.000042,0,27502,30,0.00001,2,0.8,0.875,0,0.166667,0
9906133,9906133,,0,1,1,0,1,1,0,0,139,27504,161,0.00001,1,1,1,0,0,0
9902020,9902020,,1,0,1,1,0,1,0,0,139,27503,161,0.000019,0,0,0,0,0,0.000219
9906138,9906138,,0,5,5,0,5,5,0,0.000023,0,27505,6,0.00001,12,0.159239,0.199518,0,0.35,0
9906150,9906150,,0,4,4,0,4,4,0,0.000003,0,27506,26,0.00001,16,0.145796,0.1587,0,0.333333,0
9906158,9906158,,0,2,2,0,2,2,0,0.000001,0,27507,23,0.00001,1,1,1,0,0,0
9906159,9906159,,0,9,9,0,9,9,0,0.000042,0,27508,9,0.00001,12,0.174995,0.203713,0,0.027778,0
9906171,9906171,,0,1,1,0,1,1,0,0,0,27509,5,0.00001,2,0.6,0.666667,0,0,0
9906177,9906177,,1,8,9,1,8,9,0.000027,0.000436,0,24527,13,0.000011,16,0.150651,0.172015,11.246885,0.208333,0.000226
9906178,9906178,,0,3,3,0,3,3,0,0.000086,0,27510,28,0.00001,15,0.153938,0.169853,0,0.166667,0
9906180,9906180,,0,18,18,0,18,18,0,0.000151,0,27511,26,0.00001,17,0.147233,0.165308,0,0.19281,0
9906205,9906205,,1,5,6,1,5,6,0,0.000002,0,27512,6,0.000013,10,0.178407,0.20917,270.9,0.1,0.000219
9906213,9906213,,1,2,3,1,2,3,0.000007,0.000003,0,27513,20,0.000012,1,1,1,2,0.166667,0.000219
9906231,9906231,,0,3,3,0,3,3,0,0,0,27514,25,0.00001,6,0.322581,0.495,0,0,0
9906233,9906233,,0,1,1,0,1,1,0,0,0,27515,2,0.00001,12,0.160594,0.171966,0,0,0
9906238,9906238,,1,12,13,1,12,13,0.000041,0.008509,0,11414,2,0.000012,12,0.201798,0.225209,18104.870667,0.115385,0.000226
9906245,9906245,,0,1,1,0,1,1,0,0,0,27516,23,0.00001,1,1,1,0,0,0
9907018,9907018,,0,1,1,0,1,1,0,0,0,27517,6,0.00001,8,0.17931,0.196319,0,0,0
9907033,9907033,,0,20,20,0,20,20,0,0.002745,0,27518,30,0.00001,15,0.19327,0.2183,0,0.178947,0
9907036,9907036,,0,28,28,0,28,28,0,0.005862,0,27519,2,0.00001,14,0.201645,0.231631,0,0.193122,0
9907037,9907037,,0,5,5,0,5,5,0,0.003664,0,27520,2,0.00001,13,0.181766,0.20391,0,0.2,0
9907040,9907040,,0,7,7,0,7,7,0,0.000002,0,27521,6,0.00001,11,0.183091,0.233981,0,0.214286,0
9907056,9907056,,0,2,2,0,2,2,0,0,0,27522,10,0.00001,1,1,1,0,0.5,0
9907064,9907064,,0,3,3,0,3,3,0,0,0,27523,22,0.00001,2,0.714286,0.8,0,0.166667,0
9907068,9907068,,0,9,9,0,9,9,0,0.000036,0,27524,6,0.00001,12,0.12537,0.177009,0,0.152778,0
9907069,9907069,,0,10,10,0,10,10,0,0.000008,0,27525,6,0.00001,12,0.157421,0.183356,0,0.322222,0
9907097,9907097,,0,3,3,0,3,3,0,0,0,27526,28,0.00001,3,0.5,0.625,0,0,0
9907104,9907104,,1,2,3,1,2,3,0.000023,0.00186,0,27527,4,0.000011,6,0.263804,0.29832,0,0.5,0.000219
9907105,9907105,,0,6,6,0,6,6,0,0,0,27528,6,0.00001,8,0.215736,0.264811,0,0.1,0
9907121,9907121,,0,5,5,0,5,5,0,0.000007,0,27529,9,0.00001,6,0.333333,0.436667,0,0.2,0
9907127,9907127,,0,4,4,0,4,4,0,0.000001,0,27530,23,0.00001,10,0.171313,0.191053,0,0.416667,0
9907130,9907130,,0,22,22,0,22,22,0,0.003541,0,27531,26,0.00001,14,0.195179,0.228774,0,0.127706,0
9907149,9907149,,0,7,7,0,7,7,0,0.00001,0,27532,23,0.00001,11,0.193164,0.232223,0,0.095238,0
9907150,9907150,,0,3,3,0,3,3,0,0.000507,0,27533,0,0.00001,14,0.181557,0.200554,0,0,0
9907167,9907167,,2,5,7,2,5,7,0,0,0,27534,6,0.000012,11,0.148094,0.171024,0,0.452381,0.000445
9907172,9907172,,0,11,11,0,11,11,0,0.000489,0,27535,26,0.00001,15,0.162064,0.177173,0,0.081818,0
9907173,9907173,,0,11,11,0,11,11,0,0.000474,0,27536,22,0.00001,6,0.245283,0.346154,0,0.2,0
9907174,9907174,,0,11,11,0,11,11,0,0.000478,0,27537,22,0.00001,6,0.246649,0.347826,0,0.145455,0
9910242,9910242,,0,6,6,0,6,6,0,0.00009,0,27538,41,0.00001,4,0.428571,0.534722,0,0.133333,0
9907187,9907187,,0,1,1,0,1,1,0,0.000006,0,27539,2,0.00001,13,0.148444,0.159316,0,0,0
9907193,9907193,,0,3,3,0,3,3,0,0.00002,0,27540,13,0.00001,15,0.178016,0.195016,0,0.5,0
9907195,9907195,,0,2,2,0,2,2,0,0,0,27541,28,0.00001,1,1,1,0,0,0
9907196,9907196,,0,2,2,0,2,2,0,0,0,27542,23,0.00001,1,1,1,0,0,0
9907198,9907198,,1,0,1,1,0,1,0,0,0,10232,0,0.000014,0,0,0,0,0,0.000227
9908002,9908002,,0,6,6,0,6,6,0,0.010489,0,27543,0,0.00001,13,0.181367,0.20344,0,0.133333,0
9908015,9908015,,1,2,3,1,2,3,0,0,0,27544,22,0.000013,2,0.625,0.7,0.5,0.333333,0.000219
9908026,9908026,,0,6,6,0,6,6,0,0.00002,0,27545,4,0.00001,18,0.174897,0.194091,0,0,0
9908039,9908039,,0,8,8,0,8,8,0,0.004009,0,27546,2,0.00001,14,0.193116,0.224117,0,0.214286,0
9908049,9908049,,0,63,63,0,63,63,0,0.017495,0,27547,0,0.00001,12,0.217951,0.255575,0,0.092678,0
9908051,9908051,,0,28,28,0,28,28,0,0.000052,0,27548,23,0.00001,13,0.175568,0.198063,0,0.048942,0
9908053,9908053,,0,9,9,0,9,9,0,0.001832,0,27549,2,0.00001,15,0.18481,0.208723,0,0.097222,0
9908057,9908057,,0,5,5,0,5,5,0,0,0,27550,21,0.00001,7,0.233025,0.284169,0,0.15,0
9908058,9908058,,0,2,2,0,2,2,0,0,0,27552,23,0.00001,1,1,1,0,0,0
9708155,9708155,,1,0,1,1,0,1,0,0,0,27551,23,0.000014,0,0,0,0,0,0.000219
9908059,9908059,,0,13,13,0,13,13,0,0.000018,0,27553,23,0.00001,14,0.13705,0.151831,0,0.25,0
9908061,9908061,,1,8,9,1,8,9,0.000213,0.001334,0,27554,8,0.00001,13,0.166986,0.182159,0.5,0.472222,0.000219
9908063,9908063,,0,12,12,0,12,12,0,0.003491,0,27555,0,0.00001,15,0.174416,0.20052,0,0.083333,0
9908068,9908068,,0,7,7,0,7,7,0,0.000033,0,27556,5,0.00001,20,0.144243,0.19038,0,0.238095,0
9908071,9908071,,0,13,13,0,13,13,0,0.003299,0,27557,2,0.00001,13,0.195054,0.222599,0,0.294872,0
9908077,9908077,,0,14,14,0,14,14,0,0.017918,0,27558,1,0.00001,11,0.227316,0.258052,0,0.21978,0
9908078,9908078,,0,2,2,0,2,2,0,0.000003,0,27559,20,0.00001,3,0.473684,0.555556,0,0,0
9908079,9908079,,1,3,4,1,3,4,0,0,0,27560,28,0.000012,7,0.183267,0.244772,0,0.416667,0.000219
9908081,9908081,,0,5,5,0,5,5,0,0.000003,0,27561,23,0.00001,4,0.426471,0.505747,0,0.05,0
9908083,9908083,,0,8,8,0,8,8,0,0.00035,0,27562,30,0.00001,15,0.168955,0.191976,0,0.053571,0
9908086,9908086,,0,6,6,0,6,6,0,0.005092,0,27563,13,0.00001,13,0.18881,0.217103,0,0.033333,0
9908098,9908098,,0,3,3,0,3,3,0,0.000027,0,27564,22,0.00001,13,0.173585,0.194787,0,0.166667,0
9908103,9908103,,0,3,3,0,3,3,0,0.00001,0,27565,28,0.00001,5,0.393939,0.515385,0,0.5,0
9908108,9908108,,0,5,5,0,5,5,0,0.000777,0,27566,0,0.00001,15,0.176166,0.202739,0,0.15,0
9908111,9908111,,0,5,5,0,5,5,0,0.000001,0,27567,23,0.00001,12,0.175925,0.191946,0,0.25,0
9908117,9908117,,0,1,1,0,1,1,0,0.000004,0,27568,9,0.00001,14,0.146401,0.156317,0,0,0
9908118,9908118,,0,7,7,0,7,7,0,0.001934,0,27569,4,0.00001,12,0.18116,0.206495,0,0.166667,0
9908122,9908122,,0,4,4,0,4,4,0,0.000117,0,27570,0,0.00001,13,0.176393,0.196985,0,0.166667,0
9908159,9908159,,0,3,3,0,3,3,0,0,0,27571,6,0.00001,11,0.159105,0.178619,0,0.333333,0
9908164,9908164,,0,6,6,0,6,6,0,0.000178,0,27572,4,0.00001,13,0.171653,0.191256,0,0.333333,0
9908168,9908168,,0,1,1,0,1,1,0,0,0,27573,22,0.00001,2,0.666667,0.75,0,0,0
9908183,9908183,,0,3,3,0,3,3,0,0.000174,0,27574,1,0.00001,14,0.156558,0.170084,0,0.5,0
9908185,9908185,,0,6,6,0,6,6,0,0.000014,0,27575,52,0.00001,12,0.151309,0.16602,0,0.133333,0
9908190,9908190,,0,5,5,0,5,5,0,0.000021,0,27576,4,0.00001,16,0.16899,0.191062,0,0.1,0
9908191,9908191,,0,1,1,0,1,1,0,0.000068,0,27577,4,0.00001,4,0.308333,0.351351,0,0,0
9908194,9908194,,0,1,1,0,1,1,0,0.000008,0,27578,23,0.00001,1,1,1,0,0,0
9908195,9908195,,0,3,3,0,3,3,0,0.000022,0,27579,26,0.00001,15,0.1476,0.157999,0,0.166667,0
9908199,9908199,,0,90,90,0,90,90,0,0.039095,0,27580,4,0.00001,11,0.251538,0.29735,0,0.061798,0
9908200,9908200,,0,3,3,0,3,3,0,0,0,27581,22,0.00001,3,0.5625,0.648148,0,0.166667,0
9908205,9908205,,0,2,2,0,2,2,0,0,14,27583,162,0.00001,1,1,1,0,0,0
9902050,9902050,,1,0,1,1,0,1,0,0,14,27582,162,0.000014,0,0,0,0,0,0.000219
9908206,9908206,,0,1,1,0,1,1,0,0,0,27584,9,0.00001,5,0.276316,0.330952,0,0,0
9908207,9908207,,0,2,2,0,2,2,0,0.000002,0,27585,26,0.00001,4,0.395833,0.460526,0,0,0
9908209,9908209,,0,14,14,0,14,14,0,0.000647,0,27586,0,0.00001,13,0.179617,0.210249,0,0.203297,0
9909002,9909002,,0,12,12,0,12,12,0,0.000001,0,27589,22,0.00001,4,0.445455,0.545918,0,0.030303,0
9401168,9401168,,1,0,1,1,0,1,0,0,0,27588,22,0.000011,0,0,0,0,0,0.000219
9403184,9403184,,1,0,1,1,0,1,0,0,0,27587,22,0.000011,0,0,0,0,0,0.000219
9909008,9909008,,0,1,1,0,1,1,0,0,0,27590,22,0.00001,2,0.666667,0.75,0,0,0
9909009,9909009,,0,4,4,0,4,4,0,0,0,27591,26,0.00001,1,1,1,0,0.083333,0
9909012,9909012,,0,5,5,0,5,5,0,0.000004,0,27592,3,0.00001,13,0.161494,0.177971,0,0.1,0
9909024,9909024,,0,3,3,0,3,3,0,0.000001,0,27593,8,0.00001,2,0.8,0.875,0,0.166667,0
9909029,9909029,,0,8,8,0,8,8,0,0.000017,0,27594,28,0.00001,5,0.342105,0.465385,0,0.25,0
9909045,9909045,,0,4,4,0,4,4,0,0.000001,0,27596,28,0.00001,11,0.155981,0.17912,0,0,0
9810037,9810037,,1,0,1,1,0,1,0,0,0,27595,28,0.000012,0,0,0,0,0,0.000219
9909050,9909050,,0,8,8,0,8,8,0,0.001105,0,27597,4,0.00001,13,0.180181,0.200721,0,0.107143,0
9909054,9909054,,0,11,11,0,11,11,0,0.000492,0,27598,0,0.00001,14,0.182417,0.20362,0,0.336364,0
9909055,9909055,,0,6,6,0,6,6,0,0.000121,0,27599,23,0.00001,13,0.171958,0.188278,0,0.033333,0
9909060,9909060,,2,3,5,2,3,5,0.000005,0.000437,0,27600,30,0.000021,14,0.177074,0.194215,7747,0.3,0.000438
9909066,9909066,,1,8,9,1,8,9,0,0.000004,0,27601,23,0.000011,8,0.19061,0.222361,175.5,0.111111,0.000219
9909069,9909069,,0,8,8,0,8,8,0,0.000552,0,27602,1,0.00001,12,0.194986,0.215675,0,0.214286,0
9909074,9909074,,0,1,1,0,1,1,0,0.000001,0,27603,28,0.00001,1,1,1,0,0,0
9909083,9909083,,0,1,1,0,1,1,0,0,0,27604,22,0.00001,1,1,1,0,0,0
9909084,9909084,,0,5,5,0,5,5,0,0,0,27605,21,0.00001,8,0.206284,0.265263,0,0.25,0
9909090,9909090,,0,10,10,0,10,10,0,0.000005,0,27606,23,0.00001,15,0.125727,0.141442,0,0.333333,0
9909093,9909093,,0,4,4,0,4,4,0,0.000704,0,27607,1,0.00001,14,0.181147,0.198469,0,0.5,0
9909096,9909096,,0,7,7,0,7,7,0,0.000241,0,27608,13,0.00001,14,0.174632,0.193039,0,0.404762,0
9909100,9909100,,0,5,5,0,5,5,0,0.000004,0,27609,23,0.00001,7,0.216049,0.256857,0,0.1,0
9909105,9909105,,0,16,16,0,16,16,0,0.004202,0,27610,2,0.00001,15,0.186873,0.213191,0,0.229167,0
9909113,9909113,,0,2,2,0,2,2,0,0,0,27612,26,0.00001,9,0.174948,0.192134,0,0,0
9606020,9606020,,1,0,1,1,0,1,0,0,0,27611,26,0.000014,0,0,0,0,0,0.000219
9909115,9909115,,0,11,11,0,11,11,0,0.000008,0,27613,23,0.00001,16,0.138255,0.159042,0,0.154545,0
9909117,9909117,,0,3,3,0,3,3,0,0.000066,0,27615,3,0.00001,2,0.714286,0.8,0,0,0
9811102,9811102,,1,0,1,1,0,1,0.000001,0,0,27614,3,0.000013,0,0,0,0,0,0.000219
9909128,9909128,,0,12,12,0,12,12,0,0.000008,0,27616,6,0.00001,9,0.204744,0.264537,0,0.159091,0
9909131,9909131,,0,7,7,0,7,7,0,0.000559,0,27617,10,0.00001,14,0.16274,0.183137,0,0.214286,0
9909133,9909133,,0,4,4,0,4,4,0,0.000002,0,27618,26,0.00001,10,0.165596,0.185585,0,0,0
9909151,9909151,,0,1,1,0,1,1,0,0,0,27619,8,0.00001,2,0.666667,0.75,0,0,0
9909157,9909157,,0,11,11,0,11,11,0,0.004039,0,27620,13,0.00001,15,0.203072,0.233669,0,0.290909,0
9909168,9909168,,1,2,3,1,2,3,0.000001,0.000017,0,27621,4,0.000012,13,0.15329,0.169179,2033.283371,0.166667,0.000219
9909175,9909175,,0,2,2,0,2,2,0,0,0,27622,15,0.00001,7,0.261905,0.407792,0,0,0
9910212,9910212,,0,5,5,0,5,5,0,0.000052,0,27623,4,0.00001,14,0.139504,0.15823,0,0.1,0
9909181,9909181,,0,3,3,0,3,3,0,0.000052,0,27624,4,0.00001,14,0.164252,0.183121,0,0,0
9909190,9909190,,0,1,1,0,1,1,0,0.000001,0,27625,2,0.00001,4,0.380952,0.432292,0,0,0
9909192,9909192,,0,14,14,0,14,14,0,0.000336,0,27626,4,0.00001,16,0.174947,0.20007,0,0.324176,0
9909195,9909195,,0,1,1,0,1,1,0,0,0,27627,30,0.00001,15,0.150452,0.160516,0,0,0
9909200,9909200,,0,5,5,0,5,5,0,0,0,27628,26,0.00001,9,0.188612,0.262964,0,0.4,0
9909208,9909208,,0,7,7,0,7,7,0,0.000013,0,27629,23,0.00001,17,0.131357,0.15407,0,0.452381,0
9909211,9909211,,0,4,4,0,4,4,0,0,0,27630,23,0.00001,3,0.588235,0.683333,0,0.166667,0
9909217,9909217,,0,2,2,0,2,2,0,0,0,27631,23,0.00001,1,1,1,0,0.5,0
9909225,9909225,,0,3,3,0,3,3,0,0.000001,0,27632,22,0.00001,11,0.153642,0.177722,0,0.5,0
9910005,9910005,,0,7,7,0,7,7,0,0.00133,0,27633,30,0.00001,13,0.18927,0.210375,0,0.095238,0
9910010,9910010,,0,2,2,0,2,2,0,0.000001,0,27634,10,0.00001,4,0.37931,0.477273,0,0.5,0
9910012,9910012,,0,26,26,0,26,26,0,0.022645,0,27635,26,0.00001,11,0.236243,0.270421,0,0.147692,0
9910014,9910014,,0,1,1,0,1,1,0,0,0,27636,26,0.00001,6,0.290323,0.337037,0,0,0
9910029,9910029,,0,2,2,0,2,2,0,0,0,27637,23,0.00001,8,0.170274,0.19544,0,0.5,0
9910032,9910032,,0,2,2,0,2,2,0,0,0,27638,17,0.00001,2,0.75,0.833333,0,0,0
9910039,9910039,,0,3,3,0,3,3,0,0,0,27639,26,0.00001,5,0.342857,0.422917,0,0.333333,0
9910044,9910044,,0,3,3,0,3,3,0,0,0,27640,26,0.00001,1,1,1,0,0.333333,0
9910051,9910051,,0,1,1,0,1,1,0,0,140,27642,163,0.00001,1,1,1,0,0,0
9910009,9910009,,1,0,1,1,0,1,0,0,140,27641,163,0.000019,0,0,0,0,0,0.000219
9910080,9910080,,2,3,5,2,3,5,0,0.000002,0,17235,23,0.000017,11,0.168294,0.19004,721.093675,0.1,0.000472
9910061,9910061,,0,3,3,0,3,3,0,0.000002,0,27643,4,0.00001,1,1,1,0,0.333333,0
9910062,9910062,,0,29,29,0,29,29,0,0.008922,0,27644,30,0.00001,13,0.205521,0.234309,0,0.162562,0
9910069,9910069,,0,6,6,0,6,6,0,0.005756,0,27645,23,0.00001,14,0.184745,0.204628,0,0.1,0
9910078,9910078,,0,1,1,0,1,1,0,0,0,27646,41,0.00001,3,0.454545,0.533333,0,0,0
9910106,9910106,,0,31,31,0,31,31,0,0.018138,0,27647,8,0.00001,12,0.213228,0.241208,0,0.149462,0
9910119,9910119,,0,2,2,0,2,2,0,0.000005,0,27648,1,0.00001,16,0.170826,0.186474,0,0.5,0
9910121,9910121,,0,18,18,0,18,18,0,0.000003,0,27649,9,0.00001,14,0.167821,0.192365,0,0.19281,0
9910127,9910127,,0,5,5,0,5,5,0,0,0,27650,26,0.00001,8,0.189086,0.23756,0,0.45,0
9910130,9910130,,0,1,1,0,1,1,0,0.000008,0,27651,4,0.00001,9,0.188007,0.20613,0,0,0
9910137,9910137,,0,5,5,0,5,5,0,0.000001,0,27652,23,0.00001,18,0.130664,0.143249,0,0.05,0
9910142,9910142,,0,11,11,0,11,11,0,0.000011,0,27653,26,0.00001,14,0.14692,0.161801,0,0.163636,0
9910153,9910153,,0,6,6,0,6,6,0,0.000074,0,27654,1,0.00001,16,0.153042,0.169612,0,0.433333,0
9910162,9910162,,0,6,6,0,6,6,0,0.000002,0,27655,23,0.00001,10,0.162412,0.192448,0,0.266667,0
9910163,9910163,,0,11,11,0,11,11,0,0.001998,0,27656,13,0.00001,14,0.177797,0.203151,0,0.063636,0
9910191,9910191,,0,6,6,0,6,6,0,0.00005,0,27657,23,0.00001,15,0.167872,0.186137,0,0.333333,0
9910193,9910193,,0,6,6,0,6,6,0,0.000975,0,27658,2,0.00001,12,0.208287,0.234402,0,0.366667,0
9910195,9910195,,0,6,6,0,6,6,0,0.000029,0,27659,17,0.00001,5,0.315068,0.368551,0,0.133333,0
9910210,9910210,,0,9,9,0,9,9,0,0.001834,0,27660,0,0.00001,17,0.163808,0.192764,0,0.458333,0
9910211,9910211,,0,8,8,0,8,8,0,0.003533,0,27661,2,0.00001,14,0.177716,0.200424,0,0.321429,0
9910214,9910214,,0,8,8,0,8,8,0,0.00007,0,27662,22,0.00001,12,0.175166,0.192094,0,0.142857,0
9910230,9910230,,0,6,6,0,6,6,0,0.000005,0,27663,23,0.00001,15,0.14142,0.160106,0,0.2,0
9910234,9910234,,0,1,1,0,1,1,0,0,9,27664,31,0.00001,1,1,1,0,0,0
9910235,9910235,,2,3,5,2,3,5,0.000025,0.000004,0,27665,28,0.000012,16,0.151369,0.166746,131.710633,0.3,0.000438
9910253,9910253,,1,1,2,1,1,2,0,0,0,27666,6,0.000011,1,1,1,1,0,0.000219
9910257,9910257,,0,1,1,0,1,1,0,0.000003,0,27667,23,0.00001,11,0.18055,0.207459,0,0,0
9910259,9910259,,0,5,5,0,5,5,0,0,0,27668,26,0.00001,3,0.521739,0.652778,0,0.2,0
9910260,9910260,,0,11,11,0,11,11,0,0.001531,0,27669,1,0.00001,14,0.184809,0.21004,0,0.127273,0
9910261,9910261,,0,11,11,0,11,11,0,0.001692,0,27670,2,0.00001,12,0.212211,0.23982,0,0.245455,0
9910262,9910262,,0,4,4,0,4,4,0,0.000437,0,27671,30,0.00001,14,0.177093,0.194319,0,0.5,0
9911005,9911005,,0,8,8,0,8,8,0,0.00069,0,27672,13,0.00001,13,0.197566,0.2267,0,0.071429,0
9911006,9911006,,0,5,5,0,5,5,0,0.000001,0,27673,22,0.00001,8,0.259843,0.393326,0,0.3,0
9911008,9911008,,0,6,6,0,6,6,0,0.002042,0,27674,28,0.00001,15,0.16844,0.190412,0,0.2,0
9911010,9911010,,0,9,9,0,9,9,0,0.000692,0,27675,1,0.00001,15,0.175961,0.197196,0,0.166667,0
9911033,9911033,,0,5,5,0,5,5,0,0,0,27676,28,0.00001,7,0.193798,0.281857,0,0.25,0
9911034,9911034,,0,47,47,0,47,47,0,0.004067,0,27677,4,0.00001,17,0.184418,0.22136,0,0.224329,0
9911052,9911052,,0,24,24,0,24,24,0,0.002555,0,27678,2,0.00001,14,0.207396,0.240041,0,0.190217,0
9911058,9911058,,0,3,3,0,3,3,0,0.000006,0,27679,52,0.00001,4,0.403846,0.472222,0,0.333333,0
9911061,9911061,,0,7,7,0,7,7,0,0.000012,0,27680,26,0.00001,16,0.143075,0.155243,0,0.380952,0
9911070,9911070,,0,2,2,0,2,2,0,0.000037,0,27681,13,0.00001,1,1,1,0,0,0
9911103,9911103,,0,7,7,0,7,7,0,0,0,27682,23,0.00001,10,0.157057,0.189209,0,0.309524,0
9911106,9911106,,0,1,1,0,1,1,0,0,0,27683,11,0.00001,1,1,1,0,0,0
9911127,9911127,,0,2,2,0,2,2,0,0,0,27684,23,0.00001,3,0.538462,0.619048,0,0.5,0
9911145,9911145,,0,5,5,0,5,5,0,0.000001,0,27685,23,0.00001,19,0.132558,0.144696,0,0.45,0
9911155,9911155,,0,13,13,0,13,13,0,0.000285,0,27686,2,0.00001,14,0.164707,0.186629,0,0.230769,0
9911159,9911159,,0,2,2,0,2,2,0,0.000002,0,27687,5,0.00001,7,0.204255,0.237946,0,0.5,0
9911176,9911176,,0,8,8,0,8,8,0,0.000108,0,27688,23,0.00001,13,0.171644,0.188318,0,0.089286,0
9911184,9911184,,0,12,12,0,12,12,0,0.000564,0,27689,10,0.00001,16,0.181609,0.206392,0,0.151515,0
9911185,9911185,,0,12,12,0,12,12,0,0.014412,0,27690,13,0.00001,14,0.181539,0.209456,0,0.227273,0
9911196,9911196,,0,8,8,0,8,8,0,0,0,27691,20,0.00001,9,0.163075,0.198081,0,0.089286,0
9911198,9911198,,0,1,1,0,1,1,0,0.000001,0,27692,26,0.00001,1,1,1,0,0,0
9911201,9911201,,0,32,32,0,32,32,0,0.00346,0,27693,2,0.00001,16,0.167413,0.200216,0,0.149194,0
9911202,9911202,,0,14,14,0,14,14,0,0.020069,0,27694,1,0.00001,11,0.225349,0.255566,0,0.291209,0
9911204,9911204,,0,7,7,0,7,7,0,0.000048,0,27695,22,0.00001,15,0.173447,0.195601,0,0.095238,0
9911213,9911213,,0,9,9,0,9,9,0,0.000002,0,27696,6,0.00001,13,0.150515,0.171628,0,0.055556,0
9911224,9911224,,0,1,1,0,1,1,0,0,0,27697,23,0.00001,4,0.346154,0.416667,0,0,0
9911227,9911227,,0,7,7,0,7,7,0,0.000011,0,27698,23,0.00001,7,0.236409,0.26306,0,0.02381,0
9911232,9911232,,0,7,7,0,7,7,0,0.000005,0,27699,6,0.00001,8,0.245902,0.314333,0,0.214286,0
9911241,9911241,,0,2,2,0,2,2,0,0.000152,0,27700,30,0.00001,14,0.178203,0.195791,0,0,0
9911248,9911248,,0,10,10,0,10,10,0,0.000001,0,27701,5,0.00001,16,0.107824,0.118782,0,0.266667,0
9911252,9911252,,0,18,18,0,18,18,0,0.006466,0,27702,2,0.00001,14,0.194523,0.225584,0,0.196078,0
9912009,9912009,,0,10,10,0,10,10,0,0.000011,0,27703,26,0.00001,14,0.168812,0.196981,0,0.155556,0
9912010,9912010,,0,31,31,0,31,31,0,0.021437,0,27704,13,0.00001,11,0.239108,0.275637,0,0.132258,0
9912014,9912014,,0,2,2,0,2,2,0,0,93,27705,164,0.00001,1,1,1,0,0,0
9912026,9912026,,0,2,2,0,2,2,0,0,0,27706,22,0.00001,6,0.285714,0.333333,0,0,0
9912041,9912041,,0,6,6,0,6,6,0,0.000003,0,27707,23,0.00001,9,0.161157,0.186496,0,0.2,0
9912048,9912048,,0,5,5,0,5,5,0,0,0,27709,20,0.00001,20,0.11606,0.141812,0,0.05,0
9905140,9905140,,1,0,1,1,0,1,0,0,0,27708,20,0.000012,0,0,0,0,0,0.000219
9912056,9912056,,0,4,4,0,4,4,0,0.000604,0,27710,20,0.00001,16,0.15661,0.18836,0,0.166667,0
9912057,9912057,,0,7,7,0,7,7,0,0.000247,0,27711,2,0.00001,13,0.164991,0.184526,0,0.285714,0
9912068,9912068,,0,4,4,0,4,4,0,0.00002,0,27712,4,0.00001,13,0.149363,0.164234,0,0.083333,0
9912069,9912069,,0,8,8,0,8,8,0,0.000021,0,27713,5,0.00001,11,0.212085,0.239127,0,0.303571,0
9912071,9912071,,0,2,2,0,2,2,0,0.000007,0,27714,28,0.00001,5,0.333333,0.442424,0,0,0
9912089,9912089,,0,8,8,0,8,8,0,0.000103,0,27716,28,0.00001,15,0.167665,0.184431,0,0.071429,0
9910008,9910008,,1,0,1,1,0,1,0.000001,0,0,27715,28,0.000011,0,0,0,0,0,0.000219
9912091,9912091,,0,14,14,0,14,14,0,0.000013,0,27717,15,0.00001,7,0.265928,0.340861,0,0.153846,0
9912095,9912095,,0,1,1,0,1,1,0,0,0,27718,23,0.00001,3,0.5,0.611111,0,0,0
9912109,9912109,,0,5,5,0,5,5,0,0.000019,0,27719,4,0.00001,13,0.151393,0.166651,0,0.15,0
9912110,9912110,,0,4,4,0,4,4,0,0,0,27720,26,0.00001,17,0.112458,0.127796,0,0.25,0
9912115,9912115,,0,1,1,0,1,1,0,0.000037,0,27721,4,0.00001,10,0.172131,0.201737,0,0,0
9912116,9912116,,0,3,3,0,3,3,0,0.000003,0,27722,23,0.00001,5,0.309524,0.441026,0,0.166667,0
9912117,9912117,,0,6,6,0,6,6,0,0.000595,0,27723,3,0.00001,14,0.196441,0.219854,0,0.366667,0
9912126,9912126,,0,1,1,0,1,1,0,0.000018,0,27724,1,0.00001,14,0.156922,0.169381,0,0,0
9912134,9912134,,0,2,2,0,2,2,0,0,0,27725,28,0.00001,3,0.466667,0.571429,0,0,0
9912136,9912136,,0,4,4,0,4,4,0,0.000001,0,27726,26,0.00001,8,0.182879,0.218777,0,0.333333,0
9912138,9912138,,0,1,1,0,1,1,0,0,141,27728,165,0.00001,1,1,1,0,0,0
9601122,9601122,,1,0,1,1,0,1,0,0,141,27727,165,0.000019,0,0,0,0,0,0.000219
9912148,9912148,,0,3,3,0,3,3,0,0,0,27730,28,0.00001,11,0.161265,0.189402,0,0,0
9412007,9412007,,1,0,1,1,0,1,0,0,0,27729,28,0.000013,0,0,0,0,0,0.000219
9912171,9912171,,0,35,35,0,35,35,0,0.002077,0,27731,30,0.00001,13,0.194403,0.215301,0,0.077311,0
9912192,9912192,,0,5,5,0,5,5,0,0.001633,0,27732,0,0.00001,16,0.159471,0.184562,0,0.25,0
9912219,9912219,,1,8,9,1,8,9,0,0.000003,0,27733,6,0.000011,12,0.16664,0.19399,540.369048,0.263889,0.000219
9912228,9912228,,0,1,1,0,1,1,0,0,15,27734,36,0.00001,1,1,1,0,0,0
9912235,9912235,,0,7,7,0,7,7,0,0,0,27735,6,0.00001,13,0.153299,0.173399,0,0.452381,0
9912240,9912240,,0,17,17,0,17,17,0,0.000001,0,27737,23,0.00001,17,0.12167,0.131336,0,0.113971,0
9508161,9508161,,1,0,1,1,0,1,0,0,0,27736,23,0.00001,0,0,0,0,0,0.000219
9912252,9912252,,0,6,6,0,6,6,0,0.000003,0,27738,6,0.00001,13,0.140777,0.155317,0,0.3,0
9912260,9912260,,0,6,6,0,6,6,0,0.004668,0,27739,2,0.00001,13,0.171752,0.189411,0,0.133333,0
9912270,9912270,,0,1,1,0,1,1,0,0.000025,0,27740,4,0.00001,5,0.287554,0.334328,0,0,0
9912286,9912286,,0,8,8,0,8,8,0,0.000462,0,27741,5,0.00001,13,0.167832,0.183114,0,0.321429,0
