Id,Label,timeset,modularity_class,indegree,outdegree,Degree
1001,1001,,54,10,83,93
9304045,9304045,,54,16,1,17
9308122,9308122,,54,115,7,122
9309097,9309097,,54,140,4,144
9311042,9311042,,54,55,2,57
9401139,9401139,,2,421,40,461
9404151,9404151,,54,77,2,79
9407087,9407087,,37,1299,9,1308
9408099,9408099,,37,1006,7,1013
9501030,9501030,,2,126,27,153
9503124,9503124,,2,1114,10,1124
9504090,9504090,,54,337,4,341
9504145,9504145,,54,192,2,194
9505025,9505025,,54,30,14,44
9505054,9505054,,54,63,10,73
9505105,9505105,,54,327,21,348
9505162,9505162,,54,205,25,230
9506048,9506048,,54,49,7,56
9506112,9506112,,54,189,17,206
9506144,9506144,,54,77,15,92
9507050,9507050,,54,160,19,179
9507158,9507158,,54,301,16,317
9508094,9508094,,2,90,29,119
9508155,9508155,,54,192,53,245
9510142,9510142,,54,35,28,63
9510225,9510225,,54,175,22,197
9510234,9510234,,54,92,37,129
9511030,9511030,,54,329,21,350
9511171,9511171,,54,49,22,71
9601108,9601108,,54,95,39,134
9602022,9602022,,54,520,25,545
9602114,9602114,,54,252,35,287
9603003,9603003,,54,194,20,214
9603150,9603150,,54,148,26,174
9603161,9603161,,54,274,32,306
9603167,9603167,,37,467,16,483
9605184,9605184,,54,148,22,170
9605222,9605222,,54,24,23,47
9606017,9606017,,37,110,14,124
9606040,9606040,,37,118,6,124
9607163,9607163,,37,186,7,193
9607207,9607207,,37,127,11,138
9608086,9608086,,54,28,10,38
9609070,9609070,,54,81,15,96
9609071,9609071,,54,65,30,95
9609239,9609239,,37,145,41,186
9611137,9611137,,54,139,65,204
9612108,9612108,,54,37,25,62
9701162,9701162,,54,114,24,138
9702094,9702094,,37,62,37,99
9702155,9702155,,54,63,30,93
9702198,9702198,,54,59,31,90
9703082,9703082,,54,49,30,79
9703166,9703166,,37,424,22,446
9704097,9704097,,54,29,30,59
9705030,9705030,,54,70,26,96
9705044,9705044,,54,71,27,98
9705104,9705104,,54,65,34,99
9705220,9705220,,37,39,56,95
9706005,9706005,,54,11,15,26
9707014,9707014,,54,16,20,36
9707042,9707042,,2,43,18,61
9707049,9707049,,54,16,25,41
9710230,9710230,,4,139,10,149
9711036,9711036,,54,8,23,31
9711104,9711104,,54,17,7,24
9712028,9712028,,54,129,26,155
9712042,9712042,,37,14,7,21
9802194,9802194,,54,22,22,44
9805056,9805056,,54,17,13,30
9805206,9805206,,54,11,20,31
9806094,9806094,,54,22,21,43
9810188,9810188,,4,328,30,358
9811217,9811217,,54,24,58,82
9905036,9905036,,54,14,18,32
9907041,9907041,,54,12,4,16
9908007,9908007,,54,11,27,38
9908144,9908144,,4,54,41,95
9909108,9909108,,37,23,24,47
9909120,9909120,,37,22,4,26
9909229,9909229,,54,18,27,45
9910238,9910238,,54,11,21,32
9910248,9910248,,54,5,31,36
9910268,9910268,,54,5,27,32
9204040,9204040,,54,11,0,11
9203084,9203084,,54,33,0,33
9204035,9204035,,54,40,0,40
9205041,9205041,,54,34,0,34
9207049,9207049,,54,16,0,16
9207111,9207111,,54,18,0,18
9301042,9301042,,37,344,0,344
9301043,9301043,,54,69,0,69
9201015,9201015,,2,14,1,15
9201040,9201040,,4,35,0,35
9201047,9201047,,54,12,1,13
9202046,9202046,,54,91,1,92
9202059,9202059,,54,33,0,33
9202092,9202092,,1,64,0,64
9203008,9203008,,8,9,0,9
9203031,9203031,,54,17,0,17
9204037,9204037,,54,4,0,4
9204046,9204046,,2,66,0,66
9205046,9205046,,31,58,0,58
9205060,9205060,,31,3,1,4
9205062,9205062,,1,8,3,11
9205068,9205068,,54,167,0,167
9206023,9206023,,8,3,0,3
9206051,9206051,,1,19,0,19
9206078,9206078,,31,76,2,78
9207016,9207016,,2,219,1,220
9208076,9208076,,31,22,0,22
9209052,9209052,,31,41,4,45
9210015,9210015,,65,37,0,37
9210021,9210021,,65,104,0,104
9210121,9210121,,2,39,4,43
9211021,9211021,,31,199,0,199
9211041,9211041,,2,7,2,9
9212089,9212089,,54,3,1,4
9301005,9301005,,2,13,2,15
9302033,9302033,,65,80,9,89
9302069,9302069,,2,4,5,9
9302126,9302126,,34,111,10,121
9303032,9303032,,34,20,7,27
9304155,9304155,,1,15,6,21
9305185,9305185,,2,171,13,184
9308042,9308042,,1,22,3,25
9305139,9305139,,2,51,0,51
9309140,9309140,,54,194,19,213
9204102,9204102,,37,71,0,71
9211097,9211097,,37,81,1,82
9402002,9402002,,2,282,14,296
9402005,9402005,,54,58,7,65
9402044,9402044,,37,257,0,257
9403195,9403195,,37,88,1,89
9403198,9403198,,37,124,1,125
9406128,9406128,,2,29,5,34
9205081,9205081,,2,77,0,77
9207053,9207053,,2,102,0,102
9208055,9208055,,2,32,1,33
9209016,9209016,,2,76,0,76
9211056,9211056,,2,68,4,72
9303057,9303057,,2,54,10,64
9305142,9305142,,2,87,4,91
9306052,9306052,,2,101,6,107
9306125,9306125,,2,6,3,9
9311120,9311120,,2,60,7,67
9402032,9402032,,2,240,4,244
9406105,9406105,,2,87,9,96
9406198,9406198,,2,41,25,66
9407021,9407021,,2,9,9,18
9407111,9407111,,2,38,7,45
9408040,9408040,,2,31,16,47
9408074,9408074,,37,290,9,299
9408083,9408083,,2,82,27,109
9409021,9409021,,2,101,14,115
9410167,9410167,,2,748,25,773
9410210,9410210,,2,3,6,9
9412184,9412184,,2,426,36,462
9205027,9205027,,2,191,0,191
9406012,9406012,,2,13,0,13
9411149,9411149,,37,411,11,422
9411178,9411178,,2,30,17,47
9201059,9201059,,2,47,0,47
9309152,9309152,,2,8,3,11
9310067,9310067,,54,9,3,12
9412115,9412115,,54,6,14,20
9501068,9501068,,2,385,6,391
9502072,9502072,,54,151,23,174
9504027,9504027,,2,142,20,162
9504047,9504047,,2,158,22,180
9304154,9304154,,2,229,9,238
9501022,9501022,,2,36,4,40
9502057,9502057,,2,33,20,53
9503179,9503179,,37,138,18,156
9308083,9308083,,54,104,4,108
9411048,9411048,,37,314,2,316
9411057,9411057,,37,268,2,270
9501111,9501111,,54,19,7,26
9502077,9502077,,54,68,24,92
9503163,9503163,,37,144,9,153
9504006,9504006,,54,145,23,168
9504034,9504034,,54,111,9,120
9505023,9505023,,54,35,14,49
9505053,9505053,,54,136,6,142
9505062,9505062,,37,174,14,188
9302103,9302103,,54,133,1,134
9305069,9305069,,2,29,2,31
9406032,9406032,,54,13,8,21
9409188,9409188,,37,87,2,89
9406055,9406055,,54,68,15,83
9408036,9408036,,54,64,8,72
9411234,9411234,,54,31,2,33
9412200,9412200,,54,26,23,49
9506075,9506075,,54,36,31,67
9506091,9506091,,54,23,36,59
9506024,9506024,,54,15,13,28
9506077,9506077,,37,37,32,69
9506110,9506110,,54,96,23,119
9506160,9506160,,2,84,11,95
9506194,9506194,,2,102,16,118
9507027,9507027,,54,47,14,61
9207060,9207060,,2,54,0,54
9503212,9503212,,54,46,10,56
9506126,9506126,,2,159,41,200
9506150,9506150,,37,74,13,87
9507048,9507048,,2,159,9,168
9303106,9303106,,2,3,4,7
9410073,9410073,,2,150,6,156
9411187,9411187,,2,118,28,146
9504081,9504081,,2,228,13,241
9504095,9504095,,2,41,14,55
9506057,9506057,,2,57,21,78
9507090,9507090,,2,150,28,178
9508056,9508056,,2,6,10,16
9304135,9304135,,37,37,4,41
9412209,9412209,,54,47,18,65
9505073,9505073,,2,113,25,138
9505150,9505150,,37,176,18,194
9506084,9506084,,37,20,13,33
9506102,9506102,,37,155,11,166
9507113,9507113,,54,38,34,72
9507115,9507115,,54,103,17,120
9507121,9507121,,54,304,13,317
9507151,9507151,,54,28,13,41
9507153,9507153,,54,29,10,39
9507168,9507168,,54,30,17,47
9508044,9508044,,54,5,22,27
9508064,9508064,,54,47,42,89
9508071,9508071,,54,16,14,30
9508096,9508096,,54,2,17,19
9508143,9508143,,2,373,15,388
9508144,9508144,,54,30,15,45
9409110,9409110,,54,22,10,32
9503208,9503208,,37,16,9,25
9507012,9507012,,54,148,9,157
9508154,9508154,,2,126,24,150
9509009,9509009,,54,37,19,56
9510093,9510093,,54,64,18,82
9201056,9201056,,4,118,0,118
9206080,9206080,,54,9,0,9
9301083,9301083,,25,50,6,56
9307158,9307158,,54,82,4,86
9308062,9308062,,25,5,12,17
9407031,9407031,,2,136,9,145
9506122,9506122,,54,56,17,73
9509066,9509066,,37,223,38,261
9510135,9510135,,2,775,15,790
9510169,9510169,,2,388,9,397
9204030,9204030,,54,75,1,76
9205009,9205009,,54,42,0,42
9510017,9510017,,2,1155,10,1165
9510173,9510173,,54,41,6,47
9510182,9510182,,54,172,63,235
9412236,9412236,,37,63,19,82
9511164,9511164,,37,144,23,167
9511222,9511222,,37,273,15,288
9512016,9512016,,54,10,11,21
9512017,9512017,,37,15,20,35
9512059,9512059,,2,325,22,347
9512145,9512145,,2,35,17,52
9601014,9601014,,54,54,26,80
9601038,9601038,,54,329,8,337
9206101,9206101,,8,7,0,7
9409111,9409111,,34,57,0,57
9505183,9505183,,8,37,14,51
9506101,9506101,,54,65,4,69
9510086,9510086,,2,232,23,255
9510161,9510161,,2,172,15,187
9510209,9510209,,0,788,18,806
9511080,9511080,,2,121,9,130
9512077,9512077,,2,380,14,394
9512181,9512181,,2,88,37,125
9512196,9512196,,54,92,27,119
9512219,9512219,,54,169,15,184
9601036,9601036,,54,139,25,164
9602010,9602010,,54,39,25,64
9210127,9210127,,54,158,1,159
9304104,9304104,,54,45,1,46
9506156,9506156,,2,19,22,41
9508107,9508107,,37,21,13,34
9509106,9509106,,2,15,67,82
9512129,9512129,,54,46,46,92
9512178,9512178,,2,35,7,42
9602049,9602049,,2,110,15,125
9602064,9602064,,2,185,30,215
9602097,9602097,,54,42,25,67
9602118,9602118,,54,33,16,49
9512053,9512053,,54,46,15,61
9602030,9602030,,54,79,15,94
9602070,9602070,,54,325,18,343
9602098,9602098,,11,2,2,4
9602120,9602120,,54,122,18,140
9404060,9404060,,54,9,4,13
9511108,9511108,,54,73,26,99
9511157,9511157,,54,24,31,55
9602102,9602102,,54,38,30,68
9603037,9603037,,54,71,20,91
9511204,9511204,,54,25,14,39
9512078,9512078,,2,101,21,122
9509151,9509151,,37,53,13,66
9511026,9511026,,2,79,7,86
9511088,9511088,,2,79,11,90
9601029,9601029,,2,651,27,678
9601162,9601162,,37,16,7,23
9602052,9602052,,2,406,51,457
9603142,9603142,,54,494,4,498
9309110,9309110,,54,55,9,64
9403054,9403054,,37,12,4,16
9406090,9406090,,54,19,6,25
9412117,9412117,,54,23,14,37
9502012,9502012,,54,19,12,31
9510055,9510055,,54,16,18,34
9605036,9605036,,54,23,16,39
9603081,9603081,,2,132,23,155
9603127,9603127,,2,141,21,162
9604198,9604198,,37,120,8,128
9605150,9605150,,54,228,21,249
9605199,9605199,,54,139,17,156
9406178,9406178,,65,12,5,17
9510227,9510227,,54,129,7,136
9512062,9512062,,2,333,21,354
9603042,9603042,,37,98,20,118
9602167,9602167,,37,69,11,80
9509132,9509132,,2,76,51,127
9608039,9608039,,54,34,21,55
9608079,9608079,,54,54,7,61
9604097,9604097,,54,62,32,94
9605154,9605154,,54,49,45,94
9608111,9608111,,54,116,18,134
9605131,9605131,,54,56,21,77
9605200,9605200,,54,118,32,150
9606044,9606044,,54,64,13,77
9606086,9606086,,54,59,8,67
9607020,9607020,,54,25,21,46
9607139,9607139,,54,58,32,90
9608024,9608024,,2,383,51,434
9608047,9608047,,54,33,8,41
9608109,9608109,,54,36,23,59
9509042,9509042,,54,24,13,37
9509161,9509161,,37,201,17,218
9510106,9510106,,54,44,15,59
9602051,9602051,,2,201,18,219
9603108,9603108,,54,42,43,85
9608194,9608194,,54,24,20,44
9511077,9511077,,4,13,7,20
9512226,9512226,,54,6,37,43
9603170,9603170,,54,64,39,103
9604034,9604034,,37,217,56,273
9609161,9609161,,54,59,17,76
9604129,9604129,,54,136,24,160
9606165,9606165,,54,102,11,113
9610111,9610111,,54,20,20,40
9602065,9602065,,2,137,10,147
9604030,9604030,,54,116,15,131
9605053,9605053,,54,107,11,118
9606122,9606122,,54,112,23,135
9606148,9606148,,54,27,30,57
9607091,9607091,,54,42,4,46
9607105,9607105,,54,16,24,40
9610195,9610195,,54,19,55,74
9610251,9610251,,54,55,46,101
9611090,9611090,,37,80,28,108
9612052,9612052,,37,71,26,97
9701015,9701015,,37,40,23,63
9701023,9701023,,54,45,41,86
9701147,9701147,,54,18,29,47
9503115,9503115,,37,113,7,120
9505006,9505006,,37,96,7,103
9505075,9505075,,37,204,15,219
9505082,9505082,,37,23,3,26
9505100,9505100,,37,178,6,184
9506098,9506098,,37,56,7,63
9507013,9507013,,37,52,13,65
9507018,9507018,,37,45,19,64
9507032,9507032,,37,70,6,76
9507169,9507169,,37,38,11,49
9510148,9510148,,37,46,19,65
9510228,9510228,,37,37,21,58
9511154,9511154,,37,111,7,118
9603086,9603086,,2,61,25,86
9603136,9603136,,37,120,17,137
9603158,9603158,,37,41,10,51
9607076,9607076,,37,52,14,66
9607202,9607202,,37,89,14,103
9610132,9610132,,37,1,0,1
9611190,9611190,,37,91,165,256
9611197,9611197,,37,26,22,48
9612114,9612114,,37,22,2,24
9612207,9612207,,37,46,39,85
9204060,9204060,,54,41,0,41
9205004,9205004,,54,46,0,46
9304026,9304026,,37,43,0,43
9509049,9509049,,54,4,9,13
9511230,9511230,,54,22,8,30
9606112,9606112,,37,151,14,165
9606008,9606008,,54,17,11,28
9609219,9609219,,37,72,30,102
9207091,9207091,,54,49,0,49
9210068,9210068,,54,43,0,43
9504102,9504102,,37,126,7,133
9505097,9505097,,54,24,8,32
9507008,9507008,,37,118,10,128
9509175,9509175,,37,154,16,170
9509176,9509176,,37,101,17,118
9510074,9510074,,54,48,6,54
9511180,9511180,,37,40,15,55
9512005,9512005,,37,37,14,51
9512006,9512006,,2,61,4,65
9512139,9512139,,54,15,26,41
9603004,9603004,,54,49,19,68
9604062,9604062,,54,10,5,15
9605032,9605032,,54,95,41,136
9606043,9606043,,37,34,13,47
9606073,9606073,,54,7,5,12
9607032,9607032,,54,28,27,55
9608183,9608183,,37,35,24,59
9609059,9609059,,37,33,28,61
9611112,9611112,,54,6,6,12
9611188,9611188,,54,4,32,36
9612105,9612105,,54,40,45,85
9505035,9505035,,37,204,12,216
9506011,9506011,,2,86,16,102
9509162,9509162,,37,108,4,112
9510101,9510101,,37,225,14,239
9608085,9608085,,37,37,7,44
9611230,9611230,,37,438,20,458
9612131,9612131,,37,68,23,91
9702014,9702014,,37,156,14,170
9702154,9702154,,37,61,13,74
9509146,9509146,,54,25,18,43
9606133,9606133,,54,21,37,58
9610154,9610154,,54,23,11,34
9701165,9701165,,54,74,34,108
9701175,9701175,,54,18,24,42
9703007,9703007,,54,27,47,74
9703148,9703148,,54,9,27,36
9310035,9310035,,2,21,1,22
9604178,9604178,,54,127,23,150
9606176,9606176,,54,38,31,69
9607019,9607019,,54,63,13,76
9607057,9607057,,54,56,39,95
9607229,9607229,,54,63,29,92
9608053,9608053,,54,47,31,78
9611050,9611050,,2,701,71,772
9612126,9612126,,2,125,18,143
9702038,9702038,,54,54,19,73
9605030,9605030,,11,30,24,54
9609159,9609159,,54,19,13,32
9610140,9610140,,37,107,19,126
9703098,9703098,,54,18,31,49
9703167,9703167,,54,16,15,31
9609111,9609111,,54,15,18,33
9701129,9701129,,54,5,25,30
9702061,9702061,,54,23,31,54
9610076,9610076,,54,30,14,44
9611063,9611063,,37,66,26,92
9611201,9611201,,37,35,15,50
9612085,9612085,,54,28,39,67
9702180,9702180,,37,79,17,96
9703100,9703100,,37,36,8,44
9703110,9703110,,37,74,26,100
9703210,9703210,,37,108,24,132
9704043,9704043,,37,73,22,95
9704044,9704044,,37,80,27,107
9704061,9704061,,37,29,19,48
9704104,9704104,,37,100,49,149
9704170,9704170,,37,87,31,118
9705004,9705004,,37,23,25,48
9609176,9609176,,54,66,49,115
9610043,9610043,,2,1199,19,1218
9705113,9705113,,2,18,27,45
9705175,9705175,,2,28,35,63
9706155,9706155,,37,14,21,35
9506052,9506052,,37,57,3,60
9601003,9601003,,2,134,15,149
9602077,9602077,,2,76,12,88
9702136,9702136,,2,98,23,121
9704089,9704089,,2,144,22,166
9705162,9705162,,2,87,43,130
9705212,9705212,,2,26,10,36
9706117,9706117,,2,52,9,61
9706144,9706144,,2,19,8,27
9706207,9706207,,2,39,26,65
9605033,9605033,,2,196,12,208
9609017,9609017,,54,97,41,138
9610234,9610234,,2,151,11,162
9710206,9710206,,2,82,29,111
9406091,9406091,,54,11,3,14
9609167,9609167,,54,19,32,51
9611172,9611172,,54,8,17,25
9702199,9702199,,54,8,24,32
9705174,9705174,,54,23,26,49
9705210,9705210,,54,9,27,36
9709178,9709178,,37,10,12,22
9709193,9709193,,37,49,25,74
9710021,9710021,,54,8,23,31
9710031,9710031,,54,6,12,18
9711013,9711013,,37,70,29,99
9611092,9611092,,65,13,4,17
9309124,9309124,,54,17,3,20
9703157,9703157,,54,27,23,50
9707123,9707123,,37,58,33,91
9708118,9708118,,37,70,50,120
9711201,9711201,,54,56,65,121
9512043,9512043,,54,18,27,45
9709180,9709180,,37,33,46,79
9712023,9712023,,54,10,17,27
9801057,9801057,,54,21,27,48
9802093,9802093,,54,6,10,16
9711162,9711162,,3,788,18,806
9711165,9711165,,3,456,7,463
9805189,9805189,,54,17,25,42
9403040,9403040,,2,94,1,95
9511194,9511194,,4,115,1,116
9604091,9604091,,4,142,27,169
9604156,9604156,,2,105,27,132
9612215,9612215,,4,19,28,47
9704006,9704006,,4,60,9,69
9708147,9708147,,2,230,17,247
9803194,9803194,,4,123,54,177
9805019,9805019,,4,235,30,265
9805112,9805112,,34,173,24,197
9805170,9805170,,4,297,15,312
9806155,9806155,,4,105,5,110
9807138,9807138,,4,39,10,49
9807235,9807235,,37,70,25,95
9808141,9808141,,4,229,27,256
9809111,9809111,,4,104,11,115
9810163,9810163,,2,15,4,19
9402119,9402119,,54,33,3,36
9610162,9610162,,54,51,65,116
9706110,9706110,,37,125,74,199
9706226,9706226,,54,17,19,36
9801139,9801139,,37,14,11,25
9802202,9802202,,54,26,20,46
9803224,9803224,,54,31,17,48
9804176,9804176,,54,32,46,78
9807096,9807096,,54,18,35,53
9602154,9602154,,54,11,18,29
9405012,9405012,,4,5,0,5
9403096,9403096,,54,28,12,40
9403187,9403187,,54,41,11,52
9508091,9508091,,2,59,18,77
9610151,9610151,,54,56,20,76
9706195,9706195,,54,42,9,51
9707013,9707013,,54,28,25,53
9707044,9707044,,2,35,12,47
9801009,9801009,,54,2,10,12
9806140,9806140,,2,35,10,45
9812170,9812170,,2,5,8,13
9901126,9901126,,54,16,20,36
9901137,9901137,,54,7,22,29
9610148,9610148,,2,152,40,192
9610249,9610249,,2,154,17,171
9611159,9611159,,2,186,29,215
9611173,9611173,,2,214,12,226
9612080,9612080,,2,178,22,200
9709027,9709027,,2,169,17,186
9711098,9711098,,2,24,18,42
9711200,9711200,,34,2414,54,2468
9712086,9712086,,2,31,31,62
9812135,9812135,,4,164,34,198
9901042,9901042,,4,37,26,63
9902160,9902160,,4,31,24,55
9903123,9903123,,4,68,31,99
9904207,9904207,,4,282,73,355
9905006,9905006,,4,87,36,123
9905080,9905080,,4,7,24,31
9905195,9905195,,4,38,26,64
9907061,9907061,,2,1,12,13
9908091,9908091,,4,5,6,11
9908126,9908126,,4,21,29,50
9403123,9403123,,37,35,3,38
9605201,9605201,,54,21,27,48
9803205,9803205,,2,41,11,52
9807040,9807040,,37,15,28,43
9902098,9902098,,1,78,30,108
9903031,9903031,,37,76,13,89
9904104,9904104,,1,17,15,32
9905032,9905032,,1,15,30,45
9907189,9907189,,4,67,7,74
9907200,9907200,,1,25,22,47
9908041,9908041,,1,18,11,29
9212115,9212115,,19,8,0,8
9511169,9511169,,4,5,0,5
9810157,9810157,,2,11,16,27
9810064,9810064,,54,10,13,23
9903224,9903224,,1,119,30,149
9907178,9907178,,1,51,33,84
9908142,9908142,,3,1144,75,1219
9909101,9909101,,2,35,51,86
9904115,9904115,,54,11,49,60
9910216,9910216,,54,1,28,29
1002,1002,,0,43,36,79
9201007,9201007,,0,83,0,83
9204031,9204031,,0,21,0,21
9210123,9210123,,0,13,6,19
9304062,9304062,,0,14,4,18
9306005,9306005,,0,2,0,2
9402089,9402089,,0,4,8,12
9604090,9604090,,0,106,37,143
9803235,9803235,,54,208,40,248
9807051,9807051,,0,30,24,54
9809015,9809015,,34,11,18,29
9810063,9810063,,34,11,21,32
9812035,9812035,,34,79,19,98
9902125,9902125,,34,56,23,79
9902155,9902155,,34,50,16,66
9904017,9904017,,34,230,42,272
9905012,9905012,,0,223,7,230
9905210,9905210,,0,168,29,197
9906064,9906064,,0,1032,6,1038
9906194,9906194,,34,135,30,165
9907070,9907070,,34,29,47,76
9907209,9907209,,0,109,4,113
9908076,9908076,,0,115,6,121
9908116,9908116,,0,64,17,81
9908186,9908186,,0,53,16,69
9909001,9909001,,0,35,11,46
9909041,9909041,,34,47,28,75
9909053,9909053,,0,125,8,133
9909058,9909058,,0,108,24,132
9909121,9909121,,34,49,32,81
9909134,9909134,,0,232,29,261
9910149,9910149,,0,171,17,188
9910219,9910219,,0,211,9,220
9912012,9912012,,34,137,18,155
9912118,9912118,,0,96,18,114
9912132,9912132,,34,37,52,89
9912187,9912187,,0,32,30,62
9202037,9202037,,34,9,0,9
9206004,9206004,,34,17,1,18
9209116,9209116,,2,44,5,49
9202014,9202014,,2,104,0,104
9203083,9203083,,2,39,0,39
9212020,9212020,,0,11,2,13
9307049,9307049,,2,172,2,174
9309089,9309089,,1,10,0,10
9402085,9402085,,0,23,0,23
9403058,9403058,,54,33,7,40
9405124,9405124,,2,79,1,80
9409119,9409119,,2,19,11,30
9411170,9411170,,0,9,10,19
9501073,9501073,,1,8,3,11
9503114,9503114,,54,34,7,41
9510097,9510097,,2,95,34,129
9511131,9511131,,54,3,16,19
9512031,9512031,,2,176,34,210
9512127,9512127,,2,62,27,89
9601075,9601075,,0,7,1,8
9602126,9602126,,0,14,5,19
9603074,9603074,,54,31,71,102
9511203,9511203,,2,53,5,58
9601150,9601150,,2,190,11,201
9605136,9605136,,54,108,18,126
9606036,9606036,,54,48,24,72
9608019,9608019,,54,86,20,106
9608173,9608173,,2,59,12,71
9609209,9609209,,54,59,17,76
9611134,9611134,,2,32,19,51
9611196,9611196,,54,14,24,38
9701048,9701048,,54,23,16,39
9704177,9704177,,54,71,18,89
9706171,9706171,,54,25,15,40
9707143,9707143,,54,68,11,79
9707208,9707208,,54,53,10,63
9707223,9707223,,54,43,12,55
9708031,9708031,,54,25,6,31
9709043,9709043,,54,34,17,51
9709049,9709049,,54,27,18,45
9709214,9709214,,54,23,7,30
9710208,9710208,,54,76,18,94
9711080,9711080,,54,12,26,38
9711197,9711197,,54,51,15,66
9712214,9712214,,54,73,16,89
9801030,9801030,,54,55,19,74
9801087,9801087,,54,22,30,52
9801123,9801123,,54,12,24,36
9801204,9801204,,54,10,12,22
9802111,9802111,,54,8,10,18
9802148,9802148,,54,9,25,34
9504019,9504019,,2,37,8,45
9607011,9607011,,2,53,19,72
9607043,9607043,,2,11,20,31
9611079,9611079,,2,19,6,25
9704186,9704186,,2,30,17,47
9707207,9707207,,2,21,18,39
9710244,9710244,,2,16,22,38
9801160,9801160,,2,13,22,35
9802030,9802030,,31,33,1,34
9803084,9803084,,31,17,1,18
9803116,9803116,,2,73,63,136
9803156,9803156,,31,25,3,28
9803239,9803239,,2,20,19,39
9803259,9803259,,2,38,38,76
9805012,9805012,,31,4,7,11
9805032,9805032,,31,4,7,11
9805167,9805167,,31,5,10,15
9204099,9204099,,34,380,0,380
9308131,9308131,,31,15,3,18
9310159,9310159,,1,27,21,48
9512222,9512222,,34,19,4,23
9706174,9706174,,34,7,2,9
9706192,9706192,,2,57,30,87
9711161,9711161,,34,85,14,99
9803090,9803090,,34,27,41,68
9805087,9805087,,34,19,11,30
9806195,9806195,,34,20,59,79
9807137,9807137,,34,85,22,107
9807187,9807187,,34,36,11,47
9808016,9808016,,34,94,23,117
9808097,9808097,,34,27,10,37
9808149,9808149,,34,113,29,142
9607060,9607060,,34,44,2,46
9608125,9608125,,34,45,7,52
9611014,9611014,,54,41,21,62
9705024,9705024,,2,12,41,53
9711048,9711048,,54,10,11,21
9802109,9802109,,34,1641,12,1653
9802150,9802150,,34,1775,22,1797
9802203,9802203,,34,131,17,148
9803171,9803171,,34,75,25,100
9804170,9804170,,34,129,17,146
9806074,9806074,,34,155,18,173
9807090,9807090,,34,35,21,56
9807097,9807097,,34,75,26,101
9807098,9807098,,34,106,21,127
9808006,9808006,,34,74,15,89
9808162,9808162,,34,55,11,66
9809067,9809067,,34,34,19,53
9809122,9809122,,54,19,16,35
9809179,9809179,,34,49,8,57
9810051,9810051,,34,36,19,55
9508072,9508072,,2,172,7,179
9601023,9601023,,34,40,14,54
9602111,9602111,,54,88,12,100
9602136,9602136,,2,172,17,189
9802183,9802183,,34,301,17,318
9806087,9806087,,34,233,21,254
9807080,9807080,,37,233,23,256
9807087,9807087,,54,47,84,131
9807164,9807164,,34,77,22,99
9809192,9809192,,34,31,6,37
9810126,9810126,,34,177,13,190
9810206,9810206,,34,99,16,115
9811149,9811149,,34,20,11,31
9603133,9603133,,54,134,20,154
9803001,9803001,,34,248,24,272
9803002,9803002,,34,315,14,329
9803137,9803137,,34,73,33,106
9805114,9805114,,34,295,6,301
9805129,9805129,,34,114,30,144
9809022,9809022,,34,150,23,173
9811035,9811035,,34,136,28,164
9811156,9811156,,34,81,23,104
9811208,9811208,,34,32,21,53
9812017,9812017,,34,28,7,35
9812089,9812089,,34,95,23,118
9812144,9812144,,2,14,23,37
9901041,9901041,,34,42,15,57
9901101,9901101,,34,76,23,99
9902012,9902012,,34,21,20,41
9902074,9902074,,34,63,43,106
9702076,9702076,,34,172,27,199
9803023,9803023,,34,76,32,108
9803131,9803131,,34,475,58,533
9805140,9805140,,34,46,22,68
9806021,9806021,,34,89,23,112
9806171,9806171,,34,32,7,39
9503121,9503121,,37,142,6,148
9507170,9507170,,37,28,6,34
9708042,9708042,,34,93,10,103
9802042,9802042,,34,308,38,346
9803015,9803015,,37,229,11,240
9803060,9803060,,34,36,28,64
9803251,9803251,,34,84,34,118
9805015,9805015,,34,29,8,37
9805082,9805082,,34,40,42,82
9807046,9807046,,34,26,14,40
9807226,9807226,,34,76,16,92
9809009,9809009,,34,28,23,51
9811097,9811097,,34,16,24,40
9811230,9811230,,37,39,22,61
9812092,9812092,,34,13,33,46
9812238,9812238,,34,21,21,42
9901109,9901109,,37,14,13,27
9901134,9901134,,34,20,31,51
9902129,9902129,,34,6,7,13
9903026,9903026,,34,73,25,98
9903059,9903059,,34,27,11,38
9711027,9711027,,31,24,48,72
9806022,9806022,,0,80,15,95
9809124,9809124,,0,56,7,63
9811141,9811141,,0,52,10,62
9902071,9902071,,0,69,58,127
9310151,9310151,,54,44,0,44
9607164,9607164,,34,56,10,66
9611213,9611213,,0,102,3,105
9801206,9801206,,34,105,16,121
9805157,9805157,,54,115,24,139
9809147,9809147,,54,99,51,150
9810155,9810155,,54,71,25,96
9811089,9811089,,31,35,43,78
9811193,9811193,,54,34,54,88
9812093,9812093,,54,37,30,67
9812118,9812118,,54,51,41,92
9812163,9812163,,54,28,55,83
9903019,9903019,,54,13,19,32
9903225,9903225,,0,130,14,144
9904021,9904021,,0,10,16,26
9905096,9905096,,34,25,21,46
9905111,9905111,,34,807,562,1369
9910093,9910093,,0,144,4,148
9612146,9612146,,2,141,25,166
9708005,9708005,,34,167,50,217
9711035,9711035,,34,48,30,78
9805104,9805104,,34,23,11,34
9810186,9810186,,34,46,18,64
9810227,9810227,,34,48,17,65
9811120,9811120,,34,83,27,110
9902170,9902170,,34,57,31,88
9902195,9902195,,34,52,19,71
9903109,9903109,,34,25,28,53
9903132,9903132,,34,32,27,59
9905075,9905075,,34,57,17,74
9905104,9905104,,34,148,33,181
9906030,9906030,,34,43,37,80
9906201,9906201,,34,61,28,89
9603090,9603090,,2,152,25,177
9603100,9603100,,2,71,19,90
9606049,9606049,,54,46,49,95
9607108,9607108,,2,36,6,42
9702103,9702103,,54,61,33,94
9702165,9702165,,54,30,18,48
9704142,9704142,,54,43,37,80
9705169,9705169,,54,54,54,108
9801161,9801161,,54,27,18,45
9806051,9806051,,54,157,50,207
9807014,9807014,,54,19,30,49
9811133,9811133,,54,17,23,40
9812032,9812032,,34,43,8,51
9901149,9901149,,34,40,30,70
9903214,9903214,,34,57,38,95
9903269,9903269,,34,15,20,35
9904036,9904036,,34,13,10,23
9905134,9905134,,34,19,30,49
9905139,9905139,,54,15,12,27
9905143,9905143,,2,10,40,50
9907006,9907006,,34,25,53,78
9905221,9905221,,0,65,3,68
9906182,9906182,,0,141,10,151
9808117,9808117,,34,37,20,57
9811167,9811167,,34,30,47,77
9901056,9901056,,34,35,13,48
9906204,9906204,,0,27,18,45
9906224,9906224,,34,26,28,54
9907204,9907204,,34,21,15,36
9908104,9908104,,0,35,10,45
9703040,9703040,,2,146,51,197
9704189,9704189,,2,23,19,42
9908175,9908175,,34,16,53,69
9908196,9908196,,34,11,18,29
9808122,9808122,,54,14,16,30
9209117,9209117,,0,2,2,4
9909047,9909047,,34,129,37,166
9804006,9804006,,34,24,58,82
9902208,9902208,,2,35,22,57
9905148,9905148,,34,23,15,38
9906168,9906168,,34,25,8,33
9906221,9906221,,34,34,14,48
9909070,9909070,,34,116,28,144
1033,1033,,0,111,63,174
2226,2226,,34,35,35,70
9702056,9702056,,34,22,3,25
9907080,9907080,,0,20,8,28
9908174,9908174,,0,11,13,24
9909076,9909076,,0,24,14,38
9910132,9910132,,0,89,7,96
9911055,9911055,,0,191,5,196
9808032,9808032,,34,65,17,82
9903238,9903238,,34,79,32,111
9906040,9906040,,34,18,31,49
9908047,9908047,,0,26,14,40
9910081,9910081,,0,21,28,49
9909103,9909103,,0,24,30,54
9806217,9806217,,34,49,23,72
9903190,9903190,,34,74,17,91
9903241,9903241,,34,27,13,40
9301052,9301052,,0,131,0,131
9612014,9612014,,0,5,11,16
9705223,9705223,,34,12,7,19
9909130,9909130,,0,93,5,98
9909205,9909205,,0,111,11,122
9911043,9911043,,0,89,10,99
9912001,9912001,,0,138,39,177
9912233,9912233,,0,62,15,77
9405029,9405029,,7,113,6,119
9705117,9705117,,2,110,32,142
9902067,9902067,,34,26,19,45
9903091,9903091,,34,26,55,81
9905081,9905081,,34,25,54,79
9908110,9908110,,34,10,21,31
9910252,9910252,,34,15,13,28
9911040,9911040,,34,31,17,48
9911161,9911161,,34,138,49,187
9911199,9911199,,34,12,19,31
1003,1003,,0,15,1,16
9912242,9912242,,0,21,7,28
9909127,9909127,,0,13,18,31
9910269,9910269,,0,3,8,11
9912160,9912160,,0,75,5,80
1004,1004,,25,1,1,2
9810131,9810131,,25,3,0,3
1005,1005,,65,1,21,22
9311183,9311183,,54,52,1,53
9506135,9506135,,65,32,1,33
9601078,9601078,,65,43,6,49
9603097,9603097,,65,121,13,134
9611194,9611194,,65,8,4,12
9712257,9712257,,65,68,29,97
9805026,9805026,,65,5,8,13
9811178,9811178,,65,43,8,51
9901099,9901099,,9,25,11,36
9902132,9902132,,65,50,18,68
9904145,9904145,,65,52,6,58
9908025,9908025,,65,36,25,61
9908036,9908036,,65,94,32,126
9908040,9908040,,65,102,38,140
9909030,9909030,,65,84,16,100
9909114,9909114,,65,26,10,36
9909140,9909140,,65,33,5,38
9909163,9909163,,65,46,15,61
9910148,9910148,,65,10,10,20
9912239,9912239,,65,29,11,40
208020,208020,,54,205,0,205
9307107,9307107,,65,8,3,11
9306145,9306145,,65,28,0,28
9309093,9309093,,65,9,0,9
9410010,9410010,,65,13,7,20
9509105,9509105,,65,30,6,36
9409165,9409165,,65,7,2,9
9410209,9410209,,65,18,3,21
9503207,9503207,,65,89,3,92
9506014,9506014,,65,89,5,94
9511043,9511043,,2,213,18,231
9411134,9411134,,65,9,2,11
9506186,9506186,,65,7,3,10
9610192,9610192,,65,21,0,21
9611124,9611124,,65,9,4,13
9309105,9309105,,8,10,2,12
9509171,9509171,,4,13,13,26
9605042,9605042,,65,33,24,57
9611064,9611064,,8,4,0,4
9612148,9612148,,65,48,7,55
9701190,9701190,,2,50,12,62
9702037,9702037,,2,37,16,53
9702194,9702194,,65,5,45,50
9702195,9702195,,2,2,5,7
9706057,9706057,,65,13,19,32
9707068,9707068,,4,109,20,129
9708040,9708040,,54,82,14,96
9708141,9708141,,65,44,5,49
9708166,9708166,,65,28,18,46
9711029,9711029,,2,8,25,33
9711069,9711069,,54,18,58,76
9712186,9712186,,65,141,39,180
9305010,9305010,,16,33,1,34
9712197,9712197,,62,30,10,40
9807142,9807142,,65,13,3,16
9809097,9809097,,65,41,11,52
9604128,9604128,,9,23,1,24
9607174,9607174,,9,29,5,34
9609128,9609128,,9,26,4,30
9612010,9612010,,9,11,11,22
9612011,9612011,,9,11,13,24
9612012,9612012,,9,11,10,21
9709216,9709216,,9,14,2,16
9806174,9806174,,9,6,7,13
9808042,9808042,,9,42,1,43
9810022,9810022,,9,22,2,24
9810087,9810087,,9,19,15,34
9806121,9806121,,65,10,6,16
9811211,9811211,,65,15,18,33
9609112,9609112,,65,56,30,86
9803101,9803101,,65,4,3,7
9812193,9812193,,65,109,3,112
9903139,9903139,,65,14,10,24
9311168,9311168,,65,3,3,6
9412109,9412109,,65,1,0,1
9606177,9606177,,65,6,1,7
9609124,9609124,,65,2,3,5
9612078,9612078,,7,15,10,25
9712230,9712230,,37,113,19,132
9905038,9905038,,65,44,10,54
9905078,9905078,,4,9,21,30
9204036,9204036,,62,15,0,15
9205040,9205040,,65,10,0,10
9211130,9211130,,8,9,3,12
9212060,9212060,,65,28,0,28
9301026,9301026,,62,9,1,10
9304009,9304009,,65,8,0,8
9306002,9306002,,62,188,2,190
9404108,9404108,,62,63,2,65
9404185,9404185,,65,12,11,23
9405019,9405019,,65,9,0,9
9510175,9510175,,65,19,7,26
9512218,9512218,,62,8,7,15
9611071,9611071,,62,6,2,8
9805023,9805023,,65,13,8,21
9811237,9811237,,4,91,34,125
9812110,9812110,,65,15,10,25
9904100,9904100,,65,6,5,11
9310187,9310187,,3,17,5,22
9401042,9401042,,65,9,1,10
9402039,9402039,,8,21,0,21
9403066,9403066,,65,7,7,14
9505175,9505175,,3,60,0,60
9510177,9510177,,65,13,4,17
9610066,9610066,,65,7,6,13
9706132,9706132,,3,23,20,43
9711005,9711005,,2,64,14,78
9801195,9801195,,3,47,8,55
9802052,9802052,,3,43,12,55
9802069,9802069,,3,42,18,60
9803031,9803031,,3,157,13,170
9803067,9803067,,3,74,22,96
9804188,9804188,,3,23,37,60
9806194,9806194,,1,173,37,210
9810072,9810072,,3,188,30,218
9812046,9812046,,1,82,19,101
9812219,9812219,,3,257,18,275
9903205,9903205,,3,251,17,268
9903219,9903219,,1,81,23,104
9906200,9906200,,37,122,58,180
9906215,9906215,,1,43,9,52
9907114,9907114,,3,11,34,45
9907183,9907183,,65,15,20,35
9908046,9908046,,65,18,9,27
9909025,9909025,,2,4,8,12
9509080,9509080,,54,92,6,98
9806131,9806131,,54,23,26,49
9312182,9312182,,1,23,8,31
9608116,9608116,,37,71,9,80
9805006,9805006,,65,22,18,40
9901122,9901122,,65,38,26,64
9909072,9909072,,4,40,25,65
9909164,9909164,,65,16,7,23
9206032,9206032,,8,16,0,16
9603104,9603104,,54,16,11,27
9701061,9701061,,65,38,5,43
9708120,9708120,,65,27,3,30
9908034,9908034,,0,1,5,6
9910079,9910079,,65,16,8,24
9404101,9404101,,65,13,3,16
1006,1006,,62,1,1,2
9910243,9910243,,62,12,3,15
9501063,9501063,,62,13,0,13
9511002,9511002,,62,13,2,15
9805093,9805093,,62,5,20,25
1007,1007,,34,0,4,4
9405171,9405171,,34,51,0,51
9807069,9807069,,11,69,2,71
9901148,9901148,,34,25,21,46
9911150,9911150,,34,6,16,22
9610193,9610193,,11,67,0,67
9705176,9705176,,11,23,1,24
9310194,9310194,,34,51,4,55
9704005,9704005,,34,87,19,106
9711138,9711138,,2,121,47,168
9712251,9712251,,34,197,15,212
9802076,9802076,,34,57,8,65
9804085,9804085,,34,222,24,246
9805178,9805178,,34,12,6,18
9806026,9806026,,34,83,25,108
9806065,9806065,,34,12,8,20
9809021,9809021,,34,38,27,65
9810145,9810145,,2,5,15,20
9811162,9811162,,34,8,18,26
9812013,9812013,,34,68,6,74
9812056,9812056,,34,44,13,57
9901050,9901050,,2,22,91,113
9506187,9506187,,2,18,1,19
9605159,9605159,,2,30,4,34
9702025,9702025,,0,14,1,15
9710180,9710180,,2,30,7,37
9712130,9712130,,2,60,26,86
9806089,9806089,,34,9,8,17
9905228,9905228,,34,7,14,21
9906165,9906165,,0,2,4,6
9909112,9909112,,34,1,15,16
9911101,9911101,,2,3,13,16
1008,1008,,7,2,6,8
9301008,9301008,,2,4,0,4
9301014,9301014,,34,8,0,8
9303112,9303112,,7,36,0,36
9409139,9409139,,7,27,3,30
9507046,9507046,,7,23,2,25
9202013,9202013,,7,10,0,10
9202057,9202057,,7,88,0,88
9212147,9212147,,7,3,0,3
9303068,9303068,,7,5,0,5
9310104,9310104,,7,1,0,1
9311011,9311011,,7,2,0,2
9205074,9205074,,7,7,0,7
9401036,9401036,,7,9,2,11
1009,1009,,25,1,1,2
9610215,9610215,,25,4,0,4
1010,1010,,2,12,5,17
9608174,9608174,,2,28,3,31
9706225,9706225,,37,33,16,49
9808157,9808157,,34,29,25,54
9901128,9901128,,34,82,72,154
9505176,9505176,,25,2,0,2
9510023,9510023,,37,30,21,51
9601007,9601007,,37,65,15,80
9602073,9602073,,37,68,12,80
9501096,9501096,,37,52,6,58
9506002,9506002,,37,17,12,29
9606082,9606082,,37,20,15,35
9608169,9608169,,37,28,16,44
9611043,9611043,,2,9,0,9
9612143,9612143,,37,33,39,72
9612182,9612182,,37,23,3,26
9702106,9702106,,37,17,19,36
9704167,9704167,,37,55,12,67
9705127,9705127,,37,24,7,31
9705138,9705138,,37,39,10,49
9602135,9602135,,34,187,15,202
9604166,9604166,,2,148,25,173
9612231,9612231,,37,36,14,50
9704029,9704029,,2,71,19,90
9704197,9704197,,2,37,25,62
9705190,9705190,,2,27,14,41
9708036,9708036,,37,32,17,49
9709072,9709072,,37,20,6,26
9710151,9710151,,54,37,16,53
9712239,9712239,,34,84,11,95
9804009,9804009,,37,44,28,72
9804058,9804058,,34,244,62,306
9807033,9807033,,34,101,39,140
9808119,9808119,,2,20,18,38
9601085,9601085,,37,63,13,76
9601097,9601097,,37,64,7,71
9605069,9605069,,37,9,13,22
9611075,9611075,,34,49,9,58
9612115,9612115,,2,327,5,332
9612127,9612127,,54,31,17,48
9701093,9701093,,54,144,25,169
9701125,9701125,,2,220,9,229
9703228,9703228,,37,37,11,48
9704011,9704011,,37,30,18,48
9704114,9704114,,37,45,63,108
9707079,9707079,,2,112,27,139
9707093,9707093,,2,118,31,149
9711107,9711107,,2,69,17,86
9802116,9802116,,34,80,3,83
9803117,9803117,,2,54,5,59
9803265,9803265,,2,82,18,100
9804035,9804035,,34,106,7,113
9804123,9804123,,54,31,39,70
9804199,9804199,,2,46,5,51
9805105,9805105,,34,68,10,78
9805145,9805145,,34,62,10,72
9805162,9805162,,34,42,10,52
9806004,9806004,,34,11,19,30
9806216,9806216,,34,56,16,72
9808041,9808041,,34,36,15,51
9808061,9808061,,54,57,19,76
9809130,9809130,,2,29,24,53
9810243,9810243,,34,41,22,63
9811047,9811047,,34,78,28,106
9811060,9811060,,34,10,48,58
9812038,9812038,,2,9,24,33
1011,1011,,3,4,20,24
9703038,9703038,,2,44,17,61
9703078,9703078,,2,43,10,53
9708039,9708039,,2,24,21,45
9710231,9710231,,2,133,121,254
9712072,9712072,,2,119,39,158
9804041,9804041,,2,2,18,20
9804163,9804163,,3,33,14,47
9805069,9805069,,2,55,17,72
9902004,9902004,,3,17,37,54
9907211,9907211,,3,48,19,67
9908019,9908019,,3,60,24,84
9909081,9909081,,3,61,2,63
9909176,9909176,,3,69,30,99
9508117,9508117,,37,40,6,46
9508156,9508156,,37,47,6,53
9509148,9509148,,2,54,19,73
9308139,9308139,,25,92,0,92
9405069,9405069,,2,32,0,32
9409089,9409089,,34,427,3,430
9512081,9512081,,54,63,11,74
9611202,9611202,,2,184,16,200
9611215,9611215,,2,77,15,92
9612087,9612087,,2,79,25,104
9612157,9612157,,2,181,9,190
9612222,9612222,,3,74,12,86
9612223,9612223,,2,60,29,89
9701151,9701151,,2,31,13,44
9701168,9701168,,2,19,7,26
9702101,9702101,,2,79,10,89
9702187,9702187,,2,223,15,238
9608042,9608042,,2,4,0,4
9611072,9611072,,2,57,18,75
9701144,9701144,,8,11,15,26
9611042,9611042,,2,265,22,287
9701025,9701025,,2,196,7,203
9703030,9703030,,2,347,23,370
9705120,9705120,,2,51,32,83
9705128,9705128,,2,71,13,84
9706130,9706130,,2,6,26,32
9707250,9707250,,2,61,32,93
9204083,9204083,,16,133,0,133
9511193,9511193,,2,14,4,18
9602071,9602071,,2,47,20,67
9602144,9602144,,54,11,17,28
9603009,9603009,,2,68,35,103
9603113,9603113,,54,30,27,57
9604042,9604042,,2,151,15,166
9604055,9604055,,2,119,30,149
9604133,9604133,,54,8,25,33
9604139,9604139,,2,70,20,90
9606185,9606185,,2,154,33,187
9607201,9607201,,2,247,68,315
9608096,9608096,,2,106,17,123
9608117,9608117,,2,123,65,188
9610082,9610082,,2,62,52,114
9610236,9610236,,2,99,7,106
9611164,9611164,,2,85,3,88
9612121,9612121,,2,190,61,251
9612162,9612162,,2,66,22,88
9612198,9612198,,2,31,6,37
9702006,9702006,,2,42,15,57
9702203,9702203,,2,75,12,87
9703052,9703052,,2,43,22,65
9703056,9703056,,2,44,9,53
9703102,9703102,,2,62,15,77
9703208,9703208,,2,17,19,36
9703218,9703218,,2,73,17,90
9704018,9704018,,2,90,37,127
9704041,9704041,,2,71,25,96
9704080,9704080,,2,301,13,314
9704123,9704123,,2,20,30,50
9704127,9704127,,2,39,41,80
9704158,9704158,,2,67,15,82
9705046,9705046,,2,125,17,142
9705055,9705055,,2,56,45,101
9705110,9705110,,2,16,25,41
9705132,9705132,,2,20,32,52
9705188,9705188,,2,25,43,68
9706039,9706039,,2,23,8,31
9706072,9706072,,2,136,17,153
9706177,9706177,,2,8,0,8
9706194,9706194,,2,16,26,42
9706196,9706196,,2,25,26,51
9707099,9707099,,2,23,44,67
9707164,9707164,,2,10,54,64
9707217,9707217,,2,55,29,84
9707228,9707228,,2,58,36,94
9707259,9707259,,2,30,32,62
9708012,9708012,,2,34,8,42
9708022,9708022,,2,14,26,40
9708034,9708034,,2,16,24,40
9708037,9708037,,2,39,49,88
9708063,9708063,,2,13,14,27
9708119,9708119,,2,59,10,69
9709107,9709107,,2,49,46,95
9709220,9709220,,2,222,28,250
9710009,9710009,,2,264,19,283
9710014,9710014,,2,75,14,89
9710104,9710104,,2,21,22,43
9710174,9710174,,2,56,19,75
9710178,9710178,,2,66,22,88
101093,101093,,3,20,0,20
9603053,9603053,,3,92,0,92
9707179,9707179,,2,28,17,45
9709042,9709042,,3,11,7,18
9710153,9710153,,3,25,6,31
9711122,9711122,,2,4,7,11
9510134,9510134,,2,83,28,111
9603109,9603109,,2,159,21,180
9604089,9604089,,2,124,29,153
9607112,9607112,,2,82,19,101
9607149,9607149,,2,77,27,104
9608108,9608108,,2,64,18,82
9609026,9609026,,2,162,11,173
9610172,9610172,,2,113,39,152
9611125,9611125,,2,38,34,72
9612051,9612051,,2,50,32,82
9702015,9702015,,2,90,14,104
9703031,9703031,,2,100,29,129
9704112,9704112,,2,27,25,52
9705057,9705057,,37,79,13,92
9705192,9705192,,2,38,34,72
9705221,9705221,,2,208,30,238
9706100,9706100,,2,43,28,71
9707158,9707158,,37,49,36,85
9707188,9707188,,34,38,17,55
9708099,9708099,,2,24,26,50
9709091,9709091,,2,81,20,101
9709099,9709099,,2,50,32,82
9711002,9711002,,34,149,6,155
9711037,9711037,,2,70,9,79
9711053,9711053,,2,70,26,96
9711072,9711072,,2,14,10,24
9306069,9306069,,25,149,17,166
9705091,9705091,,2,106,19,125
9709108,9709108,,2,64,13,77
9709114,9709114,,2,7,37,44
9710217,9710217,,2,61,27,88
9711063,9711063,,2,15,4,19
9411021,9411021,,16,50,7,57
9411100,9411100,,16,11,1,12
9507074,9507074,,3,41,4,45
9706168,9706168,,2,32,43,75
9603089,9603089,,2,46,18,64
9603186,9603186,,65,30,4,34
9604013,9604013,,65,14,24,38
9607051,9607051,,65,20,39,59
9610024,9610024,,65,18,50,68
9610062,9610062,,65,5,20,25
9611060,9611060,,65,2,15,17
9707002,9707002,,2,11,20,31
9805018,9805018,,2,62,23,85
9712201,9712201,,3,59,22,81
9801147,9801147,,3,66,15,81
9801170,9801170,,3,26,11,37
9803044,9803044,,3,58,22,80
9803166,9803166,,3,50,23,73
9804120,9804120,,3,25,6,31
9805034,9805034,,3,95,16,111
9806099,9806099,,3,42,41,83
9807198,9807198,,3,60,17,77
9810099,9810099,,3,56,28,84
9810116,9810116,,3,68,26,94
9810185,9810185,,3,26,9,35
9810219,9810219,,3,56,22,78
9811159,9811159,,3,32,9,41
9811213,9811213,,3,26,25,51
9901008,9901008,,3,2,30,32
9901077,9901077,,3,28,9,37
9612205,9612205,,3,9,5,14
9712185,9712185,,2,62,36,98
9807060,9807060,,2,13,10,23
9812184,9812184,,2,5,10,15
9812239,9812239,,2,53,52,105
9903210,9903210,,2,59,49,108
9904095,9904095,,2,79,42,121
9711179,9711179,,2,27,36,63
9712047,9712047,,2,26,45,71
9712084,9712084,,2,38,37,75
9809039,9809039,,2,85,216,301
9812139,9812139,,54,13,24,37
9906161,9906161,,3,98,38,136
9207011,9207011,,25,26,0,26
9309028,9309028,,25,16,3,19
9403050,9403050,,16,21,6,27
9608177,9608177,,2,105,4,109
9611065,9611065,,2,75,16,91
9611233,9611233,,3,47,10,57
9702008,9702008,,2,114,15,129
9702111,9702111,,2,43,6,49
9704037,9704037,,3,28,5,33
9707190,9707190,,3,32,9,41
9712117,9712117,,2,89,42,131
9712206,9712206,,3,18,20,38
9802068,9802068,,3,232,25,257
9804001,9804001,,3,52,14,66
9810147,9810147,,3,25,6,31
9812172,9812172,,3,16,39,55
9812180,9812180,,3,59,6,65
9903077,9903077,,3,114,17,131
9903107,9903107,,3,103,22,125
9903187,9903187,,3,104,12,116
9903239,9903239,,3,34,8,42
9904064,9904064,,3,10,19,29
9904132,9904132,,3,27,9,36
9906192,9906192,,3,142,12,154
9907008,9907008,,3,18,15,33
9907166,9907166,,3,144,9,153
9908052,9908052,,3,17,4,21
9908056,9908056,,3,190,9,199
9908105,9908105,,2,154,59,213
9908134,9908134,,3,165,16,181
9801182,9801182,,2,131,126,257
9908141,9908141,,3,100,19,119
1012,1012,,1,37,10,47
9205059,9205059,,16,13,0,13
9206053,9206053,,1,26,1,27
9302035,9302035,,1,23,0,23
9403141,9403141,,1,55,8,63
9405136,9405136,,1,25,6,31
9506136,9506136,,1,85,0,85
9507109,9507109,,1,21,5,26
9702190,9702190,,62,25,6,31
9911110,9911110,,1,21,12,33
9204088,9204088,,1,10,0,10
9206047,9206047,,62,35,0,35
9208027,9208027,,4,180,0,180
9205034,9205034,,1,30,0,30
9211016,9211016,,1,6,0,6
9212004,9212004,,1,2,2,4
9305023,9305023,,1,14,5,19
9305043,9305043,,1,29,1,30
9311083,9311083,,1,3,1,4
9208075,9208075,,1,7,0,7
9401007,9401007,,1,13,7,20
9403026,9403026,,1,25,2,27
9306044,9306044,,62,52,0,52
9406125,9406125,,4,59,11,70
9604044,9604044,,62,39,7,46
9611238,9611238,,62,43,4,47
9811090,9811090,,1,6,8,14
9811203,9811203,,34,9,2,11
1013,1013,,0,16,11,27
9911234,9911234,,0,9,18,27
9912276,9912276,,0,4,2,6
9805067,9805067,,54,14,0,14
9909048,9909048,,0,26,7,33
9810123,9810123,,2,16,35,51
9808138,9808138,,0,26,7,33
9908018,9908018,,2,33,26,59
9909199,9909199,,0,54,28,82
9912182,9912182,,0,10,19,29
9912018,9912018,,34,94,19,113
1014,1014,,6,3,8,11
9502097,9502097,,6,6,0,6
9606100,9606100,,6,13,1,14
9803011,9803011,,6,22,4,26
9806244,9806244,,6,12,13,25
9807215,9807215,,6,5,1,6
9903055,9903055,,6,12,4,16
9903266,9903266,,6,5,0,5
9904136,9904136,,6,5,2,7
9511139,9511139,,6,9,1,10
9612091,9612091,,6,15,1,16
9702053,9702053,,6,18,2,20
9705216,9705216,,6,9,2,11
9411080,9411080,,6,10,2,12
9511176,9511176,,6,13,6,19
9606105,9606105,,6,16,0,16
9710093,9710093,,6,6,4,10
9803030,9803030,,6,12,15,27
9803079,9803079,,6,5,6,11
9805022,9805022,,6,4,0,4
9807078,9807078,,6,17,3,20
9903011,9903011,,6,8,2,10
9710225,9710225,,6,6,2,8
1015,1015,,11,0,1,1
9811016,9811016,,11,8,3,11
9709229,9709229,,11,7,9,16
9710069,9710069,,11,6,6,12
9810165,9810165,,11,6,4,10
1016,1016,,34,8,19,27
9607049,9607049,,11,84,2,86
9808057,9808057,,34,7,1,8
9906164,9906164,,2,7,13,20
9907158,9907158,,34,11,13,24
9911215,9911215,,34,5,17,22
9301068,9301068,,16,151,0,151
9404077,9404077,,11,9,0,9
9505052,9505052,,1,45,79,124
9604040,9604040,,25,3,14,17
9606104,9606104,,11,18,1,19
9705029,9705029,,2,20,10,30
9605009,9605009,,34,53,22,75
9308075,9308075,,34,70,4,74
9712021,9712021,,2,18,14,32
9712073,9712073,,34,55,9,64
9802047,9802047,,34,69,31,100
9802126,9802126,,34,62,13,75
9302047,9302047,,34,70,0,70
9307010,9307010,,34,68,1,69
9804083,9804083,,34,123,21,144
9303139,9303139,,37,39,0,39
9702201,9702201,,54,79,26,105
9805028,9805028,,1,153,8,161
9804101,9804101,,34,12,6,18
9805143,9805143,,34,22,17,39
9806075,9806075,,34,17,22,39
9808045,9808045,,19,9,4,13
9806103,9806103,,34,31,28,59
9806106,9806106,,2,37,15,52
9610126,9610126,,34,7,1,8
9803046,9803046,,11,11,8,19
9806199,9806199,,2,88,159,247
9807223,9807223,,8,4,22,26
9805171,9805171,,34,155,21,176
9808017,9808017,,34,119,21,140
9901012,9901012,,34,34,19,53
9901079,9901079,,34,62,12,74
9901144,9901144,,34,27,36,63
9902073,9902073,,34,18,35,53
9902101,9902101,,34,17,34,51
9902121,9902121,,34,156,16,172
9903085,9903085,,34,39,12,51
9612128,9612128,,0,177,5,182
9706109,9706109,,37,205,38,243
9711116,9711116,,0,15,8,23
9803138,9803138,,34,43,36,79
9808182,9808182,,34,8,40,48
9811010,9811010,,34,9,47,56
9811048,9811048,,34,21,13,34
9901060,9901060,,34,25,16,41
9709014,9709014,,2,74,13,87
9804180,9804180,,2,47,20,67
9807169,9807169,,14,12,1,13
9810070,9810070,,14,37,45,82
9812094,9812094,,2,16,13,29
9901073,9901073,,2,17,11,28
9904065,9904065,,14,13,3,16
9904186,9904186,,2,10,8,18
9905223,9905223,,14,20,8,28
9906244,9906244,,2,15,18,33
9601143,9601143,,8,51,3,54
9906217,9906217,,1,22,44,66
9812187,9812187,,34,15,7,22
9909043,9909043,,34,12,16,28
9910099,9910099,,34,22,27,49
9908088,9908088,,54,69,23,92
1017,1017,,11,5,10,15
9609035,9609035,,11,28,1,29
9808129,9808129,,11,42,6,48
9811053,9811053,,11,24,3,27
9811077,9811077,,11,31,9,40
9811171,9811171,,11,3,6,9
9902140,9902140,,11,4,7,11
9903223,9903223,,11,17,5,22
9905215,9905215,,11,18,7,25
9406160,9406160,,11,15,0,15
9610113,9610113,,11,11,4,15
9702089,9702089,,11,36,3,39
9705151,9705151,,11,49,7,56
9707009,9707009,,37,19,29,48
9812090,9812090,,11,39,3,42
9506026,9506026,,11,18,0,18
9611228,9611228,,11,4,1,5
9808127,9808127,,11,10,2,12
9901037,9901037,,11,3,11,14
9610101,9610101,,11,27,3,30
9709109,9709109,,11,54,11,65
9805153,9805153,,11,33,9,42
9905127,9905127,,11,13,8,21
1018,1018,,0,10,18,28
9603087,9603087,,2,183,16,199
9604035,9604035,,2,224,38,262
9604179,9604179,,2,153,17,170
9609212,9609212,,2,71,24,95
9701042,9701042,,2,48,29,77
9801049,9801049,,2,21,41,62
9802163,9802163,,2,10,55,65
9906048,9906048,,34,17,22,39
9911218,9911218,,0,36,9,45
9912135,9912135,,0,47,11,58
9912175,9912175,,0,8,27,35
9508177,9508177,,2,77,9,86
9512089,9512089,,2,52,22,74
9512177,9512177,,2,20,40,60
9601077,9601077,,2,47,12,59
9508042,9508042,,2,88,5,93
9510229,9510229,,2,65,14,79
9601177,9601177,,2,119,42,161
9602043,9602043,,2,340,30,370
9603060,9603060,,2,143,17,160
9603061,9603061,,2,137,41,178
9603126,9603126,,2,131,37,168
9603183,9603183,,2,9,11,20
9302058,9302058,,2,4,2,6
9511053,9511053,,2,70,44,114
9603123,9603123,,2,61,15,76
9511045,9511045,,2,5,12,17
9604068,9604068,,2,14,29,43
9604168,9604168,,2,62,33,95
9604189,9604189,,2,80,26,106
9606118,9606118,,2,43,17,60
9609095,9609095,,2,34,15,49
9604119,9604119,,2,102,14,116
9605077,9605077,,2,44,23,67
9609181,9609181,,2,32,25,57
9612095,9612095,,2,54,31,85
9612204,9612204,,2,60,28,88
9612236,9612236,,2,30,33,63
9305143,9305143,,2,10,1,11
9702163,9702163,,2,75,56,131
9702164,9702164,,2,27,23,50
9705011,9705011,,2,59,63,122
9705078,9705078,,2,33,67,100
9710046,9710046,,2,72,359,431
9711043,9711043,,2,31,22,53
9711205,9711205,,2,69,16,85
9712004,9712004,,2,116,49,165
9712170,9712170,,2,4,30,34
9504049,9504049,,54,7,7,14
9511115,9511115,,2,14,16,30
9604052,9604052,,2,73,34,107
9606033,9606033,,2,85,42,127
9608095,9608095,,2,13,29,42
9609225,9609225,,2,12,30,42
9611026,9611026,,2,18,32,50
9611047,9611047,,2,94,36,130
9611111,9611111,,2,13,15,28
9612054,9612054,,2,3,2,5
9612089,9612089,,2,22,33,55
9701088,9701088,,2,74,36,110
9701092,9701092,,2,12,29,41
9702058,9702058,,2,5,12,17
9702077,9702077,,2,19,32,51
9702079,9702079,,2,20,35,55
9702202,9702202,,2,97,21,118
9704120,9704120,,2,50,22,72
9704190,9704190,,2,11,18,29
9705036,9705036,,2,24,33,57
9705040,9705040,,2,95,28,123
9706096,9706096,,54,15,44,59
9710110,9710110,,2,3,32,35
9710155,9710155,,2,14,17,31
9711102,9711102,,37,16,86,102
9712221,9712221,,2,11,23,34
9801060,9801060,,37,20,73,93
9802051,9802051,,2,87,207,294
9802067,9802067,,37,164,214,378
9605234,9605234,,2,113,25,138
9705053,9705053,,2,43,26,69
9712213,9712213,,2,22,33,55
9804177,9804177,,7,81,1,82
9805156,9805156,,34,87,41,128
9809027,9809027,,34,62,23,85
9809032,9809032,,34,29,29,58
9812073,9812073,,34,89,26,115
9808079,9808079,,34,52,14,66
9806069,9806069,,2,38,29,67
1113,1113,,0,148,0,148
9605051,9605051,,2,33,33,66
9801165,9801165,,2,31,15,46
9910021,9910021,,0,35,13,48
1019,1019,,25,6,9,15
2049,2049,,25,3,11,14
9605022,9605022,,25,34,5,39
9703097,9703097,,25,9,2,11
9707253,9707253,,25,27,6,33
9908101,9908101,,25,12,7,19
9908149,9908149,,25,8,34,42
9909210,9909210,,25,6,6,12
9912176,9912176,,25,10,7,17
9912223,9912223,,25,5,13,18
9510221,9510221,,11,12,1,13
9710101,9710101,,25,14,7,21
9812059,9812059,,25,18,9,27
9901011,9901011,,25,27,13,40
9901086,9901086,,25,11,7,18
9907192,9907192,,25,12,14,26
9311060,9311060,,25,5,0,5
9406048,9406048,,25,31,0,31
9503023,9503023,,25,64,1,65
9506042,9506042,,25,13,3,16
9508082,9508082,,25,12,6,18
9508086,9508086,,25,10,1,11
9703187,9703187,,25,8,1,9
9608070,9608070,,25,26,0,26
9707122,9707122,,25,26,5,31
9806193,9806193,,25,11,2,13
9810062,9810062,,25,23,5,28
9811015,9811015,,25,43,7,50
9412055,9412055,,25,4,1,5
9506061,9506061,,11,3,6,9
9608071,9608071,,25,45,10,55
9609195,9609195,,25,12,2,14
9701022,9701022,,62,2,2,4
9702007,9702007,,25,16,3,19
9703089,9703089,,25,4,1,5
9705101,9705101,,11,2,0,2
9707073,9707073,,25,16,4,20
9707083,9707083,,25,27,14,41
9707168,9707168,,25,5,3,8
9711159,9711159,,25,3,5,8
9801129,9801129,,25,8,4,12
9802149,9802149,,25,4,0,4
9807121,9807121,,25,6,1,7
9811054,9811054,,25,2,6,8
9811174,9811174,,25,2,5,7
9811219,9811219,,25,2,2,4
9812060,9812060,,25,16,8,24
9905204,9905204,,25,5,4,9
9906228,9906228,,25,12,16,28
9607186,9607186,,25,7,1,8
9810065,9810065,,19,6,4,10
9601019,9601019,,11,3,1,4
9711168,9711168,,25,17,5,22
9809199,9809199,,25,16,5,21
9906043,9906043,,25,1,0,1
9910097,9910097,,25,2,6,8
1020,1020,,9,0,1,1
9805177,9805177,,9,12,0,12
1021,1021,,65,2,15,17
9406206,9406206,,65,82,11,93
9505186,9505186,,2,78,5,83
9604136,9604136,,65,22,3,25
9606187,9606187,,65,22,4,26
9609198,9609198,,65,5,10,15
9701178,9701178,,2,3,17,20
9704157,9704157,,65,19,7,26
9705105,9705105,,65,13,2,15
9705193,9705193,,65,29,21,50
9801102,9801102,,6,2,14,16
9806068,9806068,,65,15,21,36
9906007,9906007,,65,3,3,6
9912105,9912105,,65,2,10,12
9303016,9303016,,65,63,3,66
9308112,9308112,,65,48,3,51
9308154,9308154,,65,69,3,72
9309039,9309039,,65,87,2,89
9401147,9401147,,2,3,6,9
9403155,9403155,,65,79,3,82
9403191,9403191,,1,28,12,40
9406082,9406082,,65,23,11,34
9411102,9411102,,37,121,6,127
9504108,9504108,,2,35,4,39
9204024,9204024,,65,14,0,14
9601091,9601091,,65,24,7,31
9410237,9410237,,65,91,18,109
9401006,9401006,,65,65,5,70
9407044,9407044,,65,11,4,15
9503045,9503045,,65,38,15,53
9308124,9308124,,2,64,14,78
9311117,9311117,,6,2,0,2
9408060,9408060,,2,14,9,23
9410104,9410104,,2,59,9,68
9502065,9502065,,2,42,22,64
9504070,9504070,,25,7,8,15
9504148,9504148,,2,35,20,55
9507112,9507112,,2,35,14,49
9510028,9510028,,2,12,12,24
9510034,9510034,,65,14,20,34
9610032,9610032,,4,1,12,13
9311012,9311012,,1,24,14,38
9401025,9401025,,2,42,3,45
9402016,9402016,,2,46,17,63
9406067,9406067,,2,47,28,75
9409060,9409060,,2,17,13,30
9507022,9507022,,2,77,16,93
9610131,9610131,,31,21,2,23
9611039,9611039,,31,58,14,72
9410162,9410162,,6,11,8,19
9412228,9412228,,6,110,53,163
9508153,9508153,,6,18,3,21
9606109,9606109,,37,14,11,25
9612196,9612196,,6,13,1,14
9703081,9703081,,6,9,7,16
9706218,9706218,,2,7,7,14
9710166,9710166,,6,6,7,13
9712137,9712137,,6,4,8,12
9208026,9208026,,16,32,0,32
9502122,9502122,,65,66,19,85
9503226,9503226,,65,25,12,37
9506132,9506132,,65,4,1,5
9509095,9509095,,65,33,19,52
9509123,9509123,,65,29,26,55
9512025,9512025,,65,26,10,36
9512040,9512040,,65,34,25,59
9602179,9602179,,65,15,35,50
9704137,9704137,,65,10,30,40
9803019,9803019,,65,16,21,37
9307101,9307101,,65,5,3,8
9508141,9508141,,62,3,6,9
9805185,9805185,,62,27,38,65
9708110,9708110,,65,6,8,14
1022,1022,,19,1,3,4
9311055,9311055,,37,40,2,42
9802096,9802096,,19,9,4,13
9902115,9902115,,19,40,17,57
9202038,9202038,,37,1,0,1
9508049,9508049,,19,3,3,6
9702118,9702118,,19,6,7,13
9805128,9805128,,19,5,5,10
9211035,9211035,,19,23,0,23
9306027,9306027,,19,19,1,20
9403056,9403056,,19,17,0,17
9403116,9403116,,19,12,1,13
9406034,9406034,,19,18,4,22
9408091,9408091,,19,13,2,15
9411062,9411062,,19,13,5,18
9612194,9612194,,19,50,5,55
9701027,9701027,,19,11,2,13
9705052,9705052,,19,46,4,50
9705124,9705124,,19,38,4,42
9706102,9706102,,19,4,7,11
9709035,9709035,,19,23,3,26
9712066,9712066,,19,34,11,45
9712144,9712144,,19,21,12,33
9807017,9807017,,19,4,3,7
1023,1023,,7,9,6,15
9512044,9512044,,16,1,2,3
9612084,9612084,,7,32,14,46
9706031,9706031,,7,13,8,21
9908073,9908073,,7,2,6,8
9910131,9910131,,16,3,10,13
9912113,9912113,,7,10,16,26
9501049,9501049,,16,25,3,28
9306009,9306009,,7,25,0,25
9309034,9309034,,7,26,3,29
9311147,9311147,,7,39,1,40
9405067,9405067,,7,13,5,18
9412167,9412167,,7,39,3,42
9510144,9510144,,7,11,6,17
9602085,9602085,,7,16,9,25
9602119,9602119,,7,10,7,17
9603115,9603115,,7,5,7,12
9604045,9604045,,7,17,9,26
9609139,9609139,,9,2,6,8
9610153,9610153,,7,3,3,6
9610230,9610230,,7,3,6,9
9611040,9611040,,8,20,26,46
9207103,9207103,,8,42,0,42
9301067,9301067,,7,25,3,28
9305116,9305116,,8,18,3,21
9312153,9312153,,7,40,1,41
9405107,9405107,,7,55,2,57
9412059,9412059,,7,16,2,18
9305163,9305163,,7,18,5,23
9202074,9202074,,65,21,0,21
9205090,9205090,,16,19,0,19
9301062,9301062,,16,7,1,8
9304164,9304164,,16,5,2,7
9409167,9409167,,16,5,2,7
9505027,9505027,,16,23,4,27
9801022,9801022,,16,8,21,29
9804185,9804185,,16,9,1,10
9808192,9808192,,16,5,44,49
9907154,9907154,,16,9,8,17
9301019,9301019,,7,19,1,20
9305020,9305020,,7,18,3,21
9505128,9505128,,7,13,0,13
9602016,9602016,,7,30,3,33
9603117,9603117,,7,14,6,20
9702027,9702027,,6,19,6,25
9707023,9707023,,2,3,9,12
9809102,9809102,,7,10,35,45
9809182,9809182,,7,7,6,13
9812189,9812189,,7,3,5,8
9906248,9906248,,2,29,13,42
9908115,9908115,,7,9,19,28
9908157,9908157,,7,7,4,11
9909022,9909022,,2,13,26,39
9911080,9911080,,2,15,28,43
1024,1024,,2,27,20,47
9301050,9301050,,34,7,0,7
9512153,9512153,,2,38,13,51
9606139,9606139,,54,223,26,249
9704057,9704057,,2,24,12,36
9710129,9710129,,2,47,11,58
9811022,9811022,,2,33,19,52
9812074,9812074,,2,7,21,28
9904109,9904109,,2,33,22,55
9905196,9905196,,0,60,1,61
9905217,9905217,,0,48,10,58
9907066,9907066,,0,32,3,35
9909007,9909007,,2,4,13,17
9909015,9909015,,0,43,27,70
9909098,9909098,,2,25,20,45
9910095,9910095,,0,24,18,42
9912081,9912081,,0,28,13,41
9912226,9912226,,2,9,8,17
9212029,9212029,,2,16,1,17
9301035,9301035,,2,9,3,12
9506106,9506106,,2,65,30,95
9507160,9507160,,2,73,27,100
9508058,9508058,,2,41,35,76
9511162,9511162,,2,39,15,54
9512012,9512012,,2,90,13,103
9307050,9307050,,2,13,2,15
9605049,9605049,,54,99,9,108
9607007,9607007,,0,21,9,30
9205115,9205115,,19,19,0,19
9501069,9501069,,62,14,2,16
9607185,9607185,,2,57,7,64
9608017,9608017,,2,37,19,56
9612008,9612008,,54,24,40,64
9612119,9612119,,2,18,21,39
9703060,9703060,,2,38,24,62
9703123,9703123,,2,28,12,40
9703214,9703214,,2,31,15,46
9704009,9704009,,2,4,15,19
9307066,9307066,,62,13,0,13
9406015,9406015,,62,10,2,12
9708074,9708074,,2,20,9,29
9709065,9709065,,2,9,42,51
9206026,9206026,,2,56,0,56
9405113,9405113,,2,32,4,36
9501113,9501113,,2,77,18,95
9609086,9609086,,2,45,11,56
9701011,9701011,,2,12,14,26
9705160,9705160,,2,49,9,58
9708003,9708003,,2,55,22,77
9709002,9709002,,2,46,22,68
9710007,9710007,,2,38,21,59
9711128,9711128,,2,22,8,30
9712017,9712017,,2,15,23,38
9804011,9804011,,2,29,21,50
9201020,9201020,,2,41,0,41
9409117,9409117,,2,4,0,4
9609107,9609107,,2,7,8,15
9611024,9611024,,34,60,0,60
9611193,9611193,,34,9,1,10
9703010,9703010,,34,14,1,15
9811101,9811101,,2,19,50,69
9812161,9812161,,2,22,22,44
9811084,9811084,,0,17,15,32
9710120,9710120,,37,6,6,12
9711083,9711083,,37,12,43,55
9711099,9711099,,0,13,10,23
9801166,9801166,,37,5,27,32
9807140,9807140,,0,14,29,43
9812116,9812116,,0,10,5,15
9901032,9901032,,0,30,42,72
9711130,9711130,,54,67,13,80
9701117,9701117,,2,5,46,51
9711127,9711127,,2,14,30,44
9805148,9805148,,2,3,11,14
9606136,9606136,,2,37,29,66
9607058,9607058,,37,14,13,27
9706089,9706089,,0,82,9,91
9706141,9706141,,0,69,6,75
9707192,9707192,,37,37,52,89
9710222,9710222,,37,4,9,13
9802033,9802033,,54,41,24,65
9803142,9803142,,54,44,45,89
9806056,9806056,,37,16,19,35
9807166,9807166,,0,8,13,21
9902134,9902134,,37,10,25,35
9906243,9906243,,37,15,17,32
9907206,9907206,,34,12,20,32
9910050,9910050,,0,16,34,50
9803163,9803163,,2,44,33,77
9803216,9803216,,2,50,26,76
9803260,9803260,,2,23,11,34
9805073,9805073,,2,12,14,26
9811021,9811021,,2,36,28,64
9812224,9812224,,2,24,36,60
9408155,9408155,,37,107,1,108
9706217,9706217,,0,41,9,50
9811195,9811195,,0,28,21,49
9905165,9905165,,0,26,14,40
9908090,9908090,,0,19,7,26
9910057,9910057,,0,2,4,6
9308052,9308052,,4,13,6,19
9801090,9801090,,2,8,42,50
9806146,9806146,,34,124,42,166
9807127,9807127,,2,50,29,79
9808069,9808069,,2,34,26,60
9801142,9801142,,0,21,10,31
9912015,9912015,,0,15,13,28
9710033,9710033,,2,38,11,49
9904097,9904097,,2,6,12,18
9907170,9907170,,2,11,18,29
1025,1025,,54,17,39,56
9203079,9203079,,16,32,1,33
9308005,9308005,,54,22,6,28
9612181,9612181,,54,22,21,43
9804131,9804131,,37,48,12,60
9807056,9807056,,54,29,22,51
9907013,9907013,,37,35,4,39
9908135,9908135,,37,45,18,63
9910170,9910170,,37,57,32,89
9912279,9912279,,4,55,17,72
9202054,9202054,,16,10,0,10
9201014,9201014,,54,26,0,26
9202039,9202039,,54,12,0,12
9203071,9203071,,54,71,1,72
9206084,9206084,,4,143,1,144
9207004,9207004,,8,47,0,47
9207094,9207094,,37,126,0,126
9208035,9208035,,2,37,1,38
9209085,9209085,,54,16,1,17
9211040,9211040,,8,82,4,86
9212149,9212149,,16,124,0,124
9302048,9302048,,37,38,1,39
9303046,9303046,,16,126,0,126
9304087,9304087,,25,22,0,22
9305079,9305079,,37,20,1,21
9306122,9306122,,4,15,4,19
9211119,9211119,,37,17,1,18
9304034,9304034,,54,7,2,9
9307151,9307151,,54,5,3,8
9205051,9205051,,2,41,0,41
9206016,9206016,,2,45,0,45
9302109,9302109,,2,50,1,51
9412158,9412158,,37,48,3,51
9305083,9305083,,2,50,7,57
9503030,9503030,,54,108,14,122
9407025,9407025,,37,40,4,44
9311049,9311049,,54,4,3,7
9407190,9407190,,8,124,27,151
9604041,9604041,,37,64,25,89
9211072,9211072,,4,43,1,44
9310026,9310026,,4,18,9,27
9404025,9404025,,4,7,3,10
9512046,9512046,,54,23,37,60
9607026,9607026,,2,61,33,94
9607078,9607078,,54,21,26,47
9608014,9608014,,2,7,3,10
9608145,9608145,,54,20,14,34
9608154,9608154,,54,32,57,89
9310003,9310003,,8,5,0,5
9510016,9510016,,2,3,8,11
9612214,9612214,,11,2,1,3
9702173,9702173,,37,18,22,40
9702184,9702184,,2,45,14,59
9707174,9707174,,37,20,22,42
9710063,9710063,,2,18,6,24
9511173,9511173,,2,94,17,111
9611023,9611023,,8,1,8,9
9701137,9701137,,4,109,20,129
9702093,9702093,,54,60,45,105
9705130,9705130,,2,67,27,94
9706186,9706186,,2,29,19,48
9710049,9710049,,2,10,17,27
9710246,9710246,,54,10,35,45
9711112,9711112,,3,39,15,54
9804066,9804066,,54,4,9,13
9602014,9602014,,2,58,18,76
9701163,9701163,,2,4,30,34
9707087,9707087,,2,32,43,75
9707203,9707203,,2,4,70,74
9608015,9608015,,2,18,50,68
9610105,9610105,,54,67,47,114
9610155,9610155,,2,48,18,66
9612076,9612076,,54,27,16,43
9701054,9701054,,54,17,28,45
9702168,9702168,,54,14,20,34
9703156,9703156,,2,17,39,56
9704095,9704095,,54,13,48,61
9706097,9706097,,2,36,25,61
9708025,9708025,,2,22,11,33
9708065,9708065,,54,25,25,50
9708103,9708103,,54,29,33,62
9709113,9709113,,2,3,49,52
9711067,9711067,,54,40,24,64
9712189,9712189,,2,18,11,29
9712215,9712215,,2,11,32,43
9801081,9801081,,54,18,32,50
9802147,9802147,,2,8,36,44
9803072,9803072,,54,16,123,139
9806030,9806030,,54,6,16,22
9202085,9202085,,4,14,0,14
9311092,9311092,,4,16,0,16
9402113,9402113,,4,72,0,72
9503014,9503014,,4,10,6,16
9510008,9510008,,62,15,6,21
9704151,9704151,,37,136,20,156
9808080,9808080,,37,42,19,61
9902105,9902105,,4,193,18,211
9902120,9902120,,37,28,35,63
9611165,9611165,,2,39,29,68
9712223,9712223,,2,22,27,49
9810254,9810254,,37,26,23,49
9710006,9710006,,19,6,1,7
9712048,9712048,,37,12,11,23
9809072,9809072,,19,1,4,5
9807076,9807076,,54,49,11,60
9812031,9812031,,4,146,38,184
9907026,9907026,,37,57,44,101
9707214,9707214,,37,24,12,36
9711090,9711090,,37,24,12,36
9711124,9711124,,37,39,20,59
9901146,9901146,,3,38,40,78
9906242,9906242,,37,82,53,135
9907131,9907131,,37,41,22,63
9609122,9609122,,54,116,8,124
9806016,9806016,,2,11,8,19
9908107,9908107,,2,15,3,18
9912086,9912086,,2,26,30,56
1026,1026,,25,0,6,6
9310144,9310144,,16,35,3,38
9312059,9312059,,25,42,14,56
9405110,9405110,,25,62,2,64
9411163,9411163,,25,29,8,37
9910178,9910178,,16,4,7,11
9201036,9201036,,8,13,0,13
9206063,9206063,,8,22,0,22
209014,209014,,25,35,0,35
9201021,9201021,,25,53,0,53
9203056,9203056,,25,68,0,68
9203077,9203077,,8,13,0,13
9205030,9205030,,34,7,0,7
9205071,9205071,,25,22,1,23
9207001,9207001,,25,14,2,16
9209118,9209118,,25,20,3,23
9210010,9210010,,8,157,0,157
9210017,9210017,,25,29,2,31
9211054,9211054,,25,26,3,29
9301021,9301021,,25,10,0,10
9304012,9304012,,25,21,1,22
9307025,9307025,,25,2,4,6
9212003,9212003,,6,19,0,19
9302026,9302026,,25,32,2,34
9308002,9308002,,25,19,1,20
9312003,9312003,,25,18,1,19
9403121,9403121,,25,22,17,39
9201017,9201017,,25,20,0,20
9201041,9201041,,4,8,0,8
9202021,9202021,,6,30,0,30
9204044,9204044,,6,30,0,30
9204065,9204065,,6,19,0,19
9205018,9205018,,6,28,0,28
9205088,9205088,,6,65,0,65
9206061,9206061,,6,7,0,7
9206097,9206097,,6,15,0,15
9207067,9207067,,8,32,0,32
9208047,9208047,,6,46,0,46
9209007,9209007,,6,13,1,14
9209037,9209037,,8,22,1,23
9210026,9210026,,6,4,0,4
9210115,9210115,,6,37,0,37
9211096,9211096,,6,36,2,38
9211107,9211107,,8,9,0,9
9212072,9212072,,4,19,0,19
9301103,9301103,,6,30,3,33
9301122,9301122,,6,19,1,20
9302020,9302020,,16,3,9,12
9303027,9303027,,6,6,0,6
9303136,9303136,,6,37,1,38
9303167,9303167,,6,2,0,2
9304057,9304057,,6,90,4,94
9304061,9304061,,4,8,3,11
9305026,9305026,,4,22,13,35
9305087,9305087,,6,7,5,12
9306101,9306101,,6,11,1,12
9306147,9306147,,6,28,7,35
9307088,9307088,,4,33,19,52
9308001,9308001,,4,3,6,9
9308076,9308076,,6,2,1,3
9309011,9309011,,6,22,1,23
9309027,9309027,,6,11,7,18
9309085,9309085,,6,4,6,10
9310080,9310080,,6,16,2,18
9310126,9310126,,2,5,4,9
9310166,9310166,,6,4,2,6
9311157,9311157,,8,12,4,16
9312185,9312185,,8,6,13,19
9312206,9312206,,6,38,4,42
9401148,9401148,,6,4,3,7
9401161,9401161,,6,9,4,13
9403143,9403143,,6,26,16,42
9404170,9404170,,6,5,5,10
9405109,9405109,,6,100,10,110
9405112,9405112,,6,12,12,24
9502010,9502010,,6,29,3,32
9710176,9710176,,16,8,8,16
9807155,9807155,,16,7,11,18
1027,1027,,3,55,19,74
9802085,9802085,,2,56,23,79
9908038,9908038,,2,48,59,107
9910004,9910004,,3,150,24,174
9910091,9910091,,3,49,16,65
9911041,9911041,,3,79,25,104
9911098,9911098,,3,90,14,104
9912072,9912072,,3,341,17,358
9912075,9912075,,3,82,14,96
9912094,9912094,,3,107,13,120
9912167,9912167,,3,114,22,136
9604171,9604171,,2,20,9,29
9610041,9610041,,2,34,30,64
9712168,9712168,,2,7,29,36
9611103,9611103,,2,37,8,45
9704017,9704017,,2,15,3,18
9704098,9704098,,2,87,18,105
9708123,9708123,,2,19,29,48
9709098,9709098,,2,8,26,34
9711073,9711073,,2,25,23,48
9712179,9712179,,2,6,56,62
9801084,9801084,,2,17,49,66
9801085,9801085,,2,6,11,17
9510083,9510083,,3,48,0,48
9602115,9602115,,3,37,5,42
9902037,9902037,,7,12,6,18
9810179,9810179,,3,45,18,63
9901080,9901080,,3,78,22,100
9902051,9902051,,2,14,71,85
9410223,9410223,,19,14,1,15
9411030,9411030,,19,4,2,6
9502025,9502025,,11,25,1,26
9601092,9601092,,11,28,1,29
9712095,9712095,,3,11,24,35
9812208,9812208,,11,7,3,10
9902022,9902022,,34,21,25,46
9701139,9701139,,2,70,17,87
9706187,9706187,,2,6,15,21
9707162,9707162,,2,18,9,27
9708029,9708029,,2,8,4,12
9801051,9801051,,2,12,8,20
9801184,9801184,,2,8,0,8
9802082,9802082,,2,14,9,23
9802164,9802164,,2,8,13,21
9803088,9803088,,2,10,25,35
9805212,9805212,,2,6,12,18
9806096,9806096,,2,8,20,28
9810004,9810004,,2,6,10,16
9810035,9810035,,37,28,14,42
9810237,9810237,,2,7,26,33
9811220,9811220,,2,35,6,41
9812008,9812008,,2,3,41,44
9812177,9812177,,2,7,16,23
9902087,9902087,,2,5,24,29
9902113,9902113,,2,21,11,32
9902200,9902200,,2,9,53,62
9903037,9903037,,2,9,20,29
9903050,9903050,,2,5,45,50
9903165,9903165,,2,32,33,65
9903217,9903217,,2,17,54,71
9904122,9904122,,2,12,24,36
9209003,9209003,,7,58,0,58
9307087,9307087,,7,11,2,13
9508111,9508111,,3,4,5,9
9610248,9610248,,3,4,3,7
9908152,9908152,,3,31,7,38
9911137,9911137,,3,20,25,45
9912036,9912036,,3,15,19,34
9812063,9812063,,7,7,7,14
9909215,9909215,,3,79,36,115
9910138,9910138,,3,38,20,58
1028,1028,,8,1,6,7
9706175,9706175,,54,97,10,107
9712195,9712195,,54,11,24,35
9802162,9802162,,8,44,13,57
9809070,9809070,,2,18,25,43
9812136,9812136,,8,13,5,18
9910055,9910055,,54,21,18,39
9611205,9611205,,54,30,18,48
9704087,9704087,,2,20,30,50
9704145,9704145,,54,86,16,102
9705056,9705056,,2,30,12,42
9706025,9706025,,54,24,69,93
9707018,9707018,,54,59,16,75
9707126,9707126,,54,58,72,130
9707134,9707134,,54,54,13,67
9707222,9707222,,54,28,17,45
9709058,9709058,,54,35,64,99
9709116,9709116,,54,23,13,36
9710023,9710023,,54,30,14,44
9307001,9307001,,8,42,0,42
9311026,9311026,,8,3,2,5
9408014,9408014,,8,34,2,36
9502156,9502156,,8,18,3,21
9508135,9508135,,54,9,6,15
9512084,9512084,,8,12,3,15
9606067,9606067,,8,4,1,5
9607141,9607141,,8,20,3,23
9611045,9611045,,8,1,6,7
9611127,9611127,,8,11,14,25
9509158,9509158,,8,28,3,31
9709063,9709063,,2,29,9,38
9709199,9709199,,2,32,12,44
9801110,9801110,,2,24,28,52
9801183,9801183,,2,24,31,55
9801189,9801189,,2,20,15,35
9802088,9802088,,4,57,26,83
9805091,9805091,,2,25,25,50
9806081,9806081,,2,17,12,29
9806082,9806082,,2,14,12,26
9808188,9808188,,2,30,24,54
9712164,9712164,,54,14,16,30
9804023,9804023,,54,25,12,37
9809163,9809163,,8,3,4,7
9905050,9905050,,54,16,2,18
9907155,9907155,,54,16,16,32
9910056,9910056,,54,12,13,25
1029,1029,,54,7,33,40
9209101,9209101,,54,4,0,4
9611007,9611007,,54,23,14,37
9712035,9712035,,54,5,25,30
9811194,9811194,,31,31,14,45
9812028,9812028,,54,22,31,53
9812209,9812209,,54,22,28,50
9907134,9907134,,54,11,38,49
9907164,9907164,,54,16,18,34
9509070,9509070,,2,18,30,48
9201054,9201054,,2,26,0,26
9401070,9401070,,25,149,2,151
9510200,9510200,,2,81,12,93
9511159,9511159,,2,8,24,32
9512121,9512121,,54,26,16,42
9512191,9512191,,54,1,4,5
9512203,9512203,,2,19,36,55
9601057,9601057,,2,70,30,100
9601098,9601098,,2,18,8,26
9604070,9604070,,54,48,18,66
9608061,9608061,,2,38,28,66
9705074,9705074,,2,69,9,78
9705084,9705084,,2,71,15,86
9706142,9706142,,2,21,7,28
9710218,9710218,,2,18,39,57
9710247,9710247,,2,11,17,28
9704129,9704129,,54,15,21,36
9708137,9708137,,2,19,15,34
9303017,9303017,,54,60,4,64
9312159,9312159,,54,11,0,11
9608005,9608005,,54,42,13,55
9708130,9708130,,54,22,42,64
9709004,9709004,,54,12,16,28
9709123,9709123,,2,8,52,60
9710016,9710016,,54,8,9,17
9801205,9801205,,54,53,29,82
9804014,9804014,,54,7,30,37
9601151,9601151,,34,22,13,35
9712166,9712166,,54,25,15,40
9807111,9807111,,2,17,13,30
9501053,9501053,,54,19,2,21
9604103,9604103,,2,49,31,80
9709030,9709030,,31,22,24,46
9806230,9806230,,31,43,17,60
9608186,9608186,,54,30,17,47
9705031,9705031,,37,39,6,45
9709013,9709013,,54,67,20,87
9710116,9710116,,37,65,31,96
9801067,9801067,,54,17,37,54
9802168,9802168,,54,46,42,88
9802189,9802189,,54,20,8,28
9804210,9804210,,54,34,36,70
9805076,9805076,,54,9,34,43
9805220,9805220,,54,28,26,54
9807117,9807117,,54,8,23,31
9809026,9809026,,54,18,22,40
9406175,9406175,,2,16,3,19
9411188,9411188,,2,8,3,11
9705237,9705237,,54,20,23,43
9805131,9805131,,34,70,52,122
9811228,9811228,,54,21,37,58
9709010,9709010,,37,15,28,43
9902179,9902179,,54,9,25,34
9903215,9903215,,54,13,36,49
9811064,9811064,,54,7,21,28
1030,1030,,25,0,4,4
9406173,9406173,,25,2,2,4
9612009,9612009,,25,5,5,10
9704150,9704150,,25,4,1,5
9902165,9902165,,37,5,5,10
9402138,9402138,,25,4,1,5
9405108,9405108,,25,2,1,3
9204048,9204048,,6,5,0,5
9410137,9410137,,25,2,2,4
9506079,9506079,,25,14,2,16
9210032,9210032,,65,17,1,18
9305080,9305080,,65,11,6,17
9306012,9306012,,65,3,4,7
1031,1031,,34,5,3,8
9806236,9806236,,34,25,16,41
9910096,9910096,,34,54,24,78
9208074,9208074,,54,30,1,31
9712043,9712043,,8,14,26,40
9712246,9712246,,34,2,2,4
9802023,9802023,,3,8,18,26
9804172,9804172,,34,21,15,36
9805125,9805125,,34,26,5,31
9511063,9511063,,34,4,3,7
9606027,9606027,,8,6,8,14
9609034,9609034,,34,6,0,6
9808004,9808004,,34,26,11,37
9903020,9903020,,34,16,7,23
9906149,9906149,,34,4,7,11
9906167,9906167,,34,22,5,27
9907020,9907020,,34,3,10,13
1032,1032,,3,36,6,42
9912070,9912070,,3,30,11,41
9802129,9802129,,3,6,4,10
9911018,9911018,,3,12,8,20
9911026,9911026,,3,4,15,19
9912038,9912038,,3,13,31,44
1071,1071,,0,96,20,116
9910174,9910174,,0,56,44,100
9911083,9911083,,0,20,22,42
9911104,9911104,,0,20,19,39
9911165,9911165,,0,61,10,71
9911181,9911181,,0,37,13,50
9911237,9911237,,0,16,20,36
9912060,9912060,,0,40,22,62
9912125,9912125,,0,21,53,74
9912166,9912166,,0,1,6,7
9912186,9912186,,0,29,9,38
9912193,9912193,,0,6,18,24
9912230,9912230,,8,10,28,38
9912232,9912232,,0,54,20,74
9912287,9912287,,0,99,16,115
9912027,9912027,,34,33,20,53
9912053,9912053,,54,8,17,25
9811045,9811045,,2,8,14,22
9802195,9802195,,34,45,15,60
9803109,9803109,,34,50,49,99
9804093,9804093,,34,15,17,32
9903003,9903003,,34,4,16,20
9804096,9804096,,31,28,35,63
9809195,9809195,,0,35,9,44
9808124,9808124,,8,31,74,105
9903164,9903164,,2,2,28,30
9810028,9810028,,0,1,1,2
9908146,9908146,,54,13,24,37
9209032,9209032,,2,95,1,96
9404092,9404092,,31,38,19,57
9709023,9709023,,54,10,14,24
9807225,9807225,,34,27,16,43
9902055,9902055,,54,32,27,59
9905037,9905037,,2,10,40,50
9906206,9906206,,34,33,50,83
9512170,9512170,,2,1,7,8
9911015,9911015,,0,67,7,74
9711038,9711038,,54,10,11,21
1192,1192,,0,65,38,103
4097,4097,,0,68,10,78
9706012,9706012,,7,8,1,9
9910202,9910202,,54,24,22,46
9809057,9809057,,34,133,10,143
9903226,9903226,,34,35,11,46
9905115,9905115,,54,19,71,90
9910245,9910245,,34,25,5,30
9911164,9911164,,54,17,45,62
9901103,9901103,,54,6,20,26
9303160,9303160,,8,117,0,117
9509166,9509166,,8,69,12,81
9511134,9511134,,8,80,3,83
9512210,9512210,,8,58,9,67
9606102,9606102,,8,56,17,73
9609238,9609238,,8,26,34,60
9610168,9610168,,8,44,19,63
9703028,9703028,,8,27,10,37
9711163,9711163,,8,19,18,37
9804084,9804084,,8,9,39,48
9908139,9908139,,8,5,16,21
9909068,9909068,,8,11,17,28
9704045,9704045,,2,6,7,13
9907082,9907082,,54,17,4,21
9911230,9911230,,34,17,15,32
1034,1034,,25,0,4,4
9510091,9510091,,25,6,1,7
1035,1035,,1,53,9,62
9404162,9404162,,1,62,11,73
9604123,9604123,,1,27,16,43
9902099,9902099,,1,11,7,18
9910205,9910205,,1,14,5,19
9201004,9201004,,2,44,0,44
9207050,9207050,,2,36,1,37
9211025,9211025,,2,12,1,13
9302049,9302049,,8,19,2,21
9303025,9303025,,1,8,1,9
9303122,9303122,,2,18,2,20
9303172,9303172,,1,18,2,20
9308129,9308129,,1,45,3,48
9310170,9310170,,8,85,10,95
9312187,9312187,,8,24,5,29
9402007,9402007,,54,28,4,32
9409043,9409043,,8,14,0,14
9508139,9508139,,8,14,2,16
9309030,9309030,,1,28,2,30
9503099,9503099,,4,75,3,78
9505143,9505143,,1,5,4,9
9504140,9504140,,2,32,1,33
9512082,9512082,,2,11,5,16
9804076,9804076,,4,23,13,36
9503205,9503205,,1,56,11,67
9511187,9511187,,1,22,14,36
9608078,9608078,,1,19,20,39
9712258,9712258,,1,43,1,44
9805217,9805217,,1,76,7,83
9808020,9808020,,1,77,10,87
9808038,9808038,,1,86,10,96
9809145,9809145,,1,45,16,61
9809164,9809164,,1,43,19,62
9812062,9812062,,1,35,22,57
9812216,9812216,,1,20,17,37
9812252,9812252,,1,12,13,25
9902046,9902046,,1,25,16,41
9502162,9502162,,6,9,0,9
9607161,9607161,,6,39,1,40
9902180,9902180,,1,19,17,36
9906013,9906013,,1,18,28,46
9804166,9804166,,34,47,13,60
1036,1036,,37,11,16,27
9411047,9411047,,4,23,6,29
9603002,9603002,,37,60,20,80
9608129,9608129,,37,26,11,37
9707005,9707005,,37,15,0,15
9210090,9210090,,4,14,1,15
9304053,9304053,,4,21,7,28
9311009,9311009,,4,27,27,54
9407106,9407106,,37,72,1,73
9408013,9408013,,37,64,5,69
9502013,9502013,,37,19,11,30
9503086,9503086,,37,89,6,95
9505004,9505004,,37,94,8,102
9504080,9504080,,37,27,9,36
9504113,9504113,,37,30,16,46
9507144,9507144,,37,48,11,59
9509075,9509075,,25,6,4,10
9607125,9607125,,37,11,24,35
1037,1037,,37,32,22,54
9910172,9910172,,37,52,24,76
9912147,9912147,,37,42,18,60
9912151,9912151,,37,55,22,77
9912188,9912188,,37,44,27,71
9606169,9606169,,54,122,17,139
9509160,9509160,,54,40,32,72
9610232,9610232,,54,19,13,32
9704147,9704147,,54,31,24,55
9801191,9801191,,65,1,10,11
9803096,9803096,,2,14,21,35
9902100,9902100,,2,10,22,32
9301088,9301088,,37,17,2,19
9307038,9307038,,54,22,1,23
9312189,9312189,,25,29,9,38
9506064,9506064,,62,27,23,50
9703194,9703194,,54,10,14,24
9912123,9912123,,37,47,16,63
1038,1038,,25,1,2,3
9511055,9511055,,25,2,1,3
9704160,9704160,,25,2,2,4
9402123,9402123,,25,2,0,2
1039,1039,,25,5,2,7
9906169,9906169,,25,6,8,14
9308048,9308048,,25,13,0,13
9504029,9504029,,25,8,0,8
9505157,9505157,,25,30,3,33
9603021,9603021,,25,19,0,19
9610017,9610017,,25,6,1,7
9701018,9701018,,25,24,3,27
9704016,9704016,,25,11,18,29
9706129,9706129,,25,14,2,16
9708163,9708163,,25,12,4,16
9710048,9710048,,25,16,6,22
9806168,9806168,,25,11,11,22
1040,1040,,0,1,1,2
9912054,9912054,,0,3,0,3
1041,1041,,34,32,47,79
9208059,9208059,,8,39,0,39
9410191,9410191,,25,3,5,8
9411068,9411068,,34,12,3,15
9704108,9704108,,34,12,7,19
9803051,9803051,,34,86,34,120
9803053,9803053,,34,75,8,83
9803068,9803068,,34,62,19,81
9803077,9803077,,34,55,28,83
9808060,9808060,,2,29,19,48
9810256,9810256,,25,6,12,18
9812218,9812218,,2,12,37,49
9901021,9901021,,34,19,8,27
9901121,9901121,,34,28,36,64
9902153,9902153,,34,22,34,56
9903161,9903161,,34,10,15,25
9905005,9905005,,34,16,8,24
9905163,9905163,,34,8,7,15
9907047,9907047,,34,20,19,39
9908014,9908014,,34,19,11,30
9909094,9909094,,2,26,24,50
9909179,9909179,,34,15,18,33
9910192,9910192,,34,7,13,20
9910267,9910267,,34,37,8,45
9911109,9911109,,2,2,19,21
9911129,9911129,,34,13,8,21
9911135,9911135,,34,16,50,66
9911238,9911238,,34,35,30,65
9303044,9303044,,34,15,3,18
9205015,9205015,,25,40,1,41
9212140,9212140,,25,8,0,8
9404020,9404020,,25,5,8,13
9401031,9401031,,25,20,1,21
9304159,9304159,,2,40,0,40
9512095,9512095,,62,1,9,10
9601152,9601152,,2,85,23,108
9603078,9603078,,2,95,14,109
9204004,9204004,,34,14,0,14
9404187,9404187,,34,17,5,22
9410093,9410093,,34,23,5,28
9412061,9412061,,25,8,7,15
9505051,9505051,,37,53,9,62
9506148,9506148,,37,73,16,89
9509140,9509140,,34,44,3,47
9510205,9510205,,34,5,2,7
9511065,9511065,,37,29,15,44
9206021,9206021,,4,13,0,13
9509084,9509084,,11,10,0,10
9609211,9609211,,54,17,6,23
9510053,9510053,,2,38,6,44
9603194,9603194,,2,85,34,119
9604065,9604065,,2,69,38,107
9604127,9604127,,2,11,31,42
9608126,9608126,,2,34,8,42
9608127,9608127,,2,22,26,48
9609052,9609052,,2,67,12,79
9609076,9609076,,2,56,17,73
9701149,9701149,,2,162,25,187
9701166,9701166,,2,146,48,194
9701187,9701187,,2,43,46,89
9702045,9702045,,2,27,26,53
9702109,9702109,,2,28,22,50
9607110,9607110,,6,12,0,12
9609138,9609138,,34,7,6,13
9603147,9603147,,2,44,25,69
9605016,9605016,,2,70,24,94
9610077,9610077,,2,12,29,41
9703146,9703146,,2,18,51,69
9703216,9703216,,2,48,32,80
9704156,9704156,,2,33,25,58
9704195,9704195,,2,57,29,86
9706071,9706071,,2,35,29,64
9706204,9706204,,2,13,37,50
9611133,9611133,,34,11,7,18
9703196,9703196,,34,15,2,17
9712074,9712074,,34,36,1,37
9802198,9802198,,34,53,22,75
9803013,9803013,,34,31,8,39
9803028,9803028,,34,50,37,87
9803039,9803039,,34,68,28,96
9711020,9711020,,2,4,5,9
9709087,9709087,,2,62,70,132
9803082,9803082,,34,23,32,55
9210099,9210099,,54,23,0,23
9212146,9212146,,14,7,2,9
9403186,9403186,,2,37,7,44
9803085,9803085,,34,34,29,63
9804037,9804037,,34,3,17,20
9805041,9805041,,1,54,16,70
9506109,9506109,,2,96,11,107
9701008,9701008,,2,43,3,46
9701037,9701037,,2,114,32,146
9703127,9703127,,2,51,28,79
9805065,9805065,,2,15,22,37
9807205,9807205,,34,24,12,36
9412147,9412147,,34,42,0,42
9611074,9611074,,34,35,4,39
9309035,9309035,,25,9,0,9
9504097,9504097,,8,28,1,29
9509073,9509073,,25,13,3,16
9510140,9510140,,25,11,0,11
9609014,9609014,,25,3,2,5
9702003,9702003,,25,4,3,7
9712064,9712064,,2,12,12,24
9801056,9801056,,25,3,6,9
9409009,9409009,,16,10,14,24
9802026,9802026,,2,23,26,49
9805070,9805070,,2,18,13,31
9805136,9805136,,2,18,41,59
9806240,9806240,,2,33,61,94
9807229,9807229,,2,8,16,24
9810146,9810146,,2,29,11,40
9809188,9809188,,34,47,14,61
9808184,9808184,,34,23,18,41
9809132,9809132,,34,16,21,37
9810151,9810151,,34,23,21,44
9811106,9811106,,34,26,25,51
9811146,9811146,,34,6,10,16
9811152,9811152,,34,41,26,67
9811257,9811257,,34,37,20,57
9710065,9710065,,2,53,21,74
9705139,9705139,,2,30,35,65
9711055,9711055,,2,41,27,68
9407023,9407023,,6,13,2,15
9903196,9903196,,34,63,32,95
9902131,9902131,,34,46,50,96
9509169,9509169,,25,6,2,8
9405194,9405194,,6,70,6,76
9506035,9506035,,2,103,1,104
9511145,9511145,,6,27,6,33
9606181,9606181,,6,35,12,47
9706119,9706119,,6,35,8,43
9710147,9710147,,11,24,5,29
9712067,9712067,,2,8,3,11
9806062,9806062,,2,10,22,32
9812140,9812140,,6,11,12,23
9905018,9905018,,2,11,32,43
9906151,9906151,,34,24,43,67
9907085,9907085,,34,30,40,70
9907108,9907108,,34,16,26,42
9908160,9908160,,34,55,21,76
9908165,9908165,,34,2,33,35
9810148,9810148,,34,8,10,18
9904010,9904010,,34,23,20,43
9904085,9904085,,34,12,9,21
9910134,9910134,,34,5,2,7
9903033,9903033,,34,31,22,53
9904179,9904179,,34,30,23,53
9910023,9910023,,34,23,6,29
9503182,9503182,,2,62,2,64
9906103,9906103,,2,8,15,23
2066,2066,,34,27,16,43
9904074,9904074,,34,10,3,13
9904162,9904162,,34,13,9,22
9611100,9611100,,2,94,11,105
9803108,9803108,,2,11,54,65
9807186,9807186,,34,14,9,23
9808025,9808025,,2,10,14,24
9903230,9903230,,34,21,20,41
9910199,9910199,,34,4,9,13
9711181,9711181,,2,42,9,51
9909099,9909099,,2,29,11,40
9909203,9909203,,34,22,12,34
9910116,9910116,,2,9,20,29
9911180,9911180,,34,20,6,26
1042,1042,,16,2,12,14
9401153,9401153,,16,86,3,89
9402015,9402015,,16,27,0,27
9407056,9407056,,16,21,3,24
9707028,9707028,,16,15,2,17
9707057,9707057,,16,5,0,5
9710175,9710175,,16,6,7,13
9710233,9710233,,16,12,9,21
9712188,9712188,,16,10,8,18
9804136,9804136,,16,6,6,12
9904029,9904029,,16,3,11,14
9908161,9908161,,16,2,11,13
9210147,9210147,,16,6,0,6
9302107,9302107,,16,2,0,2
9302119,9302119,,16,19,0,19
9706212,9706212,,16,2,3,5
9411037,9411037,,16,2,3,5
9605231,9605231,,16,28,7,35
9612163,9612163,,16,9,3,12
9608035,9608035,,16,12,7,19
9610020,9610020,,16,11,5,16
9702162,9702162,,16,9,3,12
9703106,9703106,,16,8,1,9
9705021,9705021,,16,11,6,17
9708054,9708054,,16,5,10,15
9806197,9806197,,34,23,26,49
9807230,9807230,,34,7,33,40
9808035,9808035,,2,16,55,71
9806097,9806097,,16,6,1,7
9812080,9812080,,16,4,7,11
9904081,9904081,,16,2,11,13
9908124,9908124,,16,5,11,16
1044,1044,,4,3,16,19
9901159,9901159,,4,94,16,110
9905159,9905159,,54,49,5,54
9911116,9911116,,4,198,22,220
9912249,9912249,,4,201,20,221
9912275,9912275,,4,54,33,87
9707012,9707012,,37,15,16,31
9707019,9707019,,2,13,49,62
9711131,9711131,,37,20,12,32
9803076,9803076,,34,123,24,147
9803249,9803249,,34,65,5,70
9806052,9806052,,37,6,16,22
9707160,9707160,,54,53,26,79
9708016,9708016,,54,5,14,19
9708075,9708075,,54,16,10,26
9709081,9709081,,37,7,16,23
9710123,9710123,,0,28,13,41
9801128,9801128,,2,15,11,26
9712077,9712077,,2,37,28,65
9812226,9812226,,4,24,42,66
9812003,9812003,,4,3,21,24
9812175,9812175,,2,7,20,27
9901014,9901014,,4,51,22,73
9404008,9404008,,4,58,3,61
9804160,9804160,,54,47,34,81
9807161,9807161,,4,17,7,24
9808073,9808073,,37,3,13,16
9902102,9902102,,4,25,37,62
9902116,9902116,,4,27,20,47
9902158,9902158,,4,15,31,46
9902181,9902181,,4,15,17,32
9903129,9903129,,4,4,24,28
9904153,9904153,,4,9,36,45
9707148,9707148,,54,43,10,53
9803048,9803048,,2,10,27,37
9807213,9807213,,54,37,13,50
9906055,9906055,,4,64,34,98
9906109,9906109,,4,17,37,54
9906234,9906234,,54,27,38,65
9908060,9908060,,4,35,34,69
9409015,9409015,,4,12,4,16
9705241,9705241,,4,43,14,57
9909062,9909062,,4,107,30,137
9202015,9202015,,4,20,0,20
9412106,9412106,,4,3,6,9
9605088,9605088,,4,30,2,32
9705038,9705038,,4,39,9,48
9807171,9807171,,2,20,167,187
9904112,9904112,,2,16,9,25
9904129,9904129,,2,29,17,46
9905014,9905014,,2,19,18,37
9905056,9905056,,2,9,20,29
9906214,9906214,,2,37,19,56
9909027,9909027,,2,7,26,33
9909095,9909095,,2,10,30,40
9912161,9912161,,4,57,10,67
1045,1045,,25,1,3,4
9912102,9912102,,25,2,2,4
9912291,9912291,,25,3,4,7
1046,1046,,11,6,7,13
9505078,9505078,,11,1,0,1
9512070,9512070,,11,17,0,17
9705156,9705156,,11,9,10,19
9807052,9807052,,11,6,13,19
9904202,9904202,,11,9,5,14
9906080,9906080,,2,1,3,4
9907081,9907081,,11,8,13,21
9402023,9402023,,11,11,0,11
9512118,9512118,,11,4,5,9
9602083,9602083,,11,14,5,19
9606078,9606078,,11,11,0,11
9606079,9606079,,11,9,1,10
9702114,9702114,,11,6,4,10
9702204,9702204,,11,17,2,19
9703150,9703150,,31,43,13,56
9704210,9704210,,1,9,0,9
9302117,9302117,,7,4,0,4
9408019,9408019,,8,18,8,26
9703046,9703046,,7,2,2,4
9705154,9705154,,11,4,5,9
9705155,9705155,,11,14,7,21
9707072,9707072,,11,5,8,13
9803128,9803128,,11,10,0,10
9809024,9809024,,11,7,5,12
9705059,9705059,,37,4,10,14
9711097,9711097,,2,54,26,80
9208009,9208009,,6,6,0,6
9807054,9807054,,11,4,12,16
1047,1047,,2,3,9,12
9301069,9301069,,19,6,0,6
9411025,9411025,,16,31,3,34
9903030,9903030,,2,3,9,12
9904191,9904191,,34,67,16,83
9306077,9306077,,16,21,0,21
9404004,9404004,,16,36,7,43
9409098,9409098,,16,31,21,52
9410054,9410054,,16,32,8,40
9407124,9407124,,62,3,0,3
9607052,9607052,,2,24,4,28
9801023,9801023,,2,15,31,46
9803058,9803058,,2,10,34,44
9805126,9805126,,2,13,30,43
9810170,9810170,,2,11,12,23
9812037,9812037,,2,12,34,46
9901057,9901057,,34,26,14,40
9903042,9903042,,34,34,17,51
9904147,9904147,,34,12,16,28
1048,1048,,3,2,4,6
9703083,9703083,,3,3,0,3
9705006,9705006,,3,4,1,5
9707128,9707128,,3,3,1,4
9809019,9809019,,3,3,2,5
9605006,9605006,,3,2,2,4
1049,1049,,4,11,29,40
3022,3022,,4,6,27,33
9709062,9709062,,54,57,83,140
9904201,9904201,,11,6,8,14
9910109,9910109,,4,39,36,75
9912079,9912079,,65,10,30,40
1143,1143,,4,32,22,54
9211118,9211118,,2,9,0,9
9305066,9305066,,2,20,8,28
9508068,9508068,,4,63,20,83
9509067,9509067,,54,11,1,12
9510041,9510041,,4,23,25,48
9205070,9205070,,54,26,0,26
9607235,9607235,,2,164,75,239
9410052,9410052,,2,41,2,43
9411028,9411028,,25,63,47,110
9511064,9511064,,2,106,13,119
9601167,9601167,,2,40,16,56
9601037,9601037,,54,31,23,54
9612064,9612064,,2,9,29,38
9701143,9701143,,2,17,17,34
9611174,9611174,,2,79,31,110
9706024,9706024,,2,5,8,13
9212006,9212006,,4,6,3,9
9212045,9212045,,54,58,3,61
9410212,9410212,,54,31,6,37
9501020,9501020,,54,67,17,84
9501144,9501144,,65,45,32,77
9507051,9507051,,54,14,34,48
9602045,9602045,,54,61,57,118
9605028,9605028,,54,43,39,82
9606087,9606087,,54,24,20,44
9607050,9607050,,2,76,35,111
9608012,9608012,,54,36,29,65
9608034,9608034,,54,44,47,91
9610237,9610237,,54,43,34,77
9611184,9611184,,54,21,97,118
9701019,9701019,,2,37,44,81
9701069,9701069,,37,77,6,83
9703062,9703062,,2,24,16,40
9708062,9708062,,54,38,49,87
9607113,9607113,,2,6,18,24
9608167,9608167,,54,36,9,45
9704109,9704109,,2,9,24,33
9710121,9710121,,2,35,24,59
9711087,9711087,,4,8,18,26
9801135,9801135,,2,13,30,43
9504120,9504120,,37,23,3,26
9605101,9605101,,37,51,15,66
9702050,9702050,,2,17,22,39
9705239,9705239,,2,5,22,27
9708002,9708002,,2,29,29,58
9711094,9711094,,54,66,13,79
9711202,9711202,,54,37,10,47
9712050,9712050,,54,37,13,50
9712070,9712070,,54,32,14,46
9712148,9712148,,16,16,5,21
9712180,9712180,,54,16,16,32
9712211,9712211,,54,75,16,91
9801141,9801141,,54,13,16,29
9803097,9803097,,54,24,10,34
9803127,9803127,,54,46,19,65
9803232,9803232,,37,57,64,121
9703039,9703039,,2,30,20,50
9706073,9706073,,2,9,27,36
9707102,9707102,,2,13,19,32
9710136,9710136,,2,45,7,52
9503157,9503157,,37,48,8,56
9810013,9810013,,11,7,4,11
9810015,9810015,,11,6,4,10
9904200,9904200,,11,3,7,10
9903125,9903125,,4,5,10,15
9808056,9808056,,54,30,15,45
9808095,9808095,,54,13,12,25
9810129,9810129,,54,24,8,32
9904092,9904092,,54,29,36,65
9908023,9908023,,54,84,40,124
9612188,9612188,,54,32,13,45
9910263,9910263,,3,28,14,42
1050,1050,,6,6,2,8
9705007,9705007,,6,24,16,40
9307022,9307022,,6,3,1,4
9310025,9310025,,6,23,3,26
9402068,9402068,,6,1,2,3
9307155,9307155,,6,22,0,22
9404003,9404003,,6,2,0,2
9406030,9406030,,6,4,0,4
9406031,9406031,,6,4,1,5
9412092,9412092,,6,18,5,23
9501057,9501057,,6,20,11,31
9504065,9504065,,6,11,2,13
9507045,9507045,,6,22,7,29
9605158,9605158,,6,13,5,18
9605213,9605213,,2,11,6,17
9606172,9606172,,6,23,10,33
9612118,9612118,,6,8,8,16
1051,1051,,54,2,24,26
9908082,9908082,,37,4,19,23
9503127,9503127,,2,19,22,41
9204085,9204085,,8,11,0,11
9401030,9401030,,25,31,7,38
9608105,9608105,,37,31,12,43
9610016,9610016,,37,8,13,21
9609116,9609116,,37,39,30,69
9609145,9609145,,37,65,33,98
9609157,9609157,,37,25,9,34
9610099,9610099,,62,4,4,8
9702012,9702012,,37,17,24,41
9703145,9703145,,37,10,19,29
9703176,9703176,,37,26,54,80
9703186,9703186,,37,18,23,41
9704174,9704174,,37,24,63,87
9705199,9705199,,37,89,43,132
9707051,9707051,,4,12,5,17
9304121,9304121,,37,25,0,25
9609101,9609101,,37,17,4,21
9610053,9610053,,37,19,37,56
9612086,9612086,,37,11,14,25
9703072,9703072,,37,45,45,90
9706145,9706145,,37,34,16,50
9708017,9708017,,37,19,29,48
9712018,9712018,,37,14,42,56
9803014,9803014,,37,10,22,32
9806011,9806011,,54,15,30,45
9808022,9808022,,37,2,22,24
9812227,9812227,,54,4,27,31
9805096,9805096,,34,75,29,104
9805139,9805139,,37,64,35,99
9806238,9806238,,37,23,16,39
9903242,9903242,,37,15,46,61
1052,1052,,6,0,2,2
9805040,9805040,,6,6,1,7
9807083,9807083,,6,7,3,10
9303040,9303040,,54,46,1,47
9305099,9305099,,6,2,0,2
9807058,9807058,,54,3,2,5
1053,1053,,1,109,18,127
9211075,9211075,,1,11,0,11
9712256,9712256,,1,62,5,67
9806024,9806024,,1,57,14,71
9907087,9907087,,1,23,20,43
9909110,9909110,,1,67,27,94
9909149,9909149,,1,13,10,23
9911039,9911039,,1,46,29,75
9206107,9206107,,8,20,1,21
9207118,9207118,,1,10,1,11
9301015,9301015,,1,39,3,42
9301047,9301047,,1,43,6,49
9404114,9404114,,1,42,20,62
9405156,9405156,,1,8,4,12
9411078,9411078,,1,4,12,16
9402073,9402073,,54,50,13,63
9410008,9410008,,2,4,20,24
9502038,9502038,,4,38,18,56
9201080,9201080,,8,30,0,30
9506180,9506180,,8,14,5,19
9705208,9705208,,1,34,10,44
9406063,9406063,,2,20,1,21
9504012,9504012,,34,5,5,10
9801019,9801019,,34,60,16,76
9804111,9804111,,34,54,44,98
9804159,9804159,,34,26,21,47
9805165,9805165,,34,30,24,54
9806104,9806104,,34,103,99,202
9304011,9304011,,25,121,11,132
9811005,9811005,,34,28,17,45
9812027,9812027,,1,46,27,73
9512154,9512154,,4,72,18,90
9707021,9707021,,2,9,11,20
9708091,9708091,,2,6,18,24
9712118,9712118,,2,10,24,34
9803231,9803231,,2,58,83,141
9805146,9805146,,2,26,25,51
9807173,9807173,,2,23,63,86
9810135,9810135,,34,10,40,50
9601026,9601026,,8,4,7,11
9607129,9607129,,8,19,11,30
9811245,9811245,,1,30,4,34
9607145,9607145,,2,23,4,27
9708086,9708086,,2,44,11,55
9709228,9709228,,37,16,23,39
9710005,9710005,,2,31,48,79
9810210,9810210,,34,46,42,88
9903086,9903086,,1,12,29,41
9407167,9407167,,16,23,12,35
9409064,9409064,,16,26,14,40
9806159,9806159,,34,92,47,139
9808014,9808014,,34,60,23,83
9808075,9808075,,34,78,33,111
9810201,9810201,,37,117,68,185
9811004,9811004,,37,66,38,104
9811139,9811139,,37,57,25,82
9901018,9901018,,34,28,48,76
9903203,9903203,,34,37,19,56
9904187,9904187,,34,18,14,32
9905049,9905049,,34,29,17,46
9905226,9905226,,34,44,48,92
9810132,9810132,,34,13,18,31
9812237,9812237,,2,22,30,52
9904142,9904142,,2,33,13,46
9907210,9907210,,2,9,27,36
9909017,9909017,,4,12,20,32
9310046,9310046,,25,9,11,20
9510222,9510222,,37,76,20,96
9903201,9903201,,34,11,10,21
1054,1054,,37,8,45,53
9705131,9705131,,54,72,126,198
9906070,9906070,,37,114,23,137
9910182,9910182,,37,18,19,37
9203033,9203033,,31,36,0,36
9205037,9205037,,1,45,0,45
9206006,9206006,,1,67,1,68
9208001,9208001,,1,24,3,27
9209023,9209023,,1,47,3,50
9210076,9210076,,54,10,0,10
9211061,9211061,,1,32,5,37
9212099,9212099,,31,6,2,8
9201064,9201064,,25,9,0,9
9201072,9201072,,25,14,0,14
9410034,9410034,,25,10,8,18
9503012,9503012,,37,17,1,18
9505190,9505190,,37,21,2,23
9506181,9506181,,37,38,6,44
9511126,9511126,,37,94,29,123
9512161,9512161,,37,97,28,125
9602082,9602082,,37,67,8,75
9501062,9501062,,2,5,3,8
9601053,9601053,,19,5,2,7
9603116,9603116,,2,82,29,111
9507135,9507135,,37,40,3,43
9508163,9508163,,37,10,8,18
9510079,9510079,,54,6,29,35
9510129,9510129,,37,85,20,105
9510183,9510183,,37,116,31,147
9510204,9510204,,37,101,19,120
9510207,9510207,,54,10,12,22
9512138,9512138,,54,16,27,43
9512140,9512140,,37,6,12,18
9601059,9601059,,37,27,17,44
9601168,9601168,,37,45,22,67
9602061,9602061,,2,4,27,31
9602174,9602174,,37,51,43,94
9603073,9603073,,37,29,34,63
9604004,9604004,,37,67,35,102
9604043,9604043,,54,4,30,34
9604051,9604051,,37,39,10,49
9604057,9604057,,37,3,29,32
9604059,9604059,,37,34,10,44
9604077,9604077,,54,15,19,34
9604199,9604199,,37,58,25,83
9605090,9605090,,37,45,14,59
9605096,9605096,,37,51,9,60
9605135,9605135,,37,11,28,39
9605215,9605215,,37,59,8,67
9606111,9606111,,37,6,9,15
9606168,9606168,,37,8,26,34
9606191,9606191,,37,45,31,76
9606199,9606199,,37,59,9,68
9607066,9607066,,37,52,7,59
9607109,9607109,,37,81,7,88
9607159,9607159,,37,14,17,31
9607190,9607190,,19,3,22,25
9608060,9608060,,37,43,27,70
9608104,9608104,,37,9,51,60
9608121,9608121,,37,7,4,11
9608161,9608161,,37,5,0,5
9609041,9609041,,37,76,39,115
9609062,9609062,,37,22,36,58
9609065,9609065,,37,21,18,39
9609066,9609066,,37,19,19,38
9609130,9609130,,37,9,14,23
9610049,9610049,,37,13,32,45
9610142,9610142,,37,11,21,32
9610204,9610204,,37,27,19,46
9610242,9610242,,37,18,43,61
9611016,9611016,,37,33,17,50
9611104,9611104,,54,6,12,18
9611123,9611123,,37,22,23,45
9603176,9603176,,37,28,5,33
9605054,9605054,,37,25,4,29
9605182,9605182,,37,26,8,34
9608163,9608163,,37,88,17,105
9510001,9510001,,62,9,11,20
9605224,9605224,,2,27,20,47
9606113,9606113,,2,20,21,41
9703163,9703163,,2,19,33,52
9703211,9703211,,2,22,37,59
9702108,9702108,,2,46,24,70
9703016,9703016,,2,15,31,46
9703201,9703201,,2,21,32,53
9209018,9209018,,65,2,0,2
9212062,9212062,,37,5,0,5
9311128,9311128,,54,5,1,6
9402147,9402147,,37,45,0,45
9406008,9406008,,54,7,22,29
9407192,9407192,,54,6,0,6
9508089,9508089,,2,43,5,48
9602147,9602147,,54,3,11,14
9607239,9607239,,37,46,12,58
9607121,9607121,,54,17,34,51
9404071,9404071,,0,62,3,65
9504147,9504147,,2,145,25,170
9704096,9704096,,2,5,23,28
9708085,9708085,,2,25,49,74
9710226,9710226,,2,41,15,56
9711003,9711003,,2,27,25,52
9712063,9712063,,2,34,19,53
9712236,9712236,,2,23,13,36
9801048,9801048,,2,12,22,34
9801070,9801070,,2,27,48,75
9509130,9509130,,37,20,18,38
9603051,9603051,,37,31,23,54
9608090,9608090,,37,17,5,22
9610205,9610205,,54,20,36,56
9611152,9611152,,37,4,17,21
9611186,9611186,,54,24,29,53
9611222,9611222,,37,45,34,79
9612062,9612062,,37,50,10,60
9612104,9612104,,37,2,21,23
9703051,9703051,,37,67,11,78
9703172,9703172,,37,10,16,26
9703215,9703215,,37,7,16,23
9704198,9704198,,37,37,30,67
9705003,9705003,,37,16,44,60
9705022,9705022,,37,41,17,58
9705106,9705106,,37,26,31,57
9705148,9705148,,37,14,16,30
9705232,9705232,,37,64,30,94
9706047,9706047,,37,45,43,88
9706082,9706082,,37,101,37,138
9706087,9706087,,37,33,29,62
9706121,9706121,,37,4,13,17
9706127,9706127,,37,58,29,87
9706131,9706131,,37,7,28,35
9707027,9707027,,37,24,46,70
9707244,9707244,,37,71,51,122
9707247,9707247,,37,27,24,51
9707251,9707251,,37,39,11,50
9707258,9707258,,37,28,15,43
9708015,9708015,,37,27,32,59
9708041,9708041,,37,17,34,51
9708044,9708044,,37,34,59,93
9708068,9708068,,37,35,14,49
9708082,9708082,,37,27,36,63
9708122,9708122,,37,21,48,69
9708127,9708127,,37,22,48,70
9708134,9708134,,37,43,33,76
9708168,9708168,,37,20,67,87
9709096,9709096,,37,19,51,70
9710020,9710020,,37,9,30,39
9710029,9710029,,37,3,14,17
9710097,9710097,,2,36,9,45
9710181,9710181,,2,29,7,36
9711030,9711030,,37,13,30,43
9711117,9711117,,2,17,16,33
9711143,9711143,,37,38,62,100
9711177,9711177,,2,10,11,21
9712005,9712005,,37,17,74,91
9712029,9712029,,37,11,25,36
9712071,9712071,,2,46,49,95
9712143,9712143,,37,30,34,64
9712145,9712145,,37,28,35,63
9712149,9712149,,37,13,64,77
9712172,9712172,,37,13,39,52
9712187,9712187,,2,17,8,25
9712193,9712193,,37,28,35,63
9801002,9801002,,37,23,29,52
9801017,9801017,,37,29,26,55
9801020,9801020,,37,32,31,63
9801108,9801108,,37,16,12,28
9801134,9801134,,37,60,29,89
9708090,9708090,,2,5,33,38
9712200,9712200,,2,14,9,23
9707131,9707131,,2,7,18,25
9804149,9804149,,34,32,19,51
9805207,9805207,,34,23,15,38
9301003,9301003,,16,38,0,38
9305097,9305097,,16,21,1,22
9307085,9307085,,16,15,0,15
9402107,9402107,,16,48,16,64
9505032,9505032,,34,15,3,18
9611203,9611203,,2,93,85,178
9711011,9711011,,19,5,4,9
9712253,9712253,,2,65,201,266
9803061,9803061,,34,61,39,100
9803103,9803103,,2,45,22,67
9803111,9803111,,34,33,33,66
9803119,9803119,,34,31,33,64
9803135,9803135,,34,95,33,128
9803167,9803167,,34,59,47,106
9803214,9803214,,54,69,67,136
9803263,9803263,,34,78,44,122
9804060,9804060,,34,14,58,72
9804062,9804062,,34,16,50,66
9804139,9804139,,54,35,9,44
9804164,9804164,,54,37,40,77
9804174,9804174,,37,48,23,71
9804184,9804184,,54,43,31,74
9804209,9804209,,34,5,14,19
9805047,9805047,,2,9,51,60
9805050,9805050,,34,15,32,47
9805097,9805097,,2,45,44,89
9805154,9805154,,2,4,27,31
9805218,9805218,,37,17,22,39
9806039,9806039,,34,93,3,96
9806041,9806041,,34,12,40,52
9806042,9806042,,34,56,28,84
9806072,9806072,,34,10,5,15
9806091,9806091,,54,28,38,66
9806095,9806095,,1,65,30,95
9806113,9806113,,34,10,31,41
9806122,9806122,,34,11,17,28
9806125,9806125,,34,50,26,76
9806128,9806128,,34,29,4,33
9806132,9806132,,2,12,36,48
9806136,9806136,,2,15,28,43
9806158,9806158,,34,22,18,40
9806178,9806178,,2,8,35,43
9806180,9806180,,37,27,13,40
9806188,9806188,,2,6,8,14
9806235,9806235,,34,31,15,46
9807019,9807019,,34,17,11,28
9807055,9807055,,2,10,22,32
9807093,9807093,,34,9,15,24
9807109,9807109,,34,25,7,32
9807149,9807149,,34,9,10,19
9807150,9807150,,34,32,33,65
9807179,9807179,,34,35,14,49
9807185,9807185,,2,5,80,85
9807196,9807196,,34,20,14,34
9807200,9807200,,34,15,18,33
9807208,9807208,,34,3,15,18
9808026,9808026,,37,5,13,18
9808037,9808037,,34,25,42,67
9808048,9808048,,54,19,46,65
9808051,9808051,,34,4,13,17
9808052,9808052,,1,41,13,54
9808081,9808081,,34,5,20,25
9808088,9808088,,1,83,17,100
9808126,9808126,,34,17,8,25
9808143,9808143,,34,11,38,49
9808161,9808161,,37,24,32,56
9808168,9808168,,2,19,46,65
9808175,9808175,,37,11,30,41
9808177,9808177,,34,24,12,36
9809033,9809033,,34,46,48,94
9809045,9809045,,1,31,21,52
9809063,9809063,,2,4,16,20
9809106,9809106,,34,29,11,40
9809162,9809162,,54,19,18,37
9809172,9809172,,34,1,25,26
9809173,9809173,,37,2,17,19
9809193,9809193,,34,10,55,65
9809213,9809213,,1,22,30,52
9810053,9810053,,34,13,18,31
9810092,9810092,,34,38,14,52
9810152,9810152,,37,34,19,53
9810195,9810195,,34,17,46,63
9810200,9810200,,34,14,10,24
9810224,9810224,,34,21,17,38
9810225,9810225,,34,35,12,47
9810226,9810226,,34,51,26,77
9810236,9810236,,16,6,2,8
9810244,9810244,,34,19,30,49
9810257,9810257,,54,8,11,19
9811002,9811002,,1,23,16,39
9811008,9811008,,31,17,18,35
9811028,9811028,,34,13,27,40
9811042,9811042,,34,6,27,33
9811056,9811056,,34,46,16,62
9811057,9811057,,34,5,61,66
9811087,9811087,,54,4,26,30
9811131,9811131,,37,95,28,123
9811147,9811147,,34,9,25,34
9811192,9811192,,34,23,12,35
9811224,9811224,,34,21,4,25
9811243,9811243,,34,5,6,11
9812007,9812007,,34,27,35,62
9812012,9812012,,34,23,12,35
9812016,9812016,,34,8,23,31
9812025,9812025,,37,18,26,44
9812034,9812034,,7,76,19,95
9812043,9812043,,34,15,7,22
9812044,9812044,,34,8,10,18
9812067,9812067,,34,45,32,77
9812087,9812087,,1,16,23,39
9812100,9812100,,1,20,21,41
9812117,9812117,,34,19,18,37
9812121,9812121,,34,27,18,45
9812169,9812169,,34,4,12,16
9812206,9812206,,34,6,10,16
9812240,9812240,,34,25,17,42
9812250,9812250,,37,2,43,45
9901002,9901002,,2,9,27,36
9901004,9901004,,34,18,35,53
9901030,9901030,,34,5,19,24
9901033,9901033,,2,8,15,23
9901048,9901048,,34,6,26,32
9901076,9901076,,34,46,11,57
9901088,9901088,,2,1,18,19
9901091,9901091,,37,25,21,46
9901106,9901106,,34,14,11,25
9901118,9901118,,1,17,20,37
9901131,9901131,,8,2,10,12
9901135,9901135,,2,15,72,87
9901139,9901139,,7,14,11,25
9901143,9901143,,34,13,12,25
9902005,9902005,,37,22,18,40
9902007,9902007,,7,20,9,29
9902034,9902034,,2,18,9,27
9902042,9902042,,34,29,8,37
9902045,9902045,,34,15,52,67
9902052,9902052,,34,44,22,66
9902058,9902058,,2,38,41,79
9902059,9902059,,2,49,37,86
9902066,9902066,,2,19,8,27
9902068,9902068,,34,4,15,19
9902079,9902079,,1,16,27,43
9902086,9902086,,34,4,20,24
9902088,9902088,,34,56,6,62
9902095,9902095,,34,31,23,54
9902106,9902106,,34,7,30,37
9902110,9902110,,34,27,15,42
9902118,9902118,,37,12,37,49
9902122,9902122,,1,5,29,34
9902123,9902123,,34,9,11,20
9902168,9902168,,34,16,19,35
9902173,9902173,,34,46,9,55
9902197,9902197,,34,19,31,50
9902210,9902210,,2,47,33,80
9903007,9903007,,34,11,4,15
9903029,9903029,,34,16,51,67
9903036,9903036,,34,18,11,29
9903043,9903043,,34,10,17,27
9903048,9903048,,34,34,11,45
9903054,9903054,,34,7,30,37
9903058,9903058,,34,5,24,29
9903065,9903065,,34,4,19,23
9903067,9903067,,34,11,15,26
9903078,9903078,,34,16,31,47
9903079,9903079,,34,2,17,19
9903080,9903080,,34,6,23,29
9903090,9903090,,34,22,26,48
9903094,9903094,,34,33,26,59
9903120,9903120,,34,8,38,46
9903128,9903128,,34,13,38,51
9903163,9903163,,34,23,19,42
9903178,9903178,,34,8,24,32
9903186,9903186,,34,19,19,38
9903195,9903195,,34,4,19,23
9903204,9903204,,2,5,4,9
9903209,9903209,,34,2,14,16
9903222,9903222,,34,2,17,19
9903227,9903227,,34,4,23,27
9903228,9903228,,34,36,12,48
9903237,9903237,,34,10,26,36
9903240,9903240,,34,1,14,15
9903244,9903244,,34,5,25,30
9903248,9903248,,34,6,14,20
9903259,9903259,,34,6,8,14
9904013,9904013,,34,15,36,51
9904024,9904024,,1,20,8,28
9904035,9904035,,34,3,9,12
9904040,9904040,,1,14,10,24
9904050,9904050,,37,8,34,42
9904068,9904068,,34,5,7,12
9904073,9904073,,34,14,33,47
9904098,9904098,,34,5,28,33
9904101,9904101,,34,4,7,11
9904113,9904113,,37,3,23,26
9904120,9904120,,34,53,18,71
9904131,9904131,,37,33,47,80
9904143,9904143,,34,29,25,54
9904149,9904149,,34,21,18,39
9904164,9904164,,34,3,11,14
9904190,9904190,,34,2,27,29
9904198,9904198,,37,14,25,39
9904217,9904217,,2,7,22,29
9905002,9905002,,1,14,18,32
9905004,9905004,,1,12,35,47
9905020,9905020,,34,42,27,69
9905046,9905046,,34,14,21,35
9905048,9905048,,34,12,20,32
9905064,9905064,,34,29,32,61
9905085,9905085,,34,40,20,60
9905097,9905097,,1,2,32,34
9709146,9709146,,54,21,47,68
9902033,9902033,,37,30,14,44
9207064,9207064,,8,16,0,16
9212023,9212023,,25,14,1,15
9407198,9407198,,65,5,4,9
9906053,9906053,,37,2,9,11
9908008,9908008,,37,6,6,12
1055,1055,,37,27,32,59
9712049,9712049,,2,18,40,58
9807082,9807082,,37,30,16,46
9907186,9907186,,37,22,11,33
9910145,9910145,,1,6,17,23
9610104,9610104,,62,8,8,16
9709139,9709139,,2,10,52,62
9711001,9711001,,2,10,42,52
9711017,9711017,,2,14,13,27
9712075,9712075,,2,23,30,53
9611214,9611214,,2,44,51,95
9505067,9505067,,37,34,16,50
9605108,9605108,,37,19,12,31
9605113,9605113,,37,29,18,47
9606184,9606184,,37,19,15,34
9607021,9607021,,37,18,10,28
9608046,9608046,,37,12,10,22
9704185,9704185,,54,29,29,58
9708117,9708117,,54,31,18,49
9801076,9801076,,34,35,18,53
9802103,9802103,,54,29,20,49
9803033,9803033,,37,12,13,25
9803086,9803086,,37,38,31,69
9803140,9803140,,37,16,31,47
9803186,9803186,,37,8,16,24
9804026,9804026,,54,107,25,132
9805029,9805029,,37,10,26,36
9806092,9806092,,37,10,22,32
9803193,9803193,,34,19,40,59
9808139,9808139,,54,89,46,135
9809158,9809158,,54,20,4,24
9803054,9803054,,37,36,37,73
9902196,9902196,,34,27,26,53
9903053,9903053,,37,30,25,55
9905024,9905024,,4,11,15,26
9906046,9906046,,54,18,23,41
9811201,9811201,,37,21,41,62
9203058,9203058,,1,1,0,1
1056,1056,,34,23,12,35
9304146,9304146,,8,18,0,18
9912155,9912155,,34,11,29,40
9308121,9308121,,34,1,0,1
9404180,9404180,,8,25,10,35
9506118,9506118,,8,6,14,20
9512023,9512023,,8,4,12,16
9701113,9701113,,8,2,10,12
9909222,9909222,,1,7,17,24
1057,1057,,34,2,27,29
9612229,9612229,,2,44,35,79
9505058,9505058,,19,20,2,22
9506200,9506200,,2,41,34,75
9509108,9509108,,2,44,27,71
9512157,9512157,,2,11,13,24
9603195,9603195,,2,86,14,100
9604134,9604134,,2,30,20,50
9604193,9604193,,2,12,15,27
9605085,9605085,,2,39,48,87
9605091,9605091,,2,36,31,67
9605146,9605146,,2,25,10,35
9609217,9609217,,2,53,24,77
9610018,9610018,,2,20,6,26
9610125,9610125,,2,38,33,71
9605216,9605216,,2,16,20,36
9609056,9609056,,2,11,23,34
9611029,9611029,,2,3,18,21
9606193,9606193,,2,71,29,100
9610046,9610046,,2,3,25,28
9610112,9610112,,2,4,12,16
9610138,9610138,,2,15,36,51
9612142,9612142,,2,10,16,26
9605082,9605082,,2,36,14,50
9607227,9607227,,2,82,16,98
9703124,9703124,,2,12,16,28
3136,3136,,34,179,83,262
7191,7191,,34,197,46,243
8001,8001,,34,147,16,163
10069,10069,,34,9,21,30
9907129,9907129,,34,12,13,25
9907177,9907177,,34,14,21,35
9803174,9803174,,34,9,44,53
9803196,9803196,,34,13,9,22
9305047,9305047,,16,75,6,81
9803252,9803252,,34,16,15,31
9804175,9804175,,34,14,17,31
9805064,9805064,,34,14,17,31
9809055,9809055,,34,8,22,30
9809061,9809061,,2,24,32,56
1060,1060,,11,2,7,9
9406199,9406199,,11,15,0,15
9410141,9410141,,11,30,1,31
9512108,9512108,,11,8,1,9
9601128,9601128,,11,17,2,19
9605039,9605039,,11,11,32,43
9612117,9612117,,11,18,11,29
9709155,9709155,,11,4,3,7
9405190,9405190,,11,66,1,67
9508017,9508017,,11,38,7,45
9301114,9301114,,11,75,0,75
9307174,9307174,,11,64,0,64
9308134,9308134,,1,12,2,14
9310032,9310032,,11,30,0,30
9402077,9402077,,11,79,2,81
9403171,9403171,,11,19,0,19
9410084,9410084,,8,11,6,17
9410138,9410138,,11,67,6,73
9501019,9501019,,1,2,10,12
9501042,9501042,,11,7,3,10
9506019,9506019,,11,47,12,59
9506040,9506040,,1,2,6,8
9510240,9510240,,11,7,1,8
9511128,9511128,,11,15,6,21
9512073,9512073,,11,24,7,31
9512125,9512125,,1,6,10,16
9601034,9601034,,1,2,10,12
9601112,9601112,,11,7,25,32
9602012,9602012,,11,14,12,26
9604124,9604124,,11,13,11,24
9503225,9503225,,11,17,5,22
9507159,9507159,,11,14,0,14
9603005,9603005,,11,1,1,2
9604114,9604114,,11,13,6,19
9610012,9610012,,11,28,12,40
9610223,9610223,,9,14,5,19
9403111,9403111,,11,21,0,21
1061,1061,,65,1,2,3
9706214,9706214,,65,6,0,6
9812099,9812099,,65,4,1,5
1062,1062,,54,7,12,19
9310008,9310008,,54,30,2,32
9405002,9405002,,54,23,15,38
9405024,9405024,,54,40,0,40
9407049,9407049,,54,17,6,23
9810187,9810187,,54,3,19,22
9812068,9812068,,54,3,44,47
9901150,9901150,,54,3,21,24
9211027,9211027,,54,3,1,4
9208038,9208038,,54,5,0,5
9309133,9309133,,54,20,1,21
9310184,9310184,,54,6,2,8
9312122,9312122,,54,6,2,8
9403037,9403037,,42,1,2,3
9304055,9304055,,54,32,4,36
9410056,9410056,,54,20,7,27
9411218,9411218,,8,5,3,8
9510009,9510009,,54,20,24,44
9707105,9707105,,54,11,15,26
9711158,9711158,,54,29,20,49
9610157,9610157,,54,21,61,82
9706211,9706211,,54,8,38,46
9504129,9504129,,54,34,25,59
9802099,9802099,,54,5,70,75
9805198,9805198,,37,2,6,8
1063,1063,,1,16,16,32
9206008,9206008,,1,6,0,6
9908189,9908189,,1,28,31,59
9303007,9303007,,34,59,5,64
9611041,9611041,,1,20,16,36
9304102,9304102,,54,41,5,46
9903169,9903169,,1,1,4,5
9906191,9906191,,1,5,31,36
9907057,9907057,,62,2,7,9
1064,1064,,6,2,13,15
9203016,9203016,,6,20,0,20
9303077,9303077,,6,5,1,6
9502140,9502140,,6,16,5,21
9603012,9603012,,6,13,13,26
9607215,9607215,,6,12,7,19
9708035,9708035,,6,4,8,12
9210091,9210091,,6,12,0,12
9301097,9301097,,6,34,9,43
9203038,9203038,,6,7,0,7
9207114,9207114,,6,21,0,21
9211028,9211028,,7,4,0,4
9302050,9302050,,6,21,2,23
9307086,9307086,,34,4,1,5
9408100,9408100,,6,3,1,4
9505099,9505099,,6,2,3,5
9510087,9510087,,6,41,7,48
9601095,9601095,,19,1,4,5
9509044,9509044,,8,1,3,4
9611056,9611056,,6,3,4,7
1065,1065,,34,4,17,21
9611099,9611099,,2,10,11,21
9704131,9704131,,2,54,7,61
9707011,9707011,,2,13,28,41
9707113,9707113,,2,9,4,13
9711160,9711160,,2,5,24,29
9712115,9712115,,2,42,60,102
9805205,9805205,,2,7,2,9
9804056,9804056,,54,16,32,48
9810230,9810230,,7,33,1,34
9812047,9812047,,34,13,11,24
9812160,9812160,,2,11,55,66
9812196,9812196,,2,7,69,76
9206049,9206049,,7,60,1,61
9411093,9411093,,7,11,9,20
9601010,9601010,,2,8,24,32
9803124,9803124,,2,3,41,44
9810128,9810128,,34,5,11,16
9904086,9904086,,34,6,23,29
1066,1066,,4,12,35,47
9807008,9807008,,2,13,32,45
9904020,9904020,,2,20,15,35
9907098,9907098,,37,9,21,30
9910249,9910249,,4,9,48,57
9912142,9912142,,37,4,15,19
9407118,9407118,,2,44,7,51
9305068,9305068,,37,53,0,53
9505187,9505187,,37,33,8,41
9512116,9512116,,37,12,7,19
9702099,9702099,,2,39,24,63
9401133,9401133,,37,43,0,43
9605229,9605229,,37,40,18,58
9611106,9611106,,37,14,19,33
9702166,9702166,,37,26,31,57
9711145,9711145,,37,17,11,28
9712135,9712135,,37,10,20,30
9312143,9312143,,2,5,6,11
9402080,9402080,,1,7,2,9
9612164,9612164,,2,32,32,64
9806036,9806036,,2,2,19,21
9903156,9903156,,2,24,17,41
9903207,9903207,,37,10,66,76
9707224,9707224,,54,57,30,87
9903093,9903093,,37,42,28,70
9801040,9801040,,11,7,5,12
9805078,9805078,,2,18,18,36
9809100,9809100,,2,43,33,76
9905157,9905157,,4,34,13,47
9605156,9605156,,3,2,0,2
9703143,9703143,,62,1,8,9
9907014,9907014,,2,17,9,26
9907075,9907075,,2,13,32,45
9908029,9908029,,4,1,5,6
9907140,9907140,,4,31,78,109
9910217,9910217,,4,8,31,39
9202011,9202011,,62,52,0,52
9810223,9810223,,37,4,16,20
1067,1067,,7,2,9,11
9309148,9309148,,7,22,1,23
9405193,9405193,,7,14,1,15
9503126,9503126,,7,4,1,5
9505117,9505117,,7,24,8,32
9510108,9510108,,7,17,6,23
9701091,9701091,,7,18,9,27
9705034,9705034,,7,12,14,26
9802141,9802141,,7,10,23,33
9904126,9904126,,7,10,10,20
9302023,9302023,,7,52,3,55
9310021,9310021,,1,2,0,2
9301037,9301037,,7,30,0,30
9309151,9309151,,7,11,1,12
9311091,9311091,,7,5,2,7
9403010,9403010,,7,10,0,10
9405181,9405181,,7,4,3,7
9411116,9411116,,7,7,4,11
9204089,9204089,,7,31,0,31
9205086,9205086,,7,15,1,16
9305128,9305128,,7,17,6,23
9305130,9305130,,7,24,3,27
9505177,9505177,,2,2,7,9
9510021,9510021,,8,3,7,10
9601116,9601116,,7,17,8,25
9601141,9601141,,7,11,5,16
9606141,9606141,,7,14,2,16
9403042,9403042,,7,2,1,3
9404107,9404107,,19,6,2,8
9409187,9409187,,7,12,0,12
9602106,9602106,,7,5,7,12
9608180,9608180,,7,9,9,18
9701065,9701065,,7,9,10,19
9202007,9202007,,19,5,0,5
9210075,9210075,,7,4,1,5
9303019,9303019,,7,1,0,1
9304111,9304111,,2,6,0,6
9306017,9306017,,7,14,0,14
9309055,9309055,,8,57,1,58
9310001,9310001,,62,2,2,4
9412133,9412133,,7,17,0,17
9504101,9504101,,7,9,2,11
9506177,9506177,,7,18,6,24
9603149,9603149,,7,11,6,17
9606188,9606188,,7,6,8,14
9607143,9607143,,7,3,1,4
9607220,9607220,,7,8,5,13
9609203,9609203,,7,11,11,22
9610087,9610087,,7,14,10,24
1068,1068,,2,21,24,45
9506207,9506207,,54,21,14,35
9509141,9509141,,2,58,2,60
9702133,9702133,,2,75,17,92
9705226,9705226,,2,35,7,42
9712103,9712103,,2,20,11,31
9804010,9804010,,37,32,13,45
9804168,9804168,,37,23,19,42
9806160,9806160,,2,11,8,19
9809121,9809121,,2,32,5,37
9809153,9809153,,2,9,3,12
9809190,9809190,,2,26,14,40
9810154,9810154,,2,8,15,23
9810239,9810239,,37,27,15,42
9811017,9811017,,37,28,14,42
9811232,9811232,,2,61,37,98
9812051,9812051,,2,16,33,49
9905218,9905218,,2,15,7,22
9909021,9909021,,2,12,11,23
9911221,9911221,,37,26,25,51
9410205,9410205,,54,12,5,17
9412079,9412079,,54,6,5,11
9503170,9503170,,54,22,10,32
9504143,9504143,,54,22,3,25
9509050,9509050,,2,21,20,41
9406217,9406217,,2,48,0,48
9601115,9601115,,37,63,4,67
9704214,9704214,,37,45,9,54
9705189,9705189,,37,26,8,34
9706007,9706007,,37,19,16,35
9706013,9706013,,37,22,2,24
9706079,9706079,,37,23,20,43
9706099,9706099,,37,31,54,85
9707133,9707133,,37,38,5,43
9710250,9710250,,37,14,14,28
9711135,9711135,,37,9,8,17
9712128,9712128,,37,7,9,16
9801099,9801099,,16,5,3,8
9604147,9604147,,37,31,1,32
9605149,9605149,,37,28,3,31
9607089,9607089,,37,30,6,36
9703147,9703147,,37,44,8,52
9706078,9706078,,37,38,14,52
9710142,9710142,,37,37,14,51
9801121,9801121,,37,32,18,50
9803176,9803176,,37,24,13,37
9612174,9612174,,2,22,7,29
9706208,9706208,,2,22,18,40
9708011,9708011,,2,17,19,36
9710236,9710236,,2,19,6,25
9502141,9502141,,2,48,13,61
9707061,9707061,,2,46,2,48
9709069,9709069,,2,17,20,37
9711203,9711203,,2,20,30,50
9802032,9802032,,2,21,66,87
9804051,9804051,,2,28,26,54
9709122,9709122,,2,25,42,67
9806028,9806028,,2,45,17,62
9806161,9806161,,2,12,23,35
9809076,9809076,,1,17,26,43
9810024,9810024,,1,14,33,47
9701158,9701158,,37,11,6,17
9810075,9810075,,2,19,21,40
9411235,9411235,,2,18,4,22
9506137,9506137,,2,15,11,26
9512180,9512180,,54,40,8,48
9607171,9607171,,2,5,6,11
9811130,9811130,,2,21,5,26
9612191,9612191,,2,7,5,12
9701127,9701127,,2,36,32,68
9705118,9705118,,2,10,20,30
9806009,9806009,,37,8,78,86
9810109,9810109,,2,4,6,10
9811244,9811244,,2,26,16,42
9703217,9703217,,2,97,35,132
9710219,9710219,,2,15,12,27
9801127,9801127,,2,39,9,48
9805054,9805054,,2,9,11,20
9807197,9807197,,2,8,12,20
9905174,9905174,,2,23,55,78
9906239,9906239,,2,5,10,15
9907214,9907214,,2,8,6,14
9808029,9808029,,2,4,6,10
9808039,9808039,,2,28,13,41
9811031,9811031,,37,19,22,41
9907107,9907107,,34,15,29,44
9909020,9909020,,37,14,18,32
1069,1069,,0,0,1,1
1070,1070,,19,2,10,12
9407168,9407168,,19,43,0,43
9603157,9603157,,19,20,2,22
9604163,9604163,,19,10,5,15
9701172,9701172,,19,22,1,23
9705218,9705218,,19,6,2,8
9711016,9711016,,19,6,7,13
9711126,9711126,,19,9,2,11
9803226,9803226,,19,7,3,10
9811079,9811079,,19,5,5,10
9910035,9910035,,19,2,13,15
9511192,9511192,,19,8,3,11
9306023,9306023,,19,31,0,31
9401056,9401056,,19,15,1,16
9409113,9409113,,8,46,3,49
9504086,9504086,,19,9,3,12
9610002,9610002,,11,11,3,14
9710128,9710128,,11,7,3,10
9803074,9803074,,19,2,3,5
9605027,9605027,,19,6,3,9
9710203,9710203,,19,6,15,21
9802119,9802119,,19,3,7,10
9805159,9805159,,19,3,16,19
9810144,9810144,,19,1,11,12
9905116,9905116,,19,5,10,15
9510186,9510186,,54,7,15,22
9512188,9512188,,2,18,22,40
9602067,9602067,,2,14,15,29
9604177,9604177,,2,13,12,25
9607077,9607077,,54,41,12,53
9608059,9608059,,54,49,15,64
9608099,9608099,,54,36,31,67
9609204,9609204,,2,29,29,58
9611140,9611140,,2,24,20,44
9611162,9611162,,2,4,23,27
9611163,9611163,,2,26,15,41
9702087,9702087,,2,8,5,13
9611237,9611237,,2,2,16,18
9612015,9612015,,2,18,42,60
9702010,9702010,,54,13,14,27
9702110,9702110,,54,46,49,95
9911240,9911240,,34,8,25,33
9912002,9912002,,54,15,10,25
1072,1072,,1,2,5,7
9906118,9906118,,1,7,3,10
9906195,9906195,,34,10,6,16
9307126,9307126,,6,8,4,12
1073,1073,,3,6,7,13
9909202,9909202,,3,46,21,67
9910135,9910135,,3,31,11,42
9910196,9910196,,3,36,14,50
9601148,9601148,,11,15,1,16
9905162,9905162,,3,21,39,60
9909139,9909139,,3,40,1,41
1074,1074,,37,4,6,10
9804124,9804124,,37,45,41,86
9805106,9805106,,37,30,15,45
9809068,9809068,,37,24,17,41
9812232,9812232,,37,22,5,27
9905011,9905011,,37,26,5,31
9907102,9907102,,37,12,6,18
9603028,9603028,,37,30,12,42
9603069,9603069,,37,20,23,43
9610156,9610156,,37,59,41,100
9612134,9612134,,37,3,24,27
9701055,9701055,,37,41,36,77
9702083,9702083,,37,23,42,65
9708170,9708170,,37,36,28,64
9709053,9709053,,37,61,22,83
9710239,9710239,,37,35,31,66
9802130,9802130,,37,9,68,77
9803123,9803123,,37,16,19,35
9406192,9406192,,7,17,3,20
9411136,9411136,,7,8,2,10
9512065,9512065,,7,5,13,18
9512158,9512158,,62,8,2,10
9401021,9401021,,37,49,0,49
9804125,9804125,,37,26,11,37
9804126,9804126,,37,35,44,79
1075,1075,,11,0,2,2
1076,1076,,16,1,15,16
9401062,9401062,,16,21,3,24
9407114,9407114,,16,28,15,43
9611011,9611011,,16,14,11,25
9703189,9703189,,16,15,13,28
9809095,9809095,,16,17,21,38
9901053,9901053,,16,5,16,21
9903246,9903246,,2,19,35,54
9911249,9911249,,16,6,20,26
9207065,9207065,,16,18,1,19
9303159,9303159,,16,17,5,22
9309119,9309119,,16,29,9,38
9310041,9310041,,16,26,3,29
9311156,9311156,,16,22,6,28
9401041,9401041,,16,9,8,17
9308158,9308158,,16,5,1,6
9311130,9311130,,16,20,13,33
9407176,9407176,,16,11,13,24
9411210,9411210,,16,68,62,130
9502132,9502132,,16,20,6,26
9506174,9506174,,16,16,1,17
9601069,9601069,,16,23,3,26
9601153,9601153,,16,4,4,8
9609022,9609022,,16,6,20,26
9302104,9302104,,34,24,0,24
9404175,9404175,,16,13,11,24
9408115,9408115,,16,9,12,21
9409044,9409044,,16,7,0,7
9304015,9304015,,16,13,5,18
9309107,9309107,,16,22,10,32
9402097,9402097,,16,15,1,16
9705102,9705102,,16,14,18,32
9710204,9710204,,2,2,3,5
9805071,9805071,,2,25,13,38
9806037,9806037,,16,16,15,31
9710078,9710078,,54,30,18,48
9710102,9710102,,54,21,39,60
9804121,9804121,,2,41,29,70
9807232,9807232,,2,32,18,50
9210016,9210016,,0,2,0,2
9311072,9311072,,16,4,4,8
9709029,9709029,,2,31,7,38
9801047,9801047,,2,19,7,26
9806173,9806173,,2,8,28,36
9901093,9901093,,2,23,17,40
1077,1077,,54,6,59,65
9302099,9302099,,54,15,3,18
9703059,9703059,,54,58,36,94
9705037,9705037,,54,55,12,67
9804092,9804092,,54,80,51,131
9807011,9807011,,54,56,42,98
9810214,9810214,,54,45,23,68
9812158,9812158,,54,33,15,48
9904069,9904069,,54,35,13,48
9907184,9907184,,54,33,35,68
9908064,9908064,,54,54,32,86
9908072,9908072,,54,72,38,110
9909010,9909010,,54,16,24,40
9909107,9909107,,37,13,21,34
9909116,9909116,,54,13,14,27
9909172,9909172,,54,71,57,128
9911081,9911081,,54,49,54,103
9912257,9912257,,34,21,48,69
9211084,9211084,,54,5,2,7
9408119,9408119,,65,5,7,12
9311038,9311038,,54,5,0,5
9607041,9607041,,54,45,22,67
9612093,9612093,,65,3,7,10
9510098,9510098,,2,14,18,32
9605011,9605011,,54,21,43,64
9602075,9602075,,54,7,5,12
9505171,9505171,,54,32,8,40
9509115,9509115,,54,20,2,22
9402006,9402006,,54,14,1,15
9503055,9503055,,54,10,1,11
9201028,9201028,,54,2,0,2
9505194,9505194,,54,5,3,8
9506001,9506001,,54,4,3,7
9606145,9606145,,54,4,4,8
9704101,9704101,,2,3,6,9
9705182,9705182,,54,2,10,12
9704059,9704059,,54,75,27,102
9705163,9705163,,54,84,11,95
9706051,9706051,,54,77,10,87
9706158,9706158,,54,32,37,69
9801114,9801114,,54,22,17,39
9701021,9701021,,11,7,1,8
9709159,9709159,,54,12,15,27
9801058,9801058,,54,6,24,30
9802094,9802094,,54,2,2,4
9803141,9803141,,54,65,23,88
9803168,9803168,,54,7,41,48
9406132,9406132,,54,63,6,69
9505018,9505018,,54,35,3,38
9505046,9505046,,54,38,16,54
9605170,9605170,,54,31,12,43
9605180,9605180,,54,20,4,24
9708049,9708049,,54,24,43,67
9709093,9709093,,54,9,6,15
9710149,9710149,,54,10,41,51
9803143,9803143,,37,4,18,22
9804110,9804110,,54,55,17,72
9806008,9806008,,54,49,40,89
9806044,9806044,,54,47,20,67
9806143,9806143,,54,35,25,60
9807240,9807240,,54,1,46,47
9711059,9711059,,54,27,24,51
9806129,9806129,,54,16,28,44
9412076,9412076,,2,6,6,12
9806080,9806080,,54,47,20,67
9811013,9811013,,54,20,38,58
9307123,9307123,,2,11,9,20
9901085,9901085,,34,25,16,41
9904007,9904007,,54,18,18,36
9904211,9904211,,54,14,33,47
9905033,9905033,,54,13,26,39
9905042,9905042,,34,13,5,18
9906057,9906057,,34,14,28,42
9906081,9906081,,34,24,42,66
9906090,9906090,,34,8,5,13
9906101,9906101,,34,19,45,64
9906179,9906179,,34,5,21,26
9906196,9906196,,34,4,20,24
9906210,9906210,,34,4,11,15
9906220,9906220,,34,25,39,64
9906039,9906039,,54,38,64,102
9904071,9904071,,54,36,24,60
9903145,9903145,,54,20,21,41
9907112,9907112,,54,16,36,52
9907203,9907203,,54,3,42,45
9907054,9907054,,54,6,56,62
9703029,9703029,,37,3,18,21
9903181,9903181,,37,6,18,24
9906012,9906012,,37,15,33,48
9909023,9909023,,11,4,2,6
9505098,9505098,,54,10,18,28
9507162,9507162,,54,4,4,8
9512155,9512155,,54,11,24,35
9607144,9607144,,54,8,11,19
9810010,9810010,,54,27,16,43
9901098,9901098,,54,3,14,17
9903051,9903051,,54,18,24,42
9903160,9903160,,54,16,17,33
9905098,9905098,,54,13,24,37
9905137,9905137,,54,26,23,49
9906222,9906222,,54,4,26,30
9907023,9907023,,54,5,18,23
9909212,9909212,,54,8,42,50
9910094,9910094,,54,8,50,58
9910228,9910228,,54,23,64,87
9908125,9908125,,54,13,30,43
9911096,9911096,,34,100,31,131
9912145,9912145,,54,7,35,42
1080,1080,,34,0,11,11
9606062,9606062,,1,2,1,3
9610014,9610014,,1,3,2,5
9703164,9703164,,1,1,4,5
9705209,9705209,,25,4,39,43
9908150,9908150,,34,7,4,11
9910074,9910074,,62,8,5,13
9206048,9206048,,1,35,2,37
9210119,9210119,,2,45,11,56
9302037,9302037,,1,15,4,19
9302070,9302070,,1,7,6,13
9302083,9302083,,1,35,3,38
9201019,9201019,,2,16,0,16
9205025,9205025,,2,5,0,5
9205052,9205052,,2,11,0,11
9205091,9205091,,2,10,0,10
9212026,9212026,,2,3,2,5
9302038,9302038,,2,36,4,40
9303074,9303074,,2,6,0,6
9402120,9402120,,1,23,19,42
9307039,9307039,,2,17,6,23
9601155,9601155,,1,1,4,5
9209122,9209122,,25,18,1,19
9211080,9211080,,25,10,0,10
9303048,9303048,,25,84,1,85
9305109,9305109,,25,32,6,38
9305179,9305179,,25,3,6,9
9309050,9309050,,25,24,3,27
9401072,9401072,,25,67,2,69
9401125,9401125,,25,42,1,43
9403008,9403008,,34,12,5,17
9405143,9405143,,25,27,2,29
9407001,9407001,,25,33,14,47
9409168,9409168,,25,11,7,18
9409195,9409195,,31,5,0,5
9603072,9603072,,25,2,13,15
9603173,9603173,,34,3,7,10
9609085,9609085,,25,10,25,35
9208018,9208018,,34,4,0,4
9906226,9906226,,34,19,28,47
9811233,9811233,,62,6,6,12
9905178,9905178,,62,10,1,11
9905179,9905179,,62,26,6,32
1081,1081,,6,1,13,14
9502031,9502031,,6,37,12,49
9510201,9510201,,6,26,8,34
9601124,9601124,,6,17,7,24
9708077,9708077,,6,8,10,18
9805084,9805084,,6,14,8,22
9807023,9807023,,6,4,10,14
9809210,9809210,,6,6,15,21
9901046,9901046,,6,4,13,17
9905083,9905083,,6,8,14,22
9209062,9209062,,6,15,0,15
9403180,9403180,,6,13,2,15
9502030,9502030,,6,22,3,25
9505009,9505009,,6,21,12,33
9508034,9508034,,6,10,10,20
9508174,9508174,,6,3,13,16
9310167,9310167,,6,9,0,9
9408053,9408053,,4,17,3,20
9511066,9511066,,6,10,17,27
9501004,9501004,,6,21,6,27
9604027,9604027,,6,15,23,38
9609037,9609037,,6,10,13,23
9804156,9804156,,6,3,17,20
9305167,9305167,,7,8,0,8
9306111,9306111,,6,8,3,11
9310013,9310013,,6,6,5,11
9507026,9507026,,6,7,5,12
9704209,9704209,,6,1,7,8
9806114,9806114,,6,8,1,9
9809208,9809208,,6,7,8,15
9811252,9811252,,6,5,7,12
9507023,9507023,,6,18,5,23
9810125,9810125,,6,3,8,11
1082,1082,,54,42,33,75
9810068,9810068,,0,35,5,40
9812086,9812086,,54,6,12,18
9911011,9911011,,37,47,30,77
9911154,9911154,,2,7,22,29
9912022,9912022,,37,8,30,38
9912152,9912152,,54,92,18,110
9912164,9912164,,2,27,134,161
9201029,9201029,,2,43,0,43
9211015,9211015,,2,30,6,36
9309091,9309091,,2,1,0,1
9505116,9505116,,2,9,9,18
9506113,9506113,,2,23,26,49
9502049,9502049,,1,5,0,5
9502107,9502107,,34,35,1,36
9606009,9606009,,2,13,35,48
9609218,9609218,,2,6,0,6
9706050,9706050,,37,31,67,98
9707163,9707163,,0,36,0,36
9802074,9802074,,0,36,4,40
9808140,9808140,,0,41,4,45
9808101,9808101,,54,52,53,105
9702174,9702174,,37,60,5,65
9509021,9509021,,37,15,6,21
9806040,9806040,,2,15,15,30
9809187,9809187,,37,46,19,65
9811034,9811034,,2,13,28,41
9812127,9812127,,37,42,18,60
9905156,9905156,,2,28,15,43
9906190,9906190,,2,1,14,15
9805176,9805176,,2,15,5,20
9811024,9811024,,2,26,23,49
9906162,9906162,,2,7,23,30
9812205,9812205,,37,30,30,60
9911206,9911206,,3,41,24,65
9508001,9508001,,54,6,3,9
9203018,9203018,,34,43,0,43
9410046,9410046,,2,22,15,37
9611008,9611008,,2,99,9,108
9710119,9710119,,2,60,15,75
9711089,9711089,,2,18,30,48
9807115,9807115,,1,39,20,59
9808100,9808100,,2,28,66,94
9810090,9810090,,34,22,13,35
9902171,9902171,,2,9,13,22
9903143,9903143,,34,19,27,46
9908109,9908109,,34,25,18,43
9910036,9910036,,34,22,56,78
9910110,9910110,,34,16,32,48
9911067,9911067,,54,10,46,56
9911124,9911124,,34,8,24,32
9911169,9911169,,3,29,40,69
1083,1083,,54,13,64,77
9803145,9803145,,54,24,21,45
9805191,9805191,,2,16,35,51
9807067,9807067,,54,14,32,46
9901020,9901020,,54,15,34,49
9901162,9901162,,54,6,23,29
9902202,9902202,,54,9,10,19
9903010,9903010,,2,8,22,30
9903113,9903113,,54,19,44,63
9905173,9905173,,54,5,39,44
9906018,9906018,,54,18,154,172
9910115,9910115,,54,9,27,36
9910144,9910144,,54,8,26,34
9912067,9912067,,54,23,9,32
9211083,9211083,,8,6,0,6
9310202,9310202,,1,48,3,51
9311010,9311010,,1,51,3,54
9205008,9205008,,2,19,0,19
9407102,9407102,,19,4,1,5
9309145,9309145,,2,158,1,159
9310118,9310118,,2,39,1,40
9405117,9405117,,2,53,2,55
9311185,9311185,,54,14,3,17
9411099,9411099,,1,51,20,71
9411198,9411198,,4,27,17,44
9503228,9503228,,2,14,4,18
9503237,9503237,,2,4,2,6
9508046,9508046,,54,3,16,19
9508033,9508033,,54,15,4,19
9510223,9510223,,54,13,11,24
9502106,9502106,,2,9,5,14
9701075,9701075,,54,8,15,23
9601179,9601179,,54,7,17,24
9611017,9611017,,54,12,13,25
9611195,9611195,,54,9,20,29
9701142,9701142,,2,14,25,39
9703049,9703049,,54,13,20,33
9703076,9703076,,54,17,21,38
9703206,9703206,,54,3,51,54
9705023,9705023,,2,9,12,21
9605012,9605012,,54,10,25,35
9605145,9605145,,54,14,8,22
9611176,9611176,,54,25,24,49
9509017,9509017,,54,8,29,37
9707241,9707241,,54,18,13,31
9802016,9802016,,54,25,31,56
9712241,9712241,,37,8,24,32
9712156,9712156,,54,6,16,22
9708089,9708089,,2,19,20,39
9710124,9710124,,2,5,28,33
9803206,9803206,,2,17,5,22
9307171,9307171,,54,25,6,31
9709061,9709061,,54,7,17,24
9511079,9511079,,2,11,7,18
9511098,9511098,,2,13,28,41
9512028,9512028,,2,12,2,14
9602140,9602140,,2,41,9,50
9605023,9605023,,2,4,29,33
9612202,9612202,,2,33,24,57
9612254,9612254,,2,12,1,13
9703133,9703133,,2,7,12,19
9704030,9704030,,2,12,25,37
9704054,9704054,,2,37,16,53
9704086,9704086,,2,7,20,27
9705014,9705014,,2,6,17,23
9705116,9705116,,2,38,28,66
9707205,9707205,,2,3,45,48
9708064,9708064,,2,19,14,33
9708083,9708083,,2,11,17,28
9709015,9709015,,2,14,35,49
9710027,9710027,,2,8,46,54
9710122,9710122,,2,13,36,49
9711040,9711040,,2,5,32,37
9711105,9711105,,2,5,18,23
9712013,9712013,,2,20,23,43
9712155,9712155,,54,9,19,28
9712162,9712162,,2,15,27,42
9801034,9801034,,2,11,21,32
9801132,9801132,,54,19,109,128
9801144,9801144,,54,9,87,96
9803004,9803004,,2,9,50,59
9803050,9803050,,2,11,16,27
9803198,9803198,,2,3,25,28
9804152,9804152,,2,3,7,10
9805180,9805180,,2,12,15,27
9806018,9806018,,2,25,15,40
9806066,9806066,,2,22,21,43
9806126,9806126,,54,6,36,42
9806169,9806169,,2,30,45,75
9807006,9807006,,2,5,16,21
9807135,9807135,,2,11,28,39
9807199,9807199,,2,12,23,35
9808128,9808128,,2,13,9,22
9710198,9710198,,54,10,66,76
9807124,9807124,,54,28,84,112
9808024,9808024,,54,13,29,42
9808131,9808131,,54,17,21,38
9808169,9808169,,8,19,39,58
9811198,9811198,,37,5,16,21
9712079,9712079,,54,4,12,16
9511228,9511228,,54,14,38,52
9508078,9508078,,54,24,16,40
9703195,9703195,,54,7,31,38
9805083,9805083,,2,14,16,30
9812154,9812154,,54,2,24,26
9607184,9607184,,54,17,45,62
9806123,9806123,,54,1,112,113
9901117,9901117,,54,8,41,49
9903124,9903124,,54,25,81,106
9903232,9903232,,54,4,22,26
9905209,9905209,,37,9,20,29
9908035,9908035,,37,8,21,29
9601048,9601048,,8,4,2,6
9607193,9607193,,54,8,16,24
9907133,9907133,,54,8,59,67
1084,1084,,4,91,8,99
9912120,9912120,,4,23,4,27
9912121,9912121,,4,33,11,44
9912255,9912255,,4,19,9,28
9812153,9812153,,1,3,5,8
9202087,9202087,,4,5,0,5
9607070,9607070,,2,53,7,60
9706223,9706223,,8,3,19,22
1085,1085,,7,8,12,20
9303103,9303103,,7,25,0,25
9506121,9506121,,7,13,1,14
9601064,9601064,,25,5,11,16
9601073,9601073,,7,21,2,23
9709166,9709166,,7,6,3,9
9709206,9709206,,2,5,63,68
9710075,9710075,,7,10,5,15
9806203,9806203,,7,3,6,9
9807063,9807063,,7,10,5,15
9908099,9908099,,7,4,6,10
9307168,9307168,,25,69,0,69
9408039,9408039,,25,13,23,36
9502074,9502074,,25,27,7,34
9507035,9507035,,25,3,8,11
9509104,9509104,,25,3,8,11
9510026,9510026,,7,4,2,6
9510156,9510156,,25,8,8,16
9409104,9409104,,6,8,5,13
9505173,9505173,,6,37,9,46
9609053,9609053,,2,14,34,48
9611189,9611189,,2,15,27,42
9612234,9612234,,2,8,8,16
9704134,9704134,,2,26,27,53
9705165,9705165,,2,9,27,36
9707157,9707157,,2,6,23,29
9707170,9707170,,2,36,10,46
9709160,9709160,,2,13,60,73
9705017,9705017,,2,5,11,16
9506138,9506138,,25,34,13,47
9706213,9706213,,7,6,9,15
1086,1086,,25,3,2,5
9709182,9709182,,25,7,2,9
1087,1087,,6,0,2,2
9906072,9906072,,6,8,0,8
9907217,9907217,,6,8,1,9
9401083,9401083,,6,5,0,5
1088,1088,,8,2,1,3
9601043,9601043,,16,6,6,12
1089,1089,,3,16,27,43
9709054,9709054,,2,33,22,55
9712199,9712199,,3,25,16,41
9903166,9903166,,16,10,45,55
9309143,9309143,,2,26,2,28
9703204,9703204,,2,23,41,64
9707184,9707184,,2,22,3,25
9702205,9702205,,2,27,17,44
9703041,9703041,,2,35,23,58
9704143,9704143,,2,45,30,75
9701188,9701188,,2,5,20,25
2009,2009,,2,23,27,50
6137,6137,,2,16,28,44
9203040,9203040,,16,4,0,4
9211103,9211103,,16,16,0,16
9211104,9211104,,16,17,0,17
9301061,9301061,,16,7,1,8
9508036,9508036,,16,15,5,20
9511047,9511047,,16,18,6,24
9607122,9607122,,16,5,3,8
9609010,9609010,,16,10,0,10
9703149,9703149,,16,12,2,14
9805108,9805108,,16,26,10,36
9806241,9806241,,16,14,6,20
9808191,9808191,,16,14,16,30
9904009,9904009,,16,9,0,9
9904016,9904016,,16,10,13,23
9905177,9905177,,34,94,6,100
9906022,9906022,,34,100,16,116
9910146,9910146,,34,7,38,45
9912137,9912137,,16,7,3,10
9909059,9909059,,3,20,21,41
9909085,9909085,,3,32,20,52
1090,1090,,25,4,10,14
9206070,9206070,,25,125,1,126
9209012,9209012,,25,88,4,92
9211011,9211011,,25,27,4,31
9409179,9409179,,25,12,23,35
9502084,9502084,,25,1,13,14
9506206,9506206,,25,21,32,53
9804089,9804089,,25,9,9,18
9904184,9904184,,25,7,9,16
9911077,9911077,,25,1,9,10
9201061,9201061,,25,112,0,112
9203042,9203042,,25,41,0,41
9203052,9203052,,25,51,0,51
9203054,9203054,,25,46,0,46
9204090,9204090,,25,29,0,29
9308034,9308034,,25,11,3,14
9312194,9312194,,25,11,11,22
9401076,9401076,,25,4,0,4
9401159,9401159,,25,30,0,30
9403108,9403108,,25,31,7,38
9403137,9403137,,25,30,32,62
9405162,9405162,,25,17,16,33
9201074,9201074,,25,79,0,79
9205028,9205028,,25,33,0,33
9205069,9205069,,25,72,0,72
9205089,9205089,,25,88,0,88
9206020,9206020,,25,43,0,43
9206071,9206071,,25,21,0,21
9207006,9207006,,25,24,0,24
9207034,9207034,,25,25,1,26
9207095,9207095,,25,54,0,54
9209008,9209008,,25,37,2,39
9211135,9211135,,25,16,8,24
9302022,9302022,,25,31,1,32
9303014,9303014,,25,15,8,23
9304148,9304148,,25,20,14,34
9310155,9310155,,25,6,7,13
9211095,9211095,,25,11,1,12
9212136,9212136,,25,12,15,27
9305125,9305125,,25,16,14,30
9311007,9311007,,25,22,7,29
9405084,9405084,,25,10,13,23
9407039,9407039,,25,5,7,12
9204026,9204026,,25,21,0,21
9209055,9209055,,25,36,21,57
9209113,9209113,,25,13,17,30
9310150,9310150,,25,10,7,17
9408066,9408066,,25,21,7,28
9408068,9408068,,25,18,6,24
9412020,9412020,,25,26,4,30
9412027,9412027,,25,12,10,22
9502006,9502006,,25,14,8,22
9502155,9502155,,25,11,9,20
9503016,9503016,,25,35,16,51
9504022,9504022,,25,14,13,27
9506066,9506066,,25,14,11,25
9501127,9501127,,25,25,15,40
9602105,9602105,,25,26,21,47
9802117,9802117,,25,5,4,9
9502098,9502098,,25,26,19,45
9607155,9607155,,25,6,9,15
9512187,9512187,,25,10,14,24
1091,1091,,62,1,4,5
9201067,9201067,,62,73,0,73
9202069,9202069,,62,14,0,14
9503079,9503079,,62,13,13,26
9909042,9909042,,62,2,3,5
9203076,9203076,,62,42,0,42
9207015,9207015,,62,8,0,8
9209024,9209024,,62,18,0,18
9304065,9304065,,62,51,3,54
9305042,9305042,,62,12,3,15
9403162,9403162,,62,4,1,5
9405030,9405030,,62,18,4,22
9406197,9406197,,62,4,1,5
9411176,9411176,,62,17,20,37
9501136,9501136,,62,20,14,34
9401066,9401066,,62,10,0,10
9404013,9404013,,62,27,1,28
9506023,9506023,,62,16,9,25
1092,1092,,0,43,11,54
1093,1093,,54,2,30,32
9910090,9910090,,54,11,24,35
9204012,9204012,,54,51,1,52
9306048,9306048,,1,13,1,14
9401069,9401069,,31,40,1,41
9203025,9203025,,54,23,1,24
9205094,9205094,,54,15,1,16
9208024,9208024,,54,28,0,28
9209020,9209020,,54,6,1,7
9307002,9307002,,54,3,3,6
9410206,9410206,,54,34,6,40
9412196,9412196,,54,8,9,17
9506006,9506006,,54,15,2,17
9506178,9506178,,54,12,13,25
9508073,9508073,,54,14,6,20
9508178,9508178,,54,2,2,4
9510094,9510094,,54,8,8,16
9510241,9510241,,54,26,19,45
9512156,9512156,,54,6,9,15
9602032,9602032,,54,17,11,28
9601175,9601175,,54,8,8,16
9506169,9506169,,62,21,29,50
9307122,9307122,,2,7,2,9
9605174,9605174,,2,5,21,26
9606196,9606196,,2,3,19,22
9610250,9610250,,2,18,20,38
9512042,9512042,,2,24,10,34
9612192,9612192,,54,12,90,102
9512223,9512223,,37,17,4,21
9705054,9705054,,2,25,16,41
9711031,9711031,,2,7,28,35
9711046,9711046,,2,10,16,26
9711078,9711078,,2,88,41,129
9712012,9712012,,2,3,40,43
9712105,9712105,,2,41,16,57
9712159,9712159,,2,15,27,42
9712238,9712238,,2,14,16,30
9801120,9801120,,2,14,38,52
9603156,9603156,,8,26,7,33
9605168,9605168,,8,22,10,32
9703136,9703136,,2,24,71,95
9704021,9704021,,2,30,12,42
9704165,9704165,,2,20,21,41
9707135,9707135,,2,6,5,11
9707139,9707139,,2,29,10,39
9707246,9707246,,2,21,29,50
9709012,9709012,,2,11,10,21
9711014,9711014,,54,11,11,22
9712020,9712020,,37,2,54,56
9802073,9802073,,2,5,50,55
9803026,9803026,,37,14,15,29
9803106,9803106,,2,8,7,15
9805007,9805007,,2,16,22,38
9805055,9805055,,34,9,4,13
9807079,9807079,,54,6,18,24
9904151,9904151,,54,6,36,42
9905121,9905121,,54,2,25,27
9805181,9805181,,54,26,32,58
9901017,9901017,,54,28,45,73
9909219,9909219,,54,5,32,37
9702115,9702115,,54,4,9,13
9904213,9904213,,2,8,6,14
9907038,9907038,,54,16,32,48
1094,1094,,7,0,13,13
9303005,9303005,,7,27,0,27
9512083,9512083,,8,3,7,10
9705043,9705043,,7,3,10,13
9710092,9710092,,62,9,5,14
9808062,9808062,,7,6,15,21
9903130,9903130,,7,23,29,52
9905149,9905149,,7,16,6,22
9211109,9211109,,8,26,1,27
9410114,9410114,,8,13,3,16
9503161,9503161,,8,26,15,41
9510158,9510158,,8,4,3,7
9301100,9301100,,7,20,0,20
9310018,9310018,,7,8,2,10
9404039,9404039,,7,11,2,13
9404081,9404081,,7,1,1,2
9501098,9501098,,62,49,9,58
9503065,9503065,,4,1,8,9
9607085,9607085,,62,12,13,25
9304139,9304139,,7,3,0,3
9803034,9803034,,0,10,2,12
9210109,9210109,,7,21,1,22
9304047,9304047,,37,47,2,49
9308115,9308115,,7,15,2,17
9309044,9309044,,7,40,7,47
9310095,9310095,,7,12,1,13
9402099,9402099,,7,2,1,3
9410180,9410180,,7,9,1,10
9603163,9603163,,7,7,2,9
9603179,9603179,,7,6,2,8
9701084,9701084,,7,1,5,6
9702017,9702017,,7,4,16,20
9805214,9805214,,7,3,0,3
9808130,9808130,,7,4,6,10
1096,1096,,7,1,2,3
9709157,9709157,,7,1,0,1
9709158,9709158,,7,1,1,2
1097,1097,,62,4,9,13
9206003,9206003,,62,21,1,22
9403084,9403084,,62,9,0,9
9604161,9604161,,62,7,1,8
9612039,9612039,,62,12,13,25
9701156,9701156,,62,7,1,8
9710019,9710019,,62,13,6,19
9711146,9711146,,62,8,16,24
9909170,9909170,,62,1,2,3
9206002,9206002,,62,23,0,23
9406155,9406155,,62,9,2,11
9205064,9205064,,62,22,0,22
9211053,9211053,,62,45,0,45
9303052,9303052,,62,5,2,7
9306028,9306028,,62,30,0,30
9310130,9310130,,62,24,0,24
9412166,9412166,,62,8,9,17
9507010,9507010,,62,42,11,53
9601113,9601113,,62,10,22,32
9607046,9607046,,62,33,8,41
9609080,9609080,,62,9,7,16
9605065,9605065,,62,17,9,26
9709034,9709034,,62,35,7,42
9210052,9210052,,62,13,0,13
9307196,9307196,,62,41,1,42
9312121,9312121,,62,10,2,12
9312141,9312141,,62,1,4,5
9406060,9406060,,62,1,0,1
9501059,9501059,,62,20,4,24
9505091,9505091,,65,15,18,33
9606068,9606068,,62,14,2,16
9608092,9608092,,62,7,2,9
9704148,9704148,,62,2,6,8
9706172,9706172,,62,6,2,8
9707091,9707091,,62,17,14,31
9711085,9711085,,62,5,2,7
9303108,9303108,,62,18,0,18
9306146,9306146,,62,19,4,23
9307062,9307062,,62,12,0,12
9310110,9310110,,65,9,0,9
9312039,9312039,,62,5,2,7
9405014,9405014,,62,21,2,23
9407122,9407122,,62,3,5,8
9509007,9509007,,62,20,7,27
9510171,9510171,,62,13,10,23
9605187,9605187,,62,21,3,24
9609068,9609068,,62,8,2,10
9612099,9612099,,62,3,3,6
9701034,9701034,,62,6,5,11
9701062,9701062,,62,7,14,21
9702145,9702145,,62,6,2,8
9703190,9703190,,62,22,5,27
9704213,9704213,,62,11,10,21
9708148,9708148,,62,3,6,9
9712124,9712124,,62,12,9,21
9801046,9801046,,62,10,12,22
9802003,9802003,,62,5,11,16
9802132,9802132,,62,9,5,14
9804050,9804050,,62,5,20,25
1098,1098,,2,3,22,25
9902023,9902023,,2,16,6,22
9906075,9906075,,34,5,43,48
9906153,9906153,,34,4,28,32
9907126,9907126,,34,11,12,23
9909148,9909148,,2,3,31,34
9909171,9909171,,2,2,11,13
9602001,9602001,,62,2,5,7
9606173,9606173,,2,14,11,25
9307036,9307036,,2,26,1,27
9309025,9309025,,2,18,2,20
9402112,9402112,,2,11,1,12
9503069,9503069,,2,7,3,10
9511035,9511035,,2,1,0,1
9203057,9203057,,34,10,0,10
9208078,9208078,,2,36,0,36
9209125,9209125,,2,26,0,26
9303029,9303029,,2,9,3,12
9308100,9308100,,25,42,0,42
9310101,9310101,,25,17,23,40
9402125,9402125,,25,14,3,17
9402136,9402136,,25,20,2,22
9404035,9404035,,2,18,14,32
9406059,9406059,,2,40,15,55
9406069,9406069,,2,20,7,27
9407155,9407155,,2,41,7,48
9409158,9409158,,25,16,5,21
9410230,9410230,,2,40,15,55
9412162,9412162,,2,14,16,30
9503029,9503029,,2,14,8,22
9503057,9503057,,2,43,32,75
9503082,9503082,,2,22,9,31
9506182,9506182,,25,9,19,28
9509102,9509102,,2,12,16,28
9510080,9510080,,2,3,12,15
9510178,9510178,,2,4,14,18
9511116,9511116,,2,7,6,13
9512152,9512152,,2,10,27,37
9601118,9601118,,2,6,9,15
9601164,9601164,,2,6,28,34
9603099,9603099,,2,8,28,36
9604058,9604058,,2,29,4,33
9604200,9604200,,2,30,17,47
9605058,9605058,,2,2,15,17
9605059,9605059,,2,41,21,62
9605112,9605112,,2,33,8,41
9606047,9606047,,2,5,16,21
9606093,9606093,,54,9,15,24
9607107,9607107,,2,24,30,54
9608106,9608106,,54,5,11,16
9609006,9609006,,2,18,4,22
9609075,9609075,,2,41,10,51
9609126,9609126,,2,12,8,20
9610005,9610005,,2,2,45,47
9610068,9610068,,2,17,25,42
9611094,9611094,,2,12,12,24
9611161,9611161,,2,8,19,27
9611175,9611175,,2,14,21,35
9611182,9611182,,54,1,17,18
9611210,9611210,,54,6,12,18
9612004,9612004,,2,5,14,19
9612224,9612224,,31,25,25,50
9701053,9701053,,2,6,38,44
9701177,9701177,,2,8,6,14
9703101,9703101,,54,30,17,47
9703134,9703134,,2,16,23,39
9312127,9312127,,1,7,3,10
9711106,9711106,,2,50,11,61
9806162,9806162,,34,16,10,26
9902081,9902081,,2,14,4,18
9804141,9804141,,34,6,43,49
9812109,9812109,,34,4,27,31
9311115,9311115,,34,10,2,12
9506043,9506043,,34,9,3,12
9602104,9602104,,34,8,4,12
9702186,9702186,,34,6,5,11
9604014,9604014,,8,18,8,26
9905087,9905087,,2,12,16,28
1100,1100,,14,2,3,5
9211007,9211007,,14,13,2,15
9202077,9202077,,14,3,0,3
9207070,9207070,,14,5,0,5
9212153,9212153,,14,25,0,25
9305112,9305112,,14,6,4,10
9308068,9308068,,25,3,8,11
9311022,9311022,,14,11,11,22
9311098,9311098,,14,5,0,5
9312005,9312005,,14,9,4,13
9401071,9401071,,14,2,1,3
9406017,9406017,,14,9,2,11
9406021,9406021,,11,8,0,8
9409013,9409013,,11,3,2,5
9409041,9409041,,14,14,2,16
9409185,9409185,,14,11,3,14
9502045,9502045,,14,16,4,20
9503034,9503034,,14,9,4,13
9503087,9503087,,14,3,1,4
9503092,9503092,,14,3,6,9
9504053,9504053,,14,6,5,11
9506131,9506131,,2,16,4,20
9510007,9510007,,14,11,11,22
9510069,9510069,,14,9,7,16
9511071,9511071,,14,16,13,29
9604054,9604054,,14,4,6,10
9605089,9605089,,14,6,1,7
9605106,9605106,,14,8,3,11
9605109,9605109,,14,11,8,19
9605166,9605166,,14,3,4,7
9609003,9609003,,14,4,16,20
9609180,9609180,,14,8,5,13
9609201,9609201,,14,1,5,6
9612101,9612101,,14,13,4,17
9702119,9702119,,14,1,3,4
9703192,9703192,,14,5,10,15
9704026,9704026,,14,4,1,5
9705179,9705179,,14,2,5,7
9707176,9707176,,34,45,4,49
9709181,9709181,,14,1,2,3
9802143,9802143,,14,2,7,9
9804204,9804204,,14,2,3,5
9704058,9704058,,2,8,16,24
9709050,9709050,,2,7,5,12
1101,1101,,54,2,16,18
9811168,9811168,,54,43,12,55
9811240,9811240,,54,19,23,42
9901009,9901009,,54,45,41,86
9904054,9904054,,54,25,30,55
9912208,9912208,,54,34,25,59
9706093,9706093,,54,14,8,22
9709209,9709209,,54,3,19,22
9501131,9501131,,54,13,6,19
9811129,9811129,,54,4,14,18
9903052,9903052,,54,6,15,21
9903104,9903104,,54,9,48,57
9904114,9904114,,54,9,16,25
1102,1102,,37,1,1,2
9905013,9905013,,37,1,0,1
1103,1103,,34,30,33,63
9702107,9702107,,37,43,24,67
9905015,9905015,,37,32,26,58
9906011,9906011,,37,47,30,77
9908020,9908020,,34,9,20,29
9912035,9912035,,37,3,11,14
9208046,9208046,,37,26,1,27
9303100,9303100,,37,13,1,14
9312103,9312103,,37,4,0,4
9401017,9401017,,37,27,0,27
9402021,9402021,,37,9,0,9
9504141,9504141,,37,7,5,12
9201003,9201003,,37,19,0,19
9205110,9205110,,37,37,0,37
9306153,9306153,,37,99,18,117
9306102,9306102,,37,11,1,12
9411004,9411004,,65,23,3,26
9411160,9411160,,37,16,2,18
9510143,9510143,,37,13,8,21
9609104,9609104,,37,30,24,54
9407007,9407007,,16,14,1,15
9511104,9511104,,16,64,10,74
9703191,9703191,,34,19,10,29
9804099,9804099,,34,7,12,19
9802012,9802012,,37,22,5,27
9802108,9802108,,37,33,7,40
9805168,9805168,,37,40,11,51
9806034,9806034,,37,24,7,31
9902018,9902018,,37,25,45,70
9904116,9904116,,37,18,16,34
9710098,9710098,,37,9,25,34
9804069,9804069,,37,19,14,33
9811172,9811172,,34,41,14,55
9802049,9802049,,37,30,9,39
9905016,9905016,,37,4,8,12
9905138,9905138,,37,4,13,17
9908095,9908095,,37,4,11,15
9909004,9909004,,11,13,11,24
1105,1105,,3,7,8,15
9911085,9911085,,3,17,13,30
9511111,9511111,,4,6,5,11
9910258,9910258,,3,2,15,17
9907055,9907055,,3,20,6,26
9806198,9806198,,3,7,9,16
9911140,9911140,,3,23,37,60
1106,1106,,2,8,18,26
9806108,9806108,,2,58,17,75
9903022,9903022,,2,18,25,43
9903049,9903049,,2,20,23,43
9905183,9905183,,2,11,33,44
9312104,9312104,,37,37,3,40
9708097,9708097,,11,7,0,7
9801072,9801072,,2,5,16,21
9706059,9706059,,2,16,9,25
9707039,9707039,,11,2,1,3
9712133,9712133,,2,30,11,41
9801093,9801093,,2,5,17,22
9705200,9705200,,37,17,7,24
9808183,9808183,,2,11,26,37
9812039,9812039,,2,6,14,20
9901105,9901105,,2,8,36,44
9901152,9901152,,2,8,21,29
9810021,9810021,,2,18,29,47
9903025,9903025,,2,7,21,28
9903099,9903099,,2,1,15,16
9904182,9904182,,2,20,16,36
9905091,9905091,,2,3,15,18
1107,1107,,0,20,8,28
1108,1108,,19,1,6,7
9709133,9709133,,19,5,1,6
9709134,9709134,,19,4,0,4
9710025,9710025,,19,8,4,12
9801192,9801192,,19,6,14,20
9810182,9810182,,19,4,1,5
9906170,9906170,,19,1,12,13
9410225,9410225,,19,1,2,3
9302116,9302116,,19,45,1,46
9610247,9610247,,19,6,2,8
9703090,9703090,,19,7,3,10
9703200,9703200,,19,7,2,9
9306117,9306117,,19,21,0,21
9307034,9307034,,19,4,2,6
9309013,9309013,,19,33,1,34
9402020,9402020,,19,16,2,18
9404094,9404094,,19,13,4,17
9406212,9406212,,19,14,6,20
9503032,9503032,,19,10,1,11
9509003,9509003,,19,10,1,11
9606054,9606054,,19,10,14,24
9611027,9611027,,19,5,9,14
9603185,9603185,,19,5,2,7
9411175,9411175,,19,6,0,6
9809062,9809062,,19,4,11,15
1109,1109,,37,3,24,27
9512075,9512075,,37,17,1,18
9702161,9702161,,37,8,6,14
9709082,9709082,,37,7,5,12
9710185,9710185,,37,8,3,11
9803112,9803112,,37,8,7,15
9803160,9803160,,37,4,6,10
9808160,9808160,,54,11,2,13
9810250,9810250,,37,17,9,26
9812212,9812212,,37,3,10,13
9904196,9904196,,37,5,11,16
9909177,9909177,,37,2,34,36
9909228,9909228,,54,21,11,32
9605192,9605192,,37,11,5,16
9603082,9603082,,37,5,20,25
9310017,9310017,,25,1,2,3
9607054,9607054,,54,1,18,19
9710085,9710085,,37,11,53,64
9707262,9707262,,54,17,36,53
9710243,9710243,,2,39,17,56
9611209,9611209,,37,25,20,45
9902211,9902211,,37,2,13,15
9903256,9903256,,37,3,6,9
9812133,9812133,,34,7,8,15
9903183,9903183,,11,8,2,10
9910212,9910212,,37,1,5,6
1110,1110,,16,1,22,23
9212088,9212088,,16,65,0,65
9401059,9401059,,16,61,1,62
9401092,9401092,,16,37,1,38
9402008,9402008,,16,29,2,31
9609174,9609174,,16,57,7,64
9704055,9704055,,16,22,12,34
9704056,9704056,,16,16,14,30
9710103,9710103,,16,3,14,17
9711047,9711047,,16,14,11,25
9711110,9711110,,16,30,14,44
9801133,9801133,,16,28,18,46
9802174,9802174,,16,28,19,47
9806110,9806110,,16,29,15,44
9811212,9811212,,16,25,24,49
9902117,9902117,,16,11,10,21
9903096,9903096,,16,8,24,32
9903119,9903119,,16,5,5,10
9904199,9904199,,16,19,22,41
9907096,9907096,,16,8,16,24
9910107,9910107,,16,5,3,8
9910190,9910190,,16,15,26,41
9912207,9912207,,16,7,16,23
9303012,9303012,,16,56,0,56
9310049,9310049,,16,7,1,8
9404031,9404031,,16,33,2,35
9405005,9405005,,16,29,2,31
9606099,9606099,,16,8,4,12
9502096,9502096,,16,28,7,35
9605110,9605110,,16,14,5,19
9605183,9605183,,16,29,4,33
9304063,9304063,,16,13,0,13
9412230,9412230,,16,1,0,1
9606004,9606004,,37,20,7,27
9612237,9612237,,16,8,6,14
9612242,9612242,,16,2,5,7
9207020,9207020,,16,14,2,16
9302014,9302014,,37,52,6,58
9307116,9307116,,16,10,7,17
9604012,9604012,,16,2,6,8
9607243,9607243,,62,4,18,22
9702005,9702005,,16,4,9,13
9710114,9710114,,16,17,18,35
9711023,9711023,,16,30,10,40
9711057,9711057,,16,22,12,34
9711096,9711096,,16,24,14,38
9709032,9709032,,16,8,19,27
9712006,9712006,,16,17,15,32
9801042,9801042,,16,24,18,42
9412012,9412012,,16,6,1,7
9803007,9803007,,16,12,18,30
9807026,9807026,,16,10,21,31
9810130,9810130,,16,2,1,3
9811044,9811044,,16,4,14,18
9809194,9809194,,16,11,9,20
9810248,9810248,,16,6,10,16
9405006,9405006,,16,2,2,4
9201013,9201013,,37,49,0,49
9404005,9404005,,37,12,8,20
1111,1111,,3,17,20,37
9909132,9909132,,3,18,5,23
9911245,9911245,,3,24,17,41
9912293,9912293,,3,21,6,27
9612120,9612120,,2,25,19,44
9904133,9904133,,3,24,39,63
9707118,9707118,,37,33,12,45
1112,1112,,54,16,8,24
9212049,9212049,,54,58,0,58
9805005,9805005,,54,13,6,19
9307121,9307121,,2,5,13,18
9402115,9402115,,0,10,1,11
9611149,9611149,,54,16,22,38
9702105,9702105,,54,17,17,34
1114,1114,,65,3,19,22
9402031,9402031,,65,50,28,78
9411242,9411242,,65,19,5,24
9510092,9510092,,65,8,12,20
9603015,9603015,,65,8,7,15
9709071,9709071,,65,4,33,37
9811033,9811033,,34,12,22,34
9906123,9906123,,34,4,7,11
9201039,9201039,,1,16,0,16
9202002,9202002,,65,11,0,11
9203059,9203059,,25,20,0,20
9204011,9204011,,1,14,0,14
9310112,9310112,,1,97,1,98
9305055,9305055,,65,10,1,11
9409011,9409011,,65,27,6,33
9409177,9409177,,2,2,5,7
9509013,9509013,,1,2,19,21
9407113,9407113,,65,6,4,10
9601016,9601016,,65,4,9,13
9601096,9601096,,65,12,20,32
9602162,9602162,,65,11,27,38
9710163,9710163,,65,16,50,66
9311081,9311081,,1,44,0,44
9311093,9311093,,1,23,4,27
9311187,9311187,,1,22,1,23
9403041,9403041,,1,23,8,31
9404063,9404063,,1,46,48,94
9511024,9511024,,65,13,11,24
9512126,9512126,,65,7,16,23
9608023,9608023,,65,4,26,30
9407181,9407181,,34,4,4,8
9603135,9603135,,11,7,3,10
9706032,9706032,,2,10,23,33
9305155,9305155,,25,2,0,2
9709143,9709143,,1,6,2,8
9206059,9206059,,34,2,0,2
9804129,9804129,,34,6,29,35
9602060,9602060,,54,24,18,42
9705150,9705150,,54,4,36,40
9805182,9805182,,34,5,26,31
9806049,9806049,,1,6,6,12
9412144,9412144,,25,14,9,23
9803220,9803220,,34,9,45,54
9803227,9803227,,34,16,27,43
9804095,9804095,,34,27,32,59
9808002,9808002,,34,8,20,28
9205077,9205077,,6,6,0,6
9402057,9402057,,19,28,6,34
9411164,9411164,,6,7,6,13
9803208,9803208,,11,3,7,10
9806119,9806119,,34,33,10,43
9807216,9807216,,34,27,7,34
9901112,9901112,,34,7,4,11
1115,1115,,6,1,1,2
9210036,9210036,,25,18,1,19
9301119,9301119,,25,17,3,20
1116,1116,,5,0,1,1
9812221,9812221,,5,1,0,1
1117,1117,,3,0,4,4
9403067,9403067,,3,17,0,17
9506041,9506041,,3,5,6,11
9606114,9606114,,3,2,6,8
9209044,9209044,,3,51,0,51
9304157,9304157,,3,4,0,4
9401145,9401145,,3,14,2,16
9402046,9402046,,3,18,1,19
9406166,9406166,,3,4,0,4
9410201,9410201,,3,5,5,10
9212108,9212108,,16,12,0,12
9303006,9303006,,25,22,1,23
9307074,9307074,,25,5,13,18
9304023,9304023,,3,20,1,21
9402048,9402048,,3,12,2,14
9510038,9510038,,3,3,5,8
9512171,9512171,,3,5,4,9
9512215,9512215,,3,13,1,14
9603045,9603045,,3,5,11,16
1118,1118,,3,10,3,13
1119,1119,,0,1,1,2
9206055,9206055,,25,15,1,16
9210012,9210012,,2,18,4,22
9210050,9210050,,2,13,7,20
1121,1121,,37,1,16,17
9308090,9308090,,54,16,1,17
9408149,9408149,,54,12,3,15
9412125,9412125,,54,7,1,8
9606052,9606052,,54,10,10,20
9606135,9606135,,54,12,11,23
9608084,9608084,,37,13,14,27
9608157,9608157,,37,5,13,18
9701134,9701134,,34,6,1,7
9803099,9803099,,0,4,1,5
9903243,9903243,,37,7,3,10
9905062,9905062,,37,6,7,13
9906141,9906141,,37,6,8,14
9508043,9508043,,37,7,14,21
9602021,9602021,,37,12,9,21
9505113,9505113,,19,14,7,21
9506184,9506184,,16,3,9,12
9602031,9602031,,37,33,13,46
9602035,9602035,,37,12,12,24
9602180,9602180,,37,24,4,28
9607210,9607210,,37,34,19,53
9801062,9801062,,0,7,11,18
9608197,9608197,,54,15,8,23
9711178,9711178,,54,10,7,17
9805133,9805133,,54,9,14,23
1122,1122,,34,24,32,56
2125,2125,,34,13,28,41
3147,3147,,34,26,47,73
9810008,9810008,,34,43,19,62
9905180,9905180,,34,16,34,50
9905200,9905200,,34,17,35,52
9906127,9906127,,34,56,19,75
9906216,9906216,,34,7,39,46
9908066,9908066,,34,9,13,22
9911060,9911060,,34,10,12,22
9911152,9911152,,34,18,15,33
9912013,9912013,,34,11,27,38
9912191,9912191,,34,8,19,27
1131,1131,,34,18,29,47
1177,1177,,34,9,29,38
1193,1193,,34,14,21,35
2111,2111,,34,10,21,31
2230,2230,,34,65,35,100
9905227,9905227,,34,17,34,51
9911002,9911002,,34,41,15,56
9912209,9912209,,34,9,34,43
9305123,9305123,,25,2,1,3
9510029,9510029,,25,17,6,23
9511227,9511227,,25,12,11,23
206223,206223,,34,8,26,34
9308020,9308020,,25,31,7,38
9705236,9705236,,25,51,3,54
9706009,9706009,,25,44,3,47
9706143,9706143,,25,34,28,62
9707025,9707025,,25,22,7,29
9707041,9707041,,25,38,6,44
9801052,9801052,,25,7,8,15
9802029,9802029,,25,20,7,27
9802043,9802043,,25,11,14,25
9804031,9804031,,34,16,21,37
9808085,9808085,,34,20,4,24
9809035,9809035,,34,29,3,32
9812202,9812202,,34,7,3,10
9903229,9903229,,34,30,7,37
9904197,9904197,,34,27,24,51
9907188,9907188,,34,15,52,67
9310069,9310069,,2,4,0,4
9809174,9809174,,34,4,8,12
9902156,9902156,,34,1,30,31
9907143,9907143,,34,3,22,25
9908198,9908198,,34,3,19,22
9809040,9809040,,4,2,3,5
9904148,9904148,,34,21,7,28
9810014,9810014,,37,11,21,32
9812014,9812014,,2,16,34,50
9906054,9906054,,34,15,18,33
9602093,9602093,,6,3,1,4
9910040,9910040,,34,21,23,44
9910113,9910113,,34,13,8,21
9910124,9910124,,34,17,13,30
9908065,9908065,,34,14,45,59
9908022,9908022,,34,16,29,45
9909197,9909197,,34,13,9,22
9902184,9902184,,34,10,8,18
1123,1123,,4,9,23,32
11116,11116,,2,7,4,11
9904157,9904157,,2,6,1,7
9905185,9905185,,11,1,1,2
9910241,9910241,,4,4,11,15
9911173,9911173,,4,6,30,36
5165,5165,,2,8,21,29
9406202,9406202,,2,13,0,13
9710213,9710213,,37,5,38,43
9709219,9709219,,54,18,18,36
9802199,9802199,,2,21,12,33
9804208,9804208,,54,29,43,72
9806120,9806120,,2,54,37,91
9812210,9812210,,2,8,21,29
9903118,9903118,,2,7,15,22
9808074,9808074,,2,30,15,45
9812071,9812071,,54,60,18,78
9812088,9812088,,54,49,22,71
9812149,9812149,,2,24,8,32
9812101,9812101,,11,14,2,16
9710004,9710004,,54,6,25,31
9812084,9812084,,4,6,4,10
9903140,9903140,,4,9,44,53
9905034,9905034,,4,5,36,41
9905044,9905044,,4,2,12,14
9905055,9905055,,2,3,32,35
9907128,9907128,,2,3,21,24
2211,2211,,4,133,29,162
9901055,9901055,,2,10,22,32
9908094,9908094,,2,12,39,51
9910266,9910266,,4,10,19,29
1124,1124,,16,6,26,32
9208032,9208032,,16,18,0,18
9301002,9301002,,25,18,1,19
9302133,9302133,,16,53,0,53
9303041,9303041,,16,10,1,11
9303149,9303149,,16,11,2,13
9307045,9307045,,16,40,1,41
9312047,9312047,,16,36,4,40
9312158,9312158,,16,22,2,24
9401096,9401096,,16,24,2,26
9401137,9401137,,16,14,8,22
9612069,9612069,,16,3,5,8
9712058,9712058,,16,5,0,5
9802020,9802020,,16,2,6,8
9904012,9904012,,16,11,3,14
9907084,9907084,,16,8,14,22
9910232,9910232,,16,1,2,3
9912246,9912246,,11,6,8,14
9912267,9912267,,16,8,6,14
9701033,9701033,,25,7,0,7
9204017,9204017,,16,17,0,17
9204018,9204018,,16,28,0,28
9203030,9203030,,37,28,0,28
9204082,9204082,,37,11,0,11
9206088,9206088,,16,19,0,19
9208030,9208030,,16,22,1,23
9303105,9303105,,16,16,2,18
9303146,9303146,,16,9,5,14
9307120,9307120,,16,9,0,9
9310098,9310098,,16,10,1,11
9412097,9412097,,16,1,0,1
9602002,9602002,,16,5,4,9
9607071,9607071,,16,5,3,8
9503134,9503134,,16,13,11,24
9506193,9506193,,37,21,6,27
9605167,9605167,,16,3,5,8
9705202,9705202,,16,4,13,17
9511117,9511117,,16,6,10,16
9206081,9206081,,25,37,0,37
9303123,9303123,,25,37,0,37
9308099,9308099,,11,2,2,4
9311078,9311078,,11,8,4,12
9408103,9408103,,11,8,3,11
9607153,9607153,,11,3,7,10
9708019,9708019,,11,2,2,4
9810193,9810193,,9,1,4,5
9911189,9911189,,16,1,10,11
1125,1125,,2,2,28,30
9607038,9607038,,2,4,11,15
9704161,9704161,,2,10,13,23
9710223,9710223,,2,23,16,39
9801202,9801202,,2,20,11,31
9802133,9802133,,2,13,32,45
9803040,9803040,,2,10,14,24
9803041,9803041,,2,13,27,40
9804202,9804202,,2,12,27,39
9805209,9805209,,2,8,26,34
9809204,9809204,,2,9,60,69
9905144,9905144,,2,7,60,67
9906041,9906041,,2,6,75,81
9604182,9604182,,25,10,5,15
9608076,9608076,,25,4,3,7
9610209,9610209,,2,1,1,2
9409107,9409107,,2,6,2,8
9603093,9603093,,2,4,2,6
9612153,9612153,,2,9,19,28
9703179,9703179,,2,12,29,41
9602089,9602089,,25,28,7,35
9707200,9707200,,2,21,33,54
9710214,9710214,,2,13,4,17
9801038,9801038,,2,9,28,37
9404106,9404106,,19,5,1,6
9303156,9303156,,2,27,7,34
9312168,9312168,,2,23,5,28
9710215,9710215,,2,15,41,56
9710034,9710034,,37,31,23,54
9711009,9711009,,2,17,6,23
9803209,9803209,,2,54,31,85
9804087,9804087,,2,11,25,36
9708081,9708081,,25,12,5,17
9708152,9708152,,25,15,6,21
9803094,9803094,,25,4,6,10
9412163,9412163,,2,4,3,7
9705093,9705093,,2,23,21,44
9203051,9203051,,2,53,0,53
9204071,9204071,,2,35,1,36
9601109,9601109,,2,9,5,14
9608094,9608094,,2,4,9,13
9705064,9705064,,2,14,34,48
9712040,9712040,,37,19,14,33
9703099,9703099,,2,6,52,58
9707110,9707110,,2,6,49,55
9807133,9807133,,2,1,14,15
9901003,9901003,,2,38,14,52
9904041,9904041,,2,13,30,43
9905031,9905031,,1,14,7,21
9507060,9507060,,16,22,23,45
9904003,9904003,,6,9,4,13
1126,1126,,0,16,18,34
9611204,9611204,,31,30,35,65
9202003,9202003,,54,9,0,9
9509077,9509077,,25,2,2,4
9601083,9601083,,54,3,2,5
9403179,9403179,,31,44,11,55
9406216,9406216,,31,77,5,82
9509074,9509074,,31,60,7,67
9608195,9608195,,31,55,14,69
9609048,9609048,,31,11,10,21
9609087,9609087,,31,32,30,62
9610107,9610107,,31,55,19,74
9610166,9610166,,31,31,23,54
9610238,9610238,,31,64,32,96
9610252,9610252,,31,32,16,48
9802190,9802190,,54,8,10,18
9807100,9807100,,31,7,9,16
9701082,9701082,,31,40,26,66
9701154,9701154,,31,19,32,51
9704013,9704013,,31,13,40,53
9705050,9705050,,31,21,34,55
9707003,9707003,,31,6,19,25
9707182,9707182,,31,21,16,37
9708154,9708154,,31,10,24,34
9802057,9802057,,31,12,27,39
9802197,9802197,,31,3,30,33
9809105,9809105,,31,6,29,35
9812052,9812052,,54,11,32,43
9906246,9906246,,54,17,25,42
9908085,9908085,,37,7,25,32
1127,1127,,2,5,25,30
9802179,9802179,,2,6,21,27
9803049,9803049,,2,10,5,15
9501003,9501003,,6,4,4,8
9609102,9609102,,2,28,1,29
9610134,9610134,,2,33,10,43
9610226,9610226,,2,20,7,27
9701186,9701186,,2,14,41,55
9712163,9712163,,2,1,17,18
9708048,9708048,,2,3,11,14
9709196,9709196,,2,2,3,5
9810153,9810153,,54,5,10,15
1128,1128,,62,10,14,24
9206034,9206034,,62,32,0,32
9301018,9301018,,62,24,2,26
9309137,9309137,,62,29,6,35
9310060,9310060,,62,13,4,17
9810006,9810006,,62,18,30,48
9902011,9902011,,62,12,24,36
9903072,9903072,,62,3,12,15
9904159,9904159,,62,12,2,14
9907125,9907125,,62,9,11,20
9910218,9910218,,62,17,17,34
9912196,9912196,,62,13,25,38
9202020,9202020,,62,26,0,26
9207040,9207040,,62,38,2,40
9207069,9207069,,62,6,1,7
9210025,9210025,,16,3,0,3
9211111,9211111,,62,15,0,15
9305024,9305024,,62,7,1,8
9303013,9303013,,62,27,4,31
9303111,9303111,,62,5,12,17
9207061,9207061,,62,15,0,15
9208057,9208057,,62,21,0,21
9305160,9305160,,62,41,3,44
9307035,9307035,,62,17,2,19
9307175,9307175,,62,12,4,16
9310183,9310183,,62,5,2,7
9404097,9404097,,62,2,5,7
9409035,9409035,,62,12,10,22
9202070,9202070,,62,22,0,22
9212086,9212086,,62,32,2,34
9304149,9304149,,62,18,5,23
9404065,9404065,,62,10,8,18
9405034,9405034,,62,21,7,28
9408092,9408092,,62,11,10,21
9411103,9411103,,62,1,3,4
9412213,9412213,,62,30,25,55
9501078,9501078,,62,3,9,12
9503019,9503019,,62,7,7,14
9504085,9504085,,62,4,5,9
9505085,9505085,,62,10,2,12
9202034,9202034,,62,7,0,7
9211134,9211134,,62,8,2,10
9302112,9302112,,62,6,1,7
9404030,9404030,,62,10,8,18
9507001,9507001,,62,10,23,33
9604098,9604098,,62,12,0,12
9605104,9605104,,62,10,5,15
9607099,9607099,,62,41,5,46
9607167,9607167,,62,29,2,31
9608055,9608055,,62,3,7,10
9608091,9608091,,62,30,4,34
9701118,9701118,,62,7,15,22
9702196,9702196,,62,5,17,22
9703158,9703158,,62,6,26,32
9803248,9803248,,62,2,4,6
9805117,9805117,,62,13,9,22
9201032,9201032,,62,13,0,13
9204094,9204094,,62,24,0,24
9206052,9206052,,62,14,2,16
9206112,9206112,,62,10,0,10
9208011,9208011,,62,18,1,19
9308147,9308147,,62,8,4,12
9407117,9407117,,62,34,3,37
9408113,9408113,,62,38,7,45
9505102,9505102,,62,7,6,13
9511008,9511008,,62,11,3,14
9601123,9601123,,62,10,18,28
9610150,9610150,,62,6,0,6
9706140,9706140,,62,18,7,25
9711185,9711185,,62,4,2,6
9803005,9803005,,62,14,12,26
9807160,9807160,,62,8,12,20
9812211,9812211,,62,15,8,23
9812247,9812247,,62,13,8,21
9410117,9410117,,62,11,6,17
9603011,9603011,,62,15,17,32
9804144,9804144,,62,1,0,1
9810026,9810026,,62,12,9,21
9902075,9902075,,62,10,4,14
9410065,9410065,,19,9,7,16
9512054,9512054,,62,5,2,7
9702170,9702170,,62,5,5,10
9706054,9706054,,62,11,5,16
9205024,9205024,,62,12,1,13
9211115,9211115,,62,14,1,15
9410140,9410140,,62,20,5,25
9606032,9606032,,62,30,12,42
9612040,9612040,,62,8,1,9
9701109,9701109,,62,15,10,25
9706203,9706203,,62,14,24,38
9711113,9711113,,62,12,15,27
9809052,9809052,,62,4,33,37
9901145,9901145,,62,5,12,17
9904072,9904072,,62,1,0,1
9905213,9905213,,62,1,0,1
9907039,9907039,,62,6,5,11
9211102,9211102,,62,56,2,58
9301046,9301046,,62,63,6,69
9310122,9310122,,62,28,4,32
9402038,9402038,,62,30,0,30
9412062,9412062,,62,23,4,27
9412127,9412127,,62,18,14,32
9506087,9506087,,62,18,5,23
1129,1129,,6,9,5,14
9911063,9911063,,6,8,5,13
9404080,9404080,,34,3,2,5
9502157,9502157,,11,5,0,5
9809069,9809069,,6,2,1,3
1130,1130,,4,4,10,14
9909109,9909109,,34,9,17,26
9805151,9805151,,1,38,1,39
9810142,9810142,,2,2,49,51
9810205,9810205,,34,2,15,17
9903046,9903046,,54,12,20,32
9911195,9911195,,34,20,13,33
9702153,9702153,,2,18,31,49
9308077,9308077,,34,10,7,17
9310011,9310011,,34,3,5,8
9801064,9801064,,2,3,22,25
9801125,9801125,,2,7,55,62
9801145,9801145,,34,8,16,24
9803064,9803064,,2,11,25,36
9803080,9803080,,34,13,19,32
9804019,9804019,,34,21,23,44
9206103,9206103,,14,9,0,9
9511188,9511188,,34,25,3,28
9410132,9410132,,1,11,6,17
9806181,9806181,,34,3,3,6
9808181,9808181,,2,4,8,12
9805208,9805208,,2,24,39,63
9806141,9806141,,2,4,37,41
9705090,9705090,,54,8,23,31
9809167,9809167,,34,6,5,11
1132,1132,,37,32,30,62
9506104,9506104,,54,19,6,25
9911229,9911229,,65,18,10,28
9210062,9210062,,54,13,0,13
9211047,9211047,,54,18,6,24
9303015,9303015,,54,3,4,7
9501072,9501072,,54,2,5,7
1133,1133,,54,24,25,49
9908193,9908193,,54,4,40,44
9702030,9702030,,54,7,16,23
9612077,9612077,,54,10,8,18
9806059,9806059,,54,8,36,44
9812097,9812097,,37,13,42,55
9507011,9507011,,37,6,18,24
9808159,9808159,,54,6,60,66
1134,1134,,7,5,11,16
9506097,9506097,,7,2,0,2
9903249,9903249,,9,17,11,28
9904044,9904044,,9,16,9,25
9912037,9912037,,0,18,6,24
9201070,9201070,,7,8,0,8
9309067,9309067,,16,5,12,17
9401027,9401027,,2,9,5,14
9603024,9603024,,7,6,3,9
9612160,9612160,,8,2,15,17
9703094,9703094,,7,6,8,14
9705010,9705010,,7,7,2,9
9705205,9705205,,2,32,25,57
9707171,9707171,,7,5,23,28
9807107,9807107,,2,1,10,11
9808019,9808019,,54,3,31,34
9605107,9605107,,9,13,1,14
9611150,9611150,,9,12,2,14
9808113,9808113,,9,4,0,4
9811173,9811173,,9,3,12,15
9803091,9803091,,9,15,7,22
9904014,9904014,,9,8,5,13
9711103,9711103,,62,1,3,4
9909077,9909077,,34,11,30,41
1135,1135,,3,9,18,27
9911186,9911186,,3,24,34,58
9607082,9607082,,2,7,14,21
9612022,9612022,,2,3,15,18
9705025,9705025,,37,6,22,28
9601011,9601011,,37,16,22,38
9801106,9801106,,2,9,10,19
9803203,9803203,,2,9,6,15
9804114,9804114,,37,7,42,49
9510138,9510138,,37,12,5,17
9803164,9803164,,37,13,6,19
9707142,9707142,,2,3,20,23
9710010,9710010,,2,2,27,29
9710137,9710137,,2,1,21,22
9806149,9806149,,2,19,21,40
9810110,9810110,,2,2,9,11
9812159,9812159,,2,21,21,42
9811179,9811179,,37,4,17,21
9906119,9906119,,37,23,25,48
9907090,9907090,,37,16,17,33
1136,1136,,1,2,9,11
9507059,9507059,,1,2,0,2
9611054,9611054,,1,4,1,5
9705172,9705172,,1,10,6,16
9802019,9802019,,1,4,2,6
9803012,9803012,,1,9,3,12
9803025,9803025,,1,9,3,12
9806206,9806206,,1,2,5,7
9810178,9810178,,1,1,5,6
9303001,9303001,,1,23,0,23
9304086,9304086,,1,6,0,6
9410095,9410095,,1,8,0,8
9411231,9411231,,1,8,0,8
9604135,9604135,,1,1,2,3
9611082,9611082,,1,2,0,2
1137,1137,,16,9,19,28
9412234,9412234,,16,1,0,1
9206035,9206035,,16,33,0,33
9712051,9712051,,16,2,10,12
9306042,9306042,,16,9,0,9
1138,1138,,34,24,36,60
9811155,9811155,,34,24,2,26
9906051,9906051,,34,32,11,43
9910011,9910011,,34,28,27,55
9910016,9910016,,34,38,26,64
9910197,9910197,,34,26,13,39
9912210,9912210,,34,29,44,73
9610026,9610026,,37,29,54,83
9507003,9507003,,37,7,15,22
9804182,9804182,,34,20,43,63
9701064,9701064,,34,1,2,3
9804053,9804053,,34,11,7,18
9807206,9807206,,1,37,13,50
9808146,9808146,,1,33,8,41
9807034,9807034,,8,30,21,51
9903162,9903162,,8,26,60,86
9809090,9809090,,34,6,2,8
9811209,9811209,,34,7,13,20
9904076,9904076,,34,5,9,14
9812197,9812197,,9,7,3,10
9906099,9906099,,34,13,27,40
9906188,9906188,,34,56,36,92
9907088,9907088,,34,37,23,60
9902047,9902047,,34,11,22,33
9907106,9907106,,34,19,16,35
9908163,9908163,,34,32,41,73
9908171,9908171,,34,9,100,109
9911222,9911222,,34,38,47,85
9912250,9912250,,34,26,26,52
1140,1140,,14,4,6,10
9911148,9911148,,14,11,3,14
9912023,9912023,,14,2,9,11
9805059,9805059,,14,7,2,9
9911065,9911065,,2,5,21,26
1141,1141,,65,1,3,4
9505012,9505012,,25,24,9,33
1142,1142,,37,0,39,39
9803154,9803154,,37,8,11,19
9806043,9806043,,37,2,15,17
9807059,9807059,,37,5,10,15
9810040,9810040,,37,5,8,13
9902188,9902188,,37,5,17,22
9906145,9906145,,37,1,11,12
9908054,9908054,,37,14,14,28
9909183,9909183,,37,13,14,27
9502149,9502149,,8,5,2,7
9508140,9508140,,37,7,5,12
9705107,9705107,,2,7,52,59
9705181,9705181,,37,9,30,39
9703036,9703036,,37,4,9,13
9704002,9704002,,37,10,2,12
9704163,9704163,,54,5,8,13
9603129,9603129,,37,2,10,12
9705027,9705027,,37,7,12,19
9612195,9612195,,37,14,19,33
9704027,9704027,,37,6,31,37
9510045,9510045,,37,2,3,5
9803130,9803130,,37,1,4,5
9610122,9610122,,6,2,4,6
9410112,9410112,,2,2,0,2
9511112,9511112,,37,11,3,14
1144,1144,,3,12,20,32
9907100,9907100,,2,30,27,57
9907145,9907145,,2,28,14,42
9911153,9911153,,3,14,16,30
9601067,9601067,,54,5,22,27
9611169,9611169,,34,9,7,16
9407108,9407108,,65,14,0,14
9601058,9601058,,2,6,3,9
9611181,9611181,,14,2,9,11
9811116,9811116,,8,1,19,20
9903146,9903146,,34,9,14,23
9404009,9404009,,37,12,2,14
9804027,9804027,,2,44,29,73
9208007,9208007,,7,41,0,41
9404023,9404023,,7,2,1,3
9705211,9705211,,7,3,17,20
1145,1145,,34,15,10,25
9803132,9803132,,34,17,5,22
9912156,9912156,,0,23,18,41
9311037,9311037,,62,22,0,22
9902126,9902126,,34,49,22,71
9902183,9902183,,25,9,21,30
9907062,9907062,,34,7,9,16
9908070,9908070,,34,38,6,44
9908093,9908093,,34,13,11,24
1146,1146,,25,0,2,2
9812233,9812233,,25,2,2,4
9906241,9906241,,25,2,1,3
9504028,9504028,,11,9,0,9
1147,1147,,37,0,1,1
1148,1148,,3,0,4,4
9401149,9401149,,8,11,1,12
9605001,9605001,,3,55,16,71
9606001,9606001,,3,67,5,72
9304005,9304005,,3,28,0,28
9302008,9302008,,3,28,0,28
9311121,9311121,,3,5,0,5
9312186,9312186,,3,19,2,21
9401099,9401099,,3,21,1,22
9404075,9404075,,3,4,2,6
9501077,9501077,,3,26,1,27
9501142,9501142,,3,27,3,30
9502120,9502120,,3,12,6,18
9503093,9503093,,3,27,0,27
9505192,9505192,,3,7,4,11
9506115,9506115,,3,20,4,24
9509163,9509163,,3,11,4,15
9603095,9603095,,3,14,13,27
9604115,9604115,,3,9,6,15
9604169,9604169,,3,9,5,14
9404138,9404138,,3,13,1,14
1149,1149,,2,1,18,19
9403181,9403181,,2,11,11,22
9606142,9606142,,8,8,24,32
9209115,9209115,,2,17,1,18
9304046,9304046,,2,30,5,35
9403177,9403177,,2,9,6,15
9411055,9411055,,2,8,10,18
9510213,9510213,,2,8,18,26
9512103,9512103,,2,5,10,15
9609092,9609092,,2,9,13,22
1150,1150,,2,1,12,13
9906142,9906142,,2,50,157,207
9410024,9410024,,2,5,0,5
9307195,9307195,,2,9,6,15
9511042,9511042,,2,2,0,2
9705092,9705092,,2,4,17,21
9706197,9706197,,2,3,27,30
9707119,9707119,,2,3,30,33
9709202,9709202,,2,8,17,25
9712007,9712007,,2,4,9,13
9301055,9301055,,2,4,3,7
9308018,9308018,,1,11,15,26
9406071,9406071,,2,4,8,12
9502124,9502124,,2,6,3,9
9502143,9502143,,2,6,9,15
9510220,9510220,,2,19,6,25
9511049,9511049,,8,9,11,20
9603049,9603049,,1,11,7,18
9603187,9603187,,2,12,29,41
9604195,9604195,,1,12,6,18
9608093,9608093,,2,7,33,40
9610038,9610038,,2,4,14,18
9610098,9610098,,2,4,31,35
9704051,9704051,,2,34,16,50
9711007,9711007,,2,4,29,33
9801104,9801104,,37,10,14,24
9804115,9804115,,2,13,30,43
9804157,9804157,,2,10,31,41
9810038,9810038,,2,4,8,12
9810081,9810081,,2,10,9,19
9811025,9811025,,37,11,21,32
9811145,9811145,,2,9,28,37
9903149,9903149,,8,5,22,27
9904137,9904137,,2,24,26,50
9905112,9905112,,1,19,15,34
9905117,9905117,,2,4,21,25
1151,1151,,62,6,5,11
9411051,9411051,,7,11,6,17
9412229,9412229,,62,61,6,67
9807085,9807085,,2,3,25,28
9206046,9206046,,7,27,0,27
9404050,9404050,,62,37,4,41
9404192,9404192,,7,19,5,24
9406020,9406020,,62,38,4,42
9411053,9411053,,7,12,16,28
9310058,9310058,,62,8,1,9
9409176,9409176,,62,8,3,11
9603010,9603010,,62,13,7,20
9510047,9510047,,62,9,10,19
9503043,9503043,,7,15,9,24
9605225,9605225,,37,15,10,25
9703086,9703086,,37,7,7,14
9704117,9704117,,2,4,9,13
9709152,9709152,,37,4,6,10
1152,1152,,6,1,1,2
9911107,9911107,,6,4,7,11
9301060,9301060,,6,14,0,14
9512216,9512216,,6,30,0,30
9601076,9601076,,6,10,3,13
9705123,9705123,,6,22,11,33
9707129,9707129,,6,14,12,26
9806077,9806077,,6,4,0,4
1153,1153,,11,0,1,1
1154,1154,,62,0,1,1
9807099,9807099,,62,13,0,13
1155,1155,,6,1,1,2
1156,1156,,11,1,4,5
2113,2113,,0,1,3,4
9605048,9605048,,11,7,5,12
9608181,9608181,,11,3,0,3
9811043,9811043,,11,1,2,3
9508149,9508149,,0,1,2,3
9706139,9706139,,0,16,0,16
9707016,9707016,,0,25,3,28
9405187,9405187,,9,25,0,25
9501124,9501124,,11,22,1,23
9501137,9501137,,11,16,1,17
9504123,9504123,,11,6,1,7
9508052,9508052,,11,4,0,4
9211044,9211044,,11,8,0,8
9610175,9610175,,11,2,2,4
1157,1157,,54,3,18,21
9806124,9806124,,54,10,10,20
9903212,9903212,,54,8,23,31
9906126,9906126,,54,16,15,31
9910164,9910164,,2,8,14,22
9208056,9208056,,25,3,0,3
9502069,9502069,,2,12,4,16
9602062,9602062,,19,11,2,13
9606091,9606091,,54,4,18,22
9608010,9608010,,54,5,9,14
9803107,9803107,,37,9,31,40
9508173,9508173,,54,4,5,9
9512004,9512004,,37,1,12,13
9906148,9906148,,54,13,20,33
9907083,9907083,,2,1,12,13
1158,1158,,65,2,8,10
9202047,9202047,,65,15,0,15
9203047,9203047,,19,19,0,19
9303009,9303009,,65,5,0,5
9405153,9405153,,65,8,4,12
9608063,9608063,,65,12,6,18
9205072,9205072,,65,19,0,19
9210040,9210040,,8,7,0,7
9212048,9212048,,65,12,0,12
9402074,9402074,,65,6,4,10
9407055,9407055,,65,6,4,10
9509170,9509170,,54,14,22,36
9601163,9601163,,8,9,9,18
9605127,9605127,,7,12,12,24
9207019,9207019,,8,15,0,15
9209034,9209034,,8,7,1,8
9308144,9308144,,65,4,0,4
9308153,9308153,,7,49,0,49
9405121,9405121,,7,27,10,37
9408158,9408158,,7,24,10,34
9411077,9411077,,65,12,2,14
9502021,9502021,,7,20,10,30
1159,1159,,0,68,24,92
9908089,9908089,,34,12,10,22
1161,1161,,34,3,10,13
9912055,9912055,,34,21,16,37
9201002,9201002,,7,7,0,7
9201016,9201016,,7,12,0,12
9206029,9206029,,7,38,0,38
9309023,9309023,,31,91,3,94
9506027,9506027,,31,68,10,78
9510117,9510117,,31,46,11,57
9702043,9702043,,31,44,32,76
9705035,9705035,,31,45,8,53
9706221,9706221,,31,35,32,67
9708046,9708046,,31,41,32,73
9801073,9801073,,31,36,12,48
9806233,9806233,,31,8,9,17
9811051,9811051,,31,14,17,31
9902097,9902097,,31,8,35,43
9411179,9411179,,16,9,21,30
3058,3058,,34,9,5,14
9907115,9907115,,34,5,20,25
9803018,9803018,,31,11,10,21
9907012,9907012,,34,23,26,49
9907032,9907032,,31,17,25,42
1162,1162,,16,2,5,7
9303153,9303153,,16,43,2,45
9407026,9407026,,16,7,12,19
9410105,9410105,,16,9,6,15
9412113,9412113,,16,30,5,35
9503155,9503155,,16,4,6,10
9203019,9203019,,16,9,0,9
9204028,9204028,,25,15,0,15
9212038,9212038,,16,28,0,28
9209049,9209049,,16,68,2,70
9307111,9307111,,16,61,5,66
9402066,9402066,,16,19,1,20
9405028,9405028,,11,24,1,25
9412143,9412143,,11,14,1,15
1163,1163,,11,3,12,15
9903040,9903040,,11,9,3,12
9903116,9903116,,11,3,1,4
9905079,9905079,,11,10,7,17
9909189,9909189,,11,4,11,15
9911072,9911072,,11,12,7,19
9601146,9601146,,11,20,0,20
9704012,9704012,,11,10,2,12
9704028,9704028,,11,9,1,10
9606037,9606037,,11,11,5,16
9611055,9611055,,11,8,2,10
9805161,9805161,,19,1,1,2
9810067,9810067,,11,6,11,17
9902142,9902142,,37,11,3,14
9501043,9501043,,19,8,4,12
9704022,9704022,,11,3,3,6
9712087,9712087,,19,14,5,19
9712132,9712132,,19,16,1,17
9907176,9907176,,11,7,2,9
9910139,9910139,,11,6,7,13
1164,1164,,11,4,12,16
9301013,9301013,,11,12,0,12
9410126,9410126,,11,11,1,12
9504020,9504020,,19,10,2,12
9506085,9506085,,8,17,4,21
1165,1165,,54,6,11,17
9212155,9212155,,25,18,0,18
9809108,9809108,,54,6,3,9
9812024,9812024,,54,5,39,44
9908048,9908048,,2,1,6,7
9601089,9601089,,2,5,16,21
9803066,9803066,,2,8,19,27
9205012,9205012,,54,9,0,9
9511021,9511021,,2,1,8,9
1166,1166,,0,10,17,27
9802107,9802107,,37,10,14,24
9810042,9810042,,37,15,4,19
9901078,9901078,,2,16,15,31
9902010,9902010,,2,6,3,9
1167,1167,,3,37,10,47
1168,1168,,37,8,41,49
9309144,9309144,,62,2,4,6
9309154,9309154,,37,30,4,34
9312212,9312212,,37,15,8,23
9403094,9403094,,62,16,4,20
9405011,9405011,,37,17,9,26
9410228,9410228,,37,4,24,28
9505039,9505039,,37,20,6,26
9510224,9510224,,37,49,24,73
9511125,9511125,,37,9,15,24
9603140,9603140,,37,44,33,77
9604078,9604078,,37,28,28,56
9701014,9701014,,37,49,17,66
9701123,9701123,,37,62,37,99
9707111,9707111,,37,8,5,13
9711156,9711156,,37,21,53,74
9802007,9802007,,37,57,71,128
9902205,9902205,,37,27,39,66
9903087,9903087,,37,7,25,32
9903088,9903088,,37,11,57,68
9906235,9906235,,37,22,41,63
9906240,9906240,,37,15,49,64
9909224,9909224,,37,8,36,44
9912092,9912092,,9,44,8,52
9202073,9202073,,62,5,0,5
9204064,9204064,,62,85,0,85
9208063,9208063,,62,2,1,3
9305091,9305091,,62,1,3,4
9210128,9210128,,37,26,0,26
9201010,9201010,,37,17,0,17
9201011,9201011,,37,21,0,21
9203043,9203043,,37,23,1,24
9208044,9208044,,37,16,1,17
9211066,9211066,,62,21,0,21
9302139,9302139,,62,1,0,1
9305100,9305100,,62,21,2,23
9303101,9303101,,37,13,4,17
9306010,9306010,,62,3,7,10
9312213,9312213,,37,10,2,12
9303026,9303026,,37,4,0,4
9303038,9303038,,65,37,0,37
9305090,9305090,,37,15,0,15
9308060,9308060,,37,22,4,26
9311074,9311074,,62,12,1,13
9311132,9311132,,37,9,0,9
9312031,9312031,,37,2,5,7
9403168,9403168,,37,7,2,9
9407047,9407047,,37,7,7,14
9412170,9412170,,37,7,3,10
9502041,9502041,,7,3,1,4
9312210,9312210,,37,9,10,19
9510165,9510165,,37,2,1,3
9208031,9208031,,25,39,2,41
9211090,9211090,,37,20,0,20
9403190,9403190,,25,15,11,26
9404056,9404056,,25,22,10,32
9405096,9405096,,37,35,10,45
9407018,9407018,,37,61,9,70
9407134,9407134,,37,21,2,23
9502029,9502029,,25,8,22,30
9511052,9511052,,37,36,14,50
9404173,9404173,,62,31,2,33
9503133,9503133,,11,11,5,16
9511070,9511070,,37,9,5,14
9602005,9602005,,37,28,19,47
9309033,9309033,,37,14,4,18
9611158,9611158,,37,6,0,6
9211089,9211089,,25,4,0,4
9505074,9505074,,25,16,21,37
9606063,9606063,,37,18,4,22
9612238,9612238,,37,23,26,49
9701148,9701148,,16,4,11,15
9702138,9702138,,37,11,14,25
9705229,9705229,,37,12,15,27
9403001,9403001,,37,4,0,4
9606071,9606071,,16,8,5,13
9610198,9610198,,65,7,6,13
9701004,9701004,,37,3,2,5
9707120,9707120,,37,38,43,81
9704205,9704205,,37,11,27,38
9709001,9709001,,37,12,27,39
9710248,9710248,,37,16,27,43
9707017,9707017,,37,32,19,51
9710146,9710146,,37,21,32,53
9711108,9711108,,37,47,35,82
9711194,9711194,,37,16,23,39
9712039,9712039,,37,14,22,36
9712062,9712062,,37,30,20,50
9712109,9712109,,37,17,23,40
9712110,9712110,,37,13,79,92
9712177,9712177,,37,15,33,48
9801036,9801036,,37,12,35,47
9603178,9603178,,37,7,8,15
9606144,9606144,,37,8,5,13
9702182,9702182,,37,8,23,31
9801149,9801149,,37,6,29,35
9812078,9812078,,37,19,57,76
9502091,9502091,,37,22,23,45
9810031,9810031,,37,7,10,17
9801061,9801061,,37,29,18,47
9803126,9803126,,37,23,28,51
9805051,9805051,,37,13,78,91
9902030,9902030,,37,9,40,49
9303047,9303047,,37,8,0,8
9410188,9410188,,37,3,0,3
9607213,9607213,,37,1,0,1
9608013,9608013,,37,10,4,14
9610207,9610207,,37,3,5,8
9901089,9901089,,37,17,12,29
9903252,9903252,,37,5,35,40
9904121,9904121,,37,3,31,34
9905010,9905010,,37,3,0,3
9905053,9905053,,37,15,44,59
9905224,9905224,,37,14,69,83
9906027,9906027,,37,6,64,70
9906029,9906029,,37,4,39,43
9604080,9604080,,62,13,9,22
9805098,9805098,,9,8,0,8
9909126,9909126,,9,15,3,18
1169,1169,,2,6,17,23
9712059,9712059,,2,27,22,49
9510216,9510216,,2,8,7,15
9604196,9604196,,11,34,22,56
9608171,9608171,,2,3,7,10
9706094,9706094,,2,9,14,23
9706210,9706210,,65,9,41,50
9709171,9709171,,2,6,20,26
1170,1170,,4,8,31,39
9812225,9812225,,2,10,23,33
9909194,9909194,,4,5,11,16
9912030,9912030,,2,8,24,32
9609192,9609192,,6,24,20,44
9607238,9607238,,2,5,5,10
9609234,9609234,,2,4,18,22
9702044,9702044,,2,1,0,1
1171,1171,,8,1,4,5
9512142,9512142,,8,13,2,15
9605035,9605035,,8,19,2,21
9610191,9610191,,8,41,28,69
9310074,9310074,,7,2,1,3
9401132,9401132,,7,8,0,8
9409023,9409023,,4,12,0,12
9411177,9411177,,8,15,1,16
9502125,9502125,,8,26,3,29
9504087,9504087,,8,2,0,2
9505077,9505077,,8,8,2,10
9508131,9508131,,8,30,1,31
9508136,9508136,,8,24,4,28
9509005,9509005,,8,5,5,10
9510036,9510036,,8,21,6,27
9511158,9511158,,8,14,8,22
9512080,9512080,,8,18,7,25
9604152,9604152,,8,32,11,43
9608179,9608179,,7,6,2,8
9609166,9609166,,6,9,23,32
1172,1172,,62,1,17,18
9206114,9206114,,62,22,0,22
9409108,9409108,,62,17,4,21
9701107,9701107,,62,15,7,22
9712222,9712222,,62,12,8,20
9803104,9803104,,62,11,4,15
9902192,9902192,,62,3,4,7
9909031,9909031,,62,11,13,24
9910102,9910102,,62,13,22,35
9304050,9304050,,62,13,3,16
9304051,9304051,,62,17,2,19
9405087,9405087,,62,12,1,13
9509024,9509024,,62,8,3,11
9311189,9311189,,62,16,3,19
9601135,9601135,,62,20,7,27
9203065,9203065,,62,15,0,15
9503227,9503227,,62,51,8,59
9610003,9610003,,62,8,12,20
9506120,9506120,,62,3,0,3
9706017,9706017,,62,12,13,25
9607115,9607115,,62,6,0,6
9709039,9709039,,11,10,3,13
9212143,9212143,,62,6,4,10
9305134,9305134,,62,2,1,3
9312169,9312169,,62,21,1,22
9411085,9411085,,62,14,10,24
9703026,9703026,,62,6,11,17
9902053,9902053,,62,6,5,11
9902085,9902085,,62,2,2,4
9906114,9906114,,62,5,5,10
9906219,9906219,,62,10,15,25
9909104,9909104,,62,4,13,17
1173,1173,,65,5,13,18
9808023,9808023,,65,5,4,9
9904105,9904105,,65,13,8,21
9908187,9908187,,65,12,8,20
1174,1174,,6,3,5,8
9807191,9807191,,6,8,3,11
9905192,9905192,,6,5,2,7
9206106,9206106,,6,37,0,37
9302122,9302122,,6,14,0,14
9302136,9302136,,6,35,0,35
9503140,9503140,,6,9,1,10
1175,1175,,11,4,9,13
9707185,9707185,,11,25,8,33
9801169,9801169,,11,5,11,16
9802191,9802191,,11,19,5,24
9803177,9803177,,11,16,6,22
9809209,9809209,,11,10,6,16
9811248,9811248,,11,11,10,21
9512141,9512141,,11,2,0,2
9512173,9512173,,37,22,31,53
9608191,9608191,,11,5,7,12
9702035,9702035,,6,14,8,22
9702049,9702049,,11,26,13,39
9702117,9702117,,37,6,1,7
9309065,9309065,,16,8,3,11
9404059,9404059,,16,11,1,12
9408164,9408164,,11,32,2,34
9511119,9511119,,11,7,8,15
9602155,9602155,,11,19,1,20
9609055,9609055,,11,1,2,3
9610056,9610056,,11,2,4,6
9508142,9508142,,16,22,4,26
9710205,9710205,,11,33,4,37
9802066,9802066,,11,7,5,12
9610213,9610213,,11,5,2,7
9611105,9611105,,16,6,13,19
9709115,9709115,,11,3,3,6
9807108,9807108,,37,11,1,12
9602047,9602047,,11,7,2,9
9810088,9810088,,11,8,5,13
9907139,9907139,,11,17,11,28
1176,1176,,31,3,11,14
9501066,9501066,,31,39,7,46
9308023,9308023,,31,18,0,18
9404191,9404191,,31,16,13,29
9407005,9407005,,1,7,39,46
9412074,9412074,,31,10,14,24
9504083,9504083,,31,38,2,40
9507017,9507017,,31,36,9,45
9607146,9607146,,31,6,15,21
9701085,9701085,,31,22,10,32
9407101,9407101,,31,9,1,10
9410136,9410136,,31,33,6,39
9604084,9604084,,31,17,8,25
9608045,9608045,,31,18,6,24
9608136,9608136,,31,14,8,22
9704173,9704173,,31,16,20,36
9503097,9503097,,31,10,2,12
9709022,9709022,,31,13,21,34
9710018,9710018,,31,1,17,18
9710070,9710070,,31,2,9,11
9710188,9710188,,31,25,22,47
9711049,9711049,,31,4,14,18
9408023,9408023,,0,7,0,7
9503149,9503149,,31,15,4,19
9709066,9709066,,34,7,2,9
9905211,9905211,,34,18,18,36
9207054,9207054,,14,4,0,4
9209102,9209102,,14,5,0,5
9705147,9705147,,25,3,7,10
9807241,9807241,,34,3,10,13
9411214,9411214,,25,1,4,5
9407064,9407064,,25,17,2,19
9507139,9507139,,25,7,0,7
9905030,9905030,,34,16,36,52
9905205,9905205,,34,15,13,28
1178,1178,,34,19,17,36
9912007,9912007,,34,39,36,75
9912168,9912168,,34,26,11,37
9710127,9710127,,2,24,24,48
9709118,9709118,,2,19,37,56
9712082,9712082,,2,11,28,39
9705033,9705033,,62,1,1,2
9902038,9902038,,37,3,19,22
9910150,9910150,,34,36,23,59
1179,1179,,34,6,14,20
9905175,9905175,,31,20,21,41
9912073,9912073,,34,9,40,49
9610045,9610045,,2,20,25,45
9510123,9510123,,25,3,3,6
9704172,9704172,,2,9,22,31
9805014,9805014,,34,29,29,58
9305025,9305025,,31,52,3,55
9602096,9602096,,31,21,4,25
9605173,9605173,,31,37,12,49
9605176,9605176,,31,36,15,51
9607126,9607126,,31,26,17,43
9701035,9701035,,31,6,10,16
9704175,9704175,,31,3,12,15
9705061,9705061,,31,7,15,22
9805060,9805060,,11,2,1,3
9806111,9806111,,25,2,3,5
9908044,9908044,,7,45,19,64
9909082,9909082,,34,15,22,37
9910117,9910117,,34,20,26,46
9911160,9911160,,34,8,16,24
1180,1180,,1,13,14,27
9405026,9405026,,1,23,8,31
9410219,9410219,,1,18,3,21
9803038,9803038,,1,11,10,21
9805173,9805173,,1,6,5,11
9304068,9304068,,34,30,4,34
9308152,9308152,,1,4,0,4
9309016,9309016,,1,22,0,22
9310073,9310073,,1,19,2,21
9311085,9311085,,1,14,1,15
9406029,9406029,,1,15,5,20
9408065,9408065,,62,16,5,21
9509125,9509125,,1,8,1,9
9604048,9604048,,1,5,1,6
9501101,9501101,,1,20,8,28
1182,1182,,3,42,7,49
1183,1183,,0,23,20,43
9302120,9302120,,1,11,5,16
9304048,9304048,,31,11,2,13
9406028,9406028,,25,6,9,15
9506059,9506059,,25,6,8,14
9903045,9903045,,8,9,13,22
9210055,9210055,,25,2,0,2
9212120,9212120,,25,3,1,4
9301105,9301105,,25,2,0,2
9303140,9303140,,25,6,4,10
9305003,9305003,,25,5,9,14
9305030,9305030,,25,8,4,12
9311005,9311005,,25,4,3,7
9806227,9806227,,54,8,8,16
9304133,9304133,,65,16,0,16
9309106,9309106,,8,45,0,45
9503162,9503162,,8,23,13,36
9810134,9810134,,31,1,15,16
9708078,9708078,,2,9,21,30
9712112,9712112,,2,1,12,13
1184,1184,,37,19,23,42
9506147,9506147,,34,11,8,19
9605066,9605066,,34,3,3,6
9801082,9801082,,37,6,2,8
9802185,9802185,,37,36,33,69
9805172,9805172,,37,44,57,101
9807218,9807218,,37,10,4,14
9901006,9901006,,37,19,16,35
9906198,9906198,,11,14,9,23
9506050,9506050,,34,2,0,2
9505088,9505088,,37,46,19,65
9503186,9503186,,37,34,4,38
9508002,9508002,,37,36,11,47
9507082,9507082,,34,1,0,1
9605178,9605178,,37,15,4,19
9707197,9707197,,37,2,17,19
9203023,9203023,,34,9,0,9
9612240,9612240,,37,8,32,40
9712054,9712054,,37,6,30,36
9608054,9608054,,37,52,34,86
9608135,9608135,,37,30,8,38
9701170,9701170,,37,21,24,45
9801159,9801159,,37,8,25,33
9803217,9803217,,37,15,25,40
9804029,9804029,,37,6,27,33
9804038,9804038,,37,9,43,52
9804086,9804086,,37,3,52,55
9804104,9804104,,37,14,11,25
9804105,9804105,,37,19,62,81
9804151,9804151,,37,20,56,76
9804197,9804197,,6,5,2,7
9404140,9404140,,11,46,0,46
9406208,9406208,,11,33,0,33
9505070,9505070,,11,45,6,51
1185,1185,,62,6,27,33
9202028,9202028,,62,5,0,5
9307166,9307166,,8,3,7,10
9405197,9405197,,62,7,6,13
9412154,9412154,,62,17,12,29
9512104,9512104,,62,4,1,5
9201006,9201006,,62,5,0,5
9206041,9206041,,62,14,0,14
9207073,9207073,,62,14,1,15
9211034,9211034,,62,40,3,43
9211018,9211018,,62,1,0,1
9301086,9301086,,62,17,1,18
9301131,9301131,,62,3,1,4
9305114,9305114,,62,30,9,39
9311116,9311116,,62,4,4,8
9312043,9312043,,62,18,7,25
9403073,9403073,,62,37,12,49
9411203,9411203,,62,6,7,13
9505022,9505022,,62,7,12,19
9507057,9507057,,65,13,4,17
9501028,9501028,,62,8,5,13
1186,1186,,37,1,12,13
9909155,9909155,,37,1,6,7
9609183,9609183,,37,7,10,17
9704067,9704067,,37,15,35,50
9706074,9706074,,37,5,6,11
9709137,9709137,,0,27,7,34
9804068,9804068,,37,14,19,33
9805144,9805144,,37,3,7,10
9812128,9812128,,37,4,6,10
9903155,9903155,,37,2,9,11
1187,1187,,11,0,3,3
9812245,9812245,,11,4,3,7
9906026,9906026,,11,2,1,3
9908123,9908123,,11,3,4,7
9704176,9704176,,6,14,4,18
9810089,9810089,,11,14,14,28
9603006,9603006,,37,4,3,7
9604063,9604063,,16,14,7,21
1188,1188,,16,14,16,30
1189,1189,,2,6,16,22
9805080,9805080,,2,9,13,22
9908096,9908096,,2,31,17,48
9701119,9701119,,2,20,2,22
9701169,9701169,,2,16,20,36
9709132,9709132,,2,16,5,21
9709217,9709217,,2,11,1,12
9711033,9711033,,2,9,1,10
9711169,9711169,,2,5,8,13
9305120,9305120,,16,11,0,11
9805046,9805046,,2,10,11,21
9806152,9806152,,2,4,2,6
9706029,9706029,,19,1,2,3
9711032,9711032,,0,17,12,29
9805183,9805183,,2,17,1,18
9901154,9901154,,2,16,2,18
9902186,9902186,,2,11,5,16
9909028,9909028,,2,13,14,27
1190,1190,,54,7,25,32
9410152,9410152,,54,18,7,25
9712129,9712129,,54,3,3,6
9802090,9802090,,54,9,17,26
9909087,9909087,,54,2,19,21
9205097,9205097,,54,1,0,1
9302003,9302003,,54,16,0,16
9701009,9701009,,37,20,20,40
9703118,9703118,,2,7,35,42
1191,1191,,65,1,2,3
9901119,9901119,,25,11,17,28
9912028,9912028,,34,8,14,22
9912032,9912032,,34,4,8,12
9706066,9706066,,25,19,13,32
9709224,9709224,,25,26,4,30
9801180,9801180,,25,15,23,38
9806055,9806055,,25,16,24,40
9807123,9807123,,25,24,13,37
9811092,9811092,,25,20,23,43
9410050,9410050,,0,16,2,18
9902080,9902080,,54,11,47,58
9907051,9907051,,34,9,7,16
9505061,9505061,,25,57,11,68
9810104,9810104,,11,20,21,41
9906052,9906052,,16,8,15,23
9909152,9909152,,16,4,16,20
9910256,9910256,,34,7,31,38
9510111,9510111,,6,14,0,14
9602156,9602156,,11,47,13,60
9607188,9607188,,11,19,0,19
9709100,9709100,,11,16,38,54
9710145,9710145,,11,13,8,21
9711070,9711070,,11,7,1,8
9802039,9802039,,11,28,18,46
9809004,9809004,,11,16,24,40
9809023,9809023,,11,8,2,10
9312118,9312118,,16,29,3,32
9312175,9312175,,16,16,3,19
9406207,9406207,,16,25,11,36
9703115,9703115,,37,2,12,14
9908203,9908203,,16,2,10,12
9409101,9409101,,16,6,7,13
9908113,9908113,,34,2,9,11
9910058,9910058,,11,30,24,54
1194,1194,,2,0,17,17
9809065,9809065,,2,24,21,45
9910160,9910160,,7,10,29,39
9705047,9705047,,2,7,6,13
9902040,9902040,,34,45,19,64
9907101,9907101,,2,6,31,37
9907191,9907191,,7,28,8,36
9506105,9506105,,7,14,1,15
9607203,9607203,,7,6,12,18
9612173,9612173,,7,3,6,9
9705219,9705219,,7,16,13,29
9807194,9807194,,7,2,3,5
9811011,9811011,,37,3,1,4
9905070,9905070,,7,6,7,13
9907224,9907224,,7,11,21,32
9910022,9910022,,7,13,15,28
9910028,9910028,,7,10,12,22
9910033,9910033,,37,14,12,26
9910067,9910067,,1,9,32,41
1195,1195,,34,5,2,7
9803207,9803207,,34,9,1,10
9611022,9611022,,34,1,0,1
1196,1196,,7,1,4,5
9406083,9406083,,7,6,0,6
9408002,9408002,,7,9,0,9
9909169,9909169,,7,3,2,5
9911032,9911032,,7,2,5,7
9910085,9910085,,7,2,6,8
1197,1197,,0,142,15,157
1198,1198,,65,7,27,34
9211092,9211092,,2,1,2,3
9212085,9212085,,2,16,1,17
9402156,9402156,,25,20,11,31
9406179,9406179,,2,5,2,7
9210122,9210122,,65,4,0,4
1199,1199,,65,22,11,33
9404184,9404184,,65,13,3,16
9605111,9605111,,1,2,8,10
9904124,9904124,,2,20,9,29
1200,1200,,37,26,40,66
9908166,9908166,,4,2,18,20
9909089,9909089,,4,39,10,49
9403192,9403192,,2,22,8,30
9402148,9402148,,54,12,11,23
9607157,9607157,,54,5,30,35
9607131,9607131,,54,6,10,16
9703131,9703131,,19,5,1,6
9803197,9803197,,37,10,33,43
9803192,9803192,,37,5,19,24
9806012,9806012,,54,4,16,20
9806177,9806177,,37,12,42,54
1201,1201,,4,57,24,81
9909154,9909154,,2,25,10,35
9909187,9909187,,2,10,12,22
9910052,9910052,,2,84,62,146
9910053,9910053,,2,331,98,429
9211116,9211116,,19,2,0,2
9212057,9212057,,8,9,3,12
9408064,9408064,,65,2,0,2
9803003,9803003,,2,11,13,24
9712026,9712026,,2,9,37,46
9712160,9712160,,2,10,25,35
9907029,9907029,,2,10,34,44
9711012,9711012,,2,10,26,36
9711081,9711081,,2,28,24,52
9804065,9804065,,2,7,19,26
9806176,9806176,,2,7,9,16
9809088,9809088,,2,2,22,24
9811134,9811134,,2,7,26,33
9812095,9812095,,2,4,14,18
9904019,9904019,,2,11,43,54
9904117,9904117,,2,5,40,45
9907132,9907132,,2,15,7,22
1202,1202,,9,8,11,19
9912093,9912093,,9,12,9,21
9912290,9912290,,9,5,12,17
9509091,9509091,,9,4,0,4
9610128,9610128,,9,12,4,16
9612013,9612013,,9,8,13,21
9805025,9805025,,9,3,6,9
9807125,9807125,,9,2,10,12
1203,1203,,3,97,5,102
9707040,9707040,,25,4,1,5
1204,1204,,1,33,21,54
9906056,9906056,,34,9,18,27
9911123,9911123,,34,20,26,46
9506033,9506033,,2,2,2,4
9506095,9506095,,16,5,4,9
9402106,9402106,,1,7,4,11
9810136,9810136,,2,7,33,40
9702178,9702178,,25,17,0,17
9903231,9903231,,34,4,18,22
9805150,9805150,,0,21,4,25
9809133,9809133,,34,9,23,32
9906073,9906073,,34,7,15,22
1205,1205,,2,12,21,33
9911246,9911246,,2,2,44,46
9607092,9607092,,54,14,26,40
9801043,9801043,,37,3,6,9
9710126,9710126,,2,3,9,12
9712205,9712205,,2,6,14,20
9710001,9710001,,37,17,14,31
9712010,9712010,,37,15,7,22
9803139,9803139,,37,10,16,26
9710105,9710105,,37,25,35,60
9801146,9801146,,37,15,18,33
9808178,9808178,,37,3,16,19
9801083,9801083,,37,4,17,21
9806139,9806139,,2,6,20,26
9909075,9909075,,2,2,16,18
1206,1206,,0,149,26,175
9912058,9912058,,34,14,16,30
9902032,9902032,,2,20,33,53
9907007,9907007,,4,5,17,22
1207,1207,,0,2,5,7
9512137,9512137,,2,2,11,13
1208,1208,,54,2,16,18
9703003,9703003,,54,12,22,34
9502114,9502114,,25,8,4,12
9503003,9503003,,7,3,0,3
9503150,9503150,,54,4,4,8
9511058,9511058,,54,18,23,41
9601050,9601050,,54,4,18,22
9410177,9410177,,54,2,0,2
9410184,9410184,,54,5,4,9
9412226,9412226,,37,5,2,7
9504114,9504114,,54,7,10,17
9504115,9504115,,54,6,16,22
9508021,9508021,,2,29,12,41
9605047,9605047,,54,3,25,28
9610165,9610165,,54,1,1,2
9512204,9512204,,54,11,12,23
9701150,9701150,,37,8,5,13
9601147,9601147,,11,4,0,4
1209,1209,,0,20,17,37
9901081,9901081,,0,1,0,1
1210,1210,,9,3,3,6
9505166,9505166,,9,12,0,12
9706056,9706056,,9,8,2,10
9810246,9810246,,9,3,0,3
9602024,9602024,,9,9,0,9
1211,1211,,0,10,18,28
2076,2076,,0,25,20,45
4101,4101,,0,27,21,48
9136,9136,,0,3,10,13
9801152,9801152,,2,7,27,34
9912288,9912288,,3,7,30,37
2040,2040,,0,26,49,75
2091,2091,,0,186,20,206
2072,2072,,0,108,3,111
3300,3300,,0,48,5,53
4014,4014,,0,73,12,85
3118,3118,,0,35,9,44
9906038,9906038,,34,15,3,18
9209070,9209070,,2,17,1,18
9510127,9510127,,25,4,4,8
9603044,9603044,,25,5,8,13
9702075,9702075,,2,4,19,23
9704199,9704199,,2,6,18,24
9607001,9607001,,2,5,13,18
9610031,9610031,,2,2,19,21
9704050,9704050,,8,2,10,12
9801151,9801151,,6,8,25,33
4011,4011,,3,17,25,42
9907024,9907024,,34,3,19,22
9908092,9908092,,34,1,26,27
9910083,9910083,,3,3,10,13
9910092,9910092,,3,23,45,68
9911031,9911031,,3,3,13,16
9911057,9911057,,3,27,29,56
9911183,9911183,,3,4,25,29
9911193,9911193,,3,6,24,30
1212,1212,,54,17,63,80
9805141,9805141,,37,29,44,73
9908016,9908016,,54,2,25,27
9908130,9908130,,54,56,42,98
9910087,9910087,,54,1,44,45
9911021,9911021,,54,19,29,48
9912204,9912204,,54,61,39,100
9702031,9702031,,54,4,14,18
9611119,9611119,,54,12,26,38
9605221,9605221,,54,16,4,20
9607137,9607137,,54,7,2,9
9607138,9607138,,54,11,6,17
9609027,9609027,,54,8,13,21
9610106,9610106,,54,8,22,30
9701057,9701057,,54,9,11,20
9604113,9604113,,6,3,5,8
9801207,9801207,,37,10,71,81
9802005,9802005,,2,4,33,37
9607172,9607172,,54,18,1,19
9610139,9610139,,37,28,27,55
9707198,9707198,,54,5,28,33
9808087,9808087,,37,5,25,30
9902070,9902070,,0,13,6,19
9703075,9703075,,54,29,9,38
9812042,9812042,,54,10,36,46
9908017,9908017,,54,2,23,25
9710245,9710245,,2,5,12,17
9501036,9501036,,37,3,7,10
9910143,9910143,,54,12,28,40
9911190,9911190,,54,22,12,34
1213,1213,,3,20,53,73
9906232,9906232,,2,3,15,18
9908010,9908010,,34,6,24,30
9910019,9910019,,3,19,25,44
9912100,9912100,,3,1,17,18
9912140,9912140,,3,37,24,61
9912165,9912165,,3,26,30,56
9212030,9212030,,2,50,0,50
9410051,9410051,,2,1,10,11
9512061,9512061,,2,18,14,32
9612144,9612144,,2,14,9,23
9610171,9610171,,2,19,20,39
9508045,9508045,,2,18,13,31
9610021,9610021,,8,12,1,13
9703077,9703077,,2,15,12,27
9704194,9704194,,8,13,7,20
9708116,9708116,,2,13,12,25
9802080,9802080,,2,12,9,21
9802186,9802186,,2,8,17,25
9811207,9811207,,2,7,16,23
9903038,9903038,,2,20,23,43
9903023,9903023,,34,7,27,34
9402004,9402004,,25,22,4,26
9406209,9406209,,25,6,8,14
9706046,9706046,,2,3,37,40
9905067,9905067,,34,1,18,19
9907003,9907003,,34,19,11,30
9908148,9908148,,34,9,32,41
9909049,9909049,,2,7,42,49
9909102,9909102,,2,4,29,33
9706153,9706153,,2,12,39,51
9910126,9910126,,3,12,35,47
9910194,9910194,,3,19,28,47
9702176,9702176,,4,1,1,2
9705194,9705194,,2,6,14,20
9907021,9907021,,1,3,16,19
9906147,9906147,,34,6,8,14
1214,1214,,2,4,13,17
9708001,9708001,,2,12,13,25
9712068,9712068,,2,12,14,26
9809113,9809113,,2,9,5,14
9811143,9811143,,2,6,9,15
9903234,9903234,,2,7,23,30
9909143,9909143,,2,6,10,16
9212037,9212037,,2,6,1,7
9705062,9705062,,1,1,4,5
9708093,9708093,,2,3,17,20
9703104,9703104,,2,7,6,13
9810203,9810203,,2,5,18,23
9706185,9706185,,2,6,16,22
9612220,9612220,,2,3,4,7
1215,1215,,3,57,16,73
9912153,9912153,,3,37,16,53
9912158,9912158,,8,10,14,24
9212141,9212141,,7,13,1,14
9302090,9302090,,7,23,0,23
9402070,9402070,,7,8,6,14
9510210,9510210,,16,21,7,28
9608137,9608137,,2,18,12,30
9804032,9804032,,8,8,8,16
9709019,9709019,,8,16,15,31
9808164,9808164,,8,4,4,8
9811140,9811140,,8,10,24,34
9812229,9812229,,8,10,24,34
9903027,9903027,,8,5,10,15
9912183,9912183,,8,10,17,27
1216,1216,,2,18,31,49
9912051,9912051,,2,1,11,12
9912076,9912076,,1,10,21,31
9912222,9912222,,2,13,16,29
9912264,9912264,,2,4,10,14
9912292,9912292,,2,1,16,17
9808031,9808031,,11,6,2,8
9710066,9710066,,2,11,23,34
9904063,9904063,,2,32,37,69
9906223,9906223,,2,14,23,37
9907113,9907113,,1,15,24,39
1217,1217,,54,7,8,15
9812061,9812061,,54,2,115,117
9405031,9405031,,54,4,3,7
9405188,9405188,,54,26,12,38
9405198,9405198,,54,3,4,7
9512143,9512143,,54,30,2,32
9609016,9609016,,54,16,4,20
1218,1218,,3,5,10,15
9605018,9605018,,6,30,14,44
9610090,9610090,,6,5,6,11
9704034,9704034,,6,9,4,13
1219,1219,,37,0,13,13
9603206,9603206,,37,25,15,40
9801157,9801157,,37,14,19,33
9803146,9803146,,37,9,22,31
9808114,9808114,,37,2,22,24
9506139,9506139,,37,31,15,46
9506196,9506196,,37,23,15,38
9509165,9509165,,37,3,5,8
9407185,9407185,,37,13,0,13
9607200,9607200,,37,21,13,34
9609021,9609021,,37,19,10,29
9609230,9609230,,37,4,12,16
9610211,9610211,,37,7,15,22
9611049,9611049,,37,14,8,22
9611088,9611088,,37,16,21,37
9702059,9702059,,37,7,20,27
9703197,9703197,,37,28,8,36
9512024,9512024,,37,7,8,15
9705152,9705152,,37,5,9,14
9707260,9707260,,37,8,17,25
9708087,9708087,,19,6,2,8
9708113,9708113,,37,7,16,23
9709177,9709177,,37,8,7,15
9711166,9711166,,37,12,11,23
9801097,9801097,,37,3,8,11
9804097,9804097,,37,5,27,32
1220,1220,,6,0,1,1
9205092,9205092,,6,15,0,15
1221,1221,,19,1,8,9
9209005,9209005,,19,27,0,27
9210149,9210149,,19,8,0,8
9405055,9405055,,19,1,4,5
9607233,9607233,,19,12,16,28
9703121,9703121,,19,7,18,25
9705198,9705198,,19,2,0,2
9810106,9810106,,19,4,1,5
9904139,9904139,,19,4,3,7
9309123,9309123,,19,8,2,10
9201058,9201058,,11,19,0,19
9206007,9206007,,19,66,0,66
9308045,9308045,,19,34,0,34
9402096,9402096,,19,27,1,28
9410064,9410064,,19,15,1,16
9505146,9505146,,19,7,1,8
9508113,9508113,,19,9,5,14
9509109,9509109,,19,2,1,3
9601080,9601080,,37,9,4,13
9604087,9604087,,19,3,4,7
9605194,9605194,,19,4,6,10
9606149,9606149,,19,6,5,11
9607208,9607208,,19,6,4,10
9611180,9611180,,19,5,9,14
1222,1222,,62,5,9,14
9210060,9210060,,62,8,0,8
9508175,9508175,,62,7,3,10
9603190,9603190,,62,4,10,14
9608190,9608190,,62,6,9,15
9711140,9711140,,62,7,6,13
9902008,9902008,,62,12,6,18
9207025,9207025,,62,5,0,5
9304141,9304141,,62,73,1,74
9309142,9309142,,62,47,2,49
9310188,9310188,,62,59,1,60
9407148,9407148,,62,27,9,36
9402084,9402084,,62,7,0,7
9409141,9409141,,62,4,1,5
9409142,9409142,,37,6,5,11
9205045,9205045,,62,5,0,5
9207018,9207018,,62,5,0,5
9207102,9207102,,8,35,0,35
9302134,9302134,,62,3,3,6
9407069,9407069,,62,2,12,14
9510226,9510226,,62,2,0,2
9706006,9706006,,7,1,1,2
9501079,9501079,,62,2,1,3
2001,2001,,2,1,4,5
9808064,9808064,,2,1,1,2
2002,2002,,2,3,27,30
9907095,9907095,,2,2,32,34
9907144,9907144,,2,14,26,40
9909088,9909088,,2,6,36,42
9910111,9910111,,34,5,16,21
9302080,9302080,,25,33,3,36
9407008,9407008,,25,18,6,24
9411219,9411219,,34,14,0,14
9510180,9510180,,2,10,1,11
9508090,9508090,,25,3,13,16
9508151,9508151,,25,9,13,22
9512148,9512148,,25,5,9,14
9507041,9507041,,25,5,11,16
9705215,9705215,,25,3,8,11
9506071,9506071,,4,20,18,38
9601171,9601171,,2,10,18,28
9602145,9602145,,2,6,27,33
9609152,9609152,,2,9,26,35
9203069,9203069,,8,18,0,18
9712061,9712061,,2,17,12,29
9902189,9902189,,2,3,4,7
9708109,9708109,,2,12,15,27
9802151,9802151,,37,3,55,58
9903213,9903213,,2,21,43,64
9903110,9903110,,54,6,62,68
2003,2003,,11,1,10,11
9802105,9802105,,11,8,1,9
9804004,9804004,,11,6,2,8
9805094,9805094,,11,9,5,14
9806084,9806084,,11,7,7,14
9809149,9809149,,11,5,6,11
9902141,9902141,,11,11,8,19
9903168,9903168,,11,2,8,10
9301098,9301098,,8,14,0,14
9410147,9410147,,8,6,6,12
9606066,9606066,,62,15,17,32
9607017,9607017,,62,4,5,9
9707169,9707169,,7,3,3,6
9802131,9802131,,3,2,1,3
9202026,9202026,,6,6,0,6
9207039,9207039,,6,8,0,8
9509022,9509022,,16,6,7,13
9404057,9404057,,7,1,2,3
9902161,9902161,,37,9,31,40
2004,2004,,54,10,26,36
9404186,9404186,,54,6,5,11
9203066,9203066,,4,10,0,10
9311143,9311143,,54,7,3,10
9405086,9405086,,54,6,13,19
9707149,9707149,,54,20,15,35
9810168,9810168,,54,4,8,12
2006,2006,,2,2,15,17
9904174,9904174,,2,4,7,11
9202004,9202004,,25,44,0,44
9211030,9211030,,25,39,6,45
9305115,9305115,,37,14,0,14
9306001,9306001,,2,3,2,5
2007,2007,,7,15,19,34
9202036,9202036,,37,17,0,17
9307013,9307013,,62,19,0,19
9503063,9503063,,62,3,5,8
9602108,9602108,,2,19,5,24
9908202,9908202,,7,6,6,12
9911001,9911001,,7,21,16,37
9911066,9911066,,7,25,21,46
9203070,9203070,,2,25,0,25
9401003,9401003,,2,16,0,16
9505119,9505119,,2,3,3,6
9502126,9502126,,65,18,8,26
9511166,9511166,,7,7,8,15
9502009,9502009,,37,29,2,31
9706124,9706124,,37,19,13,32
9903267,9903267,,2,5,17,22
9806191,9806191,,2,11,19,30
9702067,9702067,,2,15,9,24
9907046,9907046,,2,3,18,21
9205061,9205061,,7,3,0,3
9812066,9812066,,1,8,26,34
9810204,9810204,,2,31,10,41
2008,2008,,1,11,34,45
9908114,9908114,,1,20,25,45
9912284,9912284,,1,12,15,27
9603031,9603031,,2,20,3,23
9509052,9509052,,2,15,17,32
9704093,9704093,,2,21,12,33
9512071,9512071,,7,3,0,3
9503210,9503210,,2,2,4,6
9610091,9610091,,2,3,9,12
9407152,9407152,,8,3,5,8
9202032,9202032,,8,7,0,7
9307037,9307037,,8,7,3,10
9408109,9408109,,8,12,2,14
9611083,9611083,,8,7,6,13
9506125,9506125,,2,22,4,26
9705048,9705048,,1,5,0,5
9707066,9707066,,34,5,0,5
9802097,9802097,,34,6,2,8
9812194,9812194,,34,9,41,50
9710191,9710191,,2,14,12,26
9911068,9911068,,2,39,65,104
9202018,9202018,,16,12,1,13
9506072,9506072,,16,5,1,6
9508128,9508128,,16,1,3,4
9405004,9405004,,25,13,10,23
9407141,9407141,,25,9,13,22
9604184,9604184,,16,1,0,1
9612096,9612096,,37,9,37,46
9705005,9705005,,2,15,4,19
9807092,9807092,,16,11,6,17
9301111,9301111,,2,31,0,31
9602020,9602020,,2,9,2,11
9609114,9609114,,2,9,1,10
9706027,9706027,,2,12,8,20
9711034,9711034,,2,5,9,14
2010,2010,,2,6,6,12
9401039,9401039,,2,7,2,9
9504025,9504025,,2,16,2,18
9510151,9510151,,2,12,0,12
9610023,9610023,,2,5,3,8
9806038,9806038,,2,9,3,12
9203067,9203067,,2,6,1,7
9210011,9210011,,16,23,0,23
9411091,9411091,,25,9,1,10
9407119,9407119,,2,4,2,6
2011,2011,,2,10,43,53
9210164,9210164,,2,1,0,1
9301033,9301033,,54,4,4,8
9308151,9308151,,2,21,0,21
9505106,9505106,,2,7,4,11
9506210,9506210,,4,7,6,13
9503072,9503072,,8,17,0,17
9211059,9211059,,8,44,1,45
2012,2012,,54,5,28,33
9807170,9807170,,54,2,17,19
9605020,9605020,,65,2,3,5
2013,2013,,37,1,4,5
9612066,9612066,,54,12,10,22
2014,2014,,11,0,7,7
9707067,9707067,,11,1,2,3
9804142,9804142,,11,7,7,14
9811071,9811071,,11,4,3,7
9904160,9904160,,11,4,4,8
9409182,9409182,,11,2,0,2
9610030,9610030,,11,5,5,10
9609168,9609168,,11,2,0,2
9612211,9612211,,11,1,1,2
9301101,9301101,,11,2,0,2
9710084,9710084,,11,1,8,9
9803125,9803125,,11,2,3,5
2015,2015,,7,4,4,8
9507132,9507132,,7,9,0,9
9910254,9910254,,7,5,3,8
9904038,9904038,,7,2,2,4
2016,2016,,2,52,104,156
9709044,9709044,,2,7,16,23
9802187,9802187,,2,12,15,27
9803191,9803191,,2,4,41,45
9804067,9804067,,2,6,17,23
9807182,9807182,,2,7,7,14
9809103,9809103,,2,26,38,64
9811037,9811037,,2,16,10,26
9910001,9910001,,2,15,47,62
9205099,9205099,,2,5,1,6
9210061,9210061,,2,4,1,5
9311129,9311129,,25,8,2,10
9705225,9705225,,2,22,25,47
9706002,9706002,,2,8,6,14
9708007,9708007,,0,7,7,14
9612083,9612083,,16,20,17,37
9702048,9702048,,2,3,1,4
9704171,9704171,,16,15,3,18
9707141,9707141,,16,3,3,6
9702169,9702169,,2,8,1,9
9710032,9710032,,2,12,12,24
9710057,9710057,,2,5,24,29
9710192,9710192,,2,8,19,27
9711010,9711010,,2,8,36,44
9806109,9806109,,2,15,15,30
9806166,9806166,,2,8,6,14
9807071,9807071,,2,5,34,39
9309134,9309134,,2,12,0,12
9707261,9707261,,2,7,32,39
9802173,9802173,,2,11,20,31
9707199,9707199,,19,29,6,35
9704135,9704135,,2,7,5,12
9811165,9811165,,2,5,13,18
9901158,9901158,,2,4,23,27
9609216,9609216,,16,4,8,12
9612130,9612130,,2,7,11,18
9709225,9709225,,2,19,17,36
9801053,9801053,,2,14,23,37
9805115,9805115,,2,7,7,14
9806214,9806214,,2,17,25,42
2017,2017,,2,0,8,8
9702021,9702021,,2,2,1,3
9806048,9806048,,2,1,3,4
2019,2019,,14,2,7,9
9902090,9902090,,14,2,3,5
9909226,9909226,,14,9,5,14
9912259,9912259,,34,11,4,15
9502024,9502024,,11,10,3,13
9205022,9205022,,14,2,0,2
9812083,9812083,,19,1,4,5
9505037,9505037,,34,10,1,11
9909111,9909111,,34,2,3,5
2020,2020,,3,16,14,30
9504104,9504104,,4,5,4,9
2021,2021,,2,7,34,41
9210045,9210045,,11,20,0,20
9501052,9501052,,11,13,0,13
9501097,9501097,,11,5,0,5
9502116,9502116,,11,4,2,6
9505160,9505160,,11,5,3,8
9806231,9806231,,16,10,7,17
9812190,9812190,,16,7,30,37
9904125,9904125,,11,3,9,12
9905198,9905198,,2,3,16,19
9907146,9907146,,2,2,17,19
9301102,9301102,,11,27,0,27
9306073,9306073,,6,8,1,9
9401105,9401105,,6,43,3,46
9406154,9406154,,6,16,2,18
9407078,9407078,,6,39,3,42
9501065,9501065,,54,33,6,39
9603181,9603181,,54,14,5,19
9203026,9203026,,16,19,0,19
9312096,9312096,,37,3,0,3
9401103,9401103,,65,2,1,3
9405035,9405035,,37,23,1,24
9601044,9601044,,54,6,12,18
9610229,9610229,,25,3,12,15
9711074,9711074,,37,3,13,16
9605105,9605105,,1,5,8,13
9609082,9609082,,54,5,35,40
9609084,9609084,,2,18,50,68
9711026,9711026,,2,1,0,1
9712150,9712150,,2,5,57,62
9205043,9205043,,11,26,0,26
9601030,9601030,,11,11,2,13
9612103,9612103,,11,34,5,39
9712008,9712008,,11,13,5,18
9311015,9311015,,16,47,6,53
9509020,9509020,,16,24,11,35
9512106,9512106,,16,11,5,16
9803035,9803035,,16,3,2,5
9803204,9803204,,16,5,14,19
9804024,9804024,,16,3,4,7
9212009,9212009,,16,52,0,52
9302097,9302097,,6,2,0,2
9306075,9306075,,62,14,1,15
9309128,9309128,,16,26,0,26
9311065,9311065,,16,13,0,13
9311108,9311108,,16,10,2,12
9402092,9402092,,16,14,1,15
9403038,9403038,,16,27,3,30
9406094,9406094,,16,18,0,18
9409019,9409019,,16,38,2,40
9502102,9502102,,16,9,1,10
9503002,9503002,,16,32,30,62
9506058,9506058,,16,3,12,15
9512179,9512179,,16,14,13,27
9512208,9512208,,16,3,5,8
9602006,9602006,,16,14,7,21
9602175,9602175,,16,10,5,15
9604018,9604018,,16,4,13,17
9608043,9608043,,16,9,7,16
9610173,9610173,,16,1,1,2
9704064,9704064,,16,17,18,35
9704162,9704162,,16,4,3,7
9705159,9705159,,16,11,7,18
9709165,9709165,,16,4,5,9
9509053,9509053,,11,2,3,5
9611096,9611096,,11,3,1,4
9610065,9610065,,37,4,10,14
9708129,9708129,,2,12,7,19
2022,2022,,6,4,2,6
9412177,9412177,,6,3,1,4
9712229,9712229,,6,3,0,3
9408032,9408032,,6,4,0,4
2023,2023,,4,45,11,56
2024,2024,,34,2,4,6
9805174,9805174,,34,3,4,7
9810228,9810228,,34,6,4,10
9812005,9812005,,34,11,7,18
9302046,9302046,,6,26,1,27
9504061,9504061,,1,6,4,10
9708150,9708150,,34,8,1,9
9408073,9408073,,34,14,2,16
9809142,9809142,,34,4,6,10
9811030,9811030,,34,5,3,8
2025,2025,,34,6,14,20
9602054,9602054,,34,5,6,11
9305012,9305012,,62,6,0,6
9305131,9305131,,34,15,1,16
9404150,9404150,,34,6,0,6
9306107,9306107,,34,11,0,11
9308073,9308073,,62,8,0,8
9506116,9506116,,34,13,6,19
9808067,9808067,,11,2,5,7
2026,2026,,6,3,8,11
9504015,9504015,,37,11,1,12
9801107,9801107,,6,3,7,10
9209072,9209072,,8,6,0,6
9408028,9408028,,6,8,1,9
2027,2027,,4,21,9,30
9209048,9209048,,4,3,0,3
9808049,9808049,,2,7,21,28
9911138,9911138,,2,12,19,31
9912066,9912066,,2,7,16,23
9912077,9912077,,6,11,10,21
2028,2028,,34,18,32,50
9306095,9306095,,2,4,1,5
9206028,9206028,,34,10,0,10
9810041,9810041,,34,11,7,18
2029,2029,,2,5,47,52
9510152,9510152,,62,3,4,7
9606090,9606090,,8,4,8,12
9706148,9706148,,2,19,19,38
9901027,9901027,,2,2,14,16
9901104,9901104,,2,7,14,21
9907109,9907109,,2,10,10,20
9912206,9912206,,54,10,42,52
9301024,9301024,,62,17,0,17
9510033,9510033,,62,13,4,17
9203080,9203080,,8,13,0,13
9207042,9207042,,8,39,0,39
9404125,9404125,,8,5,7,12
9407147,9407147,,37,7,1,8
9703012,9703012,,2,17,10,27
9704040,9704040,,8,9,34,43
9707215,9707215,,2,21,22,43
9602011,9602011,,2,12,4,16
9710141,9710141,,2,20,22,42
9802009,9802009,,2,4,24,28
9807195,9807195,,2,2,26,28
9803188,9803188,,2,27,22,49
9810025,9810025,,2,23,9,32
9809109,9809109,,34,12,12,24
9904022,9904022,,2,1,1,2
9908147,9908147,,54,1,32,33
9911156,9911156,,54,5,32,37
9912108,9912108,,54,17,20,37
2030,2030,,1,4,34,38
9903157,9903157,,34,1,35,36
9905118,9905118,,34,9,34,43
9907022,9907022,,34,20,31,51
9612248,9612248,,2,13,32,45
9702086,9702086,,2,10,42,52
9709005,9709005,,2,9,6,15
9710030,9710030,,2,11,19,30
9802152,9802152,,2,9,15,24
9801158,9801158,,2,9,19,28
9807050,9807050,,2,5,30,35
2031,2031,,34,1,13,14
9910082,9910082,,34,18,22,40
9802041,9802041,,31,5,34,39
9904005,9904005,,54,8,19,27
9907030,9907030,,2,19,11,30
9909056,9909056,,34,30,14,44
2032,2032,,1,1,16,17
9902209,9902209,,37,3,9,12
9310200,9310200,,8,29,1,30
9311139,9311139,,8,23,3,26
9312013,9312013,,8,16,8,24
9403150,9403150,,8,13,10,23
9404109,9404109,,54,5,10,15
9405039,9405039,,8,2,6,8
9405144,9405144,,8,12,12,24
9405174,9405174,,54,5,3,8
9804147,9804147,,34,7,1,8
9202061,9202061,,1,14,0,14
9211019,9211019,,1,2,3,5
9303133,9303133,,8,16,1,17
9306096,9306096,,54,33,1,34
9707236,9707236,,2,8,21,29
9804173,9804173,,34,5,17,22
9804200,9804200,,2,7,39,46
9804201,9804201,,2,7,16,23
9811107,9811107,,2,6,38,44
9510062,9510062,,37,1,1,2
9806204,9806204,,37,4,23,27
9810127,9810127,,37,2,3,5
2033,2033,,0,5,4,9
2034,2034,,11,50,75,125
5245,5245,,11,22,7,29
8123,8123,,11,25,16,41
9110,9110,,11,19,13,32
103195,103195,,11,22,15,37
9312114,9312114,,11,62,0,62
9403074,9403074,,11,11,0,11
9403164,9403164,,11,9,1,10
9411122,9411122,,11,53,2,55
9412195,9412195,,11,46,4,50
9511046,9511046,,11,16,6,22
9512086,9512086,,11,15,18,33
9604125,9604125,,11,9,17,26
9604192,9604192,,11,1,6,7
9609040,9609040,,11,13,9,22
9609236,9609236,,11,3,2,5
9611019,9611019,,8,9,5,14
9611038,9611038,,11,6,8,14
9701028,9701028,,11,27,5,32
9702082,9702082,,11,9,17,26
9704094,9704094,,11,12,9,21
9704202,9704202,,11,29,15,44
9705088,9705088,,11,9,19,28
9705129,9705129,,11,20,6,26
9707094,9707094,,11,14,6,20
9708124,9708124,,11,4,3,7
9709060,9709060,,11,3,2,5
9712038,9712038,,11,8,8,16
9801124,9801124,,11,3,30,33
9802064,9802064,,11,26,15,41
9802196,9802196,,11,9,11,20
9803056,9803056,,11,19,10,29
9803173,9803173,,11,3,17,20
9809020,9809020,,11,9,4,13
9810117,9810117,,11,11,13,24
9811055,9811055,,11,2,6,8
9811151,9811151,,11,6,9,15
9901063,9901063,,11,21,16,37
9902064,9902064,,8,20,6,26
9905206,9905206,,11,12,18,30
9906166,9906166,,11,13,18,31
9907027,9907027,,11,15,8,23
9908043,9908043,,11,7,14,21
9908062,9908062,,11,9,1,10
9912215,9912215,,11,3,6,9
2231,2231,,11,13,10,23
6064,6064,,11,23,29,52
9601081,9601081,,11,20,2,22
104221,104221,,11,9,8,17
107020,107020,,11,10,17,27
9401104,9401104,,11,3,0,3
9310198,9310198,,11,19,0,19
9310042,9310042,,11,26,1,27
9408132,9408132,,11,8,0,8
9404086,9404086,,11,1,0,1
9303072,9303072,,19,12,2,14
9403117,9403117,,19,12,1,13
9411227,9411227,,11,3,3,6
9503021,9503021,,8,6,8,14
9505003,9505003,,11,6,2,8
9507098,9507098,,11,1,7,8
9411226,9411226,,11,5,1,6
9503230,9503230,,9,23,0,23
9511073,9511073,,11,5,5,10
9305172,9305172,,11,7,1,8
9306078,9306078,,11,3,3,6
9501056,9501056,,25,14,5,19
9501083,9501083,,11,15,2,17
9502109,9502109,,25,8,5,13
9411154,9411154,,8,6,3,9
9609019,9609019,,11,8,12,20
9511051,9511051,,11,10,1,11
9507093,9507093,,11,18,6,24
9411019,9411019,,11,9,0,9
9511090,9511090,,11,13,4,17
9602123,9602123,,11,4,6,10
9610040,9610040,,11,5,3,8
9611132,9611132,,11,5,12,17
9610143,9610143,,11,2,6,8
9511140,9511140,,11,1,0,1
9605037,9605037,,11,5,6,11
9607118,9607118,,11,3,4,7
9404155,9404155,,11,4,0,4
9611003,9611003,,6,12,10,22
9802113,9802113,,11,7,17,24
9605024,9605024,,11,4,8,12
9712147,9712147,,11,9,8,17
9505101,9505101,,6,7,3,10
9605137,9605137,,11,3,0,3
9612226,9612226,,11,4,1,5
9705146,9705146,,11,4,15,19
9210046,9210046,,25,12,0,12
9707189,9707189,,8,20,15,35
9710062,9710062,,8,13,2,15
9802167,9802167,,8,10,1,11
9807031,9807031,,8,6,6,12
9902144,9902144,,11,3,1,4
9903173,9903173,,11,6,6,12
9812050,9812050,,11,2,3,5
9404171,9404171,,25,24,3,27
9612019,9612019,,11,15,15,30
9705008,9705008,,11,8,5,13
9707239,9707239,,11,12,5,17
9908042,9908042,,11,6,10,16
9607181,9607181,,11,5,0,5
2035,2035,,2,4,24,28
9608082,9608082,,2,16,4,20
9710210,9710210,,2,8,5,13
9903057,9903057,,2,17,12,29
9903111,9903111,,2,7,5,12
9911158,9911158,,8,9,14,23
9207107,9207107,,25,2,0,2
9305152,9305152,,8,3,1,4
9309052,9309052,,2,13,3,16
9412072,9412072,,2,12,0,12
9504088,9504088,,2,5,2,7
9506076,9506076,,2,14,25,39
9703160,9703160,,2,14,11,25
9409025,9409025,,62,10,2,12
9605144,9605144,,2,10,8,18
9607064,9607064,,62,10,13,23
9607095,9607095,,2,3,12,15
9509043,9509043,,54,4,12,16
9703198,9703198,,2,13,27,40
9707075,9707075,,54,12,70,82
9712254,9712254,,2,9,4,13
9904026,9904026,,8,8,10,18
2037,2037,,37,52,17,69
9606192,9606192,,37,4,11,15
9908009,9908009,,4,4,6,10
9804075,9804075,,54,1,10,11
2038,2038,,11,5,19,24
9708051,9708051,,11,10,9,19
2039,2039,,34,8,18,26
2041,2041,,11,2,1,3
9901036,9901036,,11,2,1,3
9906091,9906091,,11,3,3,6
2042,2042,,0,11,17,28
2043,2043,,6,9,29,38
9310201,9310201,,16,13,2,15
9403045,9403045,,25,25,4,29
9403112,9403112,,16,15,2,17
9506005,9506005,,16,3,9,12
9509015,9509015,,6,2,2,4
9607003,9607003,,16,1,12,13
9607147,9607147,,11,9,2,11
9607224,9607224,,6,4,0,4
9608027,9608027,,6,6,1,7
9701051,9701051,,6,3,0,3
9702102,9702102,,6,3,1,4
9705009,9705009,,6,4,5,9
9804133,9804133,,6,5,2,7
9807024,9807024,,11,19,0,19
9808151,9808151,,6,3,9,12
9809119,9809119,,6,11,6,17
9902017,9902017,,6,4,3,7
9301063,9301063,,16,2,0,2
9305045,9305045,,16,7,3,10
9302132,9302132,,25,7,3,10
9202053,9202053,,16,22,0,22
9310037,9310037,,16,3,1,4
9308007,9308007,,6,9,1,10
9309002,9309002,,6,15,1,16
9309003,9309003,,6,10,1,11
9405160,9405160,,6,2,3,5
9307026,9307026,,65,15,0,15
9403021,9403021,,6,3,0,3
9406165,9406165,,16,1,2,3
9412073,9412073,,16,17,3,20
9501089,9501089,,6,2,0,2
9210151,9210151,,16,1,0,1
9406096,9406096,,25,6,1,7
9411049,9411049,,54,12,10,22
9501075,9501075,,16,33,26,59
9510003,9510003,,25,10,10,20
9511037,9511037,,37,8,22,30
9511038,9511038,,37,11,9,20
9511156,9511156,,25,2,3,5
9601039,9601039,,11,9,0,9
9702135,9702135,,6,2,1,3
9606007,9606007,,6,12,0,12
9803170,9803170,,16,27,14,41
2044,2044,,34,31,22,53
9909013,9909013,,34,17,17,34
9204002,9204002,,25,9,0,9
9510115,9510115,,25,1,8,9
2045,2045,,6,3,4,7
9904096,9904096,,6,6,2,8
9203078,9203078,,8,23,0,23
9203081,9203081,,8,22,0,22
9410150,9410150,,25,3,0,3
9602072,9602072,,2,1,6,7
9604141,9604141,,8,10,4,14
9706163,9706163,,0,1,11,12
2046,2046,,2,8,12,20
9910183,9910183,,2,6,14,20
9812030,9812030,,11,3,3,6
9907179,9907179,,2,1,5,6
2047,2047,,54,5,16,21
9611078,9611078,,25,15,4,19
9610100,9610100,,11,1,1,2
9803105,9803105,,25,3,6,9
2050,2050,,16,14,4,18
2051,2051,,11,1,3,4
9705136,9705136,,11,10,3,13
9712080,9712080,,11,13,5,18
9805013,9805013,,11,12,6,18
9408081,9408081,,11,17,0,17
9410067,9410067,,11,20,0,20
9703128,9703128,,11,1,3,4
9605207,9605207,,11,3,5,8
9711189,9711189,,11,3,3,6
9803250,9803250,,11,9,8,17
2052,2052,,34,2,18,20
9907175,9907175,,2,2,20,22
9909080,9909080,,2,1,17,18
9507141,9507141,,25,7,16,23
9803189,9803189,,8,4,36,40
2053,2053,,34,1,12,13
9811183,9811183,,37,32,18,50
2054,2054,,0,28,20,48
9911084,9911084,,2,8,13,21
2055,2055,,6,0,3,3
9504067,9504067,,6,23,1,24
9711184,9711184,,6,13,7,20
9803153,9803153,,6,4,6,10
9407182,9407182,,6,72,1,73
9502066,9502066,,6,25,1,26
9509086,9509086,,6,5,3,8
9607065,9607065,,6,12,12,24
9609202,9609202,,6,12,11,23
9611077,9611077,,6,12,5,17
9409183,9409183,,6,23,3,26
9411224,9411224,,6,13,1,14
9504066,9504066,,6,23,3,26
2056,2056,,34,12,15,27
2057,2057,,34,5,22,27
9411095,9411095,,2,3,21,24
9603191,9603191,,54,12,20,32
9612203,9612203,,54,21,5,26
9705197,9705197,,54,5,12,17
9707047,9707047,,54,4,31,35
9707212,9707212,,54,3,41,44
9708009,9708009,,54,1,90,91
9709222,9709222,,54,4,48,52
2058,2058,,11,3,3,6
2059,2059,,11,0,2,2
2060,2060,,2,3,13,16
9305031,9305031,,19,15,0,15
9405053,9405053,,2,2,0,2
9411229,9411229,,16,9,2,11
9805110,9805110,,2,16,12,28
9901084,9901084,,2,2,17,19
9312044,9312044,,16,1,0,1
9506081,9506081,,2,5,4,9
9505096,9505096,,2,4,2,6
9812217,9812217,,16,2,4,6
9202043,9202043,,2,6,0,6
2061,2061,,4,9,22,31
9907201,9907201,,34,4,21,25
2062,2062,,16,6,5,11
9308006,9308006,,16,5,0,5
9901110,9901110,,16,6,1,7
2063,2063,,16,2,3,5
9511151,9511151,,16,17,1,18
9904189,9904189,,16,5,3,8
9408141,9408141,,16,5,0,5
9404093,9404093,,25,9,1,10
9711133,9711133,,16,10,5,15
2064,2064,,25,0,2,2
9205021,9205021,,0,15,0,15
9208070,9208070,,0,18,0,18
9210003,9210003,,25,8,0,8
9210085,9210085,,2,6,1,7
9211050,9211050,,25,2,0,2
9212097,9212097,,2,3,1,4
9302051,9302051,,25,13,0,13
9304092,9304092,,25,10,0,10
9306123,9306123,,25,2,1,3
9308106,9308106,,25,31,4,35
2065,2065,,62,8,23,31
9501105,9501105,,62,20,4,24
9502011,9502011,,62,23,8,31
9503083,9503083,,62,17,12,29
9504018,9504018,,62,19,10,29
9506031,9506031,,62,13,14,27
9506157,9506157,,62,21,2,23
9510071,9510071,,62,9,11,20
9609233,9609233,,62,11,14,25
9612138,9612138,,62,18,29,47
9707235,9707235,,62,23,23,46
9806003,9806003,,62,16,17,33
9807146,9807146,,62,7,21,28
9807189,9807189,,62,8,21,29
9904002,9904002,,62,18,29,47
9909145,9909145,,62,7,15,22
9205039,9205039,,62,14,0,14
9403049,9403049,,62,7,4,11
9401078,9401078,,62,10,2,12
9309135,9309135,,62,12,0,12
9402045,9402045,,62,30,1,31
9407089,9407089,,62,19,3,22
9408004,9408004,,62,25,3,28
9411112,9411112,,62,29,11,40
9311027,9311027,,62,19,5,24
9410026,9410026,,62,14,3,17
9505138,9505138,,62,6,9,15
9305154,9305154,,62,16,0,16
9510070,9510070,,62,2,7,9
9404188,9404188,,62,19,11,30
9510084,9510084,,62,4,6,10
9605061,9605061,,62,2,21,23
9503088,9503088,,62,22,4,26
9605219,9605219,,62,11,9,20
9603111,9603111,,62,5,14,19
9512174,9512174,,62,5,18,23
9601055,9601055,,62,3,19,22
9211114,9211114,,62,38,1,39
9809140,9809140,,62,7,12,19
9810098,9810098,,62,19,13,32
9406156,9406156,,37,3,1,4
9407109,9407109,,37,3,17,20
2067,2067,,3,57,27,84
9304114,9304114,,16,13,2,15
9402098,9402098,,9,6,1,7
9404159,9404159,,16,5,4,9
9407193,9407193,,16,14,2,16
9501092,9501092,,16,8,4,12
9508003,9508003,,16,10,5,15
9509002,9509002,,16,3,5,8
9509034,9509034,,16,5,8,13
9608003,9608003,,16,1,8,9
9206024,9206024,,7,11,0,11
9409048,9409048,,7,3,5,8
9707202,9707202,,3,18,37,55
9409106,9409106,,19,2,2,4
9810215,9810215,,7,6,11,17
2068,2068,,65,1,4,5
2069,2069,,2,2,5,7
9807156,9807156,,34,5,19,24
9902128,9902128,,2,19,15,34
2070,2070,,31,14,20,34
9401160,9401160,,31,1,1,2
9412157,9412157,,2,6,4,10
9501070,9501070,,1,2,15,17
9503218,9503218,,2,2,4,6
9605043,9605043,,2,6,12,18
9707233,9707233,,2,3,8,11
9806167,9806167,,31,7,14,21
9909061,9909061,,31,61,154,215
205040,205040,,1,9,0,9
9203082,9203082,,11,17,0,17
9406009,9406009,,2,21,3,24
9407099,9407099,,1,21,33,54
9404132,9404132,,1,4,14,18
9406136,9406136,,1,8,18,26
9408048,9408048,,1,4,5,9
9408169,9408169,,34,6,5,11
9311080,9311080,,31,3,3,6
9502007,9502007,,31,19,11,30
9503142,9503142,,31,8,9,17
9703009,9703009,,2,12,33,45
9210001,9210001,,34,5,0,5
9511163,9511163,,2,3,3,6
9502002,9502002,,2,17,0,17
9504057,9504057,,31,6,10,16
9504155,9504155,,2,7,3,10
9506205,9506205,,2,4,14,18
9602087,9602087,,31,35,6,41
9608041,9608041,,31,9,13,22
9609013,9609013,,25,1,2,3
9610179,9610179,,31,13,9,22
9701115,9701115,,31,13,14,27
9701146,9701146,,31,8,8,16
9705016,9705016,,2,9,17,26
9705058,9705058,,2,8,35,43
9708008,9708008,,31,8,36,44
9708153,9708153,,2,2,24,26
9708157,9708157,,2,21,20,41
9802138,9802138,,2,6,2,8
9809185,9809185,,31,2,17,19
9810159,9810159,,2,8,39,47
9810240,9810240,,2,3,29,32
9811019,9811019,,2,4,97,101
9901044,9901044,,31,11,14,25
9903008,9903008,,31,20,47,67
9904033,9904033,,2,5,42,47
9906006,9906006,,31,12,28,40
2071,2071,,7,1,5,6
9512036,9512036,,7,13,7,20
9604006,9604006,,7,13,4,17
9604074,9604074,,7,10,7,17
9712056,9712056,,7,9,5,14
9805044,9805044,,7,4,22,26
9308022,9308022,,1,11,4,15
9308140,9308140,,7,6,2,8
9401011,9401011,,7,2,0,2
9409001,9409001,,7,10,0,10
9502148,9502148,,7,1,0,1
9706152,9706152,,2,5,12,17
9709025,9709025,,2,7,20,27
9711196,9711196,,2,4,14,18
9202025,9202025,,7,7,0,7
9208049,9208049,,7,2,0,2
9209086,9209086,,7,12,0,12
9310142,9310142,,7,8,0,8
9403196,9403196,,7,18,1,19
9405164,9405164,,6,2,2,4
9506010,9506010,,7,7,0,7
9602048,9602048,,7,9,3,12
9603052,9603052,,7,4,6,10
9608088,9608088,,7,4,2,6
9712247,9712247,,7,4,8,12
2073,2073,,4,49,18,67
9207045,9207045,,54,1,1,2
9210047,9210047,,54,1,2,3
2074,2074,,4,2,12,14
9804081,9804081,,2,14,5,19
9901136,9901136,,2,9,14,23
2075,2075,,3,182,8,190
2077,2077,,2,4,13,17
9702052,9702052,,2,3,13,16
9908136,9908136,,8,4,9,13
9612102,9612102,,2,31,36,67
9612171,9612171,,8,4,20,24
9905161,9905161,,2,7,21,28
2078,2078,,8,4,12,16
9809160,9809160,,8,10,20,30
9912033,9912033,,8,3,8,11
9207024,9207024,,8,25,0,25
9412179,9412179,,8,17,1,18
9510005,9510005,,8,1,5,6
9605208,9605208,,8,13,3,16
9605233,9605233,,8,16,4,20
9606061,9606061,,8,25,5,30
9608196,9608196,,8,16,9,25
9611101,9611101,,8,13,3,16
9704076,9704076,,8,15,13,28
9710196,9710196,,8,5,2,7
9710197,9710197,,8,7,2,9
9711111,9711111,,8,6,4,10
9804206,9804206,,8,4,24,28
9203074,9203074,,8,36,0,36
2080,2080,,65,0,5,5
9207071,9207071,,65,10,0,10
9712243,9712243,,8,1,1,2
9912112,9912112,,65,1,5,6
9301094,9301094,,62,3,0,3
9305072,9305072,,65,6,0,6
9305174,9305174,,8,15,0,15
9306164,9306164,,8,6,1,7
9307163,9307163,,65,5,6,11
9308105,9308105,,65,1,1,2
9309087,9309087,,65,4,0,4
9310040,9310040,,65,6,4,10
9311062,9311062,,65,14,14,28
9312050,9312050,,65,9,0,9
9312094,9312094,,65,12,3,15
9406076,9406076,,65,9,7,16
9407131,9407131,,65,6,3,9
9408034,9408034,,65,1,5,6
9408087,9408087,,8,2,1,3
9408112,9408112,,1,1,16,17
9411209,9411209,,65,1,6,7
9503209,9503209,,8,53,2,55
9607048,9607048,,8,8,6,14
9611208,9611208,,8,4,1,5
9710036,9710036,,8,2,0,2
9307106,9307106,,62,9,3,12
9410029,9410029,,65,12,0,12
2081,2081,,8,0,17,17
9204097,9204097,,8,21,0,21
9212113,9212113,,8,20,5,25
9511208,9511208,,8,8,1,9
9601056,9601056,,8,19,5,24
9602166,9602166,,8,3,7,10
9701041,9701041,,8,14,19,33
9706041,9706041,,8,10,7,17
9707211,9707211,,8,7,9,16
9712085,9712085,,8,8,11,19
9712165,9712165,,8,4,9,13
9807234,9807234,,8,6,12,18
9902044,9902044,,8,3,11,14
9905063,9905063,,8,4,16,20
9905150,9905150,,8,2,8,10
9201071,9201071,,25,10,0,10
9204063,9204063,,8,6,0,6
9207032,9207032,,8,30,0,30
9504056,9504056,,8,12,3,15
9308037,9308037,,8,13,4,17
9311180,9311180,,8,17,10,27
9403124,9403124,,8,9,10,19
9411119,9411119,,8,5,3,8
9512079,9512079,,8,11,15,26
9201079,9201079,,8,10,0,10
9209105,9209105,,8,18,3,21
9306034,9306034,,8,13,3,16
9309014,9309014,,8,8,3,11
9403032,9403032,,8,9,3,12
9403075,9403075,,8,5,10,15
9505149,9505149,,8,1,11,12
9605220,9605220,,8,12,11,23
9705234,9705234,,8,6,6,12
9712102,9712102,,8,3,21,24
9201008,9201008,,1,7,0,7
9511032,9511032,,8,4,0,4
9712169,9712169,,16,1,7,8
9802204,9802204,,8,2,13,15
2082,2082,,0,9,6,15
2083,2083,,7,0,2,2
9705075,9705075,,7,8,1,9
9911093,9911093,,7,3,3,6
9703087,9703087,,7,1,0,1
9809175,9809175,,7,2,1,3
2084,2084,,3,50,32,82
9205103,9205103,,7,27,1,28
9902187,9902187,,3,3,17,20
9903089,9903089,,2,6,32,38
9904091,9904091,,34,3,7,10
9910037,9910037,,2,5,11,16
9912212,9912212,,3,7,12,19
9701096,9701096,,3,12,3,15
9705153,9705153,,3,10,4,14
9706107,9706107,,3,10,12,22
9712174,9712174,,3,3,2,5
9812235,9812235,,3,3,11,14
9205003,9205003,,7,15,0,15
9403033,9403033,,7,3,1,4
9508170,9508170,,7,4,0,4
9306030,9306030,,7,10,0,10
9906225,9906225,,7,8,8,16
9912185,9912185,,3,14,18,32
2085,2085,,34,2,8,10
9512098,9512098,,8,6,1,7
9606034,9606034,,8,4,4,8
9903221,9903221,,34,8,13,21
9910173,9910173,,11,5,7,12
9504045,9504045,,11,1,2,3
9504046,9504046,,11,3,2,5
9712120,9712120,,11,9,1,10
9806098,9806098,,11,4,2,6
2086,2086,,2,2,31,33
9910154,9910154,,25,3,12,15
2087,2087,,54,5,30,35
106174,106174,,54,4,6,10
9405066,9405066,,54,1,3,4
9906152,9906152,,54,4,31,35
4125,4125,,0,35,43,78
12104,12104,,54,20,53,73
102046,102046,,54,10,31,41
9505145,9505145,,1,2,34,36
9904008,9904008,,54,8,6,14
2088,2088,,1,1,10,11
9502018,9502018,,1,7,4,11
9503001,9503001,,1,8,1,9
9608008,9608008,,6,8,2,10
9306046,9306046,,1,5,0,5
2089,2089,,37,0,5,5
2090,2090,,3,31,18,49
9912019,9912019,,3,31,17,48
9912047,9912047,,3,54,23,77
9908204,9908204,,37,10,18,28
9701078,9701078,,3,38,23,61
9805132,9805132,,3,10,3,13
2092,2092,,34,2,2,4
2093,2093,,16,4,21,25
9402029,9402029,,16,24,1,25
9606194,9606194,,16,12,12,24
9612246,9612246,,16,2,18,20
9708115,9708115,,16,6,19,25
9709101,9709101,,16,15,6,21
9906049,9906049,,37,8,28,36
9906125,9906125,,16,8,15,23
9911208,9911208,,16,3,16,19
9306013,9306013,,16,53,5,58
12228,12228,,25,22,0,22
9206015,9206015,,16,45,0,45
9207086,9207086,,16,8,0,8
9208002,9208002,,16,33,0,33
9212011,9212011,,16,6,0,6
9212074,9212074,,16,7,1,8
9306091,9306091,,16,10,1,11
9207017,9207017,,16,24,0,24
9501024,9501024,,16,25,6,31
9503033,9503033,,16,6,23,29
9504150,9504150,,16,51,19,70
9512135,9512135,,16,13,10,23
9605172,9605172,,16,10,6,16
9311164,9311164,,16,4,4,8
9312110,9312110,,16,12,0,12
9602176,9602176,,0,4,5,9
9604017,9604017,,37,2,2,4
9509036,9509036,,16,12,12,24
9603205,9603205,,16,4,5,9
9609140,9609140,,16,8,1,9
9612073,9612073,,16,10,14,24
9210136,9210136,,16,1,0,1
9310105,9310105,,16,4,5,9
9501099,9501099,,16,5,18,23
9208012,9208012,,16,10,0,10
9311064,9311064,,16,7,9,16
9503109,9503109,,16,7,12,19
9511110,9511110,,16,17,2,19
9512048,9512048,,16,11,10,21
9609228,9609228,,16,4,13,17
9612030,9612030,,16,5,22,27
9401044,9401044,,16,13,2,15
9401046,9401046,,16,5,3,8
9508006,9508006,,16,7,8,15
9610007,9610007,,16,2,7,9
9701140,9701140,,16,12,8,20
9703114,9703114,,16,12,5,17
9603084,9603084,,16,5,2,7
9609185,9609185,,16,5,2,7
9701017,9701017,,16,7,4,11
9706019,9706019,,16,9,3,12
9310165,9310165,,16,16,2,18
9510154,9510154,,16,7,26,33
9710112,9710112,,37,15,20,35
9711054,9711054,,37,4,1,5
9712046,9712046,,0,38,16,54
9805142,9805142,,37,7,29,36
9808005,9808005,,0,7,17,24
9809184,9809184,,0,6,14,20
9806190,9806190,,16,7,8,15
9811050,9811050,,16,6,20,26
9904061,9904061,,16,4,11,15
2094,2094,,31,41,67,108
9602084,9602084,,31,8,11,19
9712122,9712122,,31,4,5,9
9908024,9908024,,31,4,29,33
9910169,9910169,,31,14,25,39
9506140,9506140,,31,2,4,6
9204079,9204079,,31,5,0,5
9205016,9205016,,2,5,0,5
9602078,9602078,,25,3,8,11
9607027,9607027,,2,13,19,32
9403048,9403048,,1,3,23,26
9502136,9502136,,31,2,8,10
9507092,9507092,,2,9,2,11
9512091,9512091,,31,5,8,13
9608148,9608148,,25,3,7,10
9609063,9609063,,19,1,12,13
9408137,9408137,,25,1,10,11
9501055,9501055,,31,14,5,19
9509149,9509149,,2,7,18,25
9611122,9611122,,31,2,9,11
9611223,9611223,,31,6,12,18
9702009,9702009,,25,2,7,9
9704115,9704115,,25,3,21,24
9706053,9706053,,16,3,8,11
9706154,9706154,,31,3,16,19
9604159,9604159,,31,2,8,10
9706201,9706201,,31,4,14,18
9704178,9704178,,2,4,17,21
9707243,9707243,,31,2,12,14
9403133,9403133,,8,18,12,30
9608026,9608026,,31,12,8,20
9609115,9609115,,31,5,8,13
9704047,9704047,,31,2,7,9
9704169,9704169,,8,9,23,32
9607148,9607148,,31,3,17,20
9308066,9308066,,54,13,4,17
9812104,9812104,,2,5,7,12
2096,2096,,6,2,4,6
9903167,9903167,,6,2,0,2
9212112,9212112,,6,10,0,10
9302123,9302123,,6,10,0,10
9305132,9305132,,6,10,2,12
9401140,9401140,,6,4,0,4
9510089,9510089,,6,2,0,2
9606045,9606045,,6,6,2,8
2097,2097,,54,0,15,15
9805045,9805045,,54,12,38,50
9307108,9307108,,1,31,1,32
9405195,9405195,,1,1,7,8
9702104,9702104,,0,3,0,3
9707106,9707106,,37,1,0,1
9709211,9709211,,37,8,27,35
2098,2098,,14,8,15,23
9911209,9911209,,14,6,6,12
9408156,9408156,,7,7,0,7
2099,2099,,34,11,17,28
2100,2100,,37,21,31,52
9204041,9204041,,54,13,0,13
9707031,9707031,,16,2,5,7
9507036,9507036,,2,24,13,37
9707121,9707121,,37,1,0,1
9609113,9609113,,37,14,6,20
2101,2101,,3,11,16,27
9607182,9607182,,2,6,2,8
9709145,9709145,,3,6,6,12
9709198,9709198,,3,5,17,22
9805027,9805027,,2,1,21,22
2102,2102,,54,3,58,61
9606016,9606016,,2,7,20,27
9805190,9805190,,54,9,17,26
9812141,9812141,,54,6,31,37
9812253,9812253,,54,3,11,14
9305040,9305040,,25,12,78,90
9601104,9601104,,16,2,20,22
9607067,9607067,,2,13,9,22
9608056,9608056,,25,10,7,17
9609051,9609051,,54,3,4,7
9609046,9609046,,54,13,7,20
9403017,9403017,,37,4,0,4
9510105,9510105,,2,1,1,2
9705068,9705068,,54,7,17,24
9706075,9706075,,37,7,7,14
9807222,9807222,,37,4,19,23
9605019,9605019,,7,7,3,10
9708112,9708112,,54,7,34,41
9803262,9803262,,54,7,17,24
9906108,9906108,,2,2,9,11
2103,2103,,37,19,29,48
9907086,9907086,,37,27,55,82
9409096,9409096,,54,10,1,11
9409151,9409151,,54,8,0,8
9311014,9311014,,54,12,6,18
9510022,9510022,,54,3,13,16
9706023,9706023,,37,9,29,38
9805158,9805158,,37,24,30,54
9812072,9812072,,37,11,106,117
9903061,9903061,,37,4,10,14
9907074,9907074,,37,10,55,65
9412086,9412086,,54,1,7,8
9801201,9801201,,54,7,2,9
2104,2104,,1,7,23,30
9902166,9902166,,2,7,28,35
9707232,9707232,,37,3,2,5
9705079,9705079,,2,9,33,42
9901102,9901102,,2,12,12,24
9412002,9412002,,2,11,2,13
2105,2105,,16,1,4,5
9504105,9504105,,16,15,2,17
9803115,9803115,,19,3,0,3
9911177,9911177,,19,4,12,16
9302129,9302129,,19,15,1,16
9306050,9306050,,11,4,0,4
9612112,9612112,,19,6,4,10
9802040,9802040,,19,6,2,8
9803149,9803149,,34,3,5,8
9812166,9812166,,19,8,22,30
9904173,9904173,,19,3,6,9
9904180,9904180,,19,1,15,16
9905132,9905132,,19,2,2,4
9906085,9906085,,34,4,14,18
2106,2106,,34,20,7,27
2107,2107,,2,5,14,19
9909191,9909191,,2,8,6,14
9912163,9912163,,2,5,2,7
2108,2108,,16,3,6,9
9605079,9605079,,16,5,2,7
9608083,9608083,,6,9,4,13
9711144,9711144,,16,9,2,11
9805089,9805089,,16,4,6,10
9807039,9807039,,16,1,3,4
9410085,9410085,,62,5,1,6
9510119,9510119,,9,7,2,9
9608006,9608006,,16,9,2,11
9709151,9709151,,16,5,0,5
9405135,9405135,,62,7,0,7
9606046,9606046,,62,6,3,9
2109,2109,,7,0,1,1
2110,2110,,37,14,8,22
3272,3272,,37,17,22,39
9906193,9906193,,37,19,36,55
9211121,9211121,,54,35,0,35
9306150,9306150,,37,11,0,11
9904087,9904087,,37,25,39,64
9809159,9809159,,34,8,2,10
9906175,9906175,,34,1,9,10
2112,2112,,37,0,4,4
9412222,9412222,,37,8,4,12
9901038,9901038,,37,5,10,15
9910007,9910007,,37,1,4,5
9805043,9805043,,6,8,3,11
9810137,9810137,,37,4,19,23
9409173,9409173,,0,1,0,1
9412156,9412156,,0,1,0,1
2114,2114,,6,4,9,13
9208062,9208062,,6,7,0,7
9411180,9411180,,6,6,1,7
9603020,9603020,,6,2,2,4
9603180,9603180,,6,3,6,9
9708098,9708098,,6,10,3,13
9901125,9901125,,6,8,0,8
9303145,9303145,,6,11,0,11
9301034,9301034,,6,11,0,11
9306068,9306068,,6,4,0,4
9511100,9511100,,6,10,4,14
9609074,9609074,,19,7,9,16
9412141,9412141,,6,4,7,11
9505049,9505049,,6,23,8,31
9508075,9508075,,6,26,6,32
9509133,9509133,,6,29,9,38
9602017,9602017,,6,14,8,22
9607040,9607040,,6,17,9,26
9703048,9703048,,6,11,12,23
9703219,9703219,,19,8,14,22
9705186,9705186,,6,5,17,22
9707033,9707033,,6,6,8,14
9707100,9707100,,6,11,10,21
9710091,9710091,,6,2,12,14
9712157,9712157,,6,9,9,18
9801021,9801021,,6,7,13,20
2115,2115,,7,0,3,3
9308128,9308128,,7,5,0,5
9404190,9404190,,7,5,1,6
9704049,9704049,,7,4,11,15
9401009,9401009,,7,21,0,21
9410014,9410014,,2,5,6,11
9410239,9410239,,7,1,2,3
9607140,9607140,,7,5,4,9
9609032,9609032,,7,3,8,11
9609033,9609033,,7,3,6,9
2116,2116,,34,3,68,71
9306080,9306080,,54,31,3,34
9907216,9907216,,34,24,20,44
9907219,9907219,,34,22,29,51
9908005,9908005,,34,8,1,9
9909137,9909137,,34,7,5,12
9909188,9909188,,34,10,11,21
9911095,9911095,,34,9,32,41
9912107,9912107,,34,12,33,45
9912277,9912277,,34,4,9,13
9205066,9205066,,54,13,0,13
9208029,9208029,,54,40,0,40
9411205,9411205,,54,29,11,40
9505123,9505123,,54,14,17,31
9706048,9706048,,2,4,6,10
9806226,9806226,,4,17,13,30
9401073,9401073,,16,5,4,9
9310019,9310019,,54,6,3,9
9811098,9811098,,2,4,26,30
9603083,9603083,,16,3,7,10
9812022,9812022,,11,11,14,25
9902137,9902137,,34,17,9,26
9908162,9908162,,34,8,32,40
9711153,9711153,,2,1,58,59
9910155,9910155,,37,8,37,45
2117,2117,,4,107,16,123
9311056,9311056,,4,7,0,7
9306089,9306089,,62,15,2,17
9311058,9311058,,62,3,7,10
2118,2118,,54,5,99,104
9806001,9806001,,2,2,27,29
9808185,9808185,,54,9,31,40
9812021,9812021,,54,6,20,26
9901107,9901107,,37,16,20,36
9903095,9903095,,37,5,18,23
9905230,9905230,,37,10,29,39
9906247,9906247,,54,5,13,18
9907157,9907157,,54,5,14,19
9909035,9909035,,37,11,17,28
9910236,9910236,,54,1,38,39
9911090,9911090,,2,5,51,56
9912082,9912082,,37,16,27,43
9912083,9912083,,37,13,23,36
9607151,9607151,,37,21,19,40
9705069,9705069,,37,15,15,30
9711076,9711076,,37,1,10,11
9607198,9607198,,16,5,5,10
9701185,9701185,,37,16,26,42
9706068,9706068,,19,3,10,13
9804018,9804018,,2,6,16,22
9707125,9707125,,54,6,9,15
9803078,9803078,,2,2,33,35
9708149,9708149,,37,5,17,22
9704153,9704153,,37,12,5,17
9709080,9709080,,37,7,7,14
9805163,9805163,,37,3,7,10
9806237,9806237,,37,4,6,10
9310134,9310134,,16,11,4,15
9602009,9602009,,6,4,3,7
9811258,9811258,,37,17,14,31
9905212,9905212,,37,16,16,32
9707175,9707175,,7,12,5,17
9905169,9905169,,4,5,5,10
9410166,9410166,,16,1,2,3
9805031,9805031,,2,4,15,19
9812081,9812081,,54,2,40,42
9907152,9907152,,2,34,19,53
9705041,9705041,,37,6,19,25
9901094,9901094,,7,2,0,2
9907156,9907156,,2,2,21,23
9909218,9909218,,37,2,18,20
2119,2119,,3,34,18,52
2120,2120,,37,1,4,5
9803183,9803183,,8,11,27,38
9909135,9909135,,37,2,5,7
9406101,9406101,,8,32,10,42
9512130,9512130,,8,7,3,10
9606077,9606077,,8,15,30,45
9702144,9702144,,8,3,6,9
9703154,9703154,,8,12,6,18
9710041,9710041,,3,9,15,24
9710064,9710064,,2,7,24,31
9710165,9710165,,2,13,34,47
9801100,9801100,,25,1,2,3
9709192,9709192,,37,14,47,61
9806239,9806239,,8,6,15,21
2121,2121,,0,43,12,55
2122,2122,,62,2,3,5
9712111,9712111,,62,14,9,23
9903082,9903082,,62,2,5,7
9911192,9911192,,62,4,11,15
9709028,9709028,,62,8,5,13
9811215,9811215,,62,5,6,11
2123,2123,,62,4,4,8
9303043,9303043,,62,11,0,11
9506195,9506195,,62,2,1,3
9806083,9806083,,62,2,2,4
9411045,9411045,,62,6,1,7
2126,2126,,34,11,25,36
9406061,9406061,,37,4,0,4
9910233,9910233,,34,3,8,11
9907079,9907079,,34,14,22,36
2127,2127,,54,3,21,24
9901001,9901001,,54,5,9,14
9909178,9909178,,54,3,20,23
9910054,9910054,,54,13,44,57
9910207,9910207,,54,4,49,53
9408133,9408133,,37,13,4,17
9909173,9909173,,62,2,8,10
2128,2128,,34,5,17,22
9711068,9711068,,2,3,10,13
9806010,9806010,,2,3,13,16
9904135,9904135,,2,7,25,32
9704204,9704204,,2,11,27,38
9901115,9901115,,2,6,25,31
2129,2129,,37,2,9,11
2130,2130,,0,14,84,98
9911134,9911134,,0,4,6,10
9605087,9605087,,54,14,18,32
2131,2131,,2,6,18,24
2132,2132,,0,21,27,48
2133,2133,,2,1,13,14
9907202,9907202,,2,33,15,48
9912236,9912236,,2,8,17,25
9509145,9509145,,2,4,20,24
9610074,9610074,,2,19,41,60
9708055,9708055,,2,24,38,62
9803006,9803006,,2,7,23,30
9910030,9910030,,2,41,5,46
2134,2134,,2,1,13,14
2135,2135,,34,1,7,8
9710212,9710212,,54,13,29,42
9803202,9803202,,37,1,3,4
9805152,9805152,,54,14,15,29
2136,2136,,9,3,7,10
6187,6187,,9,7,1,8
9407027,9407027,,9,18,1,19
9505084,9505084,,9,18,2,20
9803264,9803264,,9,15,0,15
9310031,9310031,,9,12,0,12
2138,2138,,3,15,25,40
9912174,9912174,,3,7,7,14
9912238,9912238,,3,20,2,22
9311094,9311094,,7,4,0,4
9509092,9509092,,3,14,0,14
9510011,9510011,,3,7,5,12
9512056,9512056,,3,1,1,2
9604142,9604142,,3,8,10,18
9612221,9612221,,3,7,10,17
9702046,9702046,,3,12,14,26
9705013,9705013,,2,6,18,24
9802091,9802091,,2,4,29,33
9512124,9512124,,65,23,27,50
9904168,9904168,,6,2,2,4
9711183,9711183,,3,32,6,38
2139,2139,,4,3,7,10
9207051,9207051,,4,6,0,6
9307093,9307093,,4,7,0,7
9509097,9509097,,4,6,8,14
9511153,9511153,,4,4,12,16
9512224,9512224,,4,8,7,15
9704116,9704116,,4,4,6,10
9210065,9210065,,4,142,0,142
9303143,9303143,,4,117,0,117
9306119,9306119,,4,9,2,11
9505134,9505134,,4,4,5,9
9508062,9508062,,62,4,4,8
9309015,9309015,,4,4,0,4
2140,2140,,2,11,30,41
9804028,9804028,,2,22,20,42
9806085,9806085,,2,17,21,38
9809034,9809034,,2,20,22,42
9812113,9812113,,2,8,17,25
9907077,9907077,,2,10,8,18
9912049,9912049,,2,9,10,19
9504124,9504124,,2,6,6,12
9601125,9601125,,2,5,0,5
9312150,9312150,,8,11,10,21
9206076,9206076,,62,7,0,7
9512115,9512115,,2,7,3,10
9805127,9805127,,34,3,0,3
9709007,9709007,,2,2,1,3
9907034,9907034,,2,3,7,10
2141,2141,,34,6,12,18
12168,12168,,34,6,3,9
9702047,9702047,,37,5,10,15
9701076,9701076,,16,1,8,9
2142,2142,,8,11,7,18
9303050,9303050,,8,10,6,16
9606130,9606130,,8,29,29,58
9606143,9606143,,8,28,12,40
9704082,9704082,,8,14,7,21
9707090,9707090,,8,31,36,67
9209046,9209046,,8,8,0,8
9212010,9212010,,8,10,1,11
9212015,9212015,,8,8,0,8
9212019,9212019,,8,12,0,12
9212021,9212021,,8,14,2,16
9212145,9212145,,8,24,0,24
9301030,9301030,,8,6,0,6
9310056,9310056,,8,4,5,9
9312097,9312097,,8,6,1,7
9503005,9503005,,8,29,4,33
9505111,9505111,,8,5,3,8
9506189,9506189,,8,10,1,11
9507165,9507165,,8,2,2,4
9507166,9507166,,8,28,10,38
9508040,9508040,,8,4,9,13
9510149,9510149,,8,41,4,45
9512022,9512022,,8,6,11,17
9603200,9603200,,8,2,4,6
9604007,9604007,,8,15,11,26
9604026,9604026,,8,34,9,43
9605062,9605062,,8,42,7,49
9605151,9605151,,8,47,18,65
9605152,9605152,,8,11,13,24
9605157,9605157,,11,3,2,5
9606050,9606050,,8,39,13,52
9605046,9605046,,8,32,47,79
9212075,9212075,,8,29,0,29
9404113,9404113,,8,23,11,34
9406203,9406203,,8,18,24,42
9407151,9407151,,8,25,2,27
9606138,9606138,,8,34,17,51
9606154,9606154,,8,11,14,25
9611160,9611160,,8,30,21,51
9612217,9612217,,62,3,6,9
9705240,9705240,,8,39,21,60
9707060,9707060,,8,11,13,24
2143,2143,,3,45,13,58
2171,2171,,3,63,28,91
9910031,9910031,,3,6,18,24
9912172,9912172,,7,1,4,5
2144,2144,,14,0,3,3
9908128,9908128,,54,1,5,6
9901147,9901147,,34,32,7,39
9902056,9902056,,54,1,0,1
2145,2145,,34,45,20,65
9607104,9607104,,25,24,19,43
9703178,9703178,,25,22,10,32
9204072,9204072,,25,40,0,40
9207105,9207105,,25,18,0,18
9304027,9304027,,25,14,13,27
9304128,9304128,,25,30,4,34
9306083,9306083,,25,6,22,28
9307079,9307079,,25,6,7,13
9408089,9408089,,25,15,7,22
9408098,9408098,,25,22,8,30
9504033,9504033,,25,17,17,34
9508104,9508104,,25,11,15,26
9512184,9512184,,25,16,30,46
9603106,9603106,,25,15,23,38
9603175,9603175,,25,4,10,14
9604118,9604118,,25,10,20,30
9605153,9605153,,25,11,21,32
9406011,9406011,,25,3,2,5
9612061,9612061,,25,6,14,20
9701099,9701099,,25,3,14,17
2146,2146,,54,13,9,22
9912218,9912218,,54,13,38,51
9909003,9909003,,54,3,13,16
9911205,9911205,,54,8,55,63
2147,2147,,0,28,16,44
2148,2148,,16,2,7,9
9205014,9205014,,16,18,1,19
9202006,9202006,,37,13,0,13
9201033,9201033,,16,15,0,15
9201001,9201001,,37,30,0,30
9203009,9203009,,37,16,1,17
9212127,9212127,,19,5,0,5
9503185,9503185,,37,2,3,5
9504089,9504089,,37,4,7,11
9512052,9512052,,37,10,3,13
2149,2149,,54,15,27,42
9711077,9711077,,54,7,24,31
9701103,9701103,,65,5,4,9
9801190,9801190,,65,1,4,5
9908172,9908172,,9,7,4,11
9911223,9911223,,54,7,8,15
2150,2150,,54,2,30,32
9807139,9807139,,54,3,18,21
9701152,9701152,,2,16,47,63
9610048,9610048,,16,3,0,3
9811186,9811186,,2,4,6,10
2151,2151,,0,1,2,3
9706085,9706085,,0,1,0,1
9707096,9707096,,0,1,0,1
2152,2152,,34,4,15,19
2153,2153,,62,2,1,3
2154,2154,,34,23,30,53
9906155,9906155,,34,10,8,18
2155,2155,,7,2,27,29
9302044,9302044,,1,11,0,11
9407179,9407179,,1,2,4,6
9503053,9503053,,1,4,3,7
9508010,9508010,,7,4,3,7
9601072,9601072,,1,10,17,27
9703162,9703162,,7,2,4,6
9710082,9710082,,37,5,14,19
9710168,9710168,,37,3,12,15
9209107,9209107,,2,2,4,6
9303039,9303039,,1,2,0,2
9407045,9407045,,1,3,4,7
9410202,9410202,,1,7,2,9
9501007,9501007,,1,3,2,5
9402118,9402118,,8,8,1,9
9308142,9308142,,7,14,0,14
9203045,9203045,,1,13,0,13
9207009,9207009,,1,15,2,17
9301049,9301049,,1,6,0,6
9307043,9307043,,1,5,2,7
9307189,9307189,,1,10,4,14
9409020,9409020,,1,6,5,11
9501140,9501140,,1,5,4,9
9506179,9506179,,7,12,1,13
9509059,9509059,,7,8,3,11
9611036,9611036,,37,7,31,38
9603033,9603033,,54,18,24,42
9705161,9705161,,37,3,1,4
2156,2156,,34,8,12,20
9911142,9911142,,34,2,2,4
2157,2157,,2,13,12,25
2158,2158,,3,61,24,85
2159,2159,,34,114,40,154
2160,2160,,34,102,70,172
9305016,9305016,,34,17,2,19
9903144,9903144,,54,1,14,15
9403089,9403089,,16,11,2,13
9407014,9407014,,16,12,3,15
9410103,9410103,,2,38,0,38
9810255,9810255,,37,1,3,4
2161,2161,,0,66,4,70
2190,2190,,0,76,6,82
2162,2162,,1,1,4,5
2164,2164,,0,57,6,63
2165,2165,,2,1,28,29
9711120,9711120,,2,12,2,14
9303065,9303065,,65,2,0,2
9403173,9403173,,6,31,3,34
9512066,9512066,,8,2,11,13
9705173,9705173,,54,3,45,48
9709104,9709104,,2,7,0,7
9812207,9812207,,65,5,10,15
2166,2166,,2,1,25,26
9505038,9505038,,2,9,10,19
9806186,9806186,,2,4,23,27
9312058,9312058,,2,10,2,12
9502099,9502099,,2,12,7,19
9505045,9505045,,2,17,20,37
9707059,9707059,,37,2,5,7
9807136,9807136,,2,11,40,51
9810150,9810150,,2,3,7,10
9811251,9811251,,2,8,37,45
2167,2167,,6,5,7,12
9407105,9407105,,6,15,1,16
9512026,9512026,,6,8,1,9
9611070,9611070,,6,4,4,8
9805200,9805200,,37,14,10,24
9909166,9909166,,6,2,5,7
9305148,9305148,,6,19,0,19
9505181,9505181,,6,3,1,4
9606080,9606080,,37,11,10,21
9611136,9611136,,8,10,16,26
9707209,9707209,,6,11,24,35
2168,2168,,37,0,2,2
9612216,9612216,,37,14,7,21
9811199,9811199,,37,3,7,10
9401061,9401061,,25,13,1,14
9511196,9511196,,25,3,1,4
9405151,9405151,,8,6,0,6
2169,2169,,54,5,30,35
9811214,9811214,,37,7,21,28
9901151,9901151,,54,8,12,20
9910181,9910181,,54,15,33,48
9405023,9405023,,62,10,3,13
9607029,9607029,,54,13,5,18
9403193,9403193,,1,10,2,12
9503105,9503105,,37,17,12,29
9504010,9504010,,37,24,14,38
9507140,9507140,,37,21,17,38
9603169,9603169,,37,13,18,31
9403099,9403099,,16,11,0,11
9403119,9403119,,16,10,17,27
9510218,9510218,,54,1,8,9
9612200,9612200,,54,4,27,31
9410011,9410011,,8,4,3,7
9611120,9611120,,37,3,24,27
9412175,9412175,,37,4,1,5
2170,2170,,34,29,25,54
9904056,9904056,,8,19,35,54
9904039,9904039,,34,5,7,12
9701079,9701079,,7,1,2,3
9811117,9811117,,16,8,0,8
9211093,9211093,,7,13,1,14
9601033,9601033,,7,9,5,14
2172,2172,,34,20,42,62
9603034,9603034,,37,19,17,36
9611020,9611020,,37,14,18,32
9710053,9710053,,54,2,34,36
2173,2173,,62,6,5,11
9203039,9203039,,62,31,0,31
9803122,9803122,,62,10,2,12
9803234,9803234,,62,8,5,13
9810057,9810057,,62,5,5,10
9304156,9304156,,62,8,3,11
9512030,9512030,,62,14,5,19
9312108,9312108,,62,19,1,20
9403197,9403197,,62,9,4,13
9810011,9810011,,62,2,4,6
2174,2174,,0,31,18,49
2175,2175,,3,12,28,40
2176,2176,,0,14,35,49
9708060,9708060,,0,22,5,27
9805086,9805086,,0,11,7,18
9805134,9805134,,0,4,8,12
2177,2177,,34,0,3,3
9405141,9405141,,7,12,6,18
9206027,9206027,,7,69,0,69
9211071,9211071,,7,26,0,26
9402128,9402128,,7,3,3,6
9405057,9405057,,7,11,8,19
2178,2178,,19,0,3,3
9506069,9506069,,19,3,6,9
9305007,9305007,,19,8,0,8
2180,2180,,2,25,16,41
9712057,9712057,,65,6,12,18
2181,2181,,7,2,2,4
9803043,9803043,,7,4,1,5
9905225,9905225,,0,3,7,10
9803020,9803020,,7,1,6,7
9204007,9204007,,0,3,0,3
2182,2182,,2,3,2,5
9803179,9803179,,2,9,3,12
2183,2183,,34,9,21,30
9808190,9808190,,34,8,4,12
2184,2184,,2,8,75,83
9503125,9503125,,25,5,13,18
9511218,9511218,,2,10,10,20
9610120,9610120,,2,4,14,18
9805121,9805121,,2,16,32,48
9906112,9906112,,34,12,13,25
9911003,9911003,,2,5,53,58
9203060,9203060,,25,22,0,22
9210107,9210107,,25,24,0,24
9210120,9210120,,25,26,2,28
9212027,9212027,,25,8,3,11
9303116,9303116,,25,8,5,13
9304072,9304072,,25,12,7,19
9501071,9501071,,25,49,47,96
9301129,9301129,,2,6,3,9
9504139,9504139,,2,13,7,20
9504142,9504142,,2,5,4,9
9312107,9312107,,25,10,2,12
9601117,9601117,,2,1,9,10
9303060,9303060,,54,5,0,5
9210031,9210031,,2,15,0,15
9603019,9603019,,16,3,1,4
9701077,9701077,,2,10,12,22
9703126,9703126,,62,3,9,12
9611146,9611146,,2,5,48,53
9701095,9701095,,2,7,36,43
9408134,9408134,,2,18,0,18
9706151,9706151,,2,11,36,47
9410074,9410074,,25,9,4,13
9606026,9606026,,2,3,0,3
9705063,9705063,,2,4,25,29
9705095,9705095,,2,3,24,27
9707124,9707124,,2,6,17,23
9710158,9710158,,2,4,8,12
9901092,9901092,,2,11,5,16
2185,2185,,62,2,8,10
9903134,9903134,,1,9,11,20
9907072,9907072,,62,9,5,14
9506111,9506111,,62,4,2,6
9602148,9602148,,1,10,3,13
9607120,9607120,,1,6,5,11
9807236,9807236,,62,13,11,24
9906010,9906010,,62,16,6,22
2186,2186,,3,134,20,154
2187,2187,,3,3,30,33
2188,2188,,1,5,23,28
9301010,9301010,,1,7,0,7
9706091,9706091,,8,13,20,33
9906096,9906096,,1,4,32,36
9202058,9202058,,1,10,0,10
9209075,9209075,,8,8,4,12
9207010,9207010,,1,8,2,10
9204095,9204095,,8,33,0,33
9304122,9304122,,8,14,0,14
9407180,9407180,,8,9,3,12
9504082,9504082,,8,23,2,25
9504127,9504127,,8,24,4,28
9510059,9510059,,8,6,8,14
9512175,9512175,,8,12,14,26
9605102,9605102,,8,8,3,11
9606015,9606015,,8,8,9,17
9610167,9610167,,8,16,32,48
9610224,9610224,,8,10,11,21
9703222,9703222,,62,1,15,16
9704052,9704052,,8,12,17,29
9809154,9809154,,62,1,3,4
9205065,9205065,,25,7,1,8
9403081,9403081,,1,5,0,5
9207057,9207057,,1,3,0,3
9402042,9402042,,8,21,1,22
9406189,9406189,,2,3,6,9
9410149,9410149,,25,7,1,8
9504099,9504099,,8,5,9,14
9905181,9905181,,1,2,16,18
2189,2189,,34,20,17,37
9908001,9908001,,34,10,20,30
9810069,9810069,,34,8,16,24
2191,2191,,2,13,48,61
9906094,9906094,,54,11,28,39
9910179,9910179,,54,5,21,26
9910237,9910237,,2,13,40,53
9404067,9404067,,2,2,7,9
9702167,9702167,,54,3,46,49
9812082,9812082,,54,15,16,31
9307194,9307194,,34,12,3,15
9906095,9906095,,54,5,12,17
2192,2192,,34,33,7,40
2193,2193,,3,20,3,23
2194,2194,,3,10,25,35
9903117,9903117,,3,3,22,25
2195,2195,,0,1,5,6
9311050,9311050,,0,5,0,5
9406013,9406013,,3,13,1,14
9510197,9510197,,0,8,3,11
9412165,9412165,,0,15,0,15
9501012,9501012,,0,11,1,12
2196,2196,,11,10,9,19
9601154,9601154,,25,11,13,24
9309127,9309127,,25,6,0,6
9406144,9406144,,25,11,2,13
9412161,9412161,,25,15,6,21
9210013,9210013,,25,22,0,22
9302078,9302078,,25,12,0,12
9406210,9406210,,25,14,1,15
2197,2197,,16,1,4,5
9310085,9310085,,16,13,0,13
9503137,9503137,,16,13,1,14
9602027,9602027,,16,8,10,18
9608103,9608103,,16,4,0,4
9312102,9312102,,16,16,0,16
9308067,9308067,,16,2,0,2
9308130,9308130,,16,5,0,5
9412018,9412018,,16,16,3,19
9502113,9502113,,16,18,7,25
9505092,9505092,,16,1,2,3
9505168,9505168,,16,3,2,5
2198,2198,,3,13,25,38
9911147,9911147,,2,37,29,66
9305117,9305117,,8,10,4,14
9405196,9405196,,8,7,9,16
9607117,9607117,,25,2,14,16
9706157,9706157,,2,4,17,21
2199,2199,,34,1,18,19
9910066,9910066,,34,8,25,33
9802106,9802106,,25,2,0,2
2200,2200,,2,0,10,10
9802121,9802121,,2,11,26,37
9910041,9910041,,2,6,42,48
9603107,9603107,,2,5,2,7
9710207,9710207,,2,15,16,31
9805113,9805113,,2,5,21,26
9807004,9807004,,16,10,6,16
9901130,9901130,,2,5,14,19
9907019,9907019,,2,9,37,46
2201,2201,,11,0,2,2
9908119,9908119,,11,2,2,4
9306132,9306132,,6,28,0,28
9403147,9403147,,11,15,2,17
9412145,9412145,,11,2,3,5
9510050,9510050,,11,3,1,4
9612250,9612250,,11,5,5,10
9707136,9707136,,11,12,2,14
2202,2202,,2,0,22,22
9912244,9912244,,2,3,31,34
9201005,9201005,,25,30,0,30
9202008,9202008,,16,8,0,8
9206085,9206085,,16,2,0,2
9912074,9912074,,54,7,3,10
2203,2203,,16,1,2,3
9810198,9810198,,62,8,22,30
9206045,9206045,,16,9,0,9
9211132,9211132,,16,14,0,14
9306106,9306106,,19,9,0,9
9307156,9307156,,62,2,3,5
9312055,9312055,,62,3,1,4
9406117,9406117,,16,7,0,7
9406162,9406162,,19,6,4,10
9410121,9410121,,62,1,3,4
9411016,9411016,,6,7,2,9
9705020,9705020,,34,2,3,5
9710015,9710015,,34,2,5,7
9808011,9808011,,9,1,2,3
2204,2204,,2,6,11,17
2205,2205,,37,9,33,42
2206,2206,,11,0,2,2
9909044,9909044,,11,6,5,11
9409115,9409115,,11,1,0,1
2207,2207,,2,0,5,5
9201051,9201051,,37,6,0,6
9612065,9612065,,2,12,11,23
9505161,9505161,,25,52,13,65
9605008,9605008,,25,27,5,32
2208,2208,,19,2,2,4
9809030,9809030,,19,2,2,4
9305004,9305004,,19,11,0,11
9805124,9805124,,16,4,10,14
2209,2209,,16,3,18,21
9412110,9412110,,16,3,6,9
9910088,9910088,,16,2,9,11
9910264,9910264,,16,3,9,12
9212090,9212090,,16,28,0,28
9212148,9212148,,16,3,0,3
9304060,9304060,,37,16,1,17
9305095,9305095,,37,16,3,19
9306110,9306110,,16,3,4,7
9308132,9308132,,16,4,2,6
9308135,9308135,,16,3,0,3
9310153,9310153,,16,3,0,3
9312018,9312018,,16,6,5,11
9401115,9401115,,16,19,2,21
9401130,9401130,,37,2,1,3
9402041,9402041,,16,6,4,10
9403126,9403126,,16,6,4,10
9406046,9406046,,16,5,6,11
9406100,9406100,,16,5,10,15
9408029,9408029,,16,9,13,22
9408046,9408046,,16,14,9,23
2210,2210,,3,38,2,40
9404166,9404166,,2,1,2,3
9511170,9511170,,19,3,2,5
9507038,9507038,,4,5,4,9
9605075,9605075,,4,4,19,23
9606153,9606153,,4,7,10,17
2212,2212,,3,3,11,14
9701182,9701182,,3,2,0,2
9810149,9810149,,37,6,18,24
9810164,9810164,,3,5,4,9
9909206,9909206,,3,4,4,8
9503080,9503080,,65,4,0,4
9703105,9703105,,11,3,4,7
2213,2213,,62,8,8,16
2214,2214,,54,2,15,17
9811096,9811096,,54,5,33,38
9901123,9901123,,54,9,25,34
2215,2215,,31,1,14,15
9410217,9410217,,2,14,5,19
2216,2216,,1,1,11,12
9509062,9509062,,7,9,6,15
2217,2217,,37,4,15,19
5274,5274,,37,4,17,21
9607219,9607219,,37,12,18,30
9610216,9610216,,37,8,14,22
9705108,9705108,,37,19,5,24
9711028,9711028,,37,14,12,26
9801033,9801033,,37,11,7,18
9809125,9809125,,37,12,5,17
9910042,9910042,,37,4,39,43
9809126,9809126,,37,11,5,16
9809127,9809127,,37,13,20,33
9909201,9909201,,37,10,13,23
9506007,9506007,,37,12,6,18
9605191,9605191,,37,4,0,4
9604191,9604191,,37,7,1,8
9709200,9709200,,37,4,1,5
9208023,9208023,,54,11,0,11
2218,2218,,65,1,5,6
9605169,9605169,,16,3,7,10
9711008,9711008,,16,1,14,15
9301038,9301038,,16,38,4,42
9412203,9412203,,16,26,7,33
9508099,9508099,,62,10,7,17
9510199,9510199,,16,7,28,35
9510208,9510208,,16,4,8,12
9311165,9311165,,62,3,0,3
9510137,9510137,,16,10,15,25
9603030,9603030,,16,6,5,11
9607218,9607218,,16,2,9,11
9608030,9608030,,16,1,20,21
9611207,9611207,,16,4,5,9
9211138,9211138,,65,6,1,7
9803129,9803129,,65,4,4,8
2219,2219,,62,4,17,21
9203062,9203062,,62,8,0,8
9204080,9204080,,62,1,0,1
9309018,9309018,,11,4,0,4
9206096,9206096,,62,32,0,32
9208058,9208058,,62,13,0,13
9304125,9304125,,8,17,6,23
9308086,9308086,,62,5,7,12
9408167,9408167,,62,11,1,12
9505017,9505017,,62,9,4,13
9304080,9304080,,62,3,3,6
9306031,9306031,,62,2,0,2
9409047,9409047,,34,4,1,5
2220,2220,,0,0,4,4
106067,106067,,0,18,9,27
9906047,9906047,,34,2,9,11
5016,5016,,0,84,14,98
8054,8054,,0,58,26,84
104146,104146,,2,17,22,39
106050,106050,,0,14,17,31
2221,2221,,16,0,8,8
9407076,9407076,,16,16,3,19
9502088,9502088,,16,5,1,6
9712139,9712139,,16,8,12,20
9812105,9812105,,16,5,12,17
9905057,9905057,,16,17,29,46
9210124,9210124,,16,13,0,13
9212110,9212110,,16,18,0,18
9401055,9401055,,16,2,3,5
9407070,9407070,,16,6,1,7
9502110,9502110,,6,18,4,22
9305032,9305032,,16,11,0,11
9402093,9402093,,16,11,4,15
9412084,9412084,,16,10,3,13
9607030,9607030,,16,10,3,13
9602165,9602165,,16,4,3,7
9804122,9804122,,16,6,4,10
9201027,9201027,,16,15,0,15
9305021,9305021,,19,9,1,10
9312214,9312214,,16,2,1,3
9312215,9312215,,16,2,3,5
9401095,9401095,,16,3,2,5
9709068,9709068,,8,3,4,7
2222,2222,,37,74,40,114
9503017,9503017,,37,14,22,36
9511206,9511206,,37,5,5,10
9611053,9611053,,37,3,7,10
9911220,9911220,,37,1,7,8
9204020,9204020,,65,11,0,11
9312004,9312004,,65,12,0,12
9405106,9405106,,37,11,3,14
9409029,9409029,,54,3,0,3
9411135,9411135,,37,10,4,14
9401029,9401029,,54,12,2,14
9505122,9505122,,37,10,17,27
9512131,9512131,,25,2,7,9
9809197,9809197,,16,10,12,22
2223,2223,,4,75,24,99
2224,2224,,67,0,1,1
9806183,9806183,,67,3,0,3
2225,2225,,62,5,16,21
9612154,9612154,,62,7,8,15
9909065,9909065,,62,9,12,21
9911216,9911216,,62,11,8,19
9308057,9308057,,62,21,3,24
9501029,9501029,,62,13,13,26
9205055,9205055,,62,8,0,8
9208066,9208066,,62,31,0,31
9208067,9208067,,62,15,0,15
9209130,9209130,,62,10,0,10
9501006,9501006,,62,2,2,4
9601040,9601040,,62,2,6,8
9205084,9205084,,4,19,0,19
9312207,9312207,,62,6,1,7
9501017,9501017,,62,11,1,12
9511209,9511209,,62,13,5,18
9606072,9606072,,62,9,7,16
9607154,9607154,,16,8,4,12
9912122,9912122,,34,3,10,13
9906077,9906077,,34,4,21,25
3289,3289,,34,9,42,51
9611145,9611145,,25,10,9,19
9910255,9910255,,34,1,11,12
2227,2227,,37,5,1,6
2228,2228,,34,20,24,44
2229,2229,,65,2,8,10
9705122,9705122,,65,29,16,45
9811256,9811256,,65,8,19,27
9903170,9903170,,65,4,24,28
9904188,9904188,,65,3,21,24
9209076,9209076,,65,43,0,43
9411003,9411003,,65,13,3,16
9507014,9507014,,65,10,7,17
9511061,9511061,,65,11,11,22
9310145,9310145,,7,5,1,6
9509019,9509019,,7,9,9,18
9605212,9605212,,65,12,24,36
9611199,9611199,,65,14,21,35
9307030,9307030,,65,9,0,9
9903152,9903152,,65,6,26,32
9804113,9804113,,2,2,26,28
2232,2232,,62,0,7,7
9905133,9905133,,62,2,15,17
2233,2233,,3,25,4,29
9312048,9312048,,3,17,1,18
9503046,9503046,,3,14,0,14
9612017,9612017,,3,42,9,51
9304142,9304142,,62,5,0,5
9403009,9403009,,6,3,2,5
9511219,9511219,,6,7,1,8
9607204,9607204,,2,8,8,16
2234,2234,,6,3,6,9
9904185,9904185,,6,1,2,3
9904204,9904204,,6,6,3,9
9906146,9906146,,6,6,11,17
9207008,9207008,,6,16,0,16
9502033,9502033,,6,8,8,16
9502137,9502137,,37,8,4,12
9703152,9703152,,6,7,4,11
9704023,9704023,,6,8,12,20
9706133,9706133,,6,7,33,40
9803247,9803247,,6,3,13,16
9906124,9906124,,6,9,9,18
2235,2235,,34,1,17,18
2236,2236,,3,24,6,30
9503194,9503194,,6,8,6,14
2237,2237,,4,133,24,157
2238,2238,,16,1,3,4
9302012,9302012,,16,4,0,4
9406140,9406140,,25,6,0,6
2239,2239,,25,13,9,22
9312080,9312080,,25,12,0,12
9511060,9511060,,25,15,7,22
9608192,9608192,,25,4,1,5
2240,2240,,54,7,14,21
9209059,9209059,,54,2,0,2
9210053,9210053,,54,3,0,3
9402114,9402114,,54,10,8,18
2241,2241,,54,4,9,13
2242,2242,,2,15,41,56
9202075,9202075,,25,13,0,13
9503084,9503084,,2,2,9,11
9506065,9506065,,2,8,35,43
9711042,9711042,,2,16,24,40
9802140,9802140,,54,4,20,24
2243,2243,,16,2,3,5
9405173,9405173,,16,8,0,8
9906189,9906189,,16,6,5,11
9812147,9812147,,16,6,1,7
9901100,9901100,,16,5,3,8
9905077,9905077,,16,4,6,10
2244,2244,,2,14,40,54
9803069,9803069,,37,3,29,32
9907215,9907215,,54,8,28,36
9911113,9911113,,37,6,29,35
9912157,9912157,,37,15,26,41
9810213,9810213,,54,2,16,18
2245,2245,,6,52,57,109
9306054,9306054,,6,14,0,14
9407129,9407129,,6,9,0,9
9410190,9410190,,8,6,1,7
9411202,9411202,,6,14,5,19
9502087,9502087,,6,2,2,4
9504036,9504036,,6,4,8,12
9504037,9504037,,6,2,6,8
9509035,9509035,,6,14,18,32
9509047,9509047,,6,7,15,22
9510116,9510116,,6,3,5,8
9510195,9510195,,6,7,12,19
9602163,9602163,,6,9,2,11
9702042,9702042,,6,9,6,15
9703017,9703017,,6,3,4,7
9708159,9708159,,6,5,9,14
9712125,9712125,,6,7,18,25
9712226,9712226,,6,28,19,47
9802027,9802027,,6,5,7,12
9802118,9802118,,6,6,16,22
9807016,9807016,,6,14,4,18
9811231,9811231,,6,5,8,13
9906115,9906115,,6,1,2,3
9906121,9906121,,6,1,4,5
9909223,9909223,,6,4,16,20
9910201,9910201,,6,6,14,20
9911092,9911092,,6,7,11,18
9912021,9912021,,6,4,18,22
9306135,9306135,,6,4,1,5
9307027,9307027,,8,13,1,14
9310123,9310123,,6,19,3,22
9407061,9407061,,6,7,10,17
9404183,9404183,,6,2,1,3
9210038,9210038,,6,12,0,12
9402108,9402108,,6,7,3,10
9307169,9307169,,6,13,2,15
9312087,9312087,,6,9,3,12
9405133,9405133,,6,7,7,14
9503022,9503022,,2,8,11,19
9304007,9304007,,6,9,1,10
9310179,9310179,,6,15,6,21
9405064,9405064,,6,2,0,2
9209099,9209099,,4,21,1,22
9406095,9406095,,4,3,3,6
9505156,9505156,,6,9,14,23
9512032,9512032,,4,2,6,8
9304035,9304035,,6,3,0,3
9604025,9604025,,6,14,13,27
9605218,9605218,,6,4,6,10
9704046,9704046,,6,1,3,4
9510167,9510167,,11,17,1,18
9707063,9707063,,2,10,15,25
9709021,9709021,,6,12,5,17
9604002,9604002,,6,10,2,12
9210084,9210084,,6,1,0,1
9406103,9406103,,16,7,1,8
9412164,9412164,,6,3,2,5
9808055,9808055,,6,6,7,13
9810183,9810183,,2,1,2,3
9709184,9709184,,6,2,1,3
9905193,9905193,,6,3,7,10
9804153,9804153,,6,3,9,12
9507104,9507104,,6,12,0,12
9507105,9507105,,6,19,0,19
9708140,9708140,,6,12,8,20
9709003,9709003,,6,1,0,1
9810235,9810235,,6,8,1,9
9906209,9906209,,6,1,14,15
2246,2246,,54,0,11,11
2247,2247,,7,1,13,14
9310115,9310115,,7,3,5,8
9404089,9404089,,7,11,1,12
9601020,9601020,,7,8,9,17
9603174,9603174,,7,13,4,17
9607114,9607114,,7,12,9,21
9609133,9609133,,7,6,6,12
9709141,9709141,,7,4,2,6
9801148,9801148,,7,2,11,13
9805020,9805020,,7,6,8,14
9210133,9210133,,7,5,0,5
9310177,9310177,,2,3,4,7
9412100,9412100,,7,2,0,2
9406089,9406089,,7,17,1,18
9409169,9409169,,7,11,4,15
9408027,9408027,,8,7,1,8
9403109,9403109,,7,7,1,8
9412022,9412022,,7,5,2,7
9605186,9605186,,7,1,5,6
2248,2248,,11,0,3,3
9907182,9907182,,11,17,6,23
2249,2249,,34,0,13,13
2250,2250,,3,2,25,27
9807192,9807192,,2,6,3,9
2251,2251,,16,3,2,5
9910103,9910103,,16,2,6,8
9908131,9908131,,16,2,6,8
2252,2252,,2,0,6,6
9703188,9703188,,1,4,15,19
2254,2254,,11,3,5,8
2255,2255,,34,1,16,17
2256,2256,,34,14,15,29
9206044,9206044,,25,49,0,49
9410041,9410041,,34,26,12,38
9610201,9610201,,25,11,15,26
9810251,9810251,,34,38,7,45
9910065,9910065,,34,29,26,55
9910076,9910076,,34,21,23,44
9910220,9910220,,7,5,13,18
9203050,9203050,,25,12,0,12
9305107,9305107,,2,9,2,11
9312171,9312171,,25,10,12,22
9501016,9501016,,25,18,0,18
9505136,9505136,,25,13,3,16
9506128,9506128,,25,7,5,12
9510109,9510109,,25,20,11,31
9506212,9506212,,34,2,0,2
9803083,9803083,,34,5,12,17
9802158,9802158,,25,14,10,24
9811059,9811059,,25,10,10,20
9811122,9811122,,34,7,11,18
9810169,9810169,,34,21,1,22
9901087,9901087,,34,9,21,30
9202086,9202086,,34,3,0,3
9909180,9909180,,34,7,19,26
9906187,9906187,,25,6,13,19
9903136,9903136,,7,7,0,7
9907065,9907065,,7,4,1,5
9908180,9908180,,1,7,9,16
2258,2258,,2,0,15,15
9408003,9408003,,4,2,1,3
9701122,9701122,,2,11,3,14
2259,2259,,16,0,1,1
9811236,9811236,,16,3,3,6
9801197,9801197,,16,3,2,5
9809110,9809110,,16,2,0,2
3001,3001,,16,2,7,9
9310055,9310055,,16,8,2,10
9502104,9502104,,16,1,10,11
9903153,9903153,,16,7,15,22
9211045,9211045,,16,6,0,6
9211052,9211052,,62,9,0,9
9309017,9309017,,16,2,0,2
9312155,9312155,,16,1,0,1
9408095,9408095,,16,3,0,3
9411223,9411223,,16,6,10,16
9306161,9306161,,11,19,0,19
9503232,9503232,,8,20,9,29
9208040,9208040,,16,8,0,8
9602029,9602029,,16,11,21,32
9609155,9609155,,16,5,2,7
9709097,9709097,,16,12,6,18
9806133,9806133,,16,23,16,39
9807022,9807022,,16,9,7,16
9808120,9808120,,16,18,23,41
3002,3002,,0,10,6,16
3003,3003,,2,3,5,8
9812004,9812004,,37,2,3,5
9906079,9906079,,2,8,11,19
9702065,9702065,,2,12,7,19
3004,3004,,34,18,2,20
3005,3005,,25,12,5,17
3006,3006,,3,28,14,42
3007,3007,,3,40,44,84
9412129,9412129,,16,3,2,5
9507088,9507088,,16,3,4,7
3008,3008,,0,3,2,5
9411092,9411092,,0,4,0,4
9307148,9307148,,11,4,2,6
3009,3009,,16,4,22,26
3010,3010,,6,5,2,7
9912289,9912289,,6,5,0,5
3012,3012,,3,20,17,37
9812143,9812143,,3,6,35,41
9712090,9712090,,2,10,15,25
3013,3013,,34,5,1,6
9508176,9508176,,6,5,6,11
9301113,9301113,,6,5,2,7
3014,3014,,19,6,2,8
9305052,9305052,,19,25,0,25
9305011,9305011,,19,9,1,10
3015,3015,,11,0,2,2
9712094,9712094,,11,2,0,2
9812064,9812064,,11,4,2,6
9608033,9608033,,11,3,2,5
9705184,9705184,,11,3,2,5
3016,3016,,31,3,1,4
3017,3017,,34,6,21,27
9712176,9712176,,54,7,7,14
3018,3018,,3,5,6,11
9401112,9401112,,7,5,2,7
9208006,9208006,,7,27,0,27
9210141,9210141,,7,42,0,42
9311112,9311112,,7,4,2,6
9402037,9402037,,7,13,3,16
9402060,9402060,,7,3,10,13
3019,3019,,4,0,31,31
9807188,9807188,,2,3,26,29
9410142,9410142,,2,10,13,23
9411195,9411195,,2,8,20,28
9711175,9711175,,6,2,15,17
9408178,9408178,,54,5,4,9
9503106,9503106,,37,20,14,34
9507040,9507040,,2,17,8,25
9508159,9508159,,2,11,11,22
9711115,9711115,,2,12,17,29
9802063,9802063,,2,10,10,20
3020,3020,,0,42,38,80
3021,3021,,11,0,5,5
9407028,9407028,,11,3,1,4
3023,3023,,2,1,7,8
9302073,9302073,,8,10,1,11
9406093,9406093,,2,4,7,11
9607236,9607236,,2,12,13,25
9612218,9612218,,8,18,12,30
3024,3024,,54,41,24,65
9909167,9909167,,2,8,16,24
3025,3025,,4,35,49,84
9908075,9908075,,37,13,19,32
9912101,9912101,,2,8,18,26
9511213,9511213,,2,7,37,44
9602112,9602112,,2,2,4,6
9604164,9604164,,54,9,23,32
9612219,9612219,,14,1,5,6
9705099,9705099,,31,6,6,12
9711157,9711157,,37,8,40,48
9506170,9506170,,19,22,5,27
9808111,9808111,,37,22,22,44
9903005,9903005,,16,27,4,31
9904118,9904118,,37,9,9,18
9904181,9904181,,37,9,20,29
9908006,9908006,,37,9,22,31
9806228,9806228,,62,10,0,10
9912104,9912104,,2,6,38,44
3026,3026,,34,4,13,17
3027,3027,,8,3,14,17
9201026,9201026,,8,44,0,44
9201057,9201057,,8,4,0,4
9202072,9202072,,7,23,0,23
9205102,9205102,,8,17,0,17
9206098,9206098,,8,21,0,21
9211113,9211113,,8,19,0,19
9301074,9301074,,8,6,1,7
9408127,9408127,,6,7,8,15
9411125,9411125,,8,10,5,15
9412078,9412078,,8,9,10,19
9602173,9602173,,8,4,11,15
9802083,9802083,,8,4,5,9
9807077,9807077,,8,1,4,5
9302006,9302006,,8,39,1,40
9302110,9302110,,8,10,8,18
9409016,9409016,,62,10,8,18
9303071,9303071,,8,3,2,5
9312093,9312093,,8,6,1,7
9405146,9405146,,8,9,1,10
9409024,9409024,,8,3,1,4
9411184,9411184,,8,3,8,11
9208072,9208072,,8,6,0,6
9304040,9304040,,8,3,0,3
9307015,9307015,,8,5,9,14
9209078,9209078,,8,3,0,3
9606163,9606163,,8,2,0,2
3028,3028,,19,0,2,2
9810199,9810199,,19,11,19,30
9507136,9507136,,19,19,0,19
9509110,9509110,,19,19,2,21
9411238,9411238,,19,14,4,18
9709079,9709079,,19,13,6,19
9710172,9710172,,19,2,4,6
9802071,9802071,,19,13,27,40
9805204,9805204,,19,13,10,23
9806047,9806047,,19,4,11,15
9808036,9808036,,19,2,9,11
9810044,9810044,,19,4,6,10
3029,3029,,8,28,21,49
9807091,9807091,,8,32,20,52
9810019,9810019,,8,11,1,12
9912143,9912143,,8,18,7,25
9501021,9501021,,8,2,2,4
9207031,9207031,,8,2,0,2
9207072,9207072,,8,5,0,5
9208069,9208069,,8,6,0,6
9302124,9302124,,8,19,6,25
9303119,9303119,,8,2,1,3
9407068,9407068,,8,3,5,8
9407074,9407074,,8,5,6,11
9307183,9307183,,8,13,0,13
9408173,9408173,,62,5,3,8
9509137,9509137,,8,16,1,17
9408082,9408082,,8,3,9,12
9607036,9607036,,8,10,11,21
9507083,9507083,,65,4,1,5
3030,3030,,11,12,1,13
9909011,9909011,,11,33,6,39
9511068,9511068,,11,13,2,15
9712181,9712181,,11,8,2,10
9802154,9802154,,11,4,3,7
9905109,9905109,,11,2,2,4
3031,3031,,4,97,9,106
3032,3032,,34,17,57,74
9911172,9911172,,34,8,35,43
9309075,9309075,,4,79,4,83
9802015,9802015,,0,28,2,30
9207074,9207074,,0,4,0,4
9805123,9805123,,37,4,38,42
9806165,9806165,,8,3,2,5
9811128,9811128,,37,6,31,37
9906211,9906211,,34,7,22,29
3033,3033,,4,15,45,60
9907094,9907094,,4,3,8,11
9908121,9908121,,4,2,26,28
9912090,9912090,,4,4,31,35
3034,3034,,37,2,1,3
3035,3035,,1,5,12,17
3036,3036,,1,6,10,16
9211112,9211112,,62,3,0,3
9311167,9311167,,62,6,2,8
9312040,9312040,,8,4,1,5
3037,3037,,65,107,27,134
9409037,9409037,,2,17,2,19
3038,3038,,34,13,21,34
3039,3039,,11,2,1,3
9811160,9811160,,11,1,3,4
9801188,9801188,,11,3,0,3
9806164,9806164,,11,1,1,2
3040,3040,,8,0,4,4
9803113,9803113,,25,2,2,4
9907208,9907208,,0,11,6,17
9701124,9701124,,8,4,5,9
9702092,9702092,,8,1,1,2
9510206,9510206,,25,4,6,10
9901023,9901023,,0,20,5,25
9906113,9906113,,7,4,0,4
3041,3041,,34,2,12,14
3042,3042,,34,5,19,24
9404006,9404006,,2,5,4,9
9507005,9507005,,2,14,29,43
9507164,9507164,,2,20,14,34
9604071,9604071,,2,2,9,11
3043,3043,,11,3,7,10
9809018,9809018,,11,13,9,22
9809183,9809183,,11,8,6,14
9812112,9812112,,11,7,13,20
9902177,9902177,,11,6,11,17
9908033,9908033,,11,5,20,25
9911231,9911231,,11,2,10,12
9605086,9605086,,11,28,3,31
9612109,9612109,,11,6,1,7
9707097,9707097,,11,8,9,17
9806153,9806153,,11,18,9,27
9805175,9805175,,11,15,9,24
9802050,9802050,,11,4,3,7
9701083,9701083,,11,6,1,7
9801024,9801024,,11,40,15,55
9906032,9906032,,11,6,21,27
9605214,9605214,,11,8,4,12
9909156,9909156,,11,3,2,5
3044,3044,,8,2,7,9
9610064,9610064,,8,8,14,22
9710067,9710067,,8,6,15,21
9802127,9802127,,8,11,13,24
9803144,9803144,,8,9,4,13
9806138,9806138,,8,6,9,15
9608022,9608022,,54,5,6,11
9610108,9610108,,8,12,22,34
3045,3045,,0,32,10,42
3046,3046,,34,6,3,9
9912119,9912119,,34,8,7,15
3047,3047,,1,0,13,13
9702143,9702143,,62,3,6,9
9201050,9201050,,8,18,0,18
9202060,9202060,,8,7,0,7
9209111,9209111,,8,19,1,20
9210134,9210134,,8,11,0,11
9212016,9212016,,8,8,0,8
9212017,9212017,,8,10,2,12
9212117,9212117,,8,13,4,17
9201078,9201078,,19,11,0,11
9205113,9205113,,19,10,0,10
9210049,9210049,,19,9,0,9
9210064,9210064,,19,3,0,3
9302071,9302071,,19,6,5,11
9305093,9305093,,19,8,6,14
9305094,9305094,,19,5,6,11
9306156,9306156,,19,2,8,10
9310102,9310102,,62,7,1,8
9610013,9610013,,62,1,0,1
3048,3048,,7,8,7,15
9204074,9204074,,7,11,0,11
9902204,9902204,,7,6,8,14
9903193,9903193,,7,6,2,8
9801037,9801037,,2,1,4,5
9902024,9902024,,2,16,6,22
3049,3049,,62,7,2,9
3050,3050,,34,16,39,55
3051,3051,,34,15,22,37
9408062,9408062,,34,6,1,7
9401091,9401091,,25,9,0,9
9802045,9802045,,2,4,9,13
3052,3052,,0,105,27,132
9710241,9710241,,11,6,7,13
9810107,9810107,,11,6,11,17
3053,3053,,37,14,13,27
3054,3054,,0,47,8,55
3055,3055,,34,34,15,49
9911088,9911088,,34,8,23,31
9910089,9910089,,34,4,27,31
3056,3056,,34,14,35,49
9308126,9308126,,16,6,1,7
9809161,9809161,,16,5,11,16
9810194,9810194,,34,5,11,16
9812162,9812162,,34,3,9,12
9901069,9901069,,16,10,4,14
9204069,9204069,,16,4,0,4
3057,3057,,65,44,21,65
3059,3059,,34,6,21,27
9909124,9909124,,34,4,10,14
9306014,9306014,,34,5,1,6
3060,3060,,31,0,6,6
3061,3061,,0,41,11,52
4004,4004,,0,7,15,22
9207079,9207079,,0,5,0,5
9211117,9211117,,0,5,0,5
9307042,9307042,,0,7,2,9
9307104,9307104,,0,5,2,7
9308030,9308030,,0,7,2,9
3062,3062,,6,2,3,5
9905076,9905076,,6,10,3,13
9912248,9912248,,11,3,12,15
9912278,9912278,,6,4,3,7
9709154,9709154,,6,10,2,12
9803212,9803212,,11,3,4,7
9805118,9805118,,9,2,1,3
3063,3063,,2,18,28,46
9811082,9811082,,2,2,9,11
9906098,9906098,,2,18,10,28
9601004,9601004,,2,1,11,12
3064,3064,,37,5,15,20
9208053,9208053,,37,22,1,23
9502014,9502014,,37,9,2,11
9602117,9602117,,37,4,8,12
9808043,9808043,,16,8,11,19
9902157,9902157,,7,23,21,44
9906130,9906130,,16,3,12,15
9907058,9907058,,2,13,13,26
9211064,9211064,,16,8,0,8
9303093,9303093,,37,28,3,31
9506022,9506022,,37,6,9,15
9410087,9410087,,16,3,8,11
9605013,9605013,,37,4,7,11
9604011,9604011,,37,4,6,10
9306039,9306039,,7,19,1,20
9405008,9405008,,7,17,1,18
9503077,9503077,,7,9,0,9
9510184,9510184,,7,10,4,14
9512147,9512147,,16,8,17,25
9607083,9607083,,62,4,10,14
9702066,9702066,,7,4,5,9
9806189,9806189,,7,5,7,12
9810211,9810211,,7,5,7,12
9305041,9305041,,16,10,3,13
9610037,9610037,,16,12,25,37
9811216,9811216,,16,2,8,10
9904058,9904058,,16,2,9,11
3065,3065,,16,1,10,11
3066,3066,,0,6,5,11
9312172,9312172,,4,71,15,86
9507143,9507143,,4,66,5,71
9604047,9604047,,2,5,2,7
3067,3067,,0,42,9,51
3068,3068,,1,5,22,27
3069,3069,,2,0,17,17
9904018,9904018,,2,3,27,30
9609151,9609151,,54,8,13,21
9707043,9707043,,2,4,6,10
9803218,9803218,,6,1,9,10
9608011,9608011,,11,3,11,14
9711100,9711100,,4,12,6,18
9807066,9807066,,3,7,6,13
3070,3070,,8,6,10,16
9810161,9810161,,8,2,21,23
9404149,9404149,,16,1,13,14
9511197,9511197,,8,1,1,2
9804143,9804143,,8,19,6,25
9807072,9807072,,8,8,6,14
3071,3071,,34,4,12,16
9705094,9705094,,2,3,33,36
9208036,9208036,,34,11,1,12
9503089,9503089,,34,9,2,11
9502001,9502001,,2,22,11,33
9607102,9607102,,2,6,10,16
9610170,9610170,,2,16,27,43
3072,3072,,2,7,18,25
9901028,9901028,,54,1,30,31
3073,3073,,14,2,7,9
9504031,9504031,,14,9,4,13
9303102,9303102,,14,3,0,3
9509101,9509101,,2,2,6,8
3074,3074,,0,42,9,51
3075,3075,,2,113,19,132
3076,3076,,0,33,59,92
4028,4028,,0,30,12,42
8151,8151,,0,29,69,98
3162,3162,,0,14,16,30
4057,4057,,0,22,16,38
3256,3256,,54,19,30,49
3269,3269,,0,11,35,46
3275,3275,,0,5,6,11
4005,4005,,0,41,13,54
4022,4022,,0,14,9,23
4056,4056,,0,34,22,56
4109,4109,,0,40,11,51
4126,4126,,0,49,20,69
4160,4160,,0,59,26,85
5013,5013,,0,6,12,18
5025,5025,,0,55,14,69
5032,5032,,0,66,32,98
5066,5066,,0,13,27,40
5139,5139,,0,20,14,34
5189,5189,,25,6,7,13
5193,5193,,0,8,7,15
6030,6030,,0,25,27,52
7064,7064,,0,93,41,134
7065,7065,,0,24,6,30
7177,7177,,0,67,47,114
7254,7254,,0,10,15,25
8102,8102,,0,15,51,66
3077,3077,,6,2,2,4
3078,3078,,54,2,25,27
9912150,9912150,,54,9,17,26
9706035,9706035,,54,1,7,8
9803254,9803254,,54,2,15,17
9903028,9903028,,54,21,15,36
3080,3080,,10,0,2,2
9901090,9901090,,10,1,0,1
9911024,9911024,,10,1,0,1
3081,3081,,4,2,11,13
9805081,9805081,,25,14,11,25
9901026,9901026,,25,5,3,8
9401131,9401131,,25,11,9,20
9503024,9503024,,25,5,0,5
9505021,9505021,,25,5,5,10
9407173,9407173,,25,6,12,18
9403018,9403018,,25,26,3,29
9802160,9802160,,25,5,3,8
9804033,9804033,,25,11,5,16
3082,3082,,16,5,1,6
9802120,9802120,,16,11,5,16
9710240,9710240,,16,14,9,23
3083,3083,,2,0,7,7
9906154,9906154,,2,5,23,28
9403031,9403031,,11,11,1,12
9407175,9407175,,11,13,0,13
9503184,9503184,,11,10,1,11
9505144,9505144,,11,8,10,18
9306130,9306130,,54,5,1,6
9901066,9901066,,2,1,11,12
3084,3084,,19,1,9,10
4132,4132,,19,1,3,4
9603152,9603152,,19,9,3,12
9603189,9603189,,19,3,0,3
9702097,9702097,,19,5,1,6
9703144,9703144,,19,2,5,7
9709077,9709077,,19,6,14,20
9711084,9711084,,19,11,29,40
9412188,9412188,,19,6,2,8
9507021,9507021,,19,3,0,3
9302074,9302074,,25,22,0,22
9401057,9401057,,19,10,2,12
9505065,9505065,,19,13,5,18
9512200,9512200,,19,5,3,8
9605195,9605195,,19,8,3,11
9611138,9611138,,19,1,7,8
9612168,9612168,,19,8,7,15
9707248,9707248,,19,6,3,9
9207077,9207077,,25,12,1,13
9306097,9306097,,25,3,14,17
9308019,9308019,,25,11,3,14
9312164,9312164,,19,16,1,17
9408101,9408101,,19,3,7,10
9411012,9411012,,25,13,0,13
9411216,9411216,,19,3,2,5
9412149,9412149,,19,5,4,9
9511059,9511059,,19,7,5,12
9602110,9602110,,19,6,5,11
9603172,9603172,,19,4,6,10
9606051,9606051,,19,1,5,6
9609018,9609018,,19,1,8,9
9701032,9701032,,25,3,16,19
3085,3085,,37,25,29,54
9903056,9903056,,37,12,30,42
9906031,9906031,,37,12,40,52
9909125,9909125,,37,12,24,36
9911114,9911114,,37,13,29,42
9912273,9912273,,37,4,15,19
9604104,9604104,,65,5,7,12
9306072,9306072,,65,6,0,6
9801171,9801171,,65,9,2,11
3086,3086,,0,14,125,139
3117,3117,,54,68,2,70
3148,3148,,0,11,20,31
3197,3197,,0,37,14,51
3237,3237,,0,64,11,75
3248,3248,,54,32,5,37
4003,4003,,0,18,22,40
4094,4094,,31,3,12,15
4155,4155,,0,14,22,36
5028,5028,,2,20,16,36
5212,5212,,31,36,12,48
5239,5239,,0,46,20,66
5248,5248,,0,13,14,27
6044,6044,,0,8,30,38
6069,6069,,0,9,26,35
6139,6139,,0,54,19,73
6164,6164,,0,3,11,14
6204,6204,,54,23,55,78
6232,6232,,0,41,29,70
7014,7014,,0,3,39,42
7044,7044,,54,94,36,130
7060,7060,,0,12,7,19
7120,7120,,0,41,35,76
7159,7159,,31,10,11,21
7178,7178,,16,1,7,8
7223,7223,,0,3,15,18
7239,7239,,0,15,31,46
8008,8008,,54,16,14,30
8087,8087,,0,15,18,33
8188,8188,,0,42,24,66
8190,8190,,0,29,23,52
8192,8192,,0,35,25,60
8193,8193,,0,2,15,17
8197,8197,,0,4,7,11
8245,8245,,0,5,13,18
9006,9006,,34,1,19,20
9010,9010,,0,18,15,33
9056,9056,,0,22,24,46
9059,9059,,0,10,42,52
9064,9064,,0,4,6,10
9083,9083,,54,31,9,40
9087,9087,,0,10,23,33
9122,9122,,0,20,8,28
9127,9127,,0,19,13,32
9132,9132,,0,3,27,30
9160,9160,,0,21,22,43
9167,9167,,54,24,18,42
9175,9175,,0,11,28,39
9180,9180,,3,3,14,17
9183,9183,,0,20,20,40
9184,9184,,0,5,24,29
9199,9199,,0,13,40,53
9207,9207,,0,2,19,21
9212,9212,,0,23,11,34
9247,9247,,0,16,32,48
10063,10063,,0,24,16,40
10093,10093,,0,18,34,52
9803120,9803120,,2,12,28,40
9903039,9903039,,2,7,16,23
9910161,9910161,,31,4,25,29
9911117,9911117,,31,7,23,30
9911217,9911217,,0,6,8,14
9908100,9908100,,54,3,22,25
3236,3236,,0,42,12,54
9905114,9905114,,7,4,3,7
9906144,9906144,,25,18,7,25
3103,3103,,34,20,19,39
4095,4095,,54,5,24,29
4103,4103,,54,45,43,88
9910251,9910251,,1,4,14,18
9611151,9611151,,2,5,36,41
9705185,9705185,,2,8,0,8
9707167,9707167,,2,8,4,12
9904094,9904094,,2,5,23,28
9911004,9911004,,34,12,20,32
4067,4067,,0,38,18,56
4166,4166,,0,74,20,94
4039,4039,,2,10,24,34
9402088,9402088,,31,6,1,7
9511075,9511075,,31,7,1,8
3109,3109,,0,10,15,25
4134,4134,,0,42,10,52
5014,5014,,0,10,27,37
5206,5206,,0,9,21,30
5276,5276,,0,28,31,59
4133,4133,,0,60,28,88
4165,4165,,54,42,21,63
4206,4206,,0,17,19,36
5001,5001,,0,13,17,30
3198,3198,,54,63,40,103
5121,5121,,54,5,31,36
6066,6066,,34,56,41,97
5127,5127,,0,32,33,65
5217,5217,,0,28,51,79
5230,5230,,0,10,47,57
6110,6110,,34,1,17,18
3299,3299,,0,5,20,25
9910077,9910077,,2,13,18,31
9910086,9910086,,2,11,8,19
9911253,9911253,,2,23,37,60
4093,4093,,54,47,21,68
4111,4111,,34,63,47,110
7018,7018,,34,159,60,219
3286,3286,,34,48,22,70
6085,6085,,3,54,16,70
3139,3139,,31,24,5,29
4149,4149,,31,3,38,41
6171,6171,,31,14,1,15
6191,6191,,0,10,30,40
9412182,9412182,,16,4,0,4
9508015,9508015,,16,2,3,5
9612018,9612018,,16,9,8,17
9707081,9707081,,16,11,10,21
5068,5068,,54,11,24,35
5185,5185,,34,11,35,46
6007,6007,,0,37,13,50
6115,6115,,0,27,20,47
6146,6146,,0,25,20,45
7203,7203,,0,17,17,34
6093,6093,,0,16,12,28
6203,6203,,0,38,17,55
6251,6251,,0,47,20,67
8079,8079,,0,25,7,32
7205,7205,,0,12,34,46
7029,7029,,0,34,35,69
4124,4124,,0,38,21,59
6213,6213,,0,13,4,17
8074,8074,,0,35,29,64
8134,8134,,0,5,20,25
9706179,9706179,,31,9,3,12
6068,6068,,0,26,10,36
6226,6226,,0,16,25,41
7233,7233,,0,9,6,15
107254,107254,,0,4,7,11
8185,8185,,0,16,5,21
9032,9032,,0,9,27,36
8015,8015,,2,58,46,104
8133,8133,,0,11,26,37
9022,9022,,0,23,39,62
5226,5226,,0,4,7,11
9909144,9909144,,54,13,3,16
3291,3291,,34,3,8,11
5062,5062,,31,4,5,9
7041,7041,,34,3,18,21
9039,9039,,34,12,11,23
8128,8128,,0,27,34,61
4021,4021,,0,6,10,16
7039,7039,,0,2,9,11
8164,8164,,2,15,34,49
8112,8112,,34,36,47,83
9507150,9507150,,3,19,5,24
9910064,9910064,,3,2,7,9
5137,5137,,34,17,27,44
7109,7109,,34,10,54,64
7209,7209,,0,30,60,90
8050,8050,,0,28,20,48
9703063,9703063,,2,5,9,14
6059,6059,,0,17,12,29
6215,6215,,0,16,36,52
8041,8041,,0,12,36,48
4136,4136,,0,3,27,30
5204,5204,,3,102,20,122
6192,6192,,0,18,27,45
5067,5067,,54,68,89,157
6047,6047,,37,42,28,70
7206,7206,,0,13,9,22
9176,9176,,0,29,33,62
9510027,9510027,,31,6,8,14
9707001,9707001,,31,2,17,19
9307059,9307059,,2,11,1,12
9712202,9712202,,2,15,36,51
9908102,9908102,,31,7,29,36
9907207,9907207,,31,1,2,3
3087,3087,,11,1,6,7
3089,3089,,8,0,2,2
9506146,9506146,,8,4,6,10
9712100,9712100,,8,1,3,4
9501002,9501002,,8,2,4,6
3090,3090,,16,0,7,7
9803027,9803027,,16,25,12,37
9811083,9811083,,16,15,12,27
9906087,9906087,,16,19,28,47
9911243,9911243,,16,15,17,32
9307080,9307080,,16,7,1,8
9307146,9307146,,16,8,0,8
9405176,9405176,,16,24,2,26
9504026,9504026,,16,7,13,20
9612021,9612021,,16,15,16,31
9705242,9705242,,16,8,10,18
9507062,9507062,,16,12,11,23
9809165,9809165,,16,9,17,26
9606157,9606157,,16,6,17,23
9802037,9802037,,2,11,15,26
9807035,9807035,,16,5,8,13
9810158,9810158,,16,2,19,21
9811254,9811254,,16,13,22,35
3301,3301,,16,8,3,11
3091,3091,,16,0,4,4
9703074,9703074,,16,2,1,3
9903133,9903133,,16,2,4,6
3092,3092,,6,5,4,9
9707204,9707204,,6,19,4,23
9710199,9710199,,6,9,5,14
9904203,9904203,,6,11,3,14
9407022,9407022,,6,13,5,18
9511129,9511129,,6,14,1,15
9706103,9706103,,16,4,5,9
9709105,9709105,,6,3,15,18
9710060,9710060,,2,3,15,18
9502042,9502042,,62,12,1,13
9805109,9805109,,6,25,25,50
3093,3093,,3,28,11,39
105085,105085,,3,18,21,39
3160,3160,,3,242,35,277
3231,3231,,3,26,19,45
5199,5199,,3,22,5,27
6091,6091,,3,43,26,69
6246,6246,,3,43,9,52
7140,7140,,3,24,41,65
7204,7204,,3,63,10,73
8092,8092,,3,26,36,62
9142,9142,,3,77,41,118
10006,10006,,3,31,26,57
10017,10017,,3,29,34,63
10060,10060,,3,110,51,161
10090,10090,,3,84,21,105
11095,11095,,3,46,81,127
102182,102182,,3,18,18,36
3094,3094,,11,0,1,1
9810138,9810138,,11,4,1,5
9710220,9710220,,11,1,0,1
3095,3095,,11,1,6,7
3096,3096,,34,25,36,61
3097,3097,,2,2,8,10
9708061,9708061,,37,5,2,7
3098,3098,,34,3,5,8
9906035,9906035,,34,3,4,7
9908140,9908140,,34,8,10,18
3099,3099,,3,13,9,22
9811169,9811169,,3,40,7,47
9409193,9409193,,3,4,3,7
9412185,9412185,,3,20,2,22
9507147,9507147,,3,2,2,4
9507148,9507148,,3,1,2,3
9510217,9510217,,7,9,3,12
9606056,9606056,,3,10,6,16
9610035,9610035,,3,11,7,18
9612228,9612228,,3,7,14,21
9401048,9401048,,3,11,0,11
9503152,9503152,,25,4,0,4
9503153,9503153,,3,1,1,2
9503180,9503180,,3,4,0,4
9605129,9605129,,3,5,2,7
9607005,9607005,,3,3,7,10
9612149,9612149,,3,5,6,11
9701081,9701081,,3,15,7,22
9701179,9701179,,3,8,9,17
9706105,9706105,,3,12,16,28
9603071,9603071,,3,13,4,17
9605003,9605003,,3,31,6,37
9611058,9611058,,3,10,1,11
3100,3100,,2,18,31,49
3101,3101,,4,106,25,131
9802061,9802061,,62,22,5,27
9909216,9909216,,62,16,10,26
9204049,9204049,,25,3,0,3
9204084,9204084,,25,8,0,8
9211057,9211057,,25,14,0,14
3102,3102,,34,3,17,20
9811234,9811234,,2,1,3,4
3105,3105,,16,0,1,1
3106,3106,,2,1,22,23
9901045,9901045,,2,22,32,54
9910025,9910025,,8,3,1,4
9910175,9910175,,2,1,24,25
9707130,9707130,,2,17,7,24
9710189,9710189,,2,5,9,14
9806050,9806050,,54,1,13,14
9310081,9310081,,8,1,0,1
3108,3108,,7,3,7,10
9305129,9305129,,7,10,6,16
9309059,9309059,,7,12,0,12
9212157,9212157,,7,10,1,11
9611171,9611171,,25,1,15,16
9206056,9206056,,25,13,1,14
9307052,9307052,,25,1,11,12
9310156,9310156,,25,4,21,25
9505159,9505159,,25,3,3,6
9510107,9510107,,25,1,1,2
3110,3110,,65,22,34,56
9805101,9805101,,62,10,9,19
9410042,9410042,,62,13,4,17
9306103,9306103,,62,8,2,10
9606003,9606003,,62,5,12,17
3111,3111,,6,1,5,6
9711064,9711064,,6,2,1,3
9908208,9908208,,34,9,1,10
3112,3112,,7,4,4,8
9602151,9602151,,7,1,7,8
3113,3113,,3,61,15,76
9602055,9602055,,8,3,4,7
3114,3114,,3,12,4,16
3115,3115,,34,6,22,28
9806156,9806156,,8,7,9,16
3116,3116,,34,20,25,45
9809047,9809047,,34,1,0,1
9403071,9403071,,0,1,0,1
9609024,9609024,,2,4,0,4
3119,3119,,34,0,41,41
9610144,9610144,,16,4,18,22
9307173,9307173,,16,1,7,8
9404136,9404136,,16,5,4,9
9405080,9405080,,16,7,10,17
9606117,9606117,,16,7,14,21
9607013,9607013,,16,2,10,12
3120,3120,,62,18,11,29
3121,3121,,2,8,14,22
9908153,9908153,,2,5,24,29
9906044,9906044,,2,1,76,77
9906137,9906137,,34,2,14,16
3122,3122,,4,79,43,122
9909214,9909214,,3,41,20,61
9610060,9610060,,34,4,5,9
9612027,9612027,,3,5,10,15
3123,3123,,34,6,15,21
9811108,9811108,,8,11,3,14
9910188,9910188,,34,17,20,37
9211139,9211139,,34,6,0,6
9304131,9304131,,34,18,0,18
9412132,9412132,,34,13,3,16
9509142,9509142,,54,18,2,20
9610152,9610152,,34,4,6,10
9701171,9701171,,34,10,4,14
9702141,9702141,,34,3,2,5
9710249,9710249,,34,6,5,11
9804012,9804012,,34,4,8,12
3124,3124,,4,28,28,56
9304006,9304006,,4,2,0,2
3125,3125,,37,1,3,4
9412208,9412208,,37,11,1,12
9602088,9602088,,37,10,3,13
3126,3126,,7,0,2,2
3127,3127,,7,1,6,7
9308027,9308027,,0,28,1,29
9609083,9609083,,7,4,1,5
9612068,9612068,,7,5,6,11
9707227,9707227,,7,6,5,11
9902175,9902175,,7,4,6,10
9903106,9903106,,7,3,9,12
9206113,9206113,,0,4,0,4
9501085,9501085,,7,6,0,6
9402100,9402100,,7,2,0,2
9507016,9507016,,7,10,2,12
9512020,9512020,,7,4,0,4
9705049,9705049,,7,7,1,8
3128,3128,,6,12,10,22
9412136,9412136,,6,19,1,20
9503204,9503204,,6,12,5,17
9509028,9509028,,6,17,2,19
9509159,9509159,,6,7,3,10
9608110,9608110,,6,9,6,15
9808040,9808040,,6,11,6,17
9902146,9902146,,6,9,10,19
9903121,9903121,,6,14,12,26
9502081,9502081,,6,5,4,9
9502082,9502082,,6,3,3,6
9711056,9711056,,6,14,4,18
9408090,9408090,,6,7,0,7
9810212,9810212,,6,4,14,18
3129,3129,,34,4,14,18
3130,3130,,3,5,5,10
3131,3131,,3,3,54,57
9211074,9211074,,62,3,0,3
9805102,9805102,,11,4,9,13
3132,3132,,2,0,4,4
3133,3133,,0,1,9,10
9501045,9501045,,25,2,14,16
9504109,9504109,,25,1,9,10
9705224,9705224,,0,10,0,10
9411020,9411020,,25,12,46,58
9202035,9202035,,25,9,0,9
9207108,9207108,,25,6,0,6
9307140,9307140,,25,4,6,10
9405119,9405119,,25,19,5,24
3134,3134,,19,3,1,4
9811235,9811235,,0,6,2,8
9405166,9405166,,0,15,1,16
9608025,9608025,,0,2,7,9
3135,3135,,6,3,9,12
9710162,9710162,,6,7,7,14
9805030,9805030,,6,6,7,13
9807210,9807210,,6,5,19,24
9204045,9204045,,6,11,0,11
9711191,9711191,,6,10,6,16
9804013,9804013,,6,8,10,18
9909213,9909213,,2,6,18,24
9910250,9910250,,37,2,18,20
9409099,9409099,,54,3,10,13
9611097,9611097,,37,12,9,21
9701045,9701045,,37,10,33,43
9706076,9706076,,37,9,35,44
9802092,9802092,,37,9,15,24
9807203,9807203,,0,6,10,16
9807207,9807207,,0,3,8,11
9812010,9812010,,0,2,7,9
3137,3137,,3,30,24,54
3138,3138,,11,7,4,11
9910101,9910101,,11,8,3,11
9401051,9401051,,6,1,0,1
9504130,9504130,,6,32,1,33
9507152,9507152,,6,4,0,4
9512101,9512101,,6,5,2,7
9604149,9604149,,8,3,4,7
9605116,9605116,,11,5,1,6
9608072,9608072,,11,1,6,7
3140,3140,,62,4,4,8
9808145,9808145,,9,1,5,6
3141,3141,,9,3,9,12
9305014,9305014,,16,5,0,5
9206005,9206005,,16,3,0,3
9210069,9210069,,16,9,0,9
3142,3142,,37,10,12,22
3143,3143,,25,6,11,17
9710183,9710183,,25,6,2,8
9811164,9811164,,25,5,3,8
9907076,9907076,,25,9,9,18
9501064,9501064,,25,4,0,4
9502015,9502015,,25,12,8,20
9508088,9508088,,25,14,6,20
9605026,9605026,,25,6,3,9
9602113,9602113,,25,6,3,9
9608189,9608189,,25,3,11,14
9604143,9604143,,25,16,0,16
9802055,9802055,,25,5,0,5
9501122,9501122,,25,4,0,4
9709084,9709084,,25,4,2,6
9809081,9809081,,25,7,6,13
9712019,9712019,,25,4,8,12
9802010,9802010,,25,15,55,70
3144,3144,,0,17,9,26
9610054,9610054,,16,4,2,6
9912283,9912283,,0,11,4,15
9404143,9404143,,16,3,5,8
9408120,9408120,,16,9,0,9
3145,3145,,3,53,29,82
9706115,9706115,,2,2,20,22
9905043,9905043,,3,7,4,11
9604037,9604037,,2,4,10,14
9703066,9703066,,2,3,13,16
9712220,9712220,,62,4,18,22
9805119,9805119,,3,4,0,4
3146,3146,,7,3,13,16
9807211,9807211,,7,8,1,9
9811229,9811229,,7,2,13,15
9908028,9908028,,34,8,12,20
9601065,9601065,,7,4,1,5
9807212,9807212,,7,7,0,7
9510002,9510002,,7,6,2,8
9803221,9803221,,7,9,6,15
9905219,9905219,,34,6,15,21
3149,3149,,12,1,2,3
9912034,9912034,,12,2,0,2
9912046,9912046,,12,2,0,2
3150,3150,,2,1,2,3
9803075,9803075,,2,2,0,2
3151,3151,,34,15,20,35
3152,3152,,54,2,25,27
9205011,9205011,,54,18,0,18
9404033,9404033,,54,3,4,7
9410023,9410023,,54,6,1,7
9606189,9606189,,54,2,13,15
3153,3153,,34,4,13,17
9406027,9406027,,25,12,4,16
9610006,9610006,,34,6,4,10
9612135,9612135,,34,3,0,3
9906004,9906004,,34,6,4,10
9909106,9909106,,34,8,0,8
9211008,9211008,,25,6,0,6
9604076,9604076,,34,2,0,2
9402154,9402154,,25,8,4,12
3154,3154,,25,2,11,13
9404098,9404098,,25,17,3,20
9504077,9504077,,25,5,6,11
9602038,9602038,,25,2,4,6
9604186,9604186,,25,4,9,13
9608131,9608131,,25,1,9,10
9412032,9412032,,2,5,1,6
9504007,9504007,,1,4,12,16
9406062,9406062,,25,3,1,4
9502073,9502073,,25,6,6,12
9302091,9302091,,8,9,4,13
9601173,9601173,,25,1,9,10
9311032,9311032,,6,2,0,2
9709173,9709173,,6,10,2,12
3155,3155,,2,7,3,10
9906093,9906093,,2,8,1,9
3156,3156,,37,1,18,19
9712245,9712245,,37,1,8,9
9912141,9912141,,11,2,6,8
9604112,9604112,,54,11,26,37
9712219,9712219,,37,1,2,3
9305054,9305054,,1,11,0,11
9310045,9310045,,37,1,0,1
3157,3157,,54,2,12,14
3158,3158,,25,2,5,7
9904193,9904193,,25,2,2,4
9803009,9803009,,37,3,0,3
3159,3159,,16,1,17,18
9209083,9209083,,16,10,0,10
4147,4147,,3,85,77,162
3176,3176,,3,39,31,70
3180,3180,,3,55,47,102
3215,3215,,3,51,43,94
3227,3227,,3,28,21,49
4013,4013,,3,45,37,82
4038,4038,,3,28,43,71
4072,4072,,2,30,20,50
4074,4074,,2,43,50,93
4080,4080,,3,25,31,56
4085,4085,,3,16,43,59
9805077,9805077,,3,4,1,5
9912130,9912130,,3,18,22,40
9912272,9912272,,3,10,44,54
3161,3161,,2,9,21,30
9901034,9901034,,2,6,8,14
9904042,9904042,,2,6,22,28
3163,3163,,7,3,18,21
9812199,9812199,,7,2,1,3
9303030,9303030,,7,28,2,30
9310181,9310181,,7,32,8,40
9709059,9709059,,7,1,0,1
9908045,9908045,,1,1,10,11
3164,3164,,54,0,7,7
9805058,9805058,,54,3,38,41
3165,3165,,54,0,6,6
3166,3166,,37,9,18,27
3167,3167,,12,0,3,3
3168,3168,,54,0,25,25
3169,3169,,2,6,49,55
9912214,9912214,,2,10,13,23
9612059,9612059,,2,10,5,15
9605118,9605118,,2,5,11,16
9603094,9603094,,2,5,14,19
9708053,9708053,,2,1,10,11
9608118,9608118,,2,2,22,24
3170,3170,,6,1,6,7
9910177,9910177,,6,7,11,18
9805199,9805199,,54,8,12,20
9811180,9811180,,54,12,7,19
3171,3171,,8,3,12,15
3173,3173,,2,17,16,33
9309115,9309115,,25,12,14,26
9504091,9504091,,25,9,5,14
9603096,9603096,,25,2,8,10
3174,3174,,0,4,16,20
3175,3175,,54,8,28,36
9702096,9702096,,54,2,0,2
9907225,9907225,,37,6,39,45
9510121,9510121,,37,7,0,7
9608147,9608147,,37,8,15,23
9703159,9703159,,37,5,20,25
9801007,9801007,,37,3,7,10
9802125,9802125,,37,4,12,16
9605119,9605119,,37,3,5,8
3177,3177,,65,11,23,34
3178,3178,,65,7,11,18
9201025,9201025,,62,6,0,6
9203075,9203075,,62,3,0,3
9510103,9510103,,65,4,15,19
9706199,9706199,,65,7,18,25
9707194,9707194,,65,5,29,34
9710037,9710037,,65,7,21,28
3179,3179,,34,7,26,33
9207097,9207097,,16,15,0,15
9403122,9403122,,16,2,3,5
9412120,9412120,,16,7,5,12
9412212,9412212,,16,6,6,12
9501135,9501135,,16,9,4,13
9404128,9404128,,54,7,1,8
9503040,9503040,,54,7,2,9
9602026,9602026,,54,3,9,12
9211078,9211078,,8,2,1,3
3181,3181,,2,0,3,3
9208048,9208048,,62,7,0,7
9405095,9405095,,62,14,19,33
9406054,9406054,,62,9,3,12
9704068,9704068,,2,1,5,6
9704133,9704133,,62,1,9,10
3182,3182,,2,0,6,6
3183,3183,,34,28,48,76
9912266,9912266,,37,24,29,53
9905094,9905094,,2,22,43,65
9911042,9911042,,34,34,13,47
3184,3184,,8,20,50,70
9511130,9511130,,8,5,2,7
9802102,9802102,,8,13,12,25
9803071,9803071,,8,8,17,25
9803092,9803092,,8,12,25,37
9808068,9808068,,8,8,8,16
9902104,9902104,,8,5,16,21
9911163,9911163,,8,17,21,38
9305133,9305133,,34,14,0,14
9307161,9307161,,62,6,0,6
9401124,9401124,,8,8,2,10
9605211,9605211,,8,14,9,23
9304081,9304081,,19,10,1,11
9608031,9608031,,19,5,2,7
9604157,9604157,,8,3,7,10
9711155,9711155,,8,12,26,38
9607037,9607037,,19,16,8,24
9901043,9901043,,34,4,17,21
9903041,9903041,,1,1,14,15
3185,3185,,54,4,34,38
9209045,9209045,,25,10,1,11
9211049,9211049,,25,11,4,15
9310033,9310033,,25,5,3,8
3186,3186,,8,0,4,4
9604028,9604028,,8,6,0,6
9605056,9605056,,8,2,0,2
9607124,9607124,,8,7,0,7
3187,3187,,65,81,65,146
9601169,9601169,,3,9,18,27
9310148,9310148,,3,5,0,5
9401136,9401136,,3,10,1,11
9410199,9410199,,3,4,1,5
9411127,9411127,,3,3,1,4
9502017,9502017,,3,1,4,5
9506171,9506171,,8,4,78,82
9506183,9506183,,3,3,3,6
9511011,9511011,,3,1,1,2
9601120,9601120,,3,2,3,5
9307012,9307012,,3,5,0,5
3188,3188,,9,29,4,33
3189,3189,,49,3,3,6
9906135,9906135,,49,2,0,2
9906136,9906136,,49,2,0,2
9908210,9908210,,49,1,2,3
3190,3190,,65,1,134,135
9210009,9210009,,62,16,0,16
9211003,9211003,,65,13,0,13
9212121,9212121,,7,3,0,3
9302068,9302068,,34,4,0,4
9304019,9304019,,8,4,1,5
9307110,9307110,,65,1,0,1
9307170,9307170,,8,9,3,12
9311069,9311069,,7,5,0,5
9402091,9402091,,65,5,0,5
9403163,9403163,,8,5,6,11
9404012,9404012,,65,4,1,5
9406196,9406196,,7,9,1,10
9407154,9407154,,65,10,1,11
9407186,9407186,,65,5,5,10
9412128,9412128,,62,15,9,24
9506198,9506198,,62,3,1,4
9602074,9602074,,62,21,5,26
9606095,9606095,,62,9,7,16
9707159,9707159,,62,8,5,13
9708114,9708114,,62,1,5,6
9710002,9710002,,11,2,0,2
9710099,9710099,,62,9,10,19
9805216,9805216,,62,2,8,10
9808144,9808144,,16,2,5,7
9810184,9810184,,62,3,2,5
9903068,9903068,,37,12,29,41
9904082,9904082,,62,4,10,14
9905214,9905214,,62,3,4,7
9906036,9906036,,62,9,10,19
9906185,9906185,,8,2,8,10
9907060,9907060,,37,9,17,26
9908176,9908176,,65,1,5,6
9910156,9910156,,8,9,39,48
9910226,9910226,,62,3,29,32
9911030,9911030,,62,5,1,6
9911187,9911187,,65,3,3,6
9912084,9912084,,65,9,7,16
9206075,9206075,,8,14,0,14
9204093,9204093,,37,1,0,1
9206090,9206090,,37,5,0,5
9210072,9210072,,37,4,1,5
9301004,9301004,,37,4,1,5
9303127,9303127,,16,9,4,13
9212104,9212104,,8,11,1,12
9204098,9204098,,8,4,0,4
9309146,9309146,,8,1,3,4
9312016,9312016,,8,5,4,9
9307190,9307190,,8,10,5,15
9312049,9312049,,8,9,9,18
9402001,9402001,,7,11,2,13
9209043,9209043,,65,12,0,12
9301127,9301127,,65,3,1,4
9304106,9304106,,65,1,0,1
9402027,9402027,,65,4,4,8
9403088,9403088,,65,6,0,6
9306118,9306118,,65,5,0,5
9402153,9402153,,65,3,2,5
9407013,9407013,,65,3,4,7
9201049,9201049,,1,5,0,5
9204013,9204013,,16,4,0,4
9208039,9208039,,1,3,0,3
9309125,9309125,,8,5,14,19
9311021,9311021,,19,1,8,9
9401013,9401013,,25,1,0,1
9403086,9403086,,8,7,6,13
9407052,9407052,,8,7,1,8
9408005,9408005,,25,5,5,10
9408007,9408007,,8,5,4,9
9410164,9410164,,37,7,6,13
9209009,9209009,,62,9,0,9
9405058,9405058,,62,10,3,13
9402017,9402017,,7,1,1,2
9305110,9305110,,62,16,3,19
9501087,9501087,,8,1,0,1
9503141,9503141,,65,7,7,14
9210002,9210002,,8,5,0,5
9312208,9312208,,7,10,3,13
9403047,9403047,,37,7,7,14
9412187,9412187,,37,5,17,22
9512150,9512150,,7,6,6,12
9601114,9601114,,65,4,4,8
9306162,9306162,,65,14,7,21
9408033,9408033,,8,13,8,21
9412009,9412009,,65,2,1,3
9507047,9507047,,65,3,1,4
9511143,9511143,,1,3,2,5
9601068,9601068,,1,3,8,11
9601070,9601070,,65,5,5,10
9604094,9604094,,65,4,10,14
9606175,9606175,,65,6,5,11
9612178,9612178,,62,1,19,20
9302002,9302002,,62,4,0,4
9503070,9503070,,62,11,8,19
9207101,9207101,,62,10,0,10
9406215,9406215,,62,11,2,13
9510131,9510131,,62,9,8,17
9607177,9607177,,62,8,6,14
9609135,9609135,,62,2,3,5
9607156,9607156,,16,14,2,16
9707035,9707035,,16,9,3,12
9804094,9804094,,16,6,4,10
9808001,9808001,,16,4,2,6
9310022,9310022,,62,16,3,19
9512085,9512085,,62,2,10,12
9809178,9809178,,62,6,6,12
9808156,9808156,,37,13,16,29
9412108,9412108,,62,28,17,45
9802169,9802169,,7,1,11,12
9804080,9804080,,62,1,4,5
9811023,9811023,,62,1,3,4
9302115,9302115,,62,4,1,5
9402061,9402061,,62,7,3,10
9209100,9209100,,37,2,1,3
9503028,9503028,,7,4,5,9
9503143,9503143,,65,5,7,12
9309076,9309076,,8,5,0,5
9309159,9309159,,8,4,1,5
9401166,9401166,,8,2,0,2
9406211,9406211,,8,1,0,1
9305146,9305146,,62,7,2,9
9412207,9412207,,65,1,4,5
9508016,9508016,,7,5,2,7
9509037,9509037,,62,14,2,16
9610094,9610094,,62,4,9,13
9612233,9612233,,62,1,20,21
9805008,9805008,,62,16,6,22
9203004,9203004,,65,9,0,9
9612159,9612159,,65,2,1,3
3191,3191,,6,8,5,13
9210070,9210070,,6,10,0,10
3192,3192,,6,9,15,24
3193,3193,,6,6,3,9
9211046,9211046,,6,2,0,2
9510100,9510100,,2,5,2,7
9709040,9709040,,3,3,3,6
3194,3194,,0,2,7,9
9306098,9306098,,0,7,1,8
9705183,9705183,,0,10,5,15
9706167,9706167,,0,4,7,11
9710058,9710058,,0,8,1,9
9801075,9801075,,0,7,2,9
9306066,9306066,,19,12,0,12
9310185,9310185,,0,14,0,14
9408096,9408096,,0,6,3,9
9508165,9508165,,0,7,7,14
9609089,9609089,,0,9,4,13
9611081,9611081,,2,2,1,3
3195,3195,,16,4,4,8
9609061,9609061,,16,7,5,12
9202012,9202012,,7,25,0,25
9407194,9407194,,16,14,13,27
9503220,9503220,,16,14,2,16
9602063,9602063,,16,9,2,11
3196,3196,,0,1,5,6
9808163,9808163,,0,3,1,4
9609191,9609191,,62,7,9,16
3199,3199,,6,9,6,15
3200,3200,,3,5,56,61
9705137,9705137,,2,7,21,28
3201,3201,,62,1,1,2
3202,3202,,9,1,9,10
9906111,9906111,,9,3,4,7
9911071,9911071,,9,1,0,1
3203,3203,,34,33,58,91
3204,3204,,3,5,34,39
3205,3205,,34,8,11,19
3206,3206,,34,5,9,14
9803121,9803121,,31,8,2,10
3208,3208,,2,36,42,78
9704149,9704149,,37,3,2,5
9903216,9903216,,2,4,5,9
9911170,9911170,,2,9,15,24
9503064,9503064,,54,6,1,7
9703073,9703073,,2,4,17,21
9703109,9703109,,19,4,3,7
9505127,9505127,,25,9,13,22
9910118,9910118,,37,7,19,26
3210,3210,,65,6,10,16
9602101,9602101,,65,12,2,14
9605099,9605099,,65,11,3,14
9610202,9610202,,65,11,2,13
9704069,9704069,,65,6,3,9
9907050,9907050,,65,7,12,19
9910046,9910046,,65,12,10,22
9910206,9910206,,65,4,8,12
9301045,9301045,,65,2,0,2
9407116,9407116,,65,9,1,10
9201062,9201062,,62,2,0,2
3211,3211,,2,8,37,45
9807113,9807113,,2,3,14,17
9809043,9809043,,2,1,20,21
9405070,9405070,,34,4,3,7
9410069,9410069,,2,1,4,5
9502146,9502146,,2,2,1,3
3212,3212,,62,0,2,2
9201031,9201031,,62,4,0,4
9603162,9603162,,62,1,2,3
9212105,9212105,,62,2,0,2
9305015,9305015,,62,3,0,3
3213,3213,,34,7,30,37
3214,3214,,37,0,9,9
9305028,9305028,,37,13,0,13
9404115,9404115,,37,22,1,23
3216,3216,,3,23,21,44
3217,3217,,62,4,18,22
9906069,9906069,,62,3,19,22
9911105,9911105,,62,4,17,21
9403105,9403105,,62,1,0,1
9404038,9404038,,62,4,1,5
9812091,9812091,,62,4,2,6
9309022,9309022,,62,16,1,17
9705187,9705187,,62,7,2,9
9707155,9707155,,62,1,2,3
9803118,9803118,,62,6,6,12
9807065,9807065,,62,7,13,20
9808012,9808012,,62,4,1,5
9812009,9812009,,62,7,6,13
9903066,9903066,,62,4,10,14
9903137,9903137,,62,3,11,14
9905202,9905202,,62,3,4,7
9211133,9211133,,62,6,0,6
9306036,9306036,,62,2,0,2
9407032,9407032,,62,6,2,8
9407135,9407135,,62,2,0,2
9408006,9408006,,62,5,6,11
9606116,9606116,,62,8,5,13
3218,3218,,34,19,35,54
3219,3219,,4,10,47,57
9908182,9908182,,2,9,16,25
9903012,9903012,,2,6,6,12
9905153,9905153,,4,10,11,21
3220,3220,,4,64,12,76
9309095,9309095,,8,4,4,8
3221,3221,,4,71,31,102
3222,3222,,6,1,7,8
9903260,9903260,,37,3,13,16
9805122,9805122,,54,2,16,18
3223,3223,,2,15,9,24
3224,3224,,0,5,2,7
3225,3225,,2,2,8,10
9701047,9701047,,2,5,6,11
9509118,9509118,,2,2,7,9
3226,3226,,4,8,24,32
9906160,9906160,,2,13,11,24
9911007,9911007,,2,9,22,31
9603154,9603154,,54,4,0,4
9410215,9410215,,25,18,5,23
9212035,9212035,,2,14,2,16
9910098,9910098,,2,6,34,40
3228,3228,,2,6,3,9
3229,3229,,25,3,3,6
3230,3230,,34,10,35,45
3232,3232,,3,8,27,35
9902138,9902138,,3,21,3,24
9910129,9910129,,3,31,11,42
9912050,9912050,,3,24,10,34
9903112,9903112,,3,10,7,17
3233,3233,,54,2,14,16
3234,3234,,3,1,18,19
9411140,9411140,,3,3,0,3
9801079,9801079,,37,6,9,15
9603143,9603143,,7,3,7,10
3235,3235,,34,1,23,24
9904172,9904172,,37,2,5,7
9908167,9908167,,34,1,11,12
3239,3239,,37,6,1,7
3240,3240,,2,2,26,28
9812188,9812188,,2,2,35,37
3241,3241,,54,0,20,20
9703070,9703070,,54,6,18,24
9912184,9912184,,2,6,23,29
9611110,9611110,,54,5,41,46
9710026,9710026,,2,6,6,12
3242,3242,,37,29,26,55
9306157,9306157,,37,9,0,9
9307040,9307040,,37,13,0,13
9406045,9406045,,54,4,5,9
9407009,9407009,,37,3,5,8
9408121,9408121,,54,4,5,9
9511229,9511229,,1,4,3,7
3243,3243,,62,12,5,17
9410115,9410115,,62,5,0,5
9712119,9712119,,62,9,2,11
9810080,9810080,,6,4,9,13
9404028,9404028,,62,3,1,4
9406118,9406118,,62,13,2,15
9408035,9408035,,62,12,10,22
9506016,9506016,,62,7,1,8
9710234,9710234,,62,2,4,6
9507029,9507029,,62,2,4,6
9809017,9809017,,6,7,8,15
3244,3244,,31,1,7,8
9804106,9804106,,31,12,7,19
9803178,9803178,,31,3,4,7
9803210,9803210,,31,11,6,17
3245,3245,,37,1,31,32
3246,3246,,62,7,7,14
9702095,9702095,,62,4,3,7
9805215,9805215,,62,6,4,10
3247,3247,,1,1,5,6
9608040,9608040,,1,7,6,13
9710229,9710229,,1,1,4,5
9802077,9802077,,1,3,2,5
3249,3249,,16,16,11,27
9909220,9909220,,2,6,6,12
9910222,9910222,,16,11,64,75
9509027,9509027,,16,16,9,25
9805188,9805188,,16,7,14,21
3250,3250,,16,0,5,5
9403175,9403175,,16,6,5,11
9609196,9609196,,16,3,6,9
9811144,9811144,,11,1,2,3
9901113,9901113,,16,1,3,4
9212042,9212042,,16,4,0,4
9604053,9604053,,16,2,11,13
3251,3251,,2,2,20,22
3252,3252,,11,4,5,9
9610141,9610141,,37,7,5,12
9704073,9704073,,11,10,0,10
9507173,9507173,,37,6,0,6
9609136,9609136,,37,2,3,5
9603065,9603065,,11,4,1,5
3253,3253,,8,4,3,7
9809101,9809101,,8,4,12,16
9811184,9811184,,8,2,2,4
9801105,9801105,,8,13,2,15
9303098,9303098,,19,10,0,10
9810049,9810049,,19,2,3,5
3254,3254,,11,2,1,3
3255,3255,,19,6,16,22
9409004,9409004,,19,6,2,8
9411081,9411081,,19,2,5,7
9412042,9412042,,19,2,3,5
9511010,9511010,,19,2,1,3
9512097,9512097,,19,6,0,6
9706070,9706070,,19,11,2,13
9706193,9706193,,19,5,2,7
9708032,9708032,,19,2,2,4
9708121,9708121,,19,1,0,1
9711061,9711061,,19,2,13,15
9712134,9712134,,19,2,5,7
9206039,9206039,,19,14,0,14
9405009,9405009,,19,3,1,4
9609064,9609064,,19,5,0,5
9210104,9210104,,19,3,0,3
9412050,9412050,,19,4,0,4
9707231,9707231,,19,2,1,3
9511105,9511105,,16,5,0,5
9605181,9605181,,9,7,0,7
9607074,9607074,,9,6,2,8
9609109,9609109,,19,2,3,5
9611143,9611143,,9,5,5,10
9710061,9710061,,19,4,5,9
9710087,9710087,,9,3,8,11
9908013,9908013,,54,2,35,37
3257,3257,,11,1,5,6
9401020,9401020,,11,8,0,8
9903070,9903070,,11,7,0,7
9904047,9904047,,11,9,1,10
9909142,9909142,,11,4,2,6
9910151,9910151,,11,2,4,6
9812138,9812138,,11,4,1,5
9906002,9906002,,11,2,3,5
3258,3258,,11,1,1,2
9503112,9503112,,62,2,2,4
9402144,9402144,,62,17,4,21
3259,3259,,6,1,5,6
9808058,9808058,,6,5,3,8
9907091,9907091,,6,1,4,5
9901051,9901051,,6,5,3,8
3261,3261,,2,21,26,47
9911082,9911082,,34,32,17,49
3262,3262,,8,8,20,28
9612251,9612251,,2,7,24,31
9703209,9703209,,2,4,39,43
9806013,9806013,,7,3,5,8
9510153,9510153,,34,4,4,8
9907141,9907141,,8,2,12,14
3263,3263,,37,59,26,85
3264,3264,,62,6,10,16
9503078,9503078,,2,26,14,40
9703096,9703096,,62,2,9,11
9411118,9411118,,2,4,1,5
9503154,9503154,,2,8,8,16
9506037,9506037,,2,14,21,35
3265,3265,,37,9,19,28
3266,3266,,7,0,1,1
3267,3267,,19,6,1,7
3268,3268,,7,1,13,14
9307075,9307075,,7,8,1,9
9311111,9311111,,7,10,3,13
9401093,9401093,,7,7,8,15
9411027,9411027,,7,5,2,7
9412017,9412017,,7,5,2,7
9510082,9510082,,7,6,6,12
9510189,9510189,,7,2,7,9
9603064,9603064,,7,4,0,4
9709047,9709047,,7,1,7,8
9908106,9908106,,3,7,26,33
9302111,9302111,,7,10,0,10
9208028,9208028,,7,6,0,6
9301128,9301128,,7,1,0,1
9204092,9204092,,62,5,0,5
9312019,9312019,,7,4,2,6
9408001,9408001,,7,4,1,5
9407081,9407081,,7,4,0,4
9303091,9303091,,7,2,2,4
9706176,9706176,,7,1,15,16
9706156,9706156,,2,4,19,23
9802018,9802018,,37,3,11,14
9903254,9903254,,3,7,5,12
9905092,9905092,,2,8,33,41
9804063,9804063,,62,2,9,11
9310089,9310089,,62,1,3,4
9402053,9402053,,62,7,2,9
9409153,9409153,,62,3,5,8
9706086,9706086,,62,1,3,4
3270,3270,,3,2,11,13
9204054,9204054,,7,4,2,6
9311114,9311114,,7,5,4,9
9602159,9602159,,3,2,5,7
3271,3271,,34,10,8,18
9912045,9912045,,34,5,9,14
9211063,9211063,,54,6,0,6
3273,3273,,2,21,10,31
9811094,9811094,,0,4,5,9
9908156,9908156,,0,4,8,12
9610136,9610136,,25,5,3,8
9703092,9703092,,0,3,3,6
9812019,9812019,,0,3,2,5
3276,3276,,62,2,10,12
9308053,9308053,,62,6,1,7
9309118,9309118,,62,7,1,8
9502060,9502060,,62,12,4,16
9601051,9601051,,62,4,16,20
9409138,9409138,,62,17,7,24
9410208,9410208,,62,1,1,2
9409130,9409130,,62,7,6,13
9506074,9506074,,62,2,6,8
9507070,9507070,,62,7,6,13
9507118,9507118,,62,9,22,31
9508080,9508080,,62,3,7,10
9401008,9401008,,62,13,1,14
9505124,9505124,,62,6,7,13
9803136,9803136,,62,4,11,15
3277,3277,,7,8,10,18
9404061,9404061,,7,14,3,17
9405051,9405051,,7,1,3,4
9608048,9608048,,7,9,1,10
9905135,9905135,,7,11,2,13
9404120,9404120,,7,11,2,13
9601088,9601088,,7,4,2,6
9612122,9612122,,7,3,1,4
9411104,9411104,,54,17,0,17
3278,3278,,4,37,24,61
3280,3280,,2,24,42,66
9908169,9908169,,2,10,7,17
9912225,9912225,,54,6,18,24
9905071,9905071,,2,1,8,9
3281,3281,,34,11,21,32
9709174,9709174,,2,4,13,17
3282,3282,,54,3,1,4
9911029,9911029,,54,6,5,11
9905122,9905122,,54,7,13,20
3283,3283,,11,1,1,2
9911219,9911219,,11,3,0,3
3284,3284,,34,5,36,41
9909071,9909071,,34,4,31,35
9502119,9502119,,2,6,10,16
9509090,9509090,,2,7,7,14
9605050,9605050,,2,3,8,11
9811170,9811170,,2,6,31,37
9903002,9903002,,37,11,17,28
3285,3285,,16,8,18,26
9703174,9703174,,2,5,22,27
9210110,9210110,,16,4,1,5
9305156,9305156,,16,2,0,2
9601137,9601137,,16,1,2,3
9405183,9405183,,16,7,0,7
9402040,9402040,,16,1,0,1
9609001,9609001,,16,2,6,8
3287,3287,,6,0,1,1
3288,3288,,2,2,14,16
4083,4083,,2,6,7,13
9702062,9702062,,0,2,0,2
9712088,9712088,,2,13,9,22
9807086,9807086,,2,1,3,4
9809123,9809123,,2,9,4,13
9811150,9811150,,2,6,10,16
9911235,9911235,,2,2,7,9
4084,4084,,11,11,5,16
9311059,9311059,,2,4,0,4
9202056,9202056,,7,14,0,14
9212005,9212005,,7,6,2,8
9405001,9405001,,2,6,2,8
9709089,9709089,,2,3,10,13
9801115,9801115,,2,5,5,10
9803165,9803165,,2,4,3,7
9709038,9709038,,2,3,21,24
3290,3290,,25,10,14,24
9701060,9701060,,25,29,8,37
9801122,9801122,,25,12,7,19
9803184,9803184,,25,13,2,15
9803200,9803200,,25,10,3,13
9904146,9904146,,25,8,36,44
9909086,9909086,,25,20,11,31
9407104,9407104,,25,11,3,14
9606098,9606098,,25,8,11,19
9611219,9611219,,25,1,15,16
9704014,9704014,,25,6,11,17
9206087,9206087,,25,15,1,16
9207046,9207046,,25,15,0,15
9208015,9208015,,25,19,0,19
9301106,9301106,,25,7,9,16
9304091,9304091,,25,11,10,21
9412138,9412138,,25,24,25,49
9412139,9412139,,25,4,1,5
9308028,9308028,,3,4,0,4
9710171,9710171,,25,17,4,21
9405007,9405007,,25,5,8,13
9607226,9607226,,25,25,6,31
9707115,9707115,,25,11,24,35
9709074,9709074,,25,4,3,7
9807122,9807122,,25,7,13,20
9809168,9809168,,25,11,21,32
9712015,9712015,,25,4,23,27
9802139,9802139,,25,8,22,30
9803081,9803081,,25,3,15,18
9812164,9812164,,25,4,14,18
9902035,9902035,,25,5,18,23
3292,3292,,2,2,5,7
9501141,9501141,,2,7,1,8
9507125,9507125,,2,9,1,10
3293,3293,,1,1,1,2
9204070,9204070,,1,5,0,5
3294,3294,,3,19,4,23
3295,3295,,34,15,7,22
3296,3296,,16,1,10,11
9609222,9609222,,11,2,2,4
9610025,9610025,,34,4,4,8
9808071,9808071,,19,6,2,8
9810238,9810238,,6,1,4,5
3297,3297,,6,5,9,14
9901010,9901010,,6,8,2,10
9909033,9909033,,6,9,4,13
9909221,9909221,,6,5,6,11
3298,3298,,65,20,34,54
9505059,9505059,,62,8,0,8
9705018,9705018,,65,3,1,4
9807151,9807151,,34,4,5,9
4002,4002,,3,3,28,31
9912124,9912124,,37,3,28,31
9205006,9205006,,11,8,1,9
9507167,9507167,,54,2,9,11
9510014,9510014,,11,2,7,9
9603188,9603188,,37,2,30,32
9609205,9609205,,6,3,10,13
9704136,9704136,,6,5,6,11
9801130,9801130,,37,2,0,2
9912088,9912088,,37,8,53,61
4006,4006,,37,2,8,10
201211,201211,,37,6,13,19
9602160,9602160,,37,8,11,19
9402054,9402054,,37,1,0,1
9511185,9511185,,37,3,3,6
4007,4007,,11,0,2,2
9904107,9904107,,11,15,3,18
9909123,9909123,,11,7,4,11
9307117,9307117,,11,7,0,7
4008,4008,,11,0,2,2
9612110,9612110,,11,5,4,9
9612111,9612111,,11,5,1,6
9606160,9606160,,11,1,2,3
4009,4009,,2,7,36,43
9710169,9710169,,1,1,2,3
9711082,9711082,,2,6,57,63
9709033,9709033,,2,8,43,51
9812126,9812126,,37,1,15,16
4010,4010,,9,4,13,17
4153,4153,,9,5,1,6
9611004,9611004,,9,7,3,10
9801168,9801168,,9,5,0,5
9904206,9904206,,9,2,5,7
9908032,9908032,,9,5,3,8
9307055,9307055,,9,1,0,1
9606018,9606018,,9,5,0,5
9806248,9806248,,9,2,3,5
9911119,9911119,,2,3,21,24
9908154,9908154,,2,4,13,17
4012,4012,,11,1,8,9
9309060,9309060,,11,1,0,1
9312173,9312173,,11,2,0,2
9606053,9606053,,11,2,1,3
9805201,9805201,,37,3,4,7
9809002,9809002,,0,3,0,3
4015,4015,,4,49,12,61
4017,4017,,7,5,14,19
9209058,9209058,,25,29,4,33
4018,4018,,7,2,1,3
4019,4019,,7,11,14,25
4020,4020,,25,2,3,5
9501048,9501048,,25,3,1,4
9506204,9506204,,25,6,0,6
9507096,9507096,,25,5,3,8
9601006,9601006,,25,4,7,11
4023,4023,,2,1,10,11
9909119,9909119,,2,2,27,29
4024,4024,,3,15,8,23
4025,4025,,65,5,10,15
9702197,9702197,,54,2,4,6
4026,4026,,16,1,15,16
4027,4027,,25,11,11,22
9811246,9811246,,25,4,7,11
9911091,9911091,,34,10,23,33
9302144,9302144,,25,6,8,14
9910244,9910244,,34,6,31,37
4030,4030,,34,8,29,37
4031,4031,,2,0,4,4
9407103,9407103,,2,3,2,5
9310121,9310121,,1,5,2,7
9312085,9312085,,62,3,0,3
4032,4032,,7,10,14,24
5122,5122,,7,15,8,23
9204057,9204057,,3,23,0,23
9309147,9309147,,34,5,0,5
9606162,9606162,,7,1,0,1
9709135,9709135,,37,2,5,7
9709205,9709205,,19,3,1,4
9511072,9511072,,7,15,5,20
9711170,9711170,,7,4,5,9
4036,4036,,25,9,5,14
4037,4037,,2,1,30,31
9511067,9511067,,2,2,6,8
9904011,9904011,,2,7,35,42
9711093,9711093,,2,2,32,34
9804064,9804064,,34,6,9,15
9806182,9806182,,2,1,22,23
9402049,9402049,,37,3,0,3
9811177,9811177,,37,3,14,17
9711025,9711025,,54,6,10,16
4040,4040,,34,4,30,34
9812165,9812165,,34,3,20,23
9605017,9605017,,2,2,15,17
4041,4041,,25,1,11,12
9902057,9902057,,25,2,8,10
9405043,9405043,,25,3,1,4
4043,4043,,0,5,2,7
4044,4044,,6,3,4,7
9204001,9204001,,7,4,0,4
9611051,9611051,,7,3,16,19
9911051,9911051,,6,5,3,8
9312200,9312200,,7,8,0,8
9409164,9409164,,7,5,5,10
9511167,9511167,,7,5,11,16
9601156,9601156,,7,3,2,5
9603141,9603141,,7,2,5,7
9603146,9603146,,7,1,4,5
9809085,9809085,,37,4,9,13
9812108,9812108,,1,1,4,5
4046,4046,,6,1,10,11
102118,102118,,6,2,3,5
9703020,9703020,,6,19,3,22
9911141,9911141,,6,1,3,4
9911143,9911143,,6,2,3,5
9911144,9911144,,6,1,2,3
9912197,9912197,,6,1,2,3
9912198,9912198,,6,1,3,4
9912199,9912199,,6,1,2,3
9912200,9912200,,6,1,7,8
9912201,9912201,,6,3,5,8
9408044,9408044,,6,7,0,7
4047,4047,,6,0,1,1
4048,4048,,6,7,13,20
9611114,9611114,,6,9,0,9
9611115,9611115,,6,6,0,6
9611116,9611116,,6,8,0,8
9701128,9701128,,37,21,35,56
9811191,9811191,,6,5,12,17
9310111,9310111,,6,4,2,6
9503201,9503201,,37,21,5,26
9508162,9508162,,37,10,13,23
9509048,9509048,,6,3,5,8
9801173,9801173,,37,8,51,59
9803087,9803087,,37,9,17,26
9810253,9810253,,37,1,5,6
9811132,9811132,,37,1,8,9
4049,4049,,6,7,35,42
9912052,9912052,,6,7,15,22
9910048,9910048,,4,3,22,25
4050,4050,,16,0,3,3
4051,4051,,25,4,9,13
9804103,9804103,,25,2,5,7
4052,4052,,54,2,26,28
9705244,9705244,,54,7,7,14
9804135,9804135,,54,6,13,19
9805111,9805111,,54,9,6,15
9301079,9301079,,54,5,1,6
9706125,9706125,,8,7,15,22
9708164,9708164,,2,1,93,94
4053,4053,,0,1,3,4
9504059,9504059,,7,1,0,1
9707070,9707070,,7,6,7,13
9712097,9712097,,7,2,4,6
4054,4054,,37,1,7,8
9708004,9708004,,37,6,14,20
9902111,9902111,,37,5,14,19
9604138,9604138,,37,6,1,7
9203046,9203046,,19,20,0,20
9511201,9511201,,19,7,9,16
9707117,9707117,,37,1,0,1
9801091,9801091,,37,5,2,7
9801092,9801092,,37,1,4,5
4055,4055,,65,0,4,4
9306018,9306018,,65,13,0,13
9412202,9412202,,65,2,3,5
4058,4058,,0,1,1,2
4059,4059,,16,3,1,4
4060,4060,,13,2,2,4
9907122,9907122,,13,2,2,4
9912099,9912099,,13,2,2,4
9809131,9809131,,13,3,0,3
9903035,9903035,,13,3,1,4
9512172,9512172,,13,2,0,2
4061,4061,,3,14,8,22
9704125,9704125,,2,8,12,20
9811063,9811063,,54,2,0,2
9906237,9906237,,2,9,9,18
4062,4062,,3,14,9,23
4063,4063,,34,60,25,85
4064,4064,,0,3,2,5
4065,4065,,62,2,1,3
9910265,9910265,,62,5,0,5
4066,4066,,62,0,15,15
9408086,9408086,,62,19,8,27
9508079,9508079,,62,5,26,31
9512182,9512182,,62,7,15,22
9610084,9610084,,8,9,47,56
9701043,9701043,,8,10,9,19
9702026,9702026,,62,2,14,16
9704111,9704111,,8,5,15,20
9805179,9805179,,8,8,13,21
9807144,9807144,,62,1,2,3
9907171,9907171,,8,2,16,18
9302001,9302001,,62,5,3,8
9304056,9304056,,62,14,12,26
9304150,9304150,,62,7,4,11
9307056,9307056,,62,7,5,12
9401154,9401154,,62,18,1,19
9210007,9210007,,62,6,0,6
9301084,9301084,,7,3,2,5
9407191,9407191,,62,11,4,15
9412030,9412030,,62,20,19,39
9412054,9412054,,62,5,9,14
9404116,9404116,,62,5,11,16
9408136,9408136,,62,13,5,18
9410033,9410033,,62,5,3,8
9411009,9411009,,62,11,11,22
9412199,9412199,,62,4,9,13
9501088,9501088,,62,6,4,10
9501134,9501134,,62,7,24,31
9502118,9502118,,62,6,7,13
9504052,9504052,,62,6,8,14
9505083,9505083,,62,5,11,16
9507072,9507072,,62,4,28,32
9508050,9508050,,62,9,23,32
9412104,9412104,,16,8,0,8
9510168,9510168,,62,5,22,27
9207078,9207078,,25,4,2,6
9304123,9304123,,8,7,2,9
9310076,9310076,,8,9,2,11
9410109,9410109,,8,1,8,9
9412198,9412198,,8,7,7,14
9512092,9512092,,8,3,16,19
9512189,9512189,,8,11,14,25
9603088,9603088,,8,5,14,19
9604105,9604105,,8,10,18,28
9604176,9604176,,8,9,11,20
9609004,9609004,,8,6,21,27
9607168,9607168,,62,5,21,26
9210129,9210129,,62,7,0,7
9309074,9309074,,62,5,0,5
9310070,9310070,,62,14,1,15
9502071,9502071,,11,1,7,8
9612049,9612049,,62,3,15,18
9211122,9211122,,8,1,0,1
9407057,9407057,,8,5,0,5
9712182,9712182,,8,8,11,19
9803022,9803022,,8,4,5,9
9801035,9801035,,62,3,0,3
9803024,9803024,,8,2,7,9
9812192,9812192,,8,2,11,13
4068,4068,,2,19,36,55
9901072,9901072,,2,4,7,11
9911136,9911136,,2,37,41,78
9912241,9912241,,2,2,23,25
9711044,9711044,,37,5,11,16
4069,4069,,19,2,1,3
9901049,9901049,,19,3,1,4
9701087,9701087,,19,8,2,10
4070,4070,,54,2,32,34
9908137,9908137,,2,4,23,27
4071,4071,,3,20,7,27
9206037,9206037,,37,12,0,12
9209040,9209040,,62,3,0,3
4073,4073,,4,8,17,25
9902029,9902029,,2,14,4,18
4075,4075,,2,3,16,19
9304037,9304037,,25,15,0,15
9412159,9412159,,25,5,22,27
9706083,9706083,,2,2,10,12
9904083,9904083,,2,1,10,11
9901016,9901016,,8,4,11,15
4076,4076,,2,13,15,28
9411194,9411194,,37,1,0,1
9908201,9908201,,37,5,29,34
4077,4077,,34,10,42,52
9205095,9205095,,34,6,0,6
9401110,9401110,,25,15,1,16
9805099,9805099,,34,1,21,22
4078,4078,,19,5,14,19
9510192,9510192,,19,7,0,7
9610057,9610057,,19,6,17,23
9611107,9611107,,19,8,10,18
9703071,9703071,,19,5,6,11
9710179,9710179,,19,9,17,26
9811006,9811006,,19,5,19,24
9304014,9304014,,19,2,0,2
9403104,9403104,,19,15,4,19
9406213,9406213,,19,14,8,22
9507137,9507137,,19,5,2,7
9506038,9506038,,34,3,0,3
9301036,9301036,,19,2,0,2
9702088,9702088,,19,5,8,13
4079,4079,,25,0,2,2
4081,4081,,16,6,16,22
5077,5077,,16,6,18,24
4119,4119,,16,8,27,35
9610225,9610225,,16,2,3,5
9807070,9807070,,16,1,17,18
4082,4082,,6,1,3,4
9503187,9503187,,25,2,2,4
9503188,9503188,,6,2,0,2
9907180,9907180,,11,19,9,28
9906129,9906129,,11,9,11,20
4086,4086,,2,4,13,17
9606190,9606190,,2,9,1,10
9612208,9612208,,2,6,3,9
4087,4087,,37,8,37,45
9604096,9604096,,54,1,10,11
9909073,9909073,,37,8,31,39
9911112,9911112,,37,4,30,34
9706095,9706095,,37,10,21,31
9607123,9607123,,37,1,5,6
9706060,9706060,,6,5,6,11
9410146,9410146,,62,2,2,4
9503168,9503168,,62,4,5,9
9808083,9808083,,62,1,6,7
9808134,9808134,,37,1,43,44
4088,4088,,2,3,3,6
4089,4089,,62,12,14,26
9212135,9212135,,62,8,0,8
9703055,9703055,,62,6,2,8
9612133,9612133,,62,5,8,13
9801167,9801167,,62,2,0,2
4090,4090,,2,13,18,31
4091,4091,,11,0,4,4
4092,4092,,37,3,26,29
9906020,9906020,,37,7,12,19
9910184,9910184,,37,4,23,27
9911094,9911094,,37,8,16,24
9701101,9701101,,62,2,8,10
9401053,9401053,,6,2,1,3
4096,4096,,31,2,12,14
9907067,9907067,,31,9,26,35
9706040,9706040,,54,3,43,46
9707062,9707062,,37,5,13,18
9710161,9710161,,37,11,7,18
9711150,9711150,,37,13,14,27
9706049,9706049,,31,4,9,13
4098,4098,,2,7,25,32
4099,4099,,62,0,9,9
9907103,9907103,,62,1,5,6
9701160,9701160,,6,5,3,8
9706061,9706061,,62,2,3,5
9304078,9304078,,62,2,0,2
9711052,9711052,,2,10,9,19
4100,4100,,65,6,21,27
4102,4102,,34,23,22,45
4104,4104,,3,12,30,42
4105,4105,,34,1,6,7
4106,4106,,4,49,19,68
4107,4107,,34,4,10,14
4108,4108,,14,2,5,7
9804192,9804192,,14,15,2,17
9709189,9709189,,19,2,6,8
4110,4110,,16,0,1,1
9508150,9508150,,2,3,3,6
4112,4112,,4,15,11,26
4113,4113,,2,5,12,17
4114,4114,,0,26,36,62
4115,4115,,3,29,32,61
4116,4116,,19,2,5,7
9806127,9806127,,19,10,8,18
9605121,9605121,,19,10,8,18
9408085,9408085,,7,2,1,3
4117,4117,,34,6,14,20
4118,4118,,11,0,11,11
9603029,9603029,,11,12,0,12
9611142,9611142,,11,11,1,12
9803133,9803133,,11,24,3,27
9810167,9810167,,11,17,6,23
9904045,9904045,,11,18,17,35
9911242,9911242,,11,9,27,36
9309150,9309150,,11,11,0,11
9405145,9405145,,11,7,1,8
9502083,9502083,,11,8,2,10
9511033,9511033,,11,4,2,6
9502100,9502100,,6,11,8,19
9803063,9803063,,11,16,2,18
9504001,9504001,,19,5,10,15
9907063,9907063,,11,4,8,12
4120,4120,,65,1,22,23
9311113,9311113,,6,8,0,8
4121,4121,,62,3,16,19
4122,4122,,65,2,11,13
4123,4123,,34,4,25,29
9604121,9604121,,1,4,2,6
4127,4127,,3,2,6,8
4128,4128,,6,2,6,8
102171,102171,,6,2,5,7
9307089,9307089,,6,2,1,3
4129,4129,,34,0,6,6
9810066,9810066,,34,2,5,7
9909141,9909141,,34,8,8,16
9411204,9411204,,16,5,4,9
9902145,9902145,,34,4,4,8
4130,4130,,2,4,16,20
5099,5099,,2,5,11,16
6242,6242,,2,7,19,26
9509033,9509033,,2,4,2,6
9910171,9910171,,2,14,5,19
9911174,9911174,,2,7,18,25
6090,6090,,2,8,17,25
9305111,9305111,,31,7,0,7
9303063,9303063,,2,2,2,4
9802175,9802175,,2,8,5,13
9511136,9511136,,2,2,1,3
9901133,9901133,,6,2,1,3
9904175,9904175,,2,6,12,18
4131,4131,,4,10,18,28
9904048,9904048,,11,3,1,4
9603047,9603047,,11,4,0,4
9312184,9312184,,0,1,12,13
4135,4135,,11,3,8,11
9710125,9710125,,37,8,6,14
9809007,9809007,,54,3,16,19
4137,4137,,6,2,9,11
9205111,9205111,,6,6,0,6
9305038,9305038,,6,7,3,10
4138,4138,,6,1,3,4
4139,4139,,16,2,2,4
9903017,9903017,,16,8,5,13
9501107,9501107,,16,6,1,7
9707137,9707137,,16,2,1,3
9806163,9806163,,16,6,8,14
4140,4140,,16,1,5,6
9903018,9903018,,16,4,4,8
9711022,9711022,,16,2,0,2
4141,4141,,65,43,19,62
4142,4142,,34,18,16,34
5163,5163,,34,16,15,31
6102,6102,,34,14,11,25
4143,4143,,19,1,10,11
9602080,9602080,,6,5,3,8
9603054,9603054,,19,3,1,4
9708045,9708045,,7,2,4,6
9812069,9812069,,19,5,3,8
9903127,9903127,,19,3,0,3
9905110,9905110,,19,1,3,4
9906172,9906172,,19,1,1,2
9504024,9504024,,6,5,0,5
9512197,9512197,,6,1,1,2
9512168,9512168,,19,4,0,4
9707109,9707109,,7,5,6,11
9505095,9505095,,6,13,1,14
9509157,9509157,,19,1,0,1
9503224,9503224,,6,5,0,5
4144,4144,,0,3,8,11
4145,4145,,6,7,19,26
9604181,9604181,,6,12,8,20
9808104,9808104,,2,2,4,6
9904183,9904183,,6,9,14,23
9202045,9202045,,6,7,0,7
9304067,9304067,,6,14,3,17
9311076,9311076,,6,4,1,5
9502032,9502032,,6,11,4,15
9511168,9511168,,6,12,3,15
9509173,9509173,,6,12,15,27
9511081,9511081,,6,4,10,14
9701080,9701080,,6,26,9,35
9703226,9703226,,11,10,1,11
9706018,9706018,,6,12,6,18
9712099,9712099,,6,6,4,10
4146,4146,,34,0,14,14
9612201,9612201,,8,3,15,18
9312002,9312002,,8,14,4,18
9408076,9408076,,1,11,5,16
9501058,9501058,,16,11,14,25
9503052,9503052,,8,1,2,3
9503116,9503116,,25,4,8,12
9605097,9605097,,8,7,1,8
9608020,9608020,,8,2,6,8
9310015,9310015,,8,8,0,8
9404112,9404112,,8,5,0,5
9401075,9401075,,65,11,2,13
9603168,9603168,,65,6,3,9
9607015,9607015,,25,8,7,15
9712146,9712146,,2,1,12,13
4148,4148,,34,31,42,73
9912005,9912005,,31,4,1,5
9411111,9411111,,0,1,1,2
9509127,9509127,,31,2,8,10
9303175,9303175,,31,6,7,13
9711071,9711071,,11,2,4,6
4150,4150,,34,0,4,4
4151,4151,,34,14,15,29
4152,4152,,7,2,17,19
9801199,9801199,,7,2,6,8
9803229,9803229,,7,3,10,13
9903245,9903245,,7,4,5,9
9906176,9906176,,7,4,22,26
9509031,9509031,,7,1,0,1
9510133,9510133,,7,8,3,11
9707054,9707054,,2,2,0,2
9605103,9605103,,7,6,1,7
9610055,9610055,,7,5,3,8
9707082,9707082,,7,5,2,7
9708010,9708010,,7,2,4,6
9212103,9212103,,3,9,1,10
9308102,9308102,,3,5,2,7
9508129,9508129,,3,10,2,12
9512013,9512013,,3,10,1,11
9607187,9607187,,65,11,17,28
9801117,9801117,,8,1,2,3
9407088,9407088,,7,1,0,1
9408088,9408088,,7,4,1,5
9610019,9610019,,7,8,16,24
9810105,9810105,,7,9,11,20
9207048,9207048,,7,6,0,6
9304075,9304075,,8,3,3,6
9812242,9812242,,7,4,3,7
4154,4154,,7,4,11,15
9312081,9312081,,7,4,2,6
9603139,9603139,,7,6,2,8
9302076,9302076,,7,24,0,24
4157,4157,,6,2,15,17
9403188,9403188,,6,25,2,27
9408038,9408038,,6,16,1,17
9807180,9807180,,6,5,10,15
9906019,9906019,,6,6,11,17
9908112,9908112,,6,10,5,15
9310043,9310043,,6,29,0,29
9403069,9403069,,6,29,1,30
9310044,9310044,,6,33,0,33
9511212,9511212,,6,13,7,20
9512110,9512110,,6,2,12,14
9702002,9702002,,6,15,14,29
9702134,9702134,,6,20,10,30
9711092,9711092,,6,10,11,21
9811066,9811066,,6,11,6,17
4158,4158,,11,33,12,45
4159,4159,,3,3,28,31
4161,4161,,7,2,1,3
9901163,9901163,,7,4,5,9
4162,4162,,19,1,9,10
9706198,9706198,,19,4,9,13
9204056,9204056,,19,14,0,14
9312161,9312161,,19,17,2,19
9304103,9304103,,19,6,0,6
9307178,9307178,,19,18,1,19
9403134,9403134,,7,1,1,2
9406039,9406039,,25,3,0,3
9710108,9710108,,19,1,1,2
9805036,9805036,,19,7,0,7
4163,4163,,6,2,16,18
9810078,9810078,,6,11,8,19
9903206,9903206,,6,7,6,13
9905190,9905190,,6,7,5,12
9910060,9910060,,6,7,10,17
9911214,9911214,,6,4,19,23
9508038,9508038,,6,1,1,2
9901140,9901140,,6,3,5,8
9911118,9911118,,6,5,8,13
9912097,9912097,,6,4,3,7
9912114,9912114,,6,3,4,7
9912128,9912128,,6,5,7,12
4167,4167,,37,1,12,13
4168,4168,,19,0,11,11
9306006,9306006,,19,12,3,15
9308009,9308009,,19,5,0,5
9611224,9611224,,19,3,10,13
9908181,9908181,,19,2,15,17
9210131,9210131,,19,5,0,5
9303080,9303080,,19,10,0,10
9303117,9303117,,14,8,1,9
9409133,9409133,,11,7,2,9
9412218,9412218,,19,5,4,9
9507077,9507077,,14,10,1,11
9511207,9511207,,14,19,5,24
9601046,9601046,,11,8,1,9
9702100,9702100,,19,2,1,3
4169,4169,,6,0,2,2
9401001,9401001,,6,7,0,7
4170,4170,,54,4,11,15
9910147,9910147,,54,4,13,17
9610089,9610089,,54,4,18,22
4171,4171,,1,26,1,27
4172,4172,,4,2,13,15
9304096,9304096,,31,4,3,7
9702019,9702019,,8,5,8,13
9706069,9706069,,2,1,7,8
9203012,9203012,,8,12,0,12
9206077,9206077,,8,14,0,14
9209013,9209013,,8,7,0,7
9503229,9503229,,7,8,30,38
9602172,9602172,,2,6,52,58
9602177,9602177,,62,6,6,12
9609079,9609079,,1,4,22,26
9609221,9609221,,16,1,2,3
4173,4173,,0,0,6,6
9710209,9710209,,0,3,6,9
9911053,9911053,,0,2,3,5
9406057,9406057,,0,3,0,3
9504116,9504116,,0,3,2,5
9612175,9612175,,0,3,2,5
4174,4174,,11,1,1,2
4175,4175,,7,1,1,2
9409068,9409068,,7,13,4,17
9209077,9209077,,7,2,0,2
9307099,9307099,,7,10,0,10
9310125,9310125,,7,4,3,7
4176,4176,,11,1,3,4
9603204,9603204,,0,3,6,9
9609206,9609206,,16,2,4,6
9505016,9505016,,0,5,5,10
9511221,9511221,,0,5,6,11
9512112,9512112,,0,6,9,15
4177,4177,,34,4,5,9
9903257,9903257,,34,4,7,11
9602033,9602033,,1,4,5,9
9712161,9712161,,2,6,8,14
4178,4178,,0,7,8,15
9901111,9901111,,0,7,6,13
9910071,9910071,,0,14,11,25
9708067,9708067,,0,6,2,8
9808090,9808090,,0,7,1,8
4179,4179,,34,5,13,18
4180,4180,,65,2,8,10
9403101,9403101,,65,2,0,2
4181,4181,,62,4,13,17
4182,4182,,6,2,9,11
9904152,9904152,,6,5,6,11
4183,4183,,3,31,65,96
4184,4184,,11,4,8,12
4185,4185,,34,5,19,24
4186,4186,,34,8,36,44
9903189,9903189,,11,2,1,3
9912006,9912006,,34,2,1,3
9812203,9812203,,11,4,1,5
9512064,9512064,,7,5,1,6
4187,4187,,34,12,69,81
9907142,9907142,,34,6,34,40
9801162,9801162,,2,1,13,14
9907016,9907016,,2,1,3,4
4188,4188,,0,16,36,52
9912162,9912162,,0,13,17,30
9710109,9710109,,19,2,2,4
4189,4189,,8,3,6,9
4190,4190,,11,3,1,4
9912253,9912253,,11,3,1,4
4191,4191,,6,3,5,8
4192,4192,,3,3,2,5
4193,4193,,3,1,1,2
9906140,9906140,,3,1,0,1
4194,4194,,2,13,12,25
9912103,9912103,,2,7,8,15
4195,4195,,2,22,22,44
9609069,9609069,,11,8,2,10
4196,4196,,37,22,16,38
9412210,9412210,,6,7,0,7
9208042,9208042,,37,6,0,6
4197,4197,,19,0,1,1
9811157,9811157,,19,8,3,11
9809036,9809036,,19,7,8,15
9811154,9811154,,19,8,0,8
4198,4198,,4,5,89,94
9712092,9712092,,54,2,2,4
9509006,9509006,,54,1,2,3
9703008,9703008,,2,6,20,26
4199,4199,,2,7,16,23
4200,4200,,11,0,3,3
9309045,9309045,,11,14,0,14
9710157,9710157,,11,1,0,1
4201,4201,,34,3,17,20
4202,4202,,2,0,1,1
4203,4203,,6,3,6,9
9303150,9303150,,19,11,1,12
4204,4204,,34,1,25,26
4205,4205,,11,2,4,6
9703139,9703139,,11,9,5,14
9203029,9203029,,11,7,0,7
9306008,9306008,,11,12,0,12
9510037,9510037,,11,10,1,11
9510157,9510157,,11,23,8,31
5002,5002,,1,5,5,10
5003,5003,,34,12,26,38
9804074,9804074,,37,4,15,19
9910013,9910013,,34,13,27,40
9511014,9511014,,37,8,7,15
9701012,9701012,,37,11,12,23
9210019,9210019,,19,1,1,2
9304020,9304020,,8,5,0,5
9808094,9808094,,8,1,11,12
9909097,9909097,,34,1,2,3
5004,5004,,6,3,10,13
9902048,9902048,,6,1,6,7
9308127,9308127,,37,5,2,7
9411088,9411088,,6,1,0,1
9406092,9406092,,6,4,0,4
9410134,9410134,,6,10,0,10
9606120,9606120,,6,5,5,10
9407150,9407150,,19,2,0,2
9609240,9609240,,6,1,6,7
9705028,9705028,,11,8,8,16
5005,5005,,3,24,14,38
5006,5006,,4,118,25,143
5007,5007,,3,9,47,56
5008,5008,,54,4,20,24
9703180,9703180,,37,17,42,59
9708073,9708073,,37,4,24,28
5009,5009,,7,3,6,9
9204039,9204039,,7,4,0,4
5010,5010,,2,6,11,17
9701157,9701157,,2,5,3,8
9809136,9809136,,2,7,8,15
9404095,9404095,,2,1,2,3
9702024,9702024,,2,2,15,17
9501081,9501081,,2,6,0,6
9806033,9806033,,2,1,12,13
5011,5011,,6,2,6,8
9409046,9409046,,6,3,8,11
9503192,9503192,,6,3,8,11
9203014,9203014,,16,4,0,4
5015,5015,,3,98,14,112
5129,5129,,3,157,22,179
5040,5040,,3,155,15,170
5046,5046,,3,43,5,48
5048,5048,,3,159,16,175
5073,5073,,3,62,22,84
5017,5017,,0,6,6,12
9902069,9902069,,0,8,1,9
9912229,9912229,,0,11,5,16
9810061,9810061,,0,1,1,2
5018,5018,,11,2,5,7
5019,5019,,16,0,6,6
9710042,9710042,,16,5,2,7
9903147,9903147,,16,2,1,3
9903200,9903200,,16,1,3,4
9701029,9701029,,16,5,4,9
9707112,9707112,,16,5,1,6
5020,5020,,34,0,10,10
5021,5021,,3,17,39,56
5023,5023,,6,0,3,3
5024,5024,,11,0,4,4
5026,5026,,3,42,34,76
5123,5123,,3,27,15,42
9912065,9912065,,3,7,10,17
9912274,9912274,,3,19,22,41
5027,5027,,62,6,13,19
9909019,9909019,,62,5,3,8
9911016,9911016,,1,5,29,34
9405090,9405090,,2,4,2,6
9602057,9602057,,2,6,11,17
9201044,9201044,,31,8,0,8
9207002,9207002,,31,7,1,8
9712022,9712022,,54,3,26,29
5029,5029,,4,55,73,128
9609232,9609232,,2,2,0,2
5030,5030,,2,0,15,15
9506199,9506199,,65,5,3,8
9606178,9606178,,2,4,0,4
9611232,9611232,,2,1,4,5
9804070,9804070,,6,7,5,12
9206082,9206082,,2,4,1,5
9408122,9408122,,6,5,0,5
9607044,9607044,,6,5,4,9
9611015,9611015,,6,2,10,12
5031,5031,,4,179,35,214
5033,5033,,0,1,4,5
5034,5034,,2,0,10,10
9904134,9904134,,2,7,5,12
9907148,9907148,,2,1,11,12
5035,5035,,2,1,15,16
9312045,9312045,,62,12,7,19
9411155,9411155,,2,1,0,1
9609031,9609031,,62,8,6,14
5036,5036,,4,94,32,126
5037,5037,,62,4,5,9
9512105,9512105,,62,16,18,34
9909118,9909118,,62,6,10,16
9211088,9211088,,62,8,2,10
9504131,9504131,,62,2,1,3
9505047,9505047,,62,8,14,22
9210037,9210037,,62,18,0,18
9502063,9502063,,62,1,1,2
9503211,9503211,,62,7,10,17
9503217,9503217,,62,7,8,15
9509096,9509096,,62,7,10,17
5038,5038,,25,0,1,1
9911168,9911168,,25,4,0,4
5039,5039,,62,3,2,5
9202001,9202001,,62,8,0,8
5041,5041,,7,11,3,14
5042,5042,,7,1,3,4
5043,5043,,34,0,2,2
9807094,9807094,,34,4,1,5
5044,5044,,54,4,19,23
5086,5086,,54,6,12,18
9706108,9706108,,54,18,6,24
9706169,9706169,,54,14,5,19
9706216,9706216,,54,15,9,24
9709088,9709088,,54,12,6,18
9512165,9512165,,54,7,8,15
9607216,9607216,,54,4,11,15
9709129,9709129,,54,4,40,44
5045,5045,,0,10,15,25
5047,5047,,2,15,38,53
5049,5049,,54,31,63,94
9801140,9801140,,37,3,8,11
9803228,9803228,,54,7,22,29
9812049,9812049,,54,8,52,60
9610001,9610001,,54,4,6,10
9609094,9609094,,2,4,47,51
9809202,9809202,,54,1,8,9
9811032,9811032,,2,1,20,21
5050,5050,,11,0,1,1
5051,5051,,2,1,11,12
5052,5052,,65,19,47,66
9210063,9210063,,65,2,0,2
9605232,9605232,,37,15,18,33
5053,5053,,37,8,31,39
9409093,9409093,,37,11,6,17
9409190,9409190,,37,5,6,11
9501013,9501013,,37,2,0,2
9707029,9707029,,7,4,2,6
9711006,9711006,,8,5,25,30
9309026,9309026,,37,4,4,8
9307048,9307048,,62,15,0,15
9209074,9209074,,16,8,0,8
9301059,9301059,,16,13,1,14
9303129,9303129,,37,3,3,6
9703079,9703079,,7,4,0,4
9703080,9703080,,7,4,0,4
9702018,9702018,,65,9,18,27
9703141,9703141,,2,5,7,12
9712140,9712140,,9,1,8,9
9601161,9601161,,37,4,8,12
5054,5054,,34,9,44,53
5055,5055,,16,3,17,20
9904027,9904027,,16,4,15,19
9402052,9402052,,16,18,4,22
9408129,9408129,,16,2,10,12
5056,5056,,37,1,10,11
9911126,9911126,,7,2,5,7
9805116,9805116,,7,9,7,16
5059,5059,,3,17,19,36
5060,5060,,11,1,2,3
3279,3279,,11,1,0,1
5061,5061,,1,85,16,101
9709142,9709142,,1,2,0,2
9205058,9205058,,1,18,0,18
9210160,9210160,,2,5,0,5
9309042,9309042,,1,6,7,13
9311048,9311048,,1,2,5,7
9311122,9311122,,1,4,5,9
9303054,9303054,,1,1,2,3
9406079,9406079,,2,8,2,10
9503027,9503027,,2,6,41,47
8235,8235,,31,5,3,8
10232,10232,,0,28,28,56
5063,5063,,25,3,11,14
9309094,9309094,,25,9,2,11
9311047,9311047,,25,10,2,12
9810095,9810095,,25,6,10,16
9912098,9912098,,25,6,21,27
9509168,9509168,,25,3,2,5
9610052,9610052,,25,1,3,4
9511217,9511217,,25,8,8,16
9609077,9609077,,25,4,7,11
5064,5064,,11,4,10,14
9602122,9602122,,7,6,1,7
9809060,9809060,,9,4,0,4
5065,5065,,1,16,35,51
9812195,9812195,,54,3,31,34
9512034,9512034,,54,3,11,14
9405120,9405120,,54,3,4,7
5070,5070,,11,0,2,2
9902133,9902133,,11,1,1,2
5071,5071,,2,2,6,8
9502056,9502056,,2,1,0,1
9311008,9311008,,2,8,1,9
5072,5072,,54,16,35,51
5074,5074,,2,0,6,6
5075,5075,,16,4,12,16
9805155,9805155,,16,5,14,19
9809084,9809084,,16,2,13,15
9710140,9710140,,25,4,2,6
5076,5076,,37,15,35,50
9801027,9801027,,37,5,11,16
9911097,9911097,,11,4,21,25
5078,5078,,8,3,8,11
9603057,9603057,,19,3,4,7
9604111,9604111,,19,5,2,7
9311019,9311019,,19,4,0,4
9609197,9609197,,19,2,4,6
5079,5079,,11,0,3,3
9907221,9907221,,11,1,2,3
9801045,9801045,,11,1,1,2
5080,5080,,3,7,10,17
9912254,9912254,,3,18,21,39
5081,5081,,34,2,20,22
9906102,9906102,,34,6,23,29
9906105,9906105,,34,4,18,22
9202065,9202065,,25,12,0,12
9905099,9905099,,34,4,19,23
5082,5082,,11,1,6,7
9709024,9709024,,11,5,1,6
9709144,9709144,,11,8,1,9
9712108,9712108,,11,4,0,4
9807158,9807158,,11,13,4,17
9903076,9903076,,11,2,2,4
9905022,9905022,,11,5,3,8
9707187,9707187,,11,2,0,2
9602168,9602168,,11,2,1,3
9712104,9712104,,11,2,0,2
9904004,9904004,,11,5,4,9
5083,5083,,11,8,13,21
9912020,9912020,,11,8,4,12
5085,5085,,4,19,13,32
5087,5087,,37,36,44,80
5088,5088,,37,8,23,31
9209066,9209066,,11,5,0,5
9306065,9306065,,6,4,2,6
9703171,9703171,,37,1,18,19
5089,5089,,16,6,11,17
9208041,9208041,,16,19,0,19
9209094,9209094,,16,13,0,13
9301001,9301001,,16,19,0,19
9308094,9308094,,16,11,0,11
9401045,9401045,,16,12,1,13
9409030,9409030,,16,11,6,17
9706173,9706173,,16,3,5,8
9907031,9907031,,16,1,7,8
9304088,9304088,,16,9,0,9
9503213,9503213,,16,2,14,16
5090,5090,,4,43,20,63
5091,5091,,4,22,14,36
5092,5092,,25,1,2,3
5093,5093,,54,1,31,32
9503094,9503094,,2,8,3,11
9706165,9706165,,2,5,13,18
5094,5094,,34,8,9,17
5095,5095,,3,2,29,31
9706090,9706090,,2,11,7,18
9708076,9708076,,2,7,5,12
9909051,9909051,,2,6,16,22
9310024,9310024,,16,7,2,9
9701010,9701010,,2,9,18,27
5096,5096,,16,1,11,12
9212129,9212129,,16,2,0,2
9303082,9303082,,25,6,1,7
9901061,9901061,,16,2,4,6
9907119,9907119,,16,3,14,17
5097,5097,,1,1,4,5
9706180,9706180,,1,6,3,9
9901116,9901116,,1,3,17,20
9902109,9902109,,1,2,2,4
9211082,9211082,,25,17,3,20
9401100,9401100,,1,3,3,6
9311173,9311173,,1,3,1,4
9302032,9302032,,25,4,1,5
5098,5098,,34,3,30,33
5100,5100,,62,1,8,9
9712121,9712121,,62,6,10,16
9506078,9506078,,62,1,1,2
9506108,9506108,,62,5,4,9
9506107,9506107,,62,2,2,4
9405200,9405200,,62,2,7,9
9406180,9406180,,62,10,6,16
9506167,9506167,,62,6,4,10
9707074,9707074,,62,4,6,10
5101,5101,,3,18,10,28
5102,5102,,31,0,8,8
5103,5103,,4,3,6,9
5105,5105,,4,1,28,29
5106,5106,,34,5,15,20
9801008,9801008,,31,3,19,22
9504111,9504111,,62,7,2,9
9704201,9704201,,2,3,5,8
9807104,9807104,,2,1,17,18
5107,5107,,11,1,6,7
9911111,9911111,,11,1,12,13
9506062,9506062,,11,5,1,6
9705015,9705015,,34,6,1,7
9804025,9804025,,62,6,8,14
9304095,9304095,,11,2,0,2
5108,5108,,34,6,9,15
9704072,9704072,,2,8,3,11
9507009,9507009,,25,7,17,24
5109,5109,,37,4,1,5
5110,5110,,62,4,6,10
5111,5111,,2,5,52,57
9806115,9806115,,2,7,25,32
9812119,9812119,,2,6,10,16
9407169,9407169,,2,11,3,14
9203022,9203022,,16,3,0,3
9205056,9205056,,16,8,0,8
9206060,9206060,,16,9,1,10
5112,5112,,25,3,3,6
9908027,9908027,,19,4,4,8
9911128,9911128,,25,5,8,13
9912263,9912263,,14,9,6,15
9902207,9902207,,25,4,2,6
9409088,9409088,,14,11,2,13
9507076,9507076,,14,18,1,19
9510060,9510060,,14,18,1,19
9706021,9706021,,14,13,7,20
5113,5113,,3,3,19,22
9911200,9911200,,2,6,65,71
9507063,9507063,,2,5,23,28
9904110,9904110,,34,6,13,19
5114,5114,,4,10,37,47
5115,5115,,34,10,16,26
5116,5116,,0,4,7,11
5117,5117,,2,2,18,20
5119,5119,,37,9,8,17
5120,5120,,54,9,22,31
9412152,9412152,,8,3,5,8
9606108,9606108,,25,1,8,9
9610102,9610102,,2,13,5,18
9809056,9809056,,2,3,9,12
9912181,9912181,,54,5,56,61
9210163,9210163,,8,15,0,15
9307096,9307096,,8,3,6,9
9312198,9312198,,8,3,8,11
9505068,9505068,,8,4,4,8
9708139,9708139,,25,5,10,15
9711151,9711151,,2,11,2,13
9703182,9703182,,54,2,48,50
9908067,9908067,,54,1,10,11
9912025,9912025,,54,2,18,20
9603134,9603134,,37,6,19,25
9606146,9606146,,37,4,23,27
9511028,9511028,,7,3,6,9
9605171,9605171,,7,1,3,4
5124,5124,,54,2,23,25
5125,5125,,11,14,15,29
5126,5126,,2,13,8,21
5128,5128,,37,0,16,16
9212070,9212070,,62,27,2,29
9309012,9309012,,16,9,6,15
9407091,9407091,,37,4,12,16
9410214,9410214,,16,4,3,7
9601139,9601139,,16,7,10,17
9602007,9602007,,16,2,8,10
9605140,9605140,,16,8,30,38
9605175,9605175,,37,1,1,2
9609214,9609214,,37,4,3,7
9706182,9706182,,37,3,2,5
9204019,9204019,,62,33,0,33
9208071,9208071,,16,7,0,7
9209022,9209022,,16,19,2,21
9212106,9212106,,37,6,0,6
9311070,9311070,,62,11,4,15
9402081,9402081,,37,10,0,10
9208045,9208045,,16,12,0,12
9306037,9306037,,16,9,9,18
9506030,9506030,,16,6,1,7
9310193,9310193,,16,3,2,5
9405158,9405158,,16,3,1,4
9206095,9206095,,16,12,0,12
9208020,9208020,,16,7,2,9
9306043,9306043,,16,11,6,17
9312145,9312145,,16,5,11,16
9501037,9501037,,16,6,15,21
9402111,9402111,,62,3,0,3
9505005,9505005,,37,7,3,10
9312015,9312015,,62,3,0,3
5130,5130,,62,1,26,27
9610059,9610059,,16,6,12,18
9705243,9705243,,16,3,5,8
9905026,9905026,,62,4,9,13
9407128,9407128,,16,18,7,25
9507114,9507114,,16,9,6,15
9511191,9511191,,16,3,11,14
9503235,9503235,,16,7,3,10
9608122,9608122,,16,4,5,9
9608155,9608155,,16,2,4,6
9704192,9704192,,16,3,15,18
9607088,9607088,,62,1,5,6
9610067,9610067,,6,4,5,9
9711186,9711186,,6,2,3,5
9810120,9810120,,6,1,2,3
9811001,9811001,,6,1,2,3
5131,5131,,6,0,1,1
5132,5132,,7,1,8,9
5133,5133,,25,0,24,24
9609194,9609194,,25,8,6,14
9306154,9306154,,25,13,1,14
9310128,9310128,,25,8,0,8
9412088,9412088,,25,2,0,2
9209038,9209038,,25,3,0,3
9406047,9406047,,25,9,0,9
9612116,9612116,,25,6,8,14
9702148,9702148,,25,2,0,2
9710130,9710130,,25,2,1,3
5134,5134,,62,3,7,10
9912008,9912008,,62,1,6,7
9703129,9703129,,62,8,3,11
9901031,9901031,,62,10,4,14
9908021,9908021,,62,2,14,16
5135,5135,,34,18,28,46
5136,5136,,34,23,11,34
9810231,9810231,,34,9,1,10
5138,5138,,3,9,12,21
5140,5140,,11,0,5,5
9504153,9504153,,11,9,0,9
9504154,9504154,,11,13,0,13
9811111,9811111,,11,7,1,8
9902013,9902013,,11,4,2,6
9407137,9407137,,11,6,0,6
9812167,9812167,,11,1,4,5
5141,5141,,8,0,1,1
9207066,9207066,,62,7,0,7
9305088,9305088,,16,3,0,3
9306033,9306033,,8,19,10,29
9403157,9403157,,8,2,5,7
5142,5142,,3,6,8,14
9911179,9911179,,25,3,2,5
5143,5143,,34,9,8,17
5144,5144,,8,1,13,14
9407010,9407010,,1,2,0,2
9609153,9609153,,65,3,4,7
9810018,9810018,,8,4,0,4
9811239,9811239,,8,2,2,4
9502138,9502138,,65,4,2,6
9507085,9507085,,65,3,7,10
9410091,9410091,,37,7,0,7
5145,5145,,2,28,58,86
9812120,9812120,,2,3,8,11
9907099,9907099,,2,4,29,33
9909227,9909227,,2,2,71,73
9801014,9801014,,37,9,9,18
5146,5146,,2,1,16,17
5147,5147,,2,19,37,56
9308091,9308091,,2,4,0,4
5148,5148,,65,13,16,29
5149,5149,,11,0,2,2
9608160,9608160,,6,6,1,7
9902084,9902084,,11,5,0,5
5150,5150,,19,3,1,4
9911025,9911025,,19,2,0,2
5151,5151,,34,25,47,72
9806100,9806100,,34,6,0,6
5152,5152,,1,14,26,40
6070,6070,,1,11,16,27
9905130,9905130,,34,4,35,39
5183,5183,,1,53,28,81
9608018,9608018,,8,12,8,20
5153,5153,,4,7,43,50
5154,5154,,11,8,5,13
105042,105042,,11,6,8,14
7179,7179,,11,4,4,8
9075,9075,,11,2,12,14
9911211,9911211,,11,7,6,13
5155,5155,,7,1,2,3
5156,5156,,3,6,7,13
5157,5157,,2,7,7,14
9804119,9804119,,34,4,9,13
9403077,9403077,,25,6,2,8
9604154,9604154,,25,2,7,9
5158,5158,,62,8,14,22
9806090,9806090,,62,9,3,12
9810046,9810046,,62,5,11,16
9403070,9403070,,4,12,3,15
9412064,9412064,,34,8,7,15
9210077,9210077,,37,4,0,4
9411138,9411138,,62,2,3,5
9301066,9301066,,62,2,0,2
5159,5159,,3,24,30,54
5160,5160,,37,3,26,29
9604003,9604003,,37,10,5,15
9803065,9803065,,37,9,18,27
9803148,9803148,,37,2,12,14
9508124,9508124,,37,8,8,16
5161,5161,,62,3,11,14
9403159,9403159,,62,1,2,3
5162,5162,,0,12,40,52
9306057,9306057,,0,6,0,6
9411131,9411131,,54,1,11,12
9303158,9303158,,54,6,1,7
5164,5164,,54,1,18,19
9905059,9905059,,54,1,12,13
9807018,9807018,,2,1,0,1
9707045,9707045,,2,1,0,1
9712106,9712106,,2,3,2,5
5166,5166,,37,6,23,29
5167,5167,,0,5,32,37
5168,5168,,34,7,14,21
9607002,9607002,,37,2,4,6
5169,5169,,1,2,39,41
9208025,9208025,,1,1,3,4
9205078,9205078,,1,5,2,7
9304098,9304098,,1,3,0,3
9405118,9405118,,1,6,0,6
5170,5170,,62,8,18,26
9509056,9509056,,62,11,3,14
9806184,9806184,,62,2,18,20
9810032,9810032,,62,3,0,3
9301056,9301056,,62,4,0,4
9302089,9302089,,62,2,1,3
9304112,9304112,,62,5,2,7
5171,5171,,15,0,1,1
9612006,9612006,,15,2,0,2
5172,5172,,34,6,14,20
5173,5173,,34,12,4,16
5174,5174,,3,11,23,34
5175,5175,,19,2,7,9
9404024,9404024,,6,3,1,4
9605206,9605206,,19,8,1,9
9707008,9707008,,11,7,4,11
9306067,9306067,,0,15,0,15
9410123,9410123,,37,5,0,5
9502075,9502075,,19,5,0,5
9604038,9604038,,19,2,0,2
9504038,9504038,,11,1,1,2
5176,5176,,2,0,32,32
9403125,9403125,,1,2,0,2
9801118,9801118,,2,7,20,27
5178,5178,,3,3,31,34
5179,5179,,34,14,18,32
9912024,9912024,,25,6,9,15
9301020,9301020,,25,4,2,6
9501038,9501038,,25,3,17,20
9607062,9607062,,25,27,8,35
9702139,9702139,,25,3,2,5
9705145,9705145,,25,8,7,15
9709055,9709055,,25,6,10,16
9801155,9801155,,25,4,13,17
9802013,9802013,,25,4,7,11
9310047,9310047,,25,6,2,8
9808135,9808135,,25,3,7,10
9808136,9808136,,25,3,8,11
5180,5180,,37,3,21,24
5181,5181,,62,3,8,11
9505086,9505086,,62,4,6,10
5182,5182,,34,40,39,79
5184,5184,,2,0,10,10
5186,5186,,37,8,28,36
9908120,9908120,,37,9,21,30
9408079,9408079,,19,8,4,12
9801026,9801026,,6,3,5,8
5187,5187,,65,8,12,20
9802022,9802022,,65,2,5,7
9606025,9606025,,65,7,11,18
5188,5188,,16,0,1,1
9406002,9406002,,25,8,3,11
9206036,9206036,,25,6,0,6
5190,5190,,37,2,2,4
9911023,9911023,,37,12,11,23
9609210,9609210,,2,3,11,14
9610199,9610199,,2,2,8,10
5191,5191,,3,3,4,7
9605080,9605080,,6,7,12,19
9611068,9611068,,19,6,14,20
9709020,9709020,,6,1,4,5
9808174,9808174,,19,3,1,4
9308003,9308003,,19,3,1,4
9312062,9312062,,19,18,0,18
9407067,9407067,,19,14,1,15
9408077,9408077,,19,19,6,25
9408146,9408146,,19,14,1,15
9408176,9408176,,19,14,2,16
9409134,9409134,,19,22,1,23
9410174,9410174,,19,12,10,22
9504157,9504157,,19,12,7,19
9504158,9504158,,19,17,12,29
9504159,9504159,,19,11,9,20
9510237,9510237,,19,4,3,7
9604148,9604148,,19,4,17,21
5192,5192,,34,5,52,57
9907015,9907015,,34,1,21,22
5194,5194,,3,15,17,32
9902015,9902015,,2,2,0,2
9211126,9211126,,62,4,1,5
5195,5195,,19,1,2,3
9708104,9708104,,19,10,0,10
9904055,9904055,,19,3,4,7
9801004,9801004,,19,3,3,6
9807037,9807037,,19,3,14,17
5196,5196,,2,0,6,6
5197,5197,,34,3,15,18
5198,5198,,54,1,16,17
5201,5201,,25,2,9,11
9804071,9804071,,25,9,3,12
9804072,9804072,,25,6,6,12
9805184,9805184,,25,8,9,17
9906229,9906229,,25,4,13,17
9410027,9410027,,6,4,0,4
9602134,9602134,,3,2,7,9
9606183,9606183,,6,3,1,4
9501093,9501093,,25,7,2,9
9508055,9508055,,25,7,0,7
9602046,9602046,,25,1,3,4
9503056,9503056,,25,2,0,2
9707257,9707257,,25,9,9,18
9804118,9804118,,25,10,10,20
9812137,9812137,,19,1,7,8
5202,5202,,4,5,12,17
5203,5203,,6,0,7,7
9504132,9504132,,6,5,3,8
9510136,9510136,,6,6,6,12
5205,5205,,3,5,18,23
5207,5207,,11,0,3,3
9910166,9910166,,11,2,7,9
5208,5208,,3,92,32,124
5209,5209,,7,49,9,58
9410082,9410082,,0,3,2,5
9510159,9510159,,7,3,3,6
9507094,9507094,,25,6,13,19
5210,5210,,3,19,33,52
9207084,9207084,,7,30,1,31
9312179,9312179,,7,11,8,19
9402033,9402033,,7,12,3,15
9208037,9208037,,7,8,1,9
9210150,9210150,,7,20,2,22
9304161,9304161,,7,5,2,7
5211,5211,,4,3,26,29
9909182,9909182,,54,1,9,10
9910100,9910100,,54,1,9,10
9912029,9912029,,4,1,11,12
9906059,9906059,,54,1,5,6
9205096,9205096,,31,3,0,3
5213,5213,,34,4,25,29
5214,5214,,3,3,5,8
9905065,9905065,,3,4,1,5
9410057,9410057,,19,6,1,7
9706206,9706206,,19,2,3,5
5215,5215,,2,2,7,9
9903158,9903158,,2,5,7,12
5218,5218,,62,2,2,4
9906120,9906120,,62,2,2,4
9401086,9401086,,16,11,1,12
5219,5219,,34,5,20,25
5220,5220,,34,6,32,38
9512041,9512041,,54,14,0,14
9605134,9605134,,54,4,5,9
9605143,9605143,,54,2,4,6
9609073,9609073,,54,5,5,10
5221,5221,,37,6,14,20
9811041,9811041,,37,5,7,12
9811112,9811112,,37,4,12,16
9405129,9405129,,37,6,0,6
9807172,9807172,,37,3,3,6
5222,5222,,3,27,8,35
5223,5223,,34,14,19,33
5224,5224,,34,12,6,18
9308116,9308116,,11,20,0,20
9409152,9409152,,11,9,1,10
9508148,9508148,,11,15,3,18
9510188,9510188,,11,8,2,10
9702072,9702072,,11,8,8,16
9710074,9710074,,11,5,1,6
9801163,9801163,,11,3,2,5
9801172,9801172,,11,4,1,5
9807163,9807163,,11,5,11,16
5225,5225,,54,18,17,35
9312077,9312077,,54,4,5,9
9611061,9611061,,54,1,18,19
9065,9065,,0,3,6,9
5227,5227,,25,1,4,5
9210105,9210105,,25,7,13,20
9412095,9412095,,25,7,2,9
9201034,9201034,,25,4,0,4
9201065,9201065,,25,1,0,1
9201066,9201066,,25,1,0,1
9204052,9204052,,25,11,1,12
9205020,9205020,,25,3,1,4
9205101,9205101,,25,2,0,2
9206111,9206111,,4,4,0,4
9602059,9602059,,65,4,9,13
5228,5228,,25,0,4,4
9505107,9505107,,25,5,6,11
5229,5229,,16,6,8,14
9912146,9912146,,16,8,23,31
9804049,9804049,,16,7,1,8
5231,5231,,8,1,2,3
5232,5232,,16,4,9,13
5233,5233,,16,6,11,17
5234,5234,,16,5,11,16
5235,5235,,16,6,13,19
5237,5237,,16,6,9,15
9601105,9601105,,16,5,5,10
9511122,9511122,,16,4,0,4
9605128,9605128,,16,4,5,9
9305173,9305173,,16,1,0,1
5236,5236,,31,4,17,21
5238,5238,,14,0,4,4
9209106,9209106,,14,17,0,17
5240,5240,,19,0,1,1
9902091,9902091,,19,4,0,4
5241,5241,,2,7,11,18
5242,5242,,4,23,36,59
9148,9148,,4,196,18,214
9905146,9905146,,2,12,22,34
8231,8231,,4,70,11,81
9103,9103,,4,174,16,190
9303067,9303067,,4,51,1,52
9311177,9311177,,4,92,1,93
5243,5243,,37,0,5,5
9701120,9701120,,37,7,29,36
9905208,9905208,,37,4,5,9
9503234,9503234,,37,4,0,4
9505135,9505135,,37,10,11,21
9611012,9611012,,37,2,17,19
5244,5244,,65,21,13,34
5246,5246,,2,14,30,44
9312030,9312030,,25,2,2,4
5247,5247,,37,101,42,143
9304130,9304130,,37,3,0,3
9607223,9607223,,37,3,23,26
5249,5249,,7,2,1,3
5250,5250,,34,4,28,32
9707052,9707052,,11,1,1,2
9807038,9807038,,25,3,9,12
9902190,9902190,,34,4,19,23
9903138,9903138,,19,2,10,12
5251,5251,,54,18,14,32
9912144,9912144,,54,20,14,34
5252,5252,,11,0,2,2
5253,5253,,3,16,15,31
5254,5254,,62,5,5,10
5255,5255,,6,6,2,8
9311158,9311158,,6,4,0,4
5256,5256,,34,1,33,34
5257,5257,,25,5,10,15
5258,5258,,19,2,14,16
5259,5259,,37,18,13,31
9401163,9401163,,16,7,0,7
9711091,9711091,,37,5,4,9
9909147,9909147,,37,14,7,21
9301070,9301070,,25,10,0,10
9302027,9302027,,8,13,2,15
9401135,9401135,,25,7,3,10
9209041,9209041,,62,30,1,31
9311089,9311089,,62,4,7,11
9404011,9404011,,37,8,12,20
9307115,9307115,,37,5,5,10
9209006,9209006,,62,18,2,20
9305005,9305005,,62,28,1,29
9312209,9312209,,37,9,4,13
9410048,9410048,,3,4,0,4
9303152,9303152,,37,6,0,6
9410063,9410063,,37,4,4,8
5260,5260,,3,0,2,2
9802087,9802087,,3,1,0,1
5261,5261,,34,3,6,9
5262,5262,,37,1,20,21
9709203,9709203,,37,1,7,8
9801066,9801066,,37,15,18,33
9812055,9812055,,37,7,27,34
9907123,9907123,,37,9,85,94
9512021,9512021,,37,4,5,9
9702054,9702054,,37,10,12,22
9603160,9603160,,37,1,2,3
9711132,9711132,,37,10,22,32
9806015,9806015,,37,5,28,33
9806032,9806032,,37,8,35,43
9503020,9503020,,16,5,21,26
9901161,9901161,,37,2,41,43
9903172,9903172,,37,7,25,32
9907053,9907053,,37,5,12,17
5263,5263,,19,1,7,8
9504134,9504134,,19,9,1,10
9609142,9609142,,19,6,6,12
9312089,9312089,,19,1,0,1
9312090,9312090,,19,1,0,1
9401043,9401043,,19,3,0,3
9307118,9307118,,19,13,0,13
9312091,9312091,,19,9,0,9
9506083,9506083,,19,14,7,21
5264,5264,,25,0,1,1
9407019,9407019,,25,3,0,3
9601090,9601090,,6,1,2,3
9607197,9607197,,25,1,3,4
9612155,9612155,,25,1,8,9
9703005,9703005,,25,4,1,5
5265,5265,,2,17,14,31
5266,5266,,34,7,6,13
5267,5267,,34,1,3,4
5268,5268,,2,11,19,30
5269,5269,,0,6,5,11
9905201,9905201,,16,1,3,4
9910165,9910165,,0,4,9,13
9402078,9402078,,16,3,0,3
9408010,9408010,,16,2,0,2
9610109,9610109,,16,2,0,2
9610009,9610009,,16,5,1,6
9812075,9812075,,11,2,0,2
9907199,9907199,,0,1,1,2
5270,5270,,2,27,5,32
5271,5271,,54,0,26,26
5272,5272,,3,51,33,84
9805085,9805085,,3,4,5,9
5273,5273,,3,12,13,25
9303115,9303115,,7,2,0,2
9312075,9312075,,7,5,11,16
9406042,9406042,,7,1,0,1
9406172,9406172,,7,1,1,2
9411039,9411039,,7,2,12,14
9412153,9412153,,7,2,4,6
9508047,9508047,,7,4,8,12
5275,5275,,37,7,38,45
9708006,9708006,,37,3,5,8
5277,5277,,37,11,16,27
9403136,9403136,,37,1,0,1
9809152,9809152,,7,3,5,8
9501044,9501044,,7,2,0,2
9606092,9606092,,7,7,3,10
9803169,9803169,,7,1,3,4
9501023,9501023,,7,1,2,3
9807102,9807102,,6,2,2,4
5278,5278,,37,1,11,12
9306155,9306155,,37,6,0,6
5279,5279,,9,3,14,17
9909185,9909185,,9,2,2,4
5280,5280,,34,7,29,36
5281,5281,,0,1,8,9
9408057,9408057,,0,1,0,1
5282,5282,,16,5,11,16
9404058,9404058,,16,8,6,14
9510104,9510104,,16,8,8,16
5283,5283,,3,10,18,28
5284,5284,,7,0,3,3
9501103,9501103,,7,3,0,3
9705081,9705081,,7,1,1,2
5285,5285,,19,1,5,6
5286,5286,,19,2,4,6
9202052,9202052,,19,6,0,6
9905136,9905136,,19,4,6,10
9906174,9906174,,19,3,8,11
9205116,9205116,,6,10,0,10
9511195,9511195,,19,6,12,18
9704081,9704081,,19,2,0,2
9806070,9806070,,19,1,0,1
5287,5287,,9,3,6,9
5288,5288,,34,1,5,6
6001,6001,,3,4,1,5
6003,6003,,1,28,3,31
6004,6004,,37,3,11,14
9909196,9909196,,37,5,35,40
9405018,9405018,,62,2,5,7
9807183,9807183,,37,9,28,37
9809180,9809180,,37,4,14,18
9812085,9812085,,37,4,24,28
9906207,9906207,,37,3,52,55
6005,6005,,3,9,6,15
9512007,9512007,,3,5,0,5
9601024,9601024,,3,2,1,3
9608009,9608009,,3,1,2,3
9508035,9508035,,3,1,0,1
9405073,9405073,,7,1,3,4
9409135,9409135,,3,3,0,3
9410047,9410047,,3,4,1,5
9612170,9612170,,8,3,7,10
6006,6006,,3,2,28,30
9304003,9304003,,8,4,0,4
9509098,9509098,,3,6,2,8
9511106,9511106,,7,13,0,13
9310083,9310083,,3,3,0,3
9312101,9312101,,37,4,0,4
9312133,9312133,,7,11,0,11
9702068,9702068,,2,5,9,14
9503041,9503041,,16,12,6,18
6008,6008,,37,22,24,46
6009,6009,,34,10,34,44
9704154,9704154,,7,4,5,9
6010,6010,,2,6,16,22
6011,6011,,37,10,31,41
9710073,9710073,,37,5,14,19
6013,6013,,3,25,21,46
6014,6014,,3,14,21,35
6015,6015,,2,1,11,12
6016,6016,,11,0,16,16
6017,6017,,2,2,14,16
9905108,9905108,,2,5,9,14
9911166,9911166,,2,6,6,12
9801016,9801016,,2,1,6,7
6018,6018,,3,15,14,29
6058,6058,,3,5,24,29
6019,6019,,3,2,31,33
6020,6020,,34,1,10,11
6021,6021,,11,0,1,1
9306131,9306131,,11,8,0,8
6022,6022,,34,4,18,22
9808172,9808172,,8,6,48,54
9710080,9710080,,11,3,1,4
9908138,9908138,,7,3,0,3
6023,6023,,3,47,30,77
6024,6024,,2,2,40,42
6025,6025,,34,8,2,10
9911139,9911139,,34,13,6,19
9911225,9911225,,34,11,6,17
9706219,9706219,,34,7,0,7
9805038,9805038,,34,8,6,14
9808147,9808147,,34,7,1,8
9903006,9903006,,34,3,1,4
9903174,9903174,,34,3,8,11
9910075,9910075,,34,4,2,6
6026,6026,,0,6,9,15
6027,6027,,34,8,4,12
6028,6028,,37,22,44,66
9801078,9801078,,0,2,16,18
6031,6031,,6,1,2,3
6032,6032,,2,0,8,8
9801176,9801176,,2,3,7,10
6033,6033,,54,21,50,71
6034,6034,,2,10,4,14
9709227,9709227,,2,8,7,15
6035,6035,,25,15,23,38
9401081,9401081,,25,7,4,11
9412131,9412131,,25,6,32,38
9704168,9704168,,25,10,12,22
9205114,9205114,,25,5,0,5
9301058,9301058,,25,3,7,10
9301082,9301082,,25,3,1,4
9302096,9302096,,25,12,1,13
9302101,9302101,,25,1,6,7
9302127,9302127,,25,4,0,4
9303011,9303011,,25,2,4,6
9304163,9304163,,25,2,2,4
9305165,9305165,,25,4,4,8
9306041,9306041,,25,5,30,35
9307057,9307057,,25,4,0,4
9307143,9307143,,25,2,17,19
9307157,9307157,,25,2,8,10
9307181,9307181,,25,2,5,7
9407015,9407015,,25,3,9,12
9604064,9604064,,25,1,12,13
9606097,9606097,,25,6,13,19
9307033,9307033,,25,4,1,5
9411105,9411105,,25,2,7,9
6036,6036,,11,12,4,16
9909006,9909006,,11,9,4,13
6037,6037,,34,6,27,33
8211,8211,,34,6,38,44
9811126,9811126,,34,8,9,17
8028,8028,,34,16,12,28
6038,6038,,34,1,7,8
9710024,9710024,,37,9,9,18
9802178,9802178,,37,2,11,13
6039,6039,,7,2,6,8
9312001,9312001,,7,21,3,24
9411054,9411054,,7,12,1,13
9902028,9902028,,19,4,15,19
9306076,9306076,,19,1,3,4
9506015,9506015,,19,4,5,9
9512076,9512076,,19,1,1,2
6040,6040,,25,0,4,4
9907212,9907212,,25,2,1,3
6041,6041,,34,1,39,40
6060,6060,,2,29,19,48
9803042,9803042,,37,1,9,10
9905155,9905155,,2,7,51,58
9906203,9906203,,2,8,16,24
9310197,9310197,,8,10,3,13
9311181,9311181,,8,22,3,25
9405016,9405016,,1,6,11,17
9411190,9411190,,8,5,6,11
9412051,9412051,,8,1,5,6
9502094,9502094,,8,8,6,14
6042,6042,,3,1,3,4
9906122,9906122,,3,1,15,16
6043,6043,,34,6,33,39
6045,6045,,62,0,1,1
6029,6029,,62,2,0,2
6046,6046,,0,16,15,31
6048,6048,,34,19,37,56
6049,6049,,54,6,23,29
9711039,9711039,,54,5,19,24
9505080,9505080,,54,16,0,16
6050,6050,,37,3,8,11
6051,6051,,11,11,12,23
9601028,9601028,,11,9,0,9
9907048,9907048,,11,3,4,7
6052,6052,,4,5,30,35
9909091,9909091,,2,4,13,17
6054,6054,,31,3,25,28
6179,6179,,54,9,16,25
9907124,9907124,,9,5,2,7
6056,6056,,3,9,26,35
6057,6057,,11,11,4,15
9907190,9907190,,8,6,5,11
9812124,9812124,,8,2,0,2
6062,6062,,3,105,27,132
6112,6112,,3,58,31,89
6225,6225,,3,19,19,38
6193,6193,,3,25,22,47
6202,6202,,3,35,23,58
6063,6063,,2,1,16,17
9910122,9910122,,2,3,6,9
9512107,9512107,,2,7,3,10
9607183,9607183,,2,1,0,1
9606039,9606039,,2,2,16,18
9710035,9710035,,2,1,18,19
9508053,9508053,,37,6,12,18
6065,6065,,8,0,9,9
9507163,9507163,,8,4,6,10
9612074,9612074,,8,3,7,10
9811103,9811103,,8,1,6,7
9903126,9903126,,8,2,0,2
9506004,9506004,,19,23,0,23
9601009,9601009,,19,6,7,13
9703185,9703185,,19,1,2,3
6067,6067,,2,10,15,25
9206069,9206069,,25,3,0,3
9306063,9306063,,25,4,4,8
9306141,9306141,,25,5,5,10
9307185,9307185,,25,6,4,10
9502165,9502165,,8,4,0,4
9306137,9306137,,8,3,0,3
9306139,9306139,,8,3,0,3
9310004,9310004,,8,14,0,14
6071,6071,,4,101,20,121
6073,6073,,3,6,17,23
9812230,9812230,,2,4,30,34
9907117,9907117,,2,3,35,38
9911251,9911251,,3,4,26,30
9705111,9705111,,2,6,13,19
9807239,9807239,,2,5,32,37
9412026,9412026,,11,1,3,4
6074,6074,,7,0,2,2
6075,6075,,11,1,2,3
9901025,9901025,,11,4,0,4
9901035,9901035,,11,7,0,7
6076,6076,,54,2,5,7
6077,6077,,0,7,7,14
6078,6078,,16,2,9,11
9706077,9706077,,16,3,9,12
9811182,9811182,,16,4,10,14
9907071,9907071,,16,4,9,13
9505126,9505126,,16,3,1,4
9509136,9509136,,16,10,9,19
9603177,9603177,,16,6,7,13
9207082,9207082,,16,5,0,5
9501050,9501050,,16,5,3,8
9509143,9509143,,16,8,14,22
9604032,9604032,,16,3,11,14
9703107,9703107,,16,6,6,12
9601094,9601094,,16,5,4,9
9810029,9810029,,16,2,4,6
9805088,9805088,,16,2,4,6
6079,6079,,7,8,7,15
6080,6080,,6,1,3,4
6081,6081,,62,0,8,8
9401118,9401118,,62,4,3,7
9302088,9302088,,62,4,1,5
9312008,9312008,,62,6,0,6
9406116,9406116,,62,3,1,4
9506067,9506067,,62,2,5,7
9708145,9708145,,62,2,5,7
9709078,9709078,,62,10,4,14
6084,6084,,7,1,8,9
9810176,9810176,,7,8,5,13
6086,6086,,37,3,18,21
6087,6087,,3,7,15,22
6088,6088,,54,2,36,38
6089,6089,,11,3,2,5
9908003,9908003,,11,2,0,2
9709138,9709138,,2,9,32,41
9811036,9811036,,37,3,25,28
6092,6092,,19,0,3,3
9610219,9610219,,19,1,1,2
9510085,9510085,,19,2,2,4
6094,6094,,65,10,9,19
9510095,9510095,,62,6,10,16
6095,6095,,54,1,6,7
6096,6096,,3,2,8,10
10187,10187,,3,17,11,28
9407093,9407093,,3,2,0,2
9912265,9912265,,3,3,4,7
6216,6216,,3,22,12,34
7030,7030,,3,22,10,32
8010,8010,,3,15,5,20
10165,10165,,2,14,23,37
11137,11137,,3,20,9,29
9911087,9911087,,3,26,11,37
6097,6097,,11,1,3,4
9708030,9708030,,11,19,1,20
9802084,9802084,,11,2,8,10
9707245,9707245,,11,8,14,22
9710144,9710144,,11,7,7,14
9804042,9804042,,11,2,9,11
6098,6098,,34,9,14,23
6099,6099,,11,4,5,9
6100,6100,,37,24,40,64
9902119,9902119,,37,1,23,24
6101,6101,,54,1,18,19
9909198,9909198,,54,3,17,20
9305064,9305064,,2,4,1,5
9503113,9503113,,54,5,3,8
9808142,9808142,,54,2,3,5
6103,6103,,34,15,57,72
6105,6105,,25,1,4,5
9303010,9303010,,25,2,0,2
9409087,9409087,,25,1,1,2
6106,6106,,9,7,13,20
9612037,9612037,,9,2,0,2
9612038,9612038,,9,1,0,1
6107,6107,,34,15,14,29
6108,6108,,25,5,18,23
9509147,9509147,,54,4,1,5
9905001,9905001,,0,3,10,13
9912063,9912063,,34,2,14,16
9406188,9406188,,0,4,0,4
9603062,9603062,,0,10,3,13
9603159,9603159,,0,10,3,13
9606174,9606174,,0,9,7,16
9702171,9702171,,0,4,5,9
9708138,9708138,,0,8,4,12
9805090,9805090,,0,5,7,12
9608124,9608124,,34,9,1,10
9707181,9707181,,34,5,3,8
9805009,9805009,,8,8,5,13
9807042,9807042,,34,2,7,9
9911012,9911012,,34,3,1,4
9911013,9911013,,34,2,9,11
6111,6111,,16,1,25,26
6113,6113,,37,8,27,35
11227,11227,,37,3,22,25
9901120,9901120,,37,7,42,49
9911115,9911115,,37,15,41,56
10061,10061,,37,2,29,31
9806144,9806144,,37,16,59,75
9901124,9901124,,37,14,13,27
9904078,9904078,,37,14,58,72
6114,6114,,3,20,20,40
6116,6116,,11,1,7,8
9811241,9811241,,11,5,0,5
6117,6117,,65,23,20,43
6118,6118,,7,1,6,7
9407130,9407130,,7,8,3,11
9304022,9304022,,7,2,0,2
6119,6119,,3,38,16,54
9905054,9905054,,8,8,4,12
9307065,9307065,,16,1,6,7
9504013,9504013,,16,8,3,11
6120,6120,,3,13,21,34
9904150,9904150,,2,3,38,41
9209011,9209011,,8,9,4,13
9404010,9404010,,4,5,5,10
6121,6121,,25,7,22,29
9173,9173,,25,7,13,20
10140,10140,,25,1,1,2
12241,12241,,25,2,7,9
101062,101062,,25,4,3,7
10214,10214,,25,8,7,15
6122,6122,,4,5,32,37
6123,6123,,8,2,5,7
6124,6124,,6,0,1,1
9902154,9902154,,6,2,9,11
9309049,9309049,,6,2,2,4
9804186,9804186,,6,2,6,8
6126,6126,,34,0,4,4
6128,6128,,19,0,1,1
9310096,9310096,,19,7,0,7
6131,6131,,6,0,4,4
6132,6132,,34,16,8,24
6134,6134,,0,4,15,19
6135,6135,,34,2,3,5
6136,6136,,2,0,4,4
9903192,9903192,,16,5,2,7
6138,6138,,25,1,3,4
9503181,9503181,,16,8,2,10
6140,6140,,37,4,38,42
9912133,9912133,,37,9,82,91
9712011,9712011,,37,9,29,38
9910015,9910015,,37,4,18,22
9911022,9911022,,37,4,106,110
9912011,9912011,,37,3,21,24
6141,6141,,37,3,54,57
9908143,9908143,,37,5,10,15
9507111,9507111,,7,4,1,5
9511101,9511101,,9,10,6,16
9609175,9609175,,16,3,6,9
9601170,9601170,,7,3,10,13
9802004,9802004,,37,4,50,54
9710068,9710068,,37,7,24,31
9903182,9903182,,37,1,62,63
9806234,9806234,,37,5,6,11
9806246,9806246,,37,4,15,19
9712025,9712025,,37,10,32,42
9905126,9905126,,37,5,25,30
6143,6143,,6,1,3,4
6144,6144,,34,11,7,18
3011,3011,,34,9,0,9
9210114,9210114,,54,2,0,2
6145,6145,,65,36,11,47
6147,6147,,11,7,2,9
6148,6148,,14,5,5,10
9909037,9909037,,14,8,5,13
9901096,9901096,,14,5,10,15
6149,6149,,54,1,6,7
6150,6150,,0,1,4,5
9601111,9601111,,62,6,3,9
9809025,9809025,,11,1,4,5
9407160,9407160,,0,3,1,4
9412174,9412174,,0,3,5,8
9502145,9502145,,62,7,0,7
9511118,9511118,,62,6,2,8
6151,6151,,65,13,15,28
9610058,9610058,,65,5,1,6
9707034,9707034,,65,2,7,9
9611200,9611200,,65,2,0,2
6152,6152,,6,1,8,9
9807064,9807064,,4,17,9,26
6153,6153,,9,4,3,7
9907044,9907044,,9,7,2,9
9907168,9907168,,9,8,2,10
6154,6154,,19,5,4,9
9701007,9701007,,0,1,3,4
9805095,9805095,,19,4,2,6
9912169,9912169,,19,9,2,11
9702023,9702023,,19,4,0,4
9707154,9707154,,19,1,0,1
6155,6155,,49,0,1,1
6156,6156,,62,6,14,20
9308125,9308125,,14,9,0,9
9509026,9509026,,14,10,6,16
9701039,9701039,,62,1,0,1
9408041,9408041,,62,6,1,7
9212076,9212076,,62,2,3,5
9406183,9406183,,62,3,5,8
9403013,9403013,,14,6,1,7
6157,6157,,19,2,1,3
6158,6158,,0,9,12,21
6159,6159,,54,0,7,7
6160,6160,,3,25,35,60
6161,6161,,6,1,6,7
6162,6162,,19,3,6,9
9509135,9509135,,19,6,7,13
9604031,9604031,,19,12,1,13
9612063,9612063,,19,9,6,15
9707150,9707150,,19,5,11,16
9906197,9906197,,34,5,14,19
9402129,9402129,,19,7,3,10
9404146,9404146,,19,3,4,7
9510141,9510141,,19,17,4,21
9603101,9603101,,19,6,13,19
9603128,9603128,,19,4,8,12
9506099,9506099,,19,11,2,13
9507015,9507015,,19,17,3,20
9603122,9603122,,19,2,5,7
9703193,9703193,,19,3,7,10
9711187,9711187,,34,1,0,1
9802024,9802024,,11,3,1,4
6163,6163,,19,3,18,21
9204075,9204075,,6,3,0,3
9802101,9802101,,19,6,5,11
9812041,9812041,,19,1,15,16
9407188,9407188,,19,2,1,3
9408148,9408148,,19,3,1,4
9411201,9411201,,6,13,3,16
9502070,9502070,,6,13,7,20
9611198,9611198,,6,5,3,8
9701100,9701100,,19,3,8,11
9708027,9708027,,11,2,2,4
6165,6165,,34,4,17,21
6166,6166,,7,1,11,12
9312170,9312170,,7,6,5,11
9409058,9409058,,7,4,3,7
9208008,9208008,,7,10,0,10
9212065,9212065,,7,9,0,9
9310173,9310173,,7,5,0,5
6167,6167,,7,1,11,12
6168,6168,,37,18,15,33
6169,6169,,3,3,8,11
9904001,9904001,,3,4,3,7
9511039,9511039,,11,4,3,7
9703067,9703067,,3,2,1,3
6170,6170,,11,2,8,10
6172,6172,,54,2,21,23
6173,6173,,6,0,11,11
9409081,9409081,,6,1,10,11
9511056,9511056,,2,2,12,14
9610220,9610220,,6,2,18,20
9611113,9611113,,25,1,2,3
6175,6175,,6,1,11,12
9608178,9608178,,6,1,1,2
9912282,9912282,,6,1,3,4
6176,6176,,34,10,51,61
6177,6177,,6,1,3,4
6178,6178,,37,1,2,3
9803159,9803159,,37,1,2,3
9904102,9904102,,37,7,6,13
9712171,9712171,,37,2,28,30
9703069,9703069,,37,2,3,5
6180,6180,,11,3,10,13
9912262,9912262,,11,5,10,15
9905142,9905142,,11,1,20,21
6181,6181,,65,12,14,26
9803057,9803057,,65,1,9,10
9308145,9308145,,65,4,0,4
9407079,9407079,,65,7,0,7
9512100,9512100,,65,4,0,4
9705019,9705019,,65,2,4,6
6182,6182,,14,0,4,4
6183,6183,,11,2,11,13
6184,6184,,0,1,3,4
6185,6185,,2,1,18,19
9905084,9905084,,11,6,1,7
9908069,9908069,,11,2,2,4
6186,6186,,65,4,17,21
9601087,9601087,,65,2,1,3
9601158,9601158,,2,2,17,19
6188,6188,,37,0,6,6
6189,6189,,37,18,39,57
9503214,9503214,,6,3,0,3
6190,6190,,2,4,44,48
9201063,9201063,,0,3,0,3
6236,6236,,3,66,29,95
6209,6209,,3,31,57,88
6194,6194,,54,0,33,33
9404044,9404044,,54,1,0,1
9506168,9506168,,54,1,5,6
9512060,9512060,,54,4,26,30
6196,6196,,34,15,24,39
6197,6197,,62,0,9,9
6198,6198,,37,2,22,24
9803151,9803151,,19,1,3,4
9905069,9905069,,37,6,5,11
9905194,9905194,,37,4,6,10
6199,6199,,9,5,11,16
6200,6200,,65,2,1,3
6201,6201,,54,4,30,34
9504054,9504054,,16,1,7,8
6205,6205,,6,0,1,1
9901007,9901007,,6,1,3,4
9409085,9409085,,6,11,0,11
9706159,9706159,,6,7,5,12
6206,6206,,2,0,2,2
6207,6207,,3,8,1,9
9707088,9707088,,3,3,0,3
6208,6208,,2,4,8,12
9906227,9906227,,2,2,6,8
9507064,9507064,,2,5,16,21
6210,6210,,3,21,28,49
6211,6211,,34,13,7,20
6214,6214,,7,2,3,5
9505169,9505169,,7,6,0,6
9610028,9610028,,7,10,1,11
9911233,9911233,,7,4,3,7
9610145,9610145,,7,6,0,6
9807165,9807165,,7,5,3,8
6217,6217,,34,3,7,10
9411128,9411128,,25,12,3,15
9504064,9504064,,25,7,16,23
9505121,9505121,,25,1,9,10
9610011,9610011,,25,3,22,25
9610180,9610180,,25,5,9,14
9703125,9703125,,25,1,12,13
9706065,9706065,,25,2,13,15
9709213,9709213,,25,7,15,22
6218,6218,,6,0,21,21
6219,6219,,3,49,37,86
6220,6220,,25,2,3,5
9803036,9803036,,25,3,9,12
9606132,9606132,,25,2,9,11
9809031,9809031,,25,1,10,11
6221,6221,,25,1,2,3
6222,6222,,34,7,28,35
9603075,9603075,,37,2,20,22
9203061,9203061,,25,15,0,15
9507171,9507171,,2,3,6,9
9601129,9601129,,8,2,2,4
9902072,9902072,,2,3,25,28
9902107,9902107,,2,2,20,22
9903064,9903064,,2,1,20,21
6223,6223,,4,10,10,20
6224,6224,,37,51,21,72
6227,6227,,6,4,10,14
9243,9243,,6,7,11,18
9509139,9509139,,6,11,2,13
9705157,9705157,,6,8,9,17
9504151,9504151,,6,8,6,14
9507100,9507100,,6,8,4,12
9408075,9408075,,6,13,1,14
9701102,9701102,,6,8,11,19
9803258,9803258,,6,9,11,20
6228,6228,,4,5,29,34
9210054,9210054,,2,1,0,1
6229,6229,,19,4,4,8
9506211,9506211,,19,7,0,7
9605163,9605163,,19,6,2,8
9912195,9912195,,19,5,14,19
9603102,9603102,,19,2,3,5
9905187,9905187,,19,3,13,16
6230,6230,,11,4,7,11
6231,6231,,2,6,16,22
6233,6233,,62,5,2,7
9503165,9503165,,8,1,8,9
9508020,9508020,,8,6,9,15
6234,6234,,2,9,15,24
6235,6235,,3,23,13,36
9158,9158,,3,9,13,22
7192,7192,,3,3,6,9
9908151,9908151,,6,6,7,13
6237,6237,,7,2,5,7
6238,6238,,7,1,13,14
9609002,9609002,,7,5,4,9
6239,6239,,2,12,24,36
9209057,9209057,,16,3,0,3
6240,6240,,4,106,27,133
6241,6241,,4,1,2,3
6243,6243,,62,3,3,6
6244,6244,,37,0,18,18
9504005,9504005,,37,4,3,7
9504146,9504146,,37,3,4,7
9601027,9601027,,37,5,6,11
9603023,9603023,,37,4,8,12
9603035,9603035,,37,4,3,7
6245,6245,,3,4,7,11
9903202,9903202,,3,1,6,7
6247,6247,,37,18,29,47
9207109,9207109,,25,4,2,6
6248,6248,,19,5,3,8
9307186,9307186,,6,13,1,14
9404181,9404181,,6,4,0,4
9405163,9405163,,19,2,5,7
9406033,9406033,,6,7,2,9
6249,6249,,11,4,2,6
6250,6250,,7,0,4,4
7001,7001,,0,2,35,37
9703168,9703168,,1,4,7,11
9811076,9811076,,1,3,3,6
9506021,9506021,,1,5,2,7
7002,7002,,0,3,16,19
9801094,9801094,,62,7,3,10
9403039,9403039,,62,11,0,11
9503178,9503178,,62,3,11,14
9604024,9604024,,62,1,3,4
7006,7006,,25,0,3,3
7007,7007,,8,20,47,67
7008,7008,,7,4,8,12
7009,7009,,1,5,24,29
7010,7010,,16,0,3,3
7011,7011,,2,27,26,53
7012,7012,,4,11,28,39
7013,7013,,8,6,15,21
7015,7015,,3,9,20,29
9410072,9410072,,4,3,0,3
9604085,9604085,,3,3,0,3
7016,7016,,37,3,4,7
7017,7017,,2,6,14,20
7019,7019,,2,12,28,40
9906131,9906131,,37,4,6,10
7020,7020,,8,10,19,29
9912016,9912016,,8,4,15,19
9912281,9912281,,8,6,9,15
9508012,9508012,,54,1,2,3
9608156,9608156,,8,2,3,5
9511160,9511160,,54,1,2,3
9605223,9605223,,2,2,23,25
9411101,9411101,,8,16,2,18
9607106,9607106,,8,2,9,11
9204027,9204027,,8,2,0,2
9901164,9901164,,8,8,17,25
9808053,9808053,,8,3,14,17
9912154,9912154,,8,4,16,20
7021,7021,,1,1,27,28
9910047,9910047,,1,4,31,35
9610029,9610029,,16,1,11,12
7022,7022,,2,12,19,31
7023,7023,,3,8,34,42
9412220,9412220,,3,5,3,8
7024,7024,,54,96,45,141
9908155,9908155,,54,1,30,31
7025,7025,,0,2,1,3
7026,7026,,2,1,14,15
7027,7027,,11,1,4,5
7028,7028,,34,2,10,12
7031,7031,,2,3,18,21
9710079,9710079,,37,6,5,11
9804034,9804034,,2,6,21,27
7032,7032,,9,4,5,9
9504055,9504055,,9,8,0,8
9507133,9507133,,9,5,1,6
9710047,9710047,,9,5,4,9
9710186,9710186,,9,2,4,6
9505063,9505063,,9,2,0,2
9510193,9510193,,9,4,3,7
7033,7033,,7,3,6,9
9403092,9403092,,7,1,2,3
9404070,9404070,,7,2,3,5
9407126,9407126,,7,2,4,6
9605160,9605160,,7,1,4,5
7034,7034,,19,0,6,6
7035,7035,,54,22,18,40
7036,7036,,1,29,28,57
9602109,9602109,,1,2,4,6
9901095,9901095,,1,6,27,33
9510145,9510145,,25,2,3,5
9812114,9812114,,1,2,6,8
7037,7037,,2,8,5,13
7038,7038,,37,1,3,4
7040,7040,,62,3,3,6
7042,7042,,16,1,7,8
7043,7043,,3,78,23,101
7045,7045,,65,1,2,3
7046,7046,,3,20,6,26
7047,7047,,3,3,13,16
9912217,9912217,,3,4,6,10
9507002,9507002,,3,6,0,6
9903047,9903047,,16,2,4,6
7048,7048,,2,19,45,64
7049,7049,,8,8,18,26
9609220,9609220,,4,4,4,8
9703183,9703183,,4,3,2,5
9706033,9706033,,4,2,7,9
7050,7050,,3,18,39,57
7051,7051,,2,9,7,16
7052,7052,,3,20,30,50
7053,7053,,0,19,22,41
7054,7054,,19,4,1,5
9808106,9808106,,19,1,0,1
7055,7055,,3,2,22,24
7056,7056,,2,6,32,38
9305057,9305057,,65,3,0,3
9412036,9412036,,65,1,1,2
7058,7058,,34,4,37,41
9306082,9306082,,25,2,2,4
7061,7061,,34,4,40,44
7062,7062,,34,22,22,44
7063,7063,,0,9,19,28
7066,7066,,2,0,12,12
9809135,9809135,,2,2,28,30
9403115,9403115,,2,1,0,1
9405047,9405047,,2,1,3,4
7067,7067,,2,21,43,64
7125,7125,,0,7,32,39
7068,7068,,54,0,12,12
9606186,9606186,,54,1,0,1
7069,7069,,37,13,17,30
7070,7070,,2,0,7,7
7071,7071,,37,10,20,30
7073,7073,,8,5,24,29
7074,7074,,3,11,3,14
7075,7075,,37,20,45,65
7076,7076,,2,7,15,22
9406152,9406152,,6,6,0,6
7077,7077,,62,6,13,19
9405128,9405128,,62,2,9,11
9712033,9712033,,62,4,14,18
9705142,9705142,,62,3,9,12
7078,7078,,3,52,31,83
7079,7079,,0,8,12,20
9406003,9406003,,0,3,0,3
9707095,9707095,,37,2,18,20
7080,7080,,19,0,11,11
7081,7081,,16,1,4,5
7082,7082,,34,9,32,41
7083,7083,,2,0,37,37
9309104,9309104,,19,4,0,4
9501041,9501041,,19,3,0,3
7086,7086,,1,9,10,19
9305074,9305074,,1,5,10,15
9310029,9310029,,1,1,3,4
7087,7087,,54,4,28,32
7088,7088,,8,1,11,12
9709103,9709103,,8,5,3,8
9803182,9803182,,8,5,8,13
9807153,9807153,,8,8,11,19
9906139,9906139,,8,7,6,13
9302060,9302060,,8,6,0,6
9205044,9205044,,8,1,0,1
9508030,9508030,,8,5,11,16
9606180,9606180,,8,9,2,11
9803114,9803114,,8,5,7,12
9301075,9301075,,8,8,1,9
9301031,9301031,,7,2,2,4
9301121,9301121,,8,3,0,3
7089,7089,,3,49,19,68
7090,7090,,54,61,57,118
9910246,9910246,,54,5,32,37
7091,7091,,0,0,1,1
7092,7092,,11,2,6,8
7094,7094,,25,1,8,9
9402155,9402155,,25,6,1,7
7095,7095,,65,3,13,16
9503098,9503098,,65,3,1,4
7096,7096,,65,32,13,45
7097,7097,,4,20,38,58
7098,7098,,6,0,9,9
9210158,9210158,,19,11,0,11
7099,7099,,34,6,16,22
7100,7100,,65,11,25,36
7101,7101,,1,3,2,5
9207005,9207005,,1,18,0,18
9609005,9609005,,54,4,12,16
7102,7102,,25,3,10,13
9406176,9406176,,62,1,3,4
7103,7103,,62,0,2,2
9611033,9611033,,62,4,8,12
9305078,9305078,,62,7,1,8
9504084,9504084,,62,16,8,24
9504138,9504138,,62,14,11,25
9512220,9512220,,62,2,2,4
9604165,9604165,,62,12,19,31
7104,7104,,34,8,11,19
7105,7105,,8,6,7,13
9810115,9810115,,8,5,5,10
9810119,9810119,,8,9,4,13
9906156,9906156,,8,7,3,10
9312147,9312147,,8,1,1,2
9711088,9711088,,8,2,5,7
7106,7106,,3,22,31,53
7107,7107,,3,18,16,34
7108,7108,,11,2,2,4
107135,107135,,11,2,4,6
11196,11196,,11,6,7,13
7110,7110,,54,1,39,40
9912159,9912159,,2,2,13,15
9306085,9306085,,2,4,2,6
9201045,9201045,,2,1,0,1
9303171,9303171,,2,2,1,3
9502144,9502144,,54,7,5,12
7111,7111,,19,0,3,3
9903236,9903236,,19,1,0,1
7112,7112,,11,0,2,2
9911125,9911125,,11,6,14,20
9511015,9511015,,11,9,0,9
9602157,9602157,,11,9,2,11
9712248,9712248,,11,4,3,7
9806007,9806007,,11,5,2,7
9901039,9901039,,11,7,5,12
7113,7113,,37,0,12,12
9809037,9809037,,37,4,3,7
7114,7114,,3,0,8,8
9302010,9302010,,16,5,0,5
9302019,9302019,,8,3,0,3
9304110,9304110,,16,2,0,2
7115,7115,,54,2,20,22
7116,7116,,62,7,9,16
7119,7119,,11,5,16,21
7121,7121,,25,8,3,11
9508077,9508077,,25,4,0,4
9608142,9608142,,25,4,0,4
7122,7122,,7,1,20,21
9312174,9312174,,7,2,4,6
9202024,9202024,,7,1,0,1
7123,7123,,7,2,4,6
9905229,9905229,,7,3,30,33
9503236,9503236,,7,3,2,5
9704128,9704128,,7,3,5,8
9707147,9707147,,7,1,1,2
9810113,9810113,,62,9,23,32
9811218,9811218,,37,1,2,3
9903176,9903176,,62,5,29,34
7124,7124,,0,19,10,29
7126,7126,,4,8,25,33
9309116,9309116,,4,2,1,3
7127,7127,,3,10,14,24
7128,7128,,11,1,5,6
7129,7129,,25,2,6,8
9304031,9304031,,16,5,0,5
9405140,9405140,,16,5,0,5
7130,7130,,4,3,25,28
7131,7131,,3,25,23,48
9907205,9907205,,34,2,2,4
7132,7132,,101,2,1,3
9302093,9302093,,101,2,0,2
7133,7133,,37,2,21,23
7134,7134,,2,1,8,9
9911120,9911120,,2,1,2,3
7135,7135,,11,6,4,10
7136,7136,,6,1,4,5
7137,7137,,3,8,14,22
7138,7138,,25,8,4,12
9603092,9603092,,25,6,4,10
9908031,9908031,,25,3,3,6
9407060,9407060,,6,6,0,6
9502044,9502044,,25,3,0,3
9503136,9503136,,25,4,0,4
9804021,9804021,,2,7,12,19
7139,7139,,25,1,2,3
7141,7141,,65,5,23,28
7142,7142,,7,7,13,20
7143,7143,,37,7,9,16
7144,7144,,7,7,1,8
9408025,9408025,,7,10,0,10
7145,7145,,37,10,37,47
7146,7146,,34,94,20,114
7147,7147,,3,33,35,68
7148,7148,,6,3,13,16
7149,7149,,11,0,6,6
9905093,9905093,,11,2,4,6
9910002,9910002,,11,2,3,5
9808102,9808102,,11,7,9,16
7150,7150,,7,4,15,19
7151,7151,,62,0,2,2
9908050,9908050,,62,6,8,14
9209054,9209054,,62,20,0,20
9412192,9412192,,62,4,6,10
9502053,9502053,,62,6,9,15
9502129,9502129,,62,5,6,11
9808153,9808153,,62,4,4,8
7152,7152,,16,1,9,10
7153,7153,,4,49,29,78
9202062,9202062,,4,5,0,5
9205085,9205085,,4,14,0,14
7154,7154,,65,9,17,26
7155,7155,,3,0,18,18
9808166,9808166,,2,2,10,12
7156,7156,,3,20,7,27
7157,7157,,2,16,25,41
7158,7158,,4,11,70,81
9711021,9711021,,2,3,5,8
7160,7160,,3,2,25,27
7161,7161,,16,5,11,16
7162,7162,,7,0,4,4
9304108,9304108,,7,3,0,3
9511013,9511013,,7,4,3,7
7164,7164,,65,2,4,6
9412075,9412075,,25,4,3,7
9303099,9303099,,25,17,2,19
7165,7165,,7,1,5,6
9307109,9307109,,7,4,1,5
7166,7166,,3,7,19,26
7167,7167,,7,0,2,2
7168,7168,,3,22,26,48
7169,7169,,62,9,21,30
7170,7170,,2,78,263,341
9409062,9409062,,1,7,3,10
7171,7171,,2,5,40,45
7172,7172,,25,4,15,19
9905089,9905089,,25,3,35,38
9405072,9405072,,25,10,24,34
9706123,9706123,,34,2,14,16
9808109,9808109,,25,4,6,10
9904070,9904070,,25,12,19,31
9905007,9905007,,34,9,13,22
7173,7173,,37,8,39,47
9908129,9908129,,37,5,31,36
7174,7174,,65,27,18,45
7175,7175,,4,64,19,83
7176,7176,,3,7,5,12
9510155,9510155,,16,4,27,31
9608144,9608144,,16,6,7,13
9707080,9707080,,16,7,11,18
7181,7181,,3,19,14,33
7182,7182,,8,1,1,2
7183,7183,,19,3,19,22
9412140,9412140,,19,10,0,10
9710022,9710022,,19,4,1,5
9807221,9807221,,19,4,5,9
9808027,9808027,,19,7,9,16
9811073,9811073,,19,3,1,4
9902002,9902002,,19,2,17,19
9911028,9911028,,19,5,15,20
9612140,9612140,,19,4,0,4
9511135,9511135,,19,2,0,2
9710088,9710088,,19,2,5,7
9809206,9809206,,25,1,3,4
9411132,9411132,,19,2,0,2
9410031,9410031,,19,3,1,4
9707058,9707058,,19,2,2,4
9406041,9406041,,37,1,0,1
9511141,9511141,,8,3,5,8
9610241,9610241,,16,7,12,19
7184,7184,,0,9,26,35
7185,7185,,25,7,4,11
7186,7186,,3,2,10,12
7187,7187,,65,5,8,13
7188,7188,,11,0,10,10
9212068,9212068,,11,21,1,22
9406073,9406073,,11,4,2,6
9705087,9705087,,11,14,18,32
9804132,9804132,,11,17,7,24
9607134,9607134,,11,7,9,16
7189,7189,,0,14,4,18
9806249,9806249,,34,8,5,13
9912017,9912017,,34,4,3,7
9601107,9601107,,34,1,2,3
7194,7194,,37,0,4,4
9801010,9801010,,37,2,5,7
7195,7195,,54,10,143,153
9310006,9310006,,7,1,2,3
9707108,9707108,,6,1,9,10
9712203,9712203,,16,2,1,3
9812026,9812026,,54,5,10,15
9701106,9701106,,2,7,15,22
9512117,9512117,,34,9,10,19
9610163,9610163,,34,5,10,15
9704083,9704083,,2,12,3,15
9505193,9505193,,25,4,3,7
7197,7197,,0,7,20,27
8177,8177,,0,28,17,45
9903016,9903016,,6,1,1,2
8055,8055,,0,7,15,22
9606121,9606121,,6,4,0,4
7198,7198,,2,3,20,23
9612212,9612212,,11,6,0,6
9902149,9902149,,2,7,35,42
7200,7200,,34,6,16,22
7202,7202,,2,3,19,22
9806213,9806213,,2,2,25,27
7207,7207,,25,1,10,11
9505030,9505030,,25,7,9,16
9311079,9311079,,25,6,4,10
7208,7208,,7,6,12,18
9204061,9204061,,25,7,0,7
7210,7210,,2,1,2,3
7211,7211,,34,10,45,55
7212,7212,,54,0,21,21
7213,7213,,37,17,10,27
7214,7214,,62,3,11,14
7215,7215,,3,29,36,65
7216,7216,,19,1,7,8
9507079,9507079,,11,4,0,4
9509060,9509060,,11,3,1,4
9711065,9711065,,19,1,0,1
9806027,9806027,,0,5,4,9
9809096,9809096,,34,1,8,9
9812045,9812045,,19,2,6,8
9812076,9812076,,19,1,17,18
7217,7217,,3,30,17,47
7219,7219,,8,1,3,4
7220,7220,,6,17,10,27
7221,7221,,54,2,3,5
7222,7222,,34,5,31,36
7224,7224,,7,2,1,3
7225,7225,,2,1,8,9
9506145,9506145,,37,2,3,5
7226,7226,,4,59,19,78
7227,7227,,34,2,4,6
9912111,9912111,,62,4,12,16
9907147,9907147,,62,1,8,9
7228,7228,,2,1,6,7
7229,7229,,11,0,2,2
7230,7230,,6,4,5,9
9904084,9904084,,6,2,4,6
9506166,9506166,,6,3,2,5
9701050,9701050,,6,2,2,4
7231,7231,,2,18,28,46
7234,7234,,34,14,38,52
7235,7235,,4,19,23,42
7236,7236,,3,8,61,69
7237,7237,,34,4,3,7
7238,7238,,34,2,3,5
7240,7240,,37,2,65,67
9606022,9606022,,37,1,9,10
9811121,9811121,,34,5,15,20
9902108,9902108,,34,1,8,9
9506172,9506172,,37,2,4,6
9608050,9608050,,34,2,2,4
9608058,9608058,,34,1,0,1
9601138,9601138,,7,3,0,3
9307023,9307023,,34,2,0,2
9810102,9810102,,34,2,8,10
9811049,9811049,,34,1,17,18
7241,7241,,2,11,15,26
7242,7242,,25,12,8,20
7243,7243,,54,11,45,56
9909122,9909122,,54,6,23,29
7245,7245,,17,1,1,2
7232,7232,,17,2,0,2
7246,7246,,0,1,11,12
7247,7247,,3,19,10,29
7248,7248,,7,1,5,6
10148,10148,,62,7,12,19
9710076,9710076,,7,6,1,7
8039,8039,,62,6,16,22
9910215,9910215,,62,3,11,14
7249,7249,,13,1,1,2
7250,7250,,34,14,36,50
7252,7252,,0,8,11,19
7253,7253,,2,3,39,42
7255,7255,,3,22,20,42
8002,8002,,3,15,31,46
8003,8003,,11,3,4,7
9608139,9608139,,11,1,1,2
8004,8004,,34,0,34,34
6109,6109,,0,2,0,2
9912064,9912064,,34,1,4,5
9206093,9206093,,34,4,0,4
9810101,9810101,,8,1,5,6
8005,8005,,4,2,7,9
8006,8006,,1,0,29,29
9210116,9210116,,1,5,0,5
9312115,9312115,,1,18,0,18
9412081,9412081,,1,14,1,15
9501102,9501102,,1,4,4,8
9503060,9503060,,1,8,3,11
9504050,9504050,,1,1,3,4
9504098,9504098,,1,1,9,10
9505029,9505029,,1,3,4,7
9505158,9505158,,1,1,5,6
9511069,9511069,,1,5,3,8
9512074,9512074,,1,6,12,18
9607056,9607056,,1,22,5,27
9706020,9706020,,1,6,12,18
9209047,9209047,,1,2,0,2
9307137,9307137,,1,6,0,6
9506214,9506214,,1,1,6,7
9507006,9507006,,1,15,1,16
9511103,9511103,,1,13,4,17
9606013,9606013,,1,13,1,14
9610243,9610243,,1,15,12,27
8007,8007,,17,0,2,2
8009,8009,,2,4,1,5
8011,8011,,62,3,3,6
9211137,9211137,,62,4,0,4
8012,8012,,0,13,27,40
8013,8013,,3,105,30,135
8014,8014,,0,1,5,6
8016,8016,,2,52,17,69
8017,8017,,11,0,4,4
8018,8018,,11,0,3,3
9811226,9811226,,11,2,0,2
8019,8019,,3,0,38,38
8020,8020,,3,2,16,18
9909079,9909079,,2,6,9,15
9911146,9911146,,2,3,17,20
8022,8022,,6,5,4,9
8023,8023,,4,20,38,58
8024,8024,,18,0,1,1
9512067,9512067,,18,1,0,1
8025,8025,,34,2,4,6
8026,8026,,34,0,8,8
9912243,9912243,,4,15,6,21
8027,8027,,3,19,18,37
9303147,9303147,,0,3,0,3
8029,8029,,2,2,22,24
8030,8030,,3,15,43,58
8031,8031,,37,12,28,40
8032,8032,,31,2,1,3
9612041,9612041,,31,3,2,5
8033,8033,,4,41,38,79
8034,8034,,14,2,5,7
8035,8035,,11,3,5,8
9912268,9912268,,11,5,1,6
9704206,9704206,,11,6,8,14
8036,8036,,62,1,8,9
9502051,9502051,,62,2,2,4
9403149,9403149,,62,2,0,2
8037,8037,,19,0,3,3
8038,8038,,65,30,21,51
9502067,9502067,,16,2,1,3
9902094,9902094,,62,4,9,13
8040,8040,,16,3,2,5
9805219,9805219,,16,6,4,10
8042,8042,,3,62,40,102
8043,8043,,1,0,3,3
9911089,9911089,,6,8,5,13
8044,8044,,62,14,11,25
8045,8045,,8,5,9,14
9511148,9511148,,8,2,4,6
8046,8046,,4,4,23,27
8047,8047,,34,2,10,12
8048,8048,,34,4,37,41
8049,8049,,6,3,4,7
9605074,9605074,,6,11,11,22
9405046,9405046,,6,2,0,2
9603013,9603013,,25,6,6,12
8051,8051,,34,18,10,28
8052,8052,,2,18,10,28
9411018,9411018,,34,6,1,7
9310114,9310114,,8,7,0,7
8053,8053,,4,48,26,74
8057,8057,,3,49,31,80
8058,8058,,34,8,21,29
8059,8059,,34,1,3,4
8060,8060,,2,2,8,10
9610200,9610200,,3,1,1,2
8061,8061,,25,7,18,25
9412211,9412211,,25,1,1,2
9506142,9506142,,25,2,3,5
8062,8062,,65,6,31,37
9911064,9911064,,65,2,7,9
8063,8063,,34,6,3,9
8064,8064,,4,17,9,26
8065,8065,,34,8,19,27
8066,8066,,62,1,6,7
9509004,9509004,,8,2,5,7
8067,8067,,16,2,13,15
8068,8068,,2,0,39,39
8069,8069,,9,0,2,2
8070,8070,,6,4,8,12
9701072,9701072,,6,13,4,17
9811210,9811210,,6,2,10,12
206184,206184,,2,3,2,5
9704207,9704207,,6,1,0,1
8071,8071,,62,16,10,26
9812106,9812106,,62,3,5,8
9807041,9807041,,62,2,17,19
8072,8072,,7,1,4,5
8073,8073,,3,11,28,39
9205107,9205107,,8,8,0,8
9311148,9311148,,8,6,5,11
8075,8075,,3,94,25,119
8076,8076,,34,59,21,80
9912271,9912271,,37,33,102,135
9401121,9401121,,8,5,19,24
9411058,9411058,,37,5,1,6
9809196,9809196,,37,6,29,35
9906033,9906033,,37,4,32,36
9912180,9912180,,37,9,71,80
8077,8077,,11,1,5,6
9511226,9511226,,11,10,5,15
9806148,9806148,,11,5,4,9
9505188,9505188,,11,2,3,5
9804128,9804128,,11,3,4,7
9805137,9805137,,11,6,5,11
8078,8078,,8,2,2,4
9905027,9905027,,8,4,3,7
8080,8080,,34,2,16,18
8081,8081,,34,52,43,95
8082,8082,,34,9,11,20
8083,8083,,3,12,24,36
8084,8084,,34,16,29,45
9507020,9507020,,25,15,4,19
8086,8086,,16,0,30,30
8088,8088,,2,22,20,42
8089,8089,,3,15,24,39
8090,8090,,3,44,54,98
8091,8091,,37,17,45,62
9002,9002,,4,28,17,45
9030,9030,,4,50,36,86
9706101,9706101,,3,3,8,11
8093,8093,,11,2,10,12
9905147,9905147,,11,16,7,23
9911132,9911132,,11,4,7,11
8094,8094,,6,5,8,13
9712212,9712212,,6,1,11,12
9712158,9712158,,6,1,2,3
8095,8095,,16,4,2,6
9808018,9808018,,65,1,8,9
9512212,9512212,,65,3,2,5
9703142,9703142,,16,1,13,14
9712173,9712173,,65,2,4,6
9805211,9805211,,65,1,6,7
8096,8096,,16,9,23,32
9804190,9804190,,16,3,9,12
9903101,9903101,,16,5,5,10
9908173,9908173,,16,3,4,7
9910108,9910108,,16,2,7,9
9311126,9311126,,16,3,0,3
9511179,9511179,,16,1,0,1
9406135,9406135,,62,2,4,6
9710039,9710039,,62,1,6,7
8097,8097,,34,1,4,5
9407092,9407092,,34,2,0,2
8098,8098,,11,0,4,4
9911254,9911254,,11,1,2,3
9603151,9603151,,6,3,8,11
9911175,9911175,,11,1,3,4
8099,8099,,6,2,7,9
9812148,9812148,,11,6,8,14
9401040,9401040,,19,2,0,2
9503044,9503044,,19,2,5,7
8100,8100,,37,0,16,16
9907165,9907165,,37,2,23,25
9604022,9604022,,16,2,5,7
8101,8101,,4,44,17,61
8103,8103,,2,2,25,27
8104,8104,,6,0,8,8
9806117,9806117,,6,9,1,10
9906183,9906183,,6,4,8,12
9712024,9712024,,6,4,3,7
9505014,9505014,,6,5,5,10
9510030,9510030,,6,7,10,17
9609119,9609119,,6,5,7,12
9904106,9904106,,6,1,1,2
8105,8105,,34,6,22,28
9609141,9609141,,34,7,0,7
9903122,9903122,,34,4,3,7
9911020,9911020,,8,4,6,10
9912280,9912280,,34,5,15,20
9504071,9504071,,8,8,1,9
9601035,9601035,,8,8,2,10
9812077,9812077,,7,4,2,6
8106,8106,,2,5,19,24
9806071,9806071,,2,3,24,27
8107,8107,,1,3,23,26
8108,8108,,3,19,14,33
8109,8109,,37,1,6,7
8110,8110,,11,3,3,6
8111,8111,,0,6,8,14
8114,8114,,11,6,2,8
8118,8118,,3,16,17,33
8119,8119,,3,14,49,63
8120,8120,,3,5,9,14
8121,8121,,7,0,4,4
9709102,9709102,,19,1,3,4
9301078,9301078,,7,3,0,3
9307184,9307184,,19,2,0,2
9511004,9511004,,19,2,5,7
8122,8122,,7,2,3,5
8124,8124,,34,0,8,8
8125,8125,,2,27,40,67
8126,8126,,3,16,11,27
8127,8127,,4,20,25,45
8129,8129,,2,5,11,16
9704102,9704102,,2,9,9,18
9910045,9910045,,34,3,19,22
9510190,9510190,,2,2,17,19
9903032,9903032,,2,2,16,18
8130,8130,,0,1,65,66
8131,8131,,2,8,3,11
8132,8132,,3,24,25,49
8135,8135,,0,0,5,5
9704124,9704124,,0,1,1,2
9805037,9805037,,0,3,3,6
9601031,9601031,,0,1,1,2
9511198,9511198,,2,5,8,13
8136,8136,,34,2,5,7
9709064,9709064,,25,12,12,24
8137,8137,,25,0,20,20
9511133,9511133,,25,3,17,20
8138,8138,,34,2,8,10
9510181,9510181,,34,10,3,13
8139,8139,,6,4,8,12
10064,10064,,11,6,0,6
9907078,9907078,,11,5,10,15
9407042,9407042,,16,6,6,12
9510187,9510187,,16,3,15,18
8140,8140,,34,99,16,115
8141,8141,,34,7,44,51
8142,8142,,37,124,48,172
8143,8143,,11,1,18,19
9604015,9604015,,11,6,1,7
9802180,9802180,,11,5,0,5
9804109,9804109,,11,3,1,4
9910027,9910027,,11,3,5,8
9911207,9911207,,11,4,2,6
9410130,9410130,,11,2,0,2
9209028,9209028,,11,4,0,4
9602050,9602050,,8,2,4,6
9703165,9703165,,11,13,1,14
9809177,9809177,,11,4,3,7
9902083,9902083,,11,2,5,7
9906128,9906128,,11,3,2,5
9611211,9611211,,14,2,5,7
8144,8144,,3,27,24,51
8145,8145,,1,23,12,35
8146,8146,,2,4,10,14
9912085,9912085,,2,3,14,17
8147,8147,,34,6,9,15
8148,8148,,8,3,3,6
9510179,9510179,,8,8,3,11
9209120,9209120,,8,13,1,14
8149,8149,,2,13,24,37
8150,8150,,37,4,9,13
8152,8152,,0,0,4,4
8153,8153,,62,0,2,2
9212094,9212094,,62,8,0,8
9808013,9808013,,62,7,11,18
9808171,9808171,,62,1,4,5
8154,8154,,37,21,9,30
8155,8155,,34,0,14,14
8156,8156,,25,1,10,11
9503095,9503095,,25,12,3,15
9704035,9704035,,25,7,8,15
9709147,9709147,,25,5,3,8
9805187,9805187,,25,6,8,14
9901054,9901054,,25,1,10,11
9906092,9906092,,25,4,9,13
9209073,9209073,,37,5,0,5
9706120,9706120,,25,6,11,17
9709119,9709119,,25,5,14,19
8157,8157,,37,0,15,15
9705076,9705076,,37,6,18,24
9902150,9902150,,37,4,25,29
9902163,9902163,,37,6,19,25
9909193,9909193,,37,3,29,32
9510078,9510078,,37,3,0,3
9511006,9511006,,37,5,3,8
9812002,9812002,,37,3,5,8
9803185,9803185,,37,4,14,18
9808093,9808093,,37,3,4,7
9902201,9902201,,37,4,13,17
8159,8159,,6,0,2,2
8160,8160,,34,7,11,18
8161,8161,,2,3,4,7
107051,107051,,2,5,35,40
12070,12070,,2,6,5,11
12075,12075,,2,11,33,44
102006,102006,,54,4,32,36
104041,104041,,37,5,18,23
104172,104172,,2,8,4,12
9912227,9912227,,2,6,28,34
8162,8162,,54,5,13,18
8165,8165,,8,15,16,31
9137,9137,,8,17,20,37
8166,8166,,2,1,13,14
9608028,9608028,,1,4,12,16
9612199,9612199,,1,5,3,8
9905170,9905170,,2,4,4,8
9912245,9912245,,2,3,5,8
9510231,9510231,,1,6,3,9
9605073,9605073,,2,5,15,20
9702084,9702084,,2,1,12,13
8167,8167,,37,7,44,51
9806118,9806118,,11,3,2,5
8168,8168,,6,3,7,10
9710028,9710028,,6,3,1,4
9810191,9810191,,6,3,1,4
8169,8169,,37,0,27,27
8170,8170,,37,10,10,20
8171,8171,,7,1,13,14
9407161,9407161,,7,2,5,7
9203048,9203048,,7,7,0,7
9311053,9311053,,7,2,3,5
8172,8172,,3,10,22,32
8173,8173,,54,18,35,53
8175,8175,,16,4,20,24
9303178,9303178,,16,2,0,2
9802060,9802060,,7,1,2,3
9507043,9507043,,16,7,1,8
8176,8176,,16,1,5,6
8179,8179,,34,0,11,11
8180,8180,,2,1,23,24
9411029,9411029,,2,6,2,8
8181,8181,,7,5,4,9
9911014,9911014,,7,4,4,8
9602015,9602015,,7,5,5,10
8182,8182,,11,1,2,3
8183,8183,,0,0,1,1
8184,8184,,37,7,4,11
8186,8186,,2,6,32,38
8189,8189,,34,0,1,1
9812204,9812204,,34,2,0,2
8191,8191,,37,11,9,20
8194,8194,,37,15,42,57
8195,8195,,34,3,1,4
8196,8196,,37,1,19,20
9907059,9907059,,37,3,0,3
8198,8198,,19,0,6,6
8199,8199,,3,12,11,23
8200,8200,,62,3,58,61
9809001,9809001,,62,4,12,16
9212150,9212150,,62,3,3,6
9309083,9309083,,7,10,4,14
9301115,9301115,,7,5,0,5
9303155,9303155,,7,6,0,6
9607165,9607165,,62,1,8,9
9904059,9904059,,62,1,8,9
9612172,9612172,,8,5,6,11
9710134,9710134,,7,2,9,11
8201,8201,,2,6,15,21
8202,8202,,34,0,7,7
8203,8203,,2,30,26,56
8204,8204,,3,62,11,73
8205,8205,,3,54,50,104
8206,8206,,54,0,4,4
9203036,9203036,,65,3,0,3
9410133,9410133,,1,1,0,1
9510130,9510130,,62,3,7,10
9606107,9606107,,1,1,5,6
8207,8207,,25,1,1,2
8208,8208,,62,9,23,32
10262,10262,,62,9,14,23
8209,8209,,34,3,14,17
8210,8210,,19,15,6,21
9812132,9812132,,19,22,6,28
9903044,9903044,,19,18,2,20
9903258,9903258,,19,21,10,31
9905061,9905061,,19,23,6,29
9905095,9905095,,19,17,4,21
9909014,9909014,,19,1,1,2
9904037,9904037,,19,15,2,17
9806220,9806220,,19,8,8,16
9206050,9206050,,19,7,0,7
9709067,9709067,,34,9,12,21
9807128,9807128,,34,3,4,7
9902199,9902199,,19,1,8,9
9905008,9905008,,19,2,3,5
8212,8212,,34,0,24,24
8213,8213,,3,4,30,34
8214,8214,,4,13,12,25
8215,8215,,2,0,12,12
8216,8216,,0,3,3,6
8217,8217,,34,0,1,1
8218,8218,,16,0,3,3
8219,8219,,11,0,3,3
9305121,9305121,,11,1,1,2
9605007,9605007,,1,4,1,5
8220,8220,,37,0,11,11
8221,8221,,0,20,20,40
8222,8222,,62,0,12,12
9211120,9211120,,62,9,3,12
8223,8223,,25,0,1,1
9809215,9809215,,25,2,3,5
9312069,9312069,,25,3,0,3
9401123,9401123,,25,4,0,4
9711190,9711190,,25,4,0,4
8224,8224,,34,2,10,12
8225,8225,,37,10,12,22
8226,8226,,2,3,40,43
9707156,9707156,,2,4,14,18
8227,8227,,4,46,30,76
8228,8228,,34,1,6,7
9910136,9910136,,34,2,7,9
8229,8229,,25,0,4,4
8230,8230,,37,16,47,63
8232,8232,,54,16,9,25
8233,8233,,62,0,8,8
9312202,9312202,,4,1,2,3
8234,8234,,19,1,7,8
9511205,9511205,,25,2,13,15
9406010,9406010,,19,6,2,8
9411146,9411146,,19,2,2,4
9197,9197,,34,7,8,15
8236,8236,,16,0,2,2
8237,8237,,62,13,11,24
9404118,9404118,,62,4,0,4
8238,8238,,54,0,6,6
8239,8239,,34,2,16,18
9910059,9910059,,34,4,3,7
9911073,9911073,,34,4,4,8
9911182,9911182,,34,5,9,14
9912059,9912059,,34,3,4,7
9907093,9907093,,34,2,25,27
9912003,9912003,,16,4,3,7
8240,8240,,34,5,3,8
8241,8241,,2,39,99,138
6061,6061,,6,4,0,4
9410187,9410187,,25,8,14,22
9501106,9501106,,25,7,3,10
9405103,9405103,,25,2,0,2
9403002,9403002,,2,1,0,1
8242,8242,,4,2,21,23
11225,11225,,0,36,13,49
103211,103211,,0,2,11,13
104170,104170,,25,13,8,21
8246,8246,,11,0,3,3
9407051,9407051,,11,5,0,5
8247,8247,,3,5,15,20
8248,8248,,11,1,1,2
8249,8249,,2,3,52,55
9806151,9806151,,2,2,23,25
9812011,9812011,,2,2,11,13
9912106,9912106,,2,12,23,35
9905019,9905019,,2,3,13,16
8250,8250,,54,52,26,78
9612141,9612141,,54,1,34,35
8251,8251,,25,3,8,11
8252,8252,,4,94,25,119
8253,8253,,34,8,14,22
9004,9004,,34,3,1,4
9005,9005,,7,0,1,1
9007,9007,,11,3,8,11
9411002,9411002,,11,2,0,2
9411090,9411090,,11,5,0,5
9008,9008,,34,7,9,16
9009,9009,,3,10,38,48
9011,9011,,2,5,7,12
9012,9012,,54,0,1,1
9013,9013,,2,2,4,6
9014,9014,,7,2,2,4
9015,9015,,34,13,40,53
9016,9016,,2,10,29,39
9017,9017,,3,6,10,16
9018,9018,,16,5,14,19
9019,9019,,2,25,28,53
9020,9020,,16,2,18,20
9908170,9908170,,16,1,4,5
9209031,9209031,,14,4,0,4
9309056,9309056,,16,1,3,4
9703177,9703177,,16,3,3,6
9907042,9907042,,16,2,3,5
9021,9021,,3,5,37,42
9409006,9409006,,19,4,0,4
9612183,9612183,,19,6,11,17
9801193,9801193,,19,1,3,4
9023,9023,,0,16,13,29
9912211,9912211,,0,3,6,9
9904209,9904209,,0,2,4,6
9025,9025,,4,12,21,33
9026,9026,,34,4,13,17
9027,9027,,16,2,4,6
9028,9028,,3,7,12,19
9029,9029,,2,5,2,7
9702147,9702147,,16,2,0,2
9031,9031,,19,3,7,10
9033,9033,,6,0,6,6
9034,9034,,2,1,3,4
9910231,9910231,,2,2,3,5
9035,9035,,16,1,2,3
9036,9036,,16,1,2,3
9037,9037,,3,10,13,23
9038,9038,,4,38,62,100
9809144,9809144,,34,3,7,10
9705060,9705060,,25,3,8,11
9808107,9808107,,34,1,2,3
9040,9040,,34,0,2,2
9041,9041,,11,1,10,11
9042,9042,,37,18,28,46
9043,9043,,3,3,13,16
9044,9044,,25,2,10,12
9803223,9803223,,25,1,3,4
9810190,9810190,,25,2,2,4
9912237,9912237,,25,1,3,4
9404087,9404087,,25,1,0,1
9905039,9905039,,25,3,2,5
9045,9045,,37,10,4,14
9046,9046,,25,2,7,9
9409143,9409143,,25,1,0,1
9503102,9503102,,25,2,0,2
9047,9047,,34,30,13,43
9048,9048,,34,7,12,19
9049,9049,,2,0,6,6
9050,9050,,25,11,26,37
9412014,9412014,,25,5,5,10
9811052,9811052,,25,12,8,20
9910198,9910198,,25,9,18,27
9410068,9410068,,34,5,5,10
9051,9051,,34,6,18,24
9712116,9712116,,37,9,12,21
9804061,9804061,,37,6,46,52
9052,9052,,7,10,2,12
9053,9053,,25,1,3,4
9403132,9403132,,25,3,2,5
9311087,9311087,,25,8,2,10
9054,9054,,54,12,31,43
9055,9055,,7,4,7,11
9609025,9609025,,7,2,1,3
9705141,9705141,,7,2,1,3
9510096,9510096,,7,3,1,4
9057,9057,,34,1,18,19
9058,9058,,6,0,1,1
9060,9060,,37,7,33,40
9061,9061,,4,66,30,96
9910159,9910159,,4,13,10,23
9806112,9806112,,2,2,24,26
9806054,9806054,,1,8,4,12
9062,9062,,2,9,35,44
9063,9063,,34,7,8,15
9066,9066,,2,1,10,11
9902003,9902003,,2,5,11,16
9503036,9503036,,37,3,12,15
9503145,9503145,,37,2,1,3
9410216,9410216,,6,1,3,4
9807029,9807029,,2,7,14,21
9610187,9610187,,8,7,4,11
9703002,9703002,,34,5,1,6
9704010,9704010,,34,2,7,9
9067,9067,,3,12,17,29
9068,9068,,3,9,9,18
9070,9070,,3,4,14,18
10106,10106,,1,5,13,18
9601002,9601002,,34,6,1,7
9071,9071,,9,4,3,7
9072,9072,,37,8,34,42
9073,9073,,11,5,3,8
9708102,9708102,,11,9,4,13
9905152,9905152,,11,5,2,7
9912129,9912129,,11,4,3,7
9410032,9410032,,11,5,0,5
9806023,9806023,,11,3,1,4
9074,9074,,0,13,17,30
9077,9077,,37,2,10,12
9707046,9707046,,65,3,11,14
9705149,9705149,,65,3,5,8
9078,9078,,2,0,8,8
9079,9079,,25,0,6,6
9909204,9909204,,25,6,1,7
9080,9080,,25,0,3,3
9081,9081,,25,0,4,4
9903253,9903253,,25,3,4,7
9082,9082,,3,3,31,34
9084,9084,,25,5,21,26
9412124,9412124,,7,3,1,4
9512123,9512123,,65,2,10,12
9085,9085,,3,0,2,2
9508032,9508032,,3,5,1,6
9086,9086,,62,7,4,11
9710135,9710135,,62,4,5,9
9704063,9704063,,19,3,4,7
9706014,9706014,,34,3,4,7
9088,9088,,25,0,4,4
9602129,9602129,,25,1,8,9
9604130,9604130,,25,1,9,10
9089,9089,,54,11,26,37
9090,9090,,4,13,23,36
9091,9091,,0,1,4,5
9092,9092,,2,1,6,7
7199,7199,,2,6,0,6
9093,9093,,11,0,8,8
9606055,9606055,,11,6,0,6
9094,9094,,16,0,3,3
9407125,9407125,,16,4,0,4
9510090,9510090,,16,13,3,16
9608101,9608101,,16,2,1,3
9608102,9608102,,16,3,0,3
9804205,9804205,,16,5,29,34
9095,9095,,3,3,40,43
9096,9096,,8,18,41,59
9809073,9809073,,34,1,16,17
9097,9097,,11,0,3,3
9098,9098,,3,4,31,35
9099,9099,,7,0,7,7
9605161,9605161,,7,9,1,10
9100,9100,,65,3,12,15
9101,9101,,3,32,28,60
9102,9102,,6,4,8,12
9302130,9302130,,6,7,1,8
9601144,9601144,,6,4,0,4
9808173,9808173,,6,8,6,14
9912216,9912216,,6,3,8,11
9503147,9503147,,6,4,0,4
9205053,9205053,,6,1,0,1
9303081,9303081,,6,1,1,2
9809151,9809151,,6,3,3,6
9104,9104,,54,3,2,5
9105,9105,,4,40,24,64
9106,9106,,34,24,51,75
9107,9107,,1,8,32,40
9912042,9912042,,1,1,22,23
9108,9108,,8,1,1,2
9705032,9705032,,8,3,0,3
9109,9109,,6,6,7,13
9111,9111,,65,3,8,11
9112,9112,,37,19,39,58
9701067,9701067,,3,4,5,9
9701073,9701073,,3,5,12,17
9708052,9708052,,3,1,2,3
9113,9113,,4,3,10,13
9811138,9811138,,62,2,6,8
9706150,9706150,,62,1,4,5
9114,9114,,20,0,1,1
9906008,9906008,,20,2,0,2
9115,9115,,2,1,4,5
9116,9116,,2,2,6,8
9911188,9911188,,2,3,18,21
9702200,9702200,,37,1,14,15
9707140,9707140,,2,1,4,5
9810017,9810017,,2,1,5,6
9811105,9811105,,16,1,4,5
9908097,9908097,,37,1,10,11
9117,9117,,0,11,23,34
9118,9118,,1,1,26,27
9909146,9909146,,1,3,37,40
9204050,9204050,,16,4,0,4
9304029,9304029,,16,5,1,6
9909063,9909063,,1,3,9,12
9119,9119,,34,2,15,17
9120,9120,,3,5,12,17
9907110,9907110,,7,16,7,23
9405079,9405079,,7,3,1,4
9121,9121,,7,3,4,7
9124,9124,,6,3,6,9
9125,9125,,19,2,14,16
9404084,9404084,,25,2,5,7
9410098,9410098,,19,5,2,7
9505154,9505154,,19,3,1,4
9811166,9811166,,19,2,2,4
9126,9126,,0,27,22,49
9907163,9907163,,0,8,2,10
9128,9128,,7,1,11,12
9129,9129,,16,0,3,3
9912078,9912078,,37,2,9,11
9130,9130,,6,6,3,9
9131,9131,,2,1,18,19
9133,9133,,54,3,23,26
9801200,9801200,,54,1,15,16
9901064,9901064,,54,2,7,9
9134,9134,,2,0,19,19
9412242,9412242,,8,5,11,16
9504121,9504121,,8,5,4,9
9504122,9504122,,8,5,2,7
9508100,9508100,,8,2,8,10
9611066,9611066,,54,3,10,13
9135,9135,,54,13,51,64
9138,9138,,1,19,11,30
9139,9139,,34,25,74,99
9140,9140,,3,29,21,50
9141,9141,,3,13,43,56
9143,9143,,11,1,15,16
9807157,9807157,,11,1,7,8
9144,9144,,8,9,8,17
9146,9146,,34,3,22,25
9147,9147,,3,6,18,24
9149,9149,,37,1,11,12
9410203,9410203,,62,10,9,19
9150,9150,,54,3,11,14
9151,9151,,25,0,4,4
9152,9152,,11,9,35,44
9909209,9909209,,11,7,39,46
9305175,9305175,,11,4,1,5
9509114,9509114,,11,2,2,4
9605031,9605031,,11,5,0,5
9605044,9605044,,11,6,0,6
9605045,9605045,,11,7,1,8
9606195,9606195,,11,5,8,13
9612005,9612005,,8,6,30,36
9701026,9701026,,11,4,1,5
9703050,9703050,,11,4,5,9
9804030,9804030,,11,3,6,9
9153,9153,,3,17,11,28
7072,7072,,3,2,0,2
9154,9154,,6,1,14,15
9805130,9805130,,6,3,12,15
9811068,9811068,,6,6,15,21
9203013,9203013,,3,4,0,4
9503101,9503101,,6,7,1,8
9505040,9505040,,6,4,10,14
9608057,9608057,,6,2,8,10
9307006,9307006,,6,5,0,5
9408128,9408128,,6,3,4,7
9307047,9307047,,6,1,0,1
9611147,9611147,,6,3,8,11
9155,9155,,4,1,13,14
9156,9156,,34,21,55,76
9157,9157,,6,2,9,11
9806005,9806005,,6,4,31,35
9803222,9803222,,6,2,3,5
9159,9159,,34,8,14,22
9161,9161,,11,1,13,14
9162,9162,,7,2,10,12
9310097,9310097,,7,8,0,8
9709106,9709106,,7,4,18,22
9911191,9911191,,7,5,13,18
9308136,9308136,,7,9,0,9
9405054,9405054,,7,10,0,10
9508076,9508076,,7,9,2,11
9606023,9606023,,7,5,3,8
9612082,9612082,,7,5,10,15
9703053,9703053,,7,4,7,11
9703132,9703132,,7,2,6,8
9808086,9808086,,34,4,23,27
9163,9163,,3,13,11,24
4033,4033,,3,2,0,2
9164,9164,,34,0,14,14
9806078,9806078,,34,6,11,17
9910006,9910006,,25,2,10,12
9809049,9809049,,25,3,3,6
9165,9165,,6,1,9,10
9166,9166,,2,5,16,21
9612176,9612176,,8,6,1,7
9168,9168,,1,17,8,25
9169,9169,,31,1,9,10
9506020,9506020,,31,4,4,8
9170,9170,,9,0,1,1
9803052,9803052,,9,3,5,8
9609178,9609178,,9,1,1,2
9171,9171,,1,28,38,66
9172,9172,,0,10,15,25
10004,10004,,0,9,44,53
11153,11153,,0,13,23,36
9807049,9807049,,31,4,25,29
9174,9174,,3,5,19,24
9502085,9502085,,37,1,1,2
9178,9178,,0,8,4,12
9179,9179,,2,0,9,9
9601131,9601131,,19,1,2,3
9311017,9311017,,62,5,2,7
9312166,9312166,,19,1,0,1
9506044,9506044,,3,4,6,10
9181,9181,,3,28,20,48
9182,9182,,3,29,52,81
9185,9185,,34,14,17,31
9186,9186,,34,6,12,18
9187,9187,,34,6,25,31
9188,9188,,37,17,7,24
9189,9189,,4,11,63,74
9190,9190,,3,4,19,23
9191,9191,,4,62,27,89
9192,9192,,6,3,4,7
9193,9193,,2,8,18,26
9194,9194,,62,0,27,27
9306035,9306035,,62,20,7,27
9401058,9401058,,62,6,10,16
9407112,9407112,,62,8,13,21
9408104,9408104,,62,13,10,23
9607234,9607234,,62,3,41,44
9905103,9905103,,62,2,9,11
9207027,9207027,,1,4,0,4
9201024,9201024,,62,12,0,12
9208013,9208013,,62,13,0,13
9302125,9302125,,62,7,2,9
9307147,9307147,,62,6,11,17
9301053,9301053,,62,8,1,9
9312144,9312144,,62,4,14,18
9210071,9210071,,62,3,0,3
9407017,9407017,,62,6,5,11
9407038,9407038,,62,8,1,9
9501018,9501018,,62,6,15,21
9210155,9210155,,62,5,0,5
9311067,9311067,,62,3,7,10
9404032,9404032,,62,2,0,2
9411005,9411005,,62,3,4,7
9412006,9412006,,62,6,9,15
9507089,9507089,,62,1,1,2
9511172,9511172,,62,2,7,9
9602068,9602068,,62,2,12,14
9603112,9603112,,7,7,10,17
9301080,9301080,,62,10,0,10
9403043,9403043,,62,4,0,4
9195,9195,,14,12,6,18
9196,9196,,3,27,22,49
9501121,9501121,,25,2,7,9
9912040,9912040,,34,2,4,6
9406127,9406127,,25,3,6,9
9501067,9501067,,25,5,8,13
9198,9198,,34,6,24,30
9200,9200,,25,0,1,1
9201,9201,,54,2,1,3
9202,9202,,34,18,158,176
208206,208206,,25,3,11,14
9311045,9311045,,25,7,4,11
9405059,9405059,,25,4,6,10
9501015,9501015,,25,3,24,27
9909138,9909138,,25,1,8,9
204253,204253,,25,19,160,179
9205049,9205049,,25,1,0,1
9206043,9206043,,25,6,0,6
9204042,9204042,,25,2,0,2
9208080,9208080,,25,3,5,8
9404064,9404064,,25,8,1,9
9204058,9204058,,25,2,0,2
9401102,9401102,,25,7,26,33
9409039,9409039,,25,1,16,17
9410045,9410045,,62,1,2,3
9412224,9412224,,25,3,34,37
9303170,9303170,,25,2,4,6
9305137,9305137,,31,3,2,5
9502115,9502115,,25,5,11,16
9508108,9508108,,1,2,2,4
9511031,9511031,,25,1,6,7
9810055,9810055,,25,6,16,22
9902093,9902093,,25,3,7,10
9604056,9604056,,25,3,36,39
9203,9203,,34,1,20,21
9204,9204,,19,1,2,3
10211,10211,,19,2,5,7
9205,9205,,11,3,11,14
9206,9206,,37,0,29,29
106176,106176,,37,12,23,35
9208,9208,,16,0,5,5
9209,9209,,37,18,16,34
9210,9210,,34,9,11,20
9211,9211,,34,58,28,86
9213,9213,,4,11,58,69
9214,9214,,4,3,20,23
9215,9215,,3,5,26,31
9216,9216,,8,0,7,7
9505064,9505064,,8,3,1,4
9209002,9209002,,8,4,4,8
9301017,9301017,,37,13,0,13
9303086,9303086,,8,2,0,2
9402056,9402056,,8,3,0,3
9309021,9309021,,8,8,0,8
9217,9217,,34,9,10,19
9218,9218,,7,1,1,2
9219,9219,,65,14,9,23
9220,9220,,11,4,4,8
9221,9221,,37,2,17,19
9222,9222,,16,2,6,8
3172,3172,,16,2,0,2
9907118,9907118,,16,3,6,9
9401106,9401106,,16,6,3,9
9702085,9702085,,16,1,4,5
9223,9223,,6,1,22,23
104189,104189,,6,4,31,35
9511020,9511020,,6,1,7,8
9810001,9810001,,6,9,2,11
9909064,9909064,,6,6,8,14
101089,101089,,3,9,1,10
102106,102106,,6,4,13,17
103005,103005,,6,6,11,17
9305181,9305181,,6,24,4,28
9811110,9811110,,6,5,11,16
9304025,9304025,,6,2,1,3
9509012,9509012,,6,4,10,14
9224,9224,,4,5,43,48
9225,9225,,3,7,6,13
9226,9226,,1,8,30,38
9227,9227,,34,7,12,19
9228,9228,,54,1,24,25
9229,9229,,7,6,11,17
9808179,9808179,,7,2,21,23
9508110,9508110,,62,1,7,8
9312041,9312041,,8,2,2,4
9404037,9404037,,8,8,8,16
9230,9230,,3,2,5,7
9231,9231,,3,12,8,20
9232,9232,,11,2,5,7
9801185,9801185,,11,1,0,1
9233,9233,,3,29,66,95
9234,9234,,54,12,24,36
9235,9235,,8,1,6,7
9236,9236,,3,5,3,8
9910200,9910200,,11,3,15,18
9237,9237,,16,3,19,22
9611157,9611157,,16,1,3,4
9608068,9608068,,16,2,36,38
9601041,9601041,,37,3,18,21
9238,9238,,16,0,7,7
9206033,9206033,,16,21,0,21
9212126,9212126,,16,10,1,11
9501145,9501145,,16,9,2,11
9206010,9206010,,16,4,0,4
9212071,9212071,,37,5,0,5
9305077,9305077,,16,6,2,8
9310138,9310138,,16,8,3,11
9311144,9311144,,16,5,6,11
9406068,9406068,,16,10,7,17
9409116,9409116,,16,8,1,9
9239,9239,,1,5,15,20
9803230,9803230,,6,4,8,12
9405074,9405074,,2,1,10,11
9240,9240,,37,6,15,21
9241,9241,,11,2,3,5
9123,9123,,11,4,0,4
9508087,9508087,,11,3,1,4
9406151,9406151,,11,3,0,3
9242,9242,,1,19,64,83
9810140,9810140,,34,1,9,10
9206014,9206014,,6,6,1,7
9244,9244,,34,42,7,49
9245,9245,,62,1,10,11
9246,9246,,4,67,36,103
9248,9248,,34,1,8,9
9249,9249,,1,0,4,4
9410078,9410078,,1,4,1,5
9250,9250,,62,7,22,29
9251,9251,,54,1,9,10
9252,9252,,4,6,44,50
10001,10001,,3,0,27,27
10002,10002,,37,9,35,44
9305037,9305037,,54,10,1,11
10003,10003,,3,9,15,24
10005,10005,,34,4,24,28
10007,10007,,4,0,23,23
10008,10008,,11,2,8,10
9911131,9911131,,11,3,6,9
10009,10009,,3,1,1,2
10010,10010,,34,41,25,66
10012,10012,,62,3,13,16
10013,10013,,25,0,3,3
9804015,9804015,,25,1,0,1
9811196,9811196,,2,1,18,19
9206065,9206065,,2,2,0,2
10014,10014,,0,18,27,45
10015,10015,,37,6,31,37
10016,10016,,4,20,48,68
9602146,9602146,,3,7,0,7
10020,10020,,34,0,13,13
9304016,9304016,,37,6,0,6
9201048,9201048,,7,12,0,12
10021,10021,,4,26,20,46
10022,10022,,2,3,19,22
10023,10023,,37,10,33,43
10025,10025,,34,12,16,28
10026,10026,,3,8,34,42
10027,10027,,3,0,20,20
10028,10028,,4,26,27,53
10029,10029,,3,0,4,4
9508013,9508013,,3,2,0,2
10030,10030,,62,1,1,2
9808103,9808103,,62,3,0,3
10031,10031,,11,2,6,8
10032,10032,,0,4,4,8
10033,10033,,7,0,7,7
9811109,9811109,,7,2,10,12
9910123,9910123,,7,1,14,15
9507110,9507110,,7,7,7,14
9709210,9709210,,7,3,5,8
9908127,9908127,,7,1,6,7
10034,10034,,4,27,28,55
10035,10035,,7,1,4,5
9404100,9404100,,19,5,2,7
10036,10036,,65,0,9,9
9505125,9505125,,65,1,7,8
10038,10038,,2,4,14,18
9911212,9911212,,2,2,3,5
10039,10039,,7,1,1,2
10040,10040,,3,9,15,24
9305151,9305151,,8,1,1,2
10041,10041,,0,2,4,6
10042,10042,,54,14,17,31
9711173,9711173,,34,4,2,6
10043,10043,,25,5,4,9
9912202,9912202,,8,6,17,23
9308146,9308146,,8,3,4,7
10044,10044,,2,3,36,39
9406164,9406164,,2,1,12,13
9807202,9807202,,2,2,38,40
10045,10045,,4,9,35,44
10046,10046,,54,1,29,30
10047,10047,,2,0,22,22
10048,10048,,34,12,47,59
10049,10049,,2,2,11,13
10050,10050,,6,7,8,15
10051,10051,,0,12,9,21
10052,10052,,6,0,16,16
9702172,9702172,,37,5,3,8
9804138,9804138,,37,4,5,9
9605228,9605228,,37,5,1,6
10053,10053,,6,1,4,5
10054,10054,,34,6,95,101
11182,11182,,34,10,42,52
9605236,9605236,,2,3,37,40
11115,11115,,34,44,41,85
9704075,9704075,,2,5,16,21
10055,10055,,37,3,7,10
9610069,9610069,,3,6,1,7
9603001,9603001,,37,6,0,6
9402063,9402063,,1,2,0,2
10056,10056,,8,0,7,7
9510235,9510235,,8,6,2,8
9704036,9704036,,8,6,5,11
9804052,9804052,,8,2,3,5
9306163,9306163,,8,13,3,16
9509099,9509099,,8,6,5,11
9501061,9501061,,8,8,2,10
9602058,9602058,,8,2,3,5
9207089,9207089,,8,14,0,14
9310071,9310071,,8,7,3,10
10057,10057,,11,7,3,10
9601159,9601159,,11,4,0,4
9707077,9707077,,11,6,0,6
9901071,9901071,,11,3,3,6
9802112,9802112,,11,2,0,2
9805052,9805052,,11,4,3,7
10058,10058,,4,12,26,38
10059,10059,,9,12,34,46
9406134,9406134,,6,5,0,5
10065,10065,,0,4,7,11
10066,10066,,3,7,9,16
10067,10067,,16,0,2,2
10068,10068,,37,2,13,15
10071,10071,,0,24,13,37
10072,10072,,3,12,27,39
10073,10073,,11,5,2,7
10074,10074,,7,0,3,3
9711167,9711167,,7,3,2,5
9802044,9802044,,7,1,1,2
9908087,9908087,,7,1,1,2
9611166,9611166,,7,1,0,1
10075,10075,,11,4,7,11
10076,10076,,34,19,7,26
10077,10077,,34,1,13,14
9410158,9410158,,65,4,12,16
9304024,9304024,,1,3,4,7
9308108,9308108,,1,1,3,4
10078,10078,,37,2,38,40
9704079,9704079,,62,4,4,8
10079,10079,,37,3,5,8
9903103,9903103,,37,1,14,15
9811119,9811119,,37,3,33,36
9812155,9812155,,37,3,28,31
10080,10080,,6,1,6,7
9804005,9804005,,16,1,6,7
9804098,9804098,,6,2,7,9
9609131,9609131,,16,3,8,11
10081,10081,,6,0,5,5
10082,10082,,62,12,10,22
10083,10083,,34,2,9,11
9411166,9411166,,14,5,6,11
9212078,9212078,,14,8,0,8
9409074,9409074,,14,1,5,6
9505139,9505139,,25,9,5,14
10084,10084,,65,0,21,21
9803175,9803175,,65,7,6,13
9803201,9803201,,65,3,5,8
9812048,9812048,,65,4,36,40
9906163,9906163,,65,3,22,25
9503071,9503071,,65,5,1,6
9612034,9612034,,65,7,7,14
9705233,9705233,,65,6,17,23
9301093,9301093,,62,5,0,5
9304116,9304116,,62,2,3,5
9402122,9402122,,54,6,0,6
10085,10085,,31,0,12,12
10086,10086,,54,2,24,26
10087,10087,,54,11,20,31
10088,10088,,34,54,38,92
10091,10091,,54,18,36,54
10092,10092,,2,0,13,13
10094,10094,,62,6,15,21
10095,10095,,11,10,13,23
9505172,9505172,,11,10,4,14
10096,10096,,25,9,14,23
9604167,9604167,,6,4,8,12
9910133,9910133,,25,9,9,18
9212134,9212134,,6,3,0,3
9504137,9504137,,6,1,6,7
10097,10097,,25,4,4,8
9510128,9510128,,25,1,3,4
10098,10098,,0,5,16,21
10099,10099,,0,4,12,16
9706092,9706092,,6,4,3,7
9911035,9911035,,2,3,10,13
9801126,9801126,,6,5,1,6
10100,10100,,11,4,19,23
9212083,9212083,,11,11,0,11
10101,10101,,3,30,31,61
10102,10102,,37,19,14,33
9205082,9205082,,16,4,0,4
10103,10103,,37,1,23,24
9910209,9910209,,37,2,12,14
9704032,9704032,,37,2,22,24
10104,10104,,1,13,22,35
10105,10105,,3,28,20,48
9507106,9507106,,34,1,0,1
10107,10107,,7,4,16,20
9312180,9312180,,3,4,2,6
9405125,9405125,,3,5,1,6
9606011,9606011,,3,5,3,8
9212052,9212052,,7,6,0,6
9307102,9307102,,3,4,0,4
10108,10108,,4,129,32,161
10109,10109,,11,0,11,11
10110,10110,,65,1,21,22
10111,10111,,14,0,1,1
10112,10112,,0,22,9,31
10113,10113,,3,31,24,55
10114,10114,,11,0,4,4
9304101,9304101,,11,3,1,4
9601136,9601136,,11,9,2,11
9711174,9711174,,11,2,0,2
9712096,9712096,,11,2,4,6
9202063,9202063,,16,9,0,9
10115,10115,,2,3,19,22
10116,10116,,34,10,22,32
10117,10117,,34,5,35,40
10118,10118,,8,5,12,17
9308041,9308041,,8,1,2,3
10119,10119,,3,23,21,44
9912258,9912258,,3,3,26,29
10121,10121,,0,5,18,23
10122,10122,,2,20,53,73
10123,10123,,62,0,6,6
10124,10124,,2,16,18,34
10125,10125,,16,0,2,2
10126,10126,,34,0,2,2
10127,10127,,34,35,17,52
10128,10128,,11,1,9,10
9906017,9906017,,11,2,3,5
10129,10129,,19,10,6,16
10130,10130,,34,2,6,8
10131,10131,,25,0,4,4
10132,10132,,13,0,2,2
10133,10133,,0,10,22,32
12044,12044,,0,27,23,50
10215,10215,,0,26,29,55
11254,11254,,0,10,17,27
10134,10134,,2,2,1,3
10135,10135,,2,7,9,16
10136,10136,,25,0,1,1
10137,10137,,34,31,45,76
10138,10138,,34,15,8,23
10139,10139,,8,1,6,7
10141,10141,,0,9,27,36
101164,101164,,0,13,22,35
10203,10203,,0,6,9,15
11156,11156,,0,102,24,126
11230,11230,,0,18,17,35
10142,10142,,0,0,14,14
10143,10143,,2,0,55,55
9712078,9712078,,2,2,4,6
10144,10144,,0,6,34,40
10145,10145,,34,7,13,20
10146,10146,,31,0,5,5
10147,10147,,0,0,6,6
9310094,9310094,,0,2,0,2
9503096,9503096,,0,1,1,2
9610244,9610244,,0,3,3,6
9701020,9701020,,37,5,13,18
9701155,9701155,,37,6,28,34
9408135,9408135,,62,7,6,13
9504074,9504074,,62,2,8,10
10149,10149,,3,5,6,11
10151,10151,,2,8,22,30
10152,10152,,14,3,5,8
9806088,9806088,,14,4,2,6
9907035,9907035,,14,2,2,4
9702033,9702033,,14,1,0,1
10153,10153,,34,3,11,14
9712252,9712252,,2,3,13,16
10154,10154,,34,2,10,12
10155,10155,,54,1,21,22
10156,10156,,31,1,4,5
10158,10158,,3,7,28,35
10159,10159,,11,1,1,2
3238,3238,,11,1,0,1
10160,10160,,3,9,14,23
10161,10161,,8,0,3,3
10162,10162,,7,0,4,4
9210103,9210103,,19,7,0,7
9302121,9302121,,19,9,0,9
9610177,9610177,,7,1,10,11
9610178,9610178,,7,1,10,11
9307011,9307011,,7,11,0,11
9403025,9403025,,7,2,5,7
9503117,9503117,,7,3,4,7
10163,10163,,0,7,25,32
9307177,9307177,,2,10,4,14
9304013,9304013,,1,1,11,12
10164,10164,,62,0,11,11
10166,10166,,34,1,18,19
9903208,9903208,,11,7,20,27
9802056,9802056,,11,5,4,9
9804016,9804016,,11,8,16,24
9810171,9810171,,11,7,14,21
10167,10167,,54,25,29,54
9411015,9411015,,54,9,2,11
9708131,9708131,,54,2,10,12
9710237,9710237,,54,1,14,15
9405100,9405100,,54,1,0,1
9611013,9611013,,54,1,10,11
10168,10168,,11,4,10,14
10169,10169,,3,6,26,32
10170,10170,,65,9,22,31
10171,10171,,0,5,10,15
10172,10172,,3,8,9,17
9312162,9312162,,11,6,1,7
9612255,9612255,,11,4,1,5
10173,10173,,4,6,8,14
10175,10175,,3,54,14,68
10176,10176,,7,6,3,9
10177,10177,,3,15,10,25
10178,10178,,11,0,2,2
9906236,9906236,,11,6,2,8
9710227,9710227,,16,8,6,14
10179,10179,,54,9,40,49
10180,10180,,11,0,11,11
9704025,9704025,,7,8,7,15
9808034,9808034,,7,12,5,17
10181,10181,,4,9,23,32
10182,10182,,54,9,15,24
10183,10183,,0,11,8,19
10184,10184,,37,1,11,12
10185,10185,,11,2,4,6
9806073,9806073,,11,5,1,6
9912194,9912194,,11,3,5,8
9606125,9606125,,11,3,0,3
9607128,9607128,,11,1,2,3
9810094,9810094,,11,2,2,4
10186,10186,,0,32,14,46
10188,10188,,21,0,1,1
10018,10018,,21,1,0,1
10189,10189,,4,2,29,31
10190,10190,,4,27,28,55
10191,10191,,2,10,11,21
10192,10192,,54,10,37,47
10193,10193,,0,0,12,12
10194,10194,,2,4,22,26
10195,10195,,2,4,26,30
10196,10196,,37,31,38,69
9205042,9205042,,37,1,0,1
10197,10197,,19,0,3,3
10198,10198,,54,39,11,50
10199,10199,,25,1,2,3
10200,10200,,34,12,26,38
10201,10201,,11,18,2,20
10202,10202,,0,4,19,23
9807112,9807112,,11,2,16,18
10204,10204,,3,44,41,85
10205,10205,,0,27,18,45
10206,10206,,2,14,14,28
10207,10207,,54,14,29,43
9801175,9801175,,54,3,33,36
10208,10208,,0,2,14,16
10209,10209,,11,1,1,2
9909207,9909207,,11,1,1,2
10210,10210,,19,0,2,2
9804002,9804002,,19,4,2,6
10212,10212,,22,0,1,1
3079,3079,,22,3,0,3
10216,10216,,7,0,5,5
9607173,9607173,,7,3,5,8
9610124,9610124,,7,2,8,10
9210024,9210024,,7,18,0,18
9402124,9402124,,7,5,2,7
9305046,9305046,,7,6,1,7
9305067,9305067,,7,6,3,9
10217,10217,,37,26,14,40
10218,10218,,4,48,17,65
10219,10219,,1,0,5,5
10220,10220,,3,30,22,52
11172,11172,,3,62,8,70
101081,101081,,3,6,14,20
102157,102157,,3,23,26,49
12175,12175,,3,24,8,32
101039,101039,,3,9,30,39
101029,101029,,3,96,12,108
9707237,9707237,,7,2,7,9
10221,10221,,3,28,48,76
10222,10222,,54,7,35,42
10223,10223,,37,33,46,79
9511152,9511152,,54,4,13,17
10224,10224,,65,0,3,3
9211100,9211100,,65,5,2,7
9811100,9811100,,65,2,1,3
9901022,9901022,,65,2,1,3
10225,10225,,11,11,1,12
10226,10226,,6,2,25,27
9906089,9906089,,6,7,13,20
9403027,9403027,,62,4,0,4
9803233,9803233,,62,4,1,5
9808189,9808189,,11,1,18,19
9906071,9906071,,62,2,7,9
10227,10227,,11,2,3,5
9711095,9711095,,11,3,4,7
9712126,9712126,,11,2,3,5
9504117,9504117,,11,3,0,3
10228,10228,,62,3,5,8
10229,10229,,8,2,9,11
9408016,9408016,,8,8,1,9
9810221,9810221,,8,5,3,8
9708056,9708056,,8,1,0,1
10230,10230,,11,0,1,1
9501118,9501118,,11,1,0,1
9501119,9501119,,11,2,2,4
10233,10233,,37,0,36,36
10234,10234,,34,0,3,3
10235,10235,,11,1,2,3
10236,10236,,19,2,1,3
10237,10237,,2,4,31,35
10238,10238,,8,5,20,25
9712191,9712191,,8,4,1,5
9712216,9712216,,8,4,0,4
10239,10239,,34,16,8,24
10240,10240,,4,53,65,118
10241,10241,,0,6,21,27
9901132,9901132,,11,1,1,2
9910208,9910208,,0,3,10,13
9801032,9801032,,37,3,18,21
9803155,9803155,,11,4,5,9
10242,10242,,2,0,22,22
9909005,9909005,,2,3,5,8
10243,10243,,2,1,14,15
9909136,9909136,,2,1,5,6
10244,10244,,3,13,40,53
10245,10245,,0,1,7,8
10246,10246,,6,1,8,9
9906021,9906021,,6,3,3,6
10247,10247,,4,11,39,50
10248,10248,,1,1,18,19
10251,10251,,3,26,28,54
10252,10252,,34,69,19,88
10253,10253,,3,2,8,10
9210098,9210098,,3,13,0,13
9812231,9812231,,3,2,4,6
9909026,9909026,,3,1,20,21
9803240,9803240,,3,1,19,20
9402047,9402047,,3,12,2,14
9510099,9510099,,3,2,4,6
9703213,9703213,,3,3,7,10
10254,10254,,37,0,13,13
9408152,9408152,,37,1,0,1
9804161,9804161,,3,4,5,9
9904089,9904089,,37,4,16,20
9905222,9905222,,37,2,13,15
9911228,9911228,,37,1,12,13
9703057,9703057,,37,2,10,12
10255,10255,,54,7,14,21
10256,10256,,3,15,46,61
10257,10257,,62,5,7,12
10258,10258,,31,3,21,24
10259,10259,,16,5,3,8
10260,10260,,11,7,3,10
10261,10261,,37,0,7,7
10263,10263,,34,1,15,16
10264,10264,,3,30,8,38
10265,10265,,11,5,6,11
10266,10266,,2,3,13,16
10267,10267,,7,0,6,6
9410241,9410241,,7,8,12,20
9703111,9703111,,7,5,7,12
9703137,9703137,,7,4,8,12
9210152,9210152,,62,13,0,13
9308148,9308148,,7,4,2,6
9402067,9402067,,7,1,5,6
9405161,9405161,,62,5,8,13
10268,10268,,3,8,10,18
10269,10269,,37,18,22,40
9307009,9307009,,37,1,0,1
10270,10270,,54,0,31,31
9412077,9412077,,54,2,9,11
9602139,9602139,,7,1,3,4
10271,10271,,54,7,29,36
10272,10272,,34,8,11,19
9707226,9707226,,37,1,6,7
10273,10273,,7,2,1,3
9308150,9308150,,7,4,1,5
9308141,9308141,,7,1,1,2
10274,10274,,34,27,7,34
10275,10275,,3,23,26,49
10276,10276,,0,2,3,5
10277,10277,,19,1,4,5
9706188,9706188,,19,3,8,11
9402075,9402075,,19,9,1,10
9308014,9308014,,19,4,0,4
9311100,9311100,,19,7,0,7
9401065,9401065,,19,5,0,5
9503061,9503061,,19,9,2,11
9510114,9510114,,19,5,2,7
9307165,9307165,,19,4,0,4
9807020,9807020,,19,1,3,4
10278,10278,,62,2,17,19
10279,10279,,54,38,43,81
10280,10280,,31,2,31,33
10281,10281,,54,6,14,20
10282,10282,,37,20,21,41
10283,10283,,0,4,12,16
9610189,9610189,,16,9,0,9
10285,10285,,19,8,23,31
9905172,9905172,,19,3,8,11
9204015,9204015,,19,1,0,1
10286,10286,,0,10,23,33
10287,10287,,62,2,13,15
10288,10288,,25,0,2,2
9511109,9511109,,25,2,0,2
10289,10289,,16,0,9,9
10290,10290,,62,1,4,5
10291,10291,,2,1,3,4
10292,10292,,2,6,17,23
10293,10293,,37,13,10,23
11001,11001,,34,4,15,19
11002,11002,,4,17,31,48
11003,11003,,3,0,43,43
11004,11004,,62,2,10,12
9812115,9812115,,62,2,7,9
9802188,9802188,,1,3,5,8
9810189,9810189,,1,2,9,11
11005,11005,,7,2,1,3
11006,11006,,0,25,26,51
11007,11007,,6,1,12,13
9812023,9812023,,6,2,6,8
11008,11008,,2,13,20,33
11009,11009,,4,43,22,65
11010,11010,,34,2,10,12
9910105,9910105,,34,5,30,35
11011,11011,,6,7,7,14
9711137,9711137,,6,2,4,6
9807015,9807015,,6,1,2,3
11012,11012,,8,1,7,8
11013,11013,,7,7,19,26
9612241,9612241,,7,2,25,27
11014,11014,,11,4,6,10
9912203,9912203,,11,3,15,18
9707221,9707221,,11,2,0,2
9811222,9811222,,11,3,1,4
11015,11015,,6,1,1,2
11016,11016,,34,12,35,47
11017,11017,,37,64,37,101
11018,11018,,2,27,20,47
11019,11019,,3,3,37,40
11020,11020,,2,10,13,23
11021,11021,,65,16,3,19
11022,11022,,19,0,2,2
11023,11023,,34,46,26,72
9903001,9903001,,2,2,10,12
11024,11024,,0,11,25,36
11026,11026,,9,0,4,4
11027,11027,,0,9,9,18
11028,11028,,3,0,9,9
11029,11029,,4,4,72,76
11030,11030,,34,1,5,6
11031,11031,,54,5,19,24
11032,11032,,54,0,64,64
9607119,9607119,,1,7,2,9
9702081,9702081,,1,8,5,13
9707183,9707183,,1,6,8,14
9711136,9711136,,54,5,6,11
9806134,9806134,,1,3,3,6
9809176,9809176,,1,2,13,15
9901153,9901153,,1,3,2,5
9901160,9901160,,54,3,3,6
9904208,9904208,,1,6,8,14
9909092,9909092,,1,5,9,14
9911210,9911210,,1,6,10,16
9604023,9604023,,37,3,11,14
9601102,9601102,,54,4,9,13
9608113,9608113,,54,1,14,15
9309086,9309086,,1,5,0,5
9612213,9612213,,54,3,14,17
9410143,9410143,,1,9,4,13
9503062,9503062,,1,5,2,7
9609169,9609169,,1,1,4,5
9812198,9812198,,1,2,6,8
11033,11033,,4,70,20,90
11034,11034,,3,9,13,22
11035,11035,,3,7,7,14
9912044,9912044,,54,5,20,25
11036,11036,,8,2,7,9
11037,11037,,3,4,25,29
209092,209092,,4,2,1,3
211079,211079,,4,4,1,5
11038,11038,,3,6,23,29
11039,11039,,2,0,15,15
9912261,9912261,,2,1,14,15
11040,11040,,34,10,21,31
11041,11041,,34,9,47,56
11043,11043,,16,2,15,17
11044,11044,,34,4,44,48
11045,11045,,0,18,8,26
11046,11046,,1,5,15,20
11047,11047,,4,0,19,19
11048,11048,,54,11,73,84
11073,11073,,54,83,58,141
9702179,9702179,,37,5,23,28
11049,11049,,7,6,11,17
11050,11050,,16,2,10,12
11051,11051,,0,6,16,22
11052,11052,,62,3,1,4
4164,4164,,62,2,0,2
11053,11053,,3,4,13,17
11054,11054,,3,4,12,16
11055,11055,,8,0,1,1
9403189,9403189,,8,2,2,4
9303034,9303034,,8,3,2,5
11056,11056,,8,3,19,22
111228,111228,,8,21,74,95
11102,11102,,0,6,40,46
12128,12128,,8,20,20,40
103064,103064,,8,13,45,58
103197,103197,,8,16,13,29
105248,105248,,8,11,29,40
106124,106124,,8,10,7,17
106146,106146,,8,8,37,45
106259,106259,,8,7,27,34
107150,107150,,8,8,6,14
107160,107160,,8,11,55,66
107242,107242,,8,12,71,83
9708160,9708160,,8,6,24,30
9909129,9909129,,8,3,43,46
11057,11057,,3,5,40,45
11058,11058,,0,2,4,6
11059,11059,,54,2,32,34
11060,11060,,37,29,49,78
11077,11077,,34,66,31,97
12035,12035,,34,24,39,63
11063,11063,,25,1,1,2
9810207,9810207,,25,2,0,2
11064,11064,,25,0,2,2
11061,11061,,25,2,0,2
11065,11065,,2,0,5,5
9707225,9707225,,2,2,11,13
9803152,9803152,,2,2,11,13
11066,11066,,34,8,17,25
11067,11067,,16,1,11,12
11068,11068,,11,0,5,5
11070,11070,,14,6,9,15
9907111,9907111,,14,7,6,13
9609105,9609105,,14,4,5,9
11071,11071,,4,0,11,11
11072,11072,,16,6,26,32
11075,11075,,54,7,34,41
9904218,9904218,,54,2,17,19
11076,11076,,7,2,5,7
11166,11166,,34,14,55,69
11193,11193,,34,47,46,93
11279,11279,,34,15,18,33
12169,12169,,4,2,37,39
12193,12193,,34,8,33,41
11078,11078,,1,1,1,2
11079,11079,,3,37,27,64
12054,12054,,3,39,30,69
11080,11080,,3,3,15,18
11081,11081,,37,1,14,15
11082,11082,,25,0,1,1
11083,11083,,11,2,15,17
9511175,9511175,,4,8,0,8
9709175,9709175,,11,3,2,5
9904119,9904119,,4,2,12,14
9702156,9702156,,4,2,8,10
9902162,9902162,,37,2,21,23
11084,11084,,3,4,1,5
11085,11085,,2,2,12,14
11086,11086,,34,16,40,56
11087,11087,,19,0,1,1
9607232,9607232,,19,3,2,5
9410079,9410079,,19,3,1,4
9411230,9411230,,19,2,1,3
11088,11088,,3,37,41,78
11089,11089,,37,100,18,118
11090,11090,,3,3,17,20
11091,11091,,37,7,32,39
11092,11092,,34,0,18,18
11093,11093,,37,2,49,51
9510166,9510166,,37,1,9,10
9510242,9510242,,62,4,6,10
9604009,9604009,,7,2,4,6
9604158,9604158,,7,1,13,14
11094,11094,,4,11,63,74
9911099,9911099,,37,8,12,20
11096,11096,,7,5,4,9
9611086,9611086,,7,7,2,9
9807081,9807081,,7,3,1,4
9904052,9904052,,7,2,2,4
9803253,9803253,,8,2,3,5
9310172,9310172,,7,4,0,4
11097,11097,,34,6,17,23
11098,11098,,0,2,16,18
11099,11099,,3,40,19,59
11100,11100,,2,1,3,4
9702120,9702120,,2,5,1,6
9702121,9702121,,2,3,0,3
9702073,9702073,,2,1,0,1
11101,11101,,37,2,44,46
11103,11103,,6,3,10,13
11104,11104,,62,1,4,5
11105,11105,,4,3,8,11
11106,11106,,16,2,20,22
11107,11107,,37,7,47,54
9312188,9312188,,37,5,15,20
9403183,9403183,,8,9,9,18
9409069,9409069,,8,6,17,23
9512183,9512183,,62,1,27,28
9211108,9211108,,8,6,0,6
9302086,9302086,,8,16,5,21
9210143,9210143,,8,1,0,1
9311137,9311137,,8,8,2,10
9405049,9405049,,8,4,16,20
9312032,9312032,,62,2,5,7
11108,11108,,4,9,14,23
11109,11109,,65,10,20,30
9301118,9301118,,65,2,2,4
11110,11110,,54,5,36,41
11111,11111,,54,13,51,64
11112,11112,,1,5,20,25
11113,11113,,0,14,18,32
9608077,9608077,,37,11,3,14
9701191,9701191,,37,7,30,37
9709161,9709161,,37,3,13,16
11114,11114,,37,19,18,37
9707186,9707186,,37,9,18,27
11117,11117,,4,24,13,37
11118,11118,,0,24,5,29
11119,11119,,3,3,38,41
11120,11120,,6,2,27,29
9912247,9912247,,6,2,8,10
11121,11121,,34,8,13,21
11122,11122,,2,3,28,31
11123,11123,,3,4,7,11
9803199,9803199,,3,1,10,11
9812065,9812065,,3,2,9,11
9510215,9510215,,3,6,4,10
9801143,9801143,,3,2,4,6
9510039,9510039,,3,2,5,7
11124,11124,,11,0,3,3
11125,11125,,3,72,41,113
11126,11126,,7,3,1,4
11127,11127,,0,34,35,69
9204025,9204025,,2,2,0,2
11128,11128,,0,2,8,10
11130,11130,,37,22,24,46
9407183,9407183,,37,3,1,4
11131,11131,,3,39,55,94
11132,11132,,19,6,14,20
9406049,9406049,,19,10,1,11
9408061,9408061,,19,8,4,12
9411124,9411124,,19,5,5,10
9506093,9506093,,19,5,6,11
9611046,9611046,,19,2,8,10
9710221,9710221,,19,2,8,10
9904043,9904043,,19,1,15,16
9406086,9406086,,19,5,2,7
9611185,9611185,,7,3,2,5
9612028,9612028,,19,3,5,8
11133,11133,,11,0,2,2
11134,11134,,16,2,8,10
9310146,9310146,,25,3,0,3
9404135,9404135,,25,5,11,16
9405032,9405032,,25,1,5,6
9406201,9406201,,25,2,7,9
9510124,9510124,,25,2,4,6
9511097,9511097,,25,1,0,1
11135,11135,,62,0,4,4
9311052,9311052,,62,3,2,5
9703045,9703045,,62,4,8,12
9609030,9609030,,62,3,4,7
11136,11136,,25,4,10,14
9302067,9302067,,25,1,0,1
9606134,9606134,,25,12,5,17
11138,11138,,0,41,14,55
11141,11141,,0,41,13,54
11139,11139,,3,14,14,28
11140,11140,,3,22,31,53
11143,11143,,0,1,13,14
11144,11144,,0,2,18,20
11145,11145,,37,2,21,23
9607170,9607170,,37,6,8,14
11146,11146,,34,24,34,58
11147,11147,,3,9,29,38
11148,11148,,37,10,58,68
11149,11149,,2,10,19,29
11151,11151,,25,0,17,17
11152,11152,,0,40,8,48
11154,11154,,6,0,19,19
9612129,9612129,,6,3,0,3
9709150,9709150,,6,1,0,1
9410035,9410035,,6,8,2,10
9206038,9206038,,34,10,0,10
9508070,9508070,,6,2,1,3
9604069,9604069,,8,3,1,4
11155,11155,,3,5,2,7
11160,11160,,0,24,8,32
11157,11157,,25,1,1,2
11158,11158,,3,1,4,5
11159,11159,,0,7,10,17
9409067,9409067,,2,1,0,1
11161,11161,,9,2,6,8
11162,11162,,62,0,6,6
9406161,9406161,,6,3,0,3
11163,11163,,6,0,10,10
12187,12187,,6,1,4,5
9804088,9804088,,6,2,2,4
11164,11164,,34,0,10,10
11165,11165,,34,0,8,8
11167,11167,,0,12,24,36
11168,11168,,16,1,6,7
9702126,9702126,,37,3,8,11
9705002,9705002,,16,1,4,5
9706038,9706038,,16,2,5,7
9503190,9503190,,16,7,7,14
9504094,9504094,,16,5,11,16
9410015,9410015,,37,4,3,7
9508009,9508009,,37,4,3,7
9511220,9511220,,37,3,9,12
11169,11169,,37,1,7,8
11170,11170,,3,7,36,43
11171,11171,,2,7,11,18
11173,11173,,2,6,13,19
11174,11174,,6,4,5,9
11175,11175,,2,14,28,42
11176,11176,,25,2,13,15
11177,11177,,0,24,11,35
11178,11178,,2,0,10,10
11179,11179,,34,10,15,25
11180,11180,,37,0,1,1
11181,11181,,54,0,5,5
11183,11183,,6,6,1,7
11184,11184,,31,1,8,9
9206067,9206067,,1,1,2,3
9312167,9312167,,31,3,2,5
11185,11185,,37,1,24,25
11186,11186,,34,2,17,19
11187,11187,,62,6,24,30
11188,11188,,2,2,10,12
11189,11189,,62,4,4,8
9909046,9909046,,62,6,4,10
9405003,9405003,,62,5,0,5
9310063,9310063,,62,2,0,2
11190,11190,,34,39,25,64
12195,12195,,34,36,14,50
11288,11288,,34,28,26,54
11191,11191,,1,8,35,43
11192,11192,,37,8,31,39
11256,11256,,37,113,9,122
11194,11194,,16,8,8,16
11195,11195,,0,0,5,5
11197,11197,,37,19,181,200
9810091,9810091,,37,4,10,14
9312132,9312132,,37,2,0,2
9403135,9403135,,65,2,1,3
11198,11198,,25,3,3,6
11199,11199,,62,0,1,1
11200,11200,,16,1,7,8
9711139,9711139,,16,1,3,4
11201,11201,,23,0,1,1
9909165,9909165,,23,1,0,1
11202,11202,,2,1,21,22
11203,11203,,34,0,3,3
11204,11204,,34,8,27,35
11205,11205,,3,11,17,28
11206,11206,,3,4,13,17
12200,12200,,3,11,22,33
12077,12077,,3,10,11,21
11207,11207,,34,3,24,27
11208,11208,,8,4,17,21
11209,11209,,7,5,2,7
9402121,9402121,,7,3,0,3
11210,11210,,19,0,3,3
11211,11211,,2,3,14,17
11212,11212,,2,0,1,1
11213,11213,,24,0,1,1
9909036,9909036,,24,1,0,1
11214,11214,,25,3,8,11
9307003,9307003,,25,3,0,3
9309131,9309131,,25,1,0,1
11215,11215,,2,13,8,21
11216,11216,,7,4,5,9
9604039,9604039,,25,1,4,5
9404154,9404154,,25,1,0,1
9405152,9405152,,25,6,0,6
11217,11217,,34,22,33,55
9612031,9612031,,8,1,1,2
11218,11218,,3,24,22,46
11219,11219,,34,2,18,20
11220,11220,,4,12,16,28
11221,11221,,3,1,12,13
11222,11222,,37,0,26,26
9404126,9404126,,37,1,11,12
11223,11223,,4,5,22,27
11224,11224,,16,1,9,10
9901029,9901029,,16,3,3,6
9910114,9910114,,16,2,3,5
9307051,9307051,,16,6,0,6
9505069,9505069,,16,3,4,7
9601045,9601045,,16,2,2,4
9609154,9609154,,16,3,2,5
9610050,9610050,,16,2,6,8
9701013,9701013,,16,4,11,15
11226,11226,,4,41,52,93
11228,11228,,3,0,5,5
11229,11229,,34,4,1,5
11231,11231,,2,2,1,3
11232,11232,,16,1,7,8
11233,11233,,3,12,40,52
11234,11234,,34,4,5,9
11235,11235,,9,1,13,14
9808154,9808154,,9,3,2,5
9812040,9812040,,6,3,1,4
9505019,9505019,,11,2,0,2
11236,11236,,2,12,24,36
11237,11237,,62,3,1,4
11238,11238,,4,23,14,37
11239,11239,,2,9,16,25
11240,11240,,25,8,54,62
9301029,9301029,,25,10,1,11
9302040,9302040,,25,10,1,11
9303176,9303176,,25,1,8,9
9304043,9304043,,25,6,1,7
9307018,9307018,,7,2,0,2
9307160,9307160,,25,9,3,12
9308155,9308155,,25,6,5,11
9404034,9404034,,25,4,5,9
9404045,9404045,,25,5,4,9
9405132,9405132,,25,1,11,12
9710051,9710051,,25,7,18,25
9803059,9803059,,25,4,3,7
9807007,9807007,,25,7,12,19
9809082,9809082,,25,2,3,5
9906230,9906230,,25,6,16,22
9302041,9302041,,25,4,5,9
9304041,9304041,,25,7,4,11
9511087,9511087,,37,6,9,15
9510202,9510202,,0,12,7,19
9704164,9704164,,25,3,8,11
9509174,9509174,,54,7,3,10
9708126,9708126,,25,6,6,12
9410003,9410003,,25,5,4,9
11241,11241,,3,28,39,67
11242,11242,,2,7,7,14
11243,11243,,62,3,12,15
11244,11244,,3,15,30,45
11245,11245,,0,4,36,40
11246,11246,,11,0,2,2
11247,11247,,2,11,25,36
11248,11248,,25,1,17,18
9306032,9306032,,25,1,1,2
9304084,9304084,,25,1,0,1
11249,11249,,11,2,11,13
11250,11250,,25,0,1,1
11251,11251,,54,12,43,55
9711051,9711051,,2,1,5,6
9803162,9803162,,2,3,36,39
9912213,9912213,,2,1,6,7
11252,11252,,3,5,17,22
9605209,9605209,,25,5,8,13
11253,11253,,37,1,57,58
9712218,9712218,,37,2,16,18
9812145,9812145,,37,2,4,6
9612161,9612161,,8,3,0,3
9712232,9712232,,37,3,9,12
9801039,9801039,,37,3,21,24
9801112,9801112,,37,1,4,5
9801179,9801179,,37,1,7,8
11255,11255,,34,10,15,25
11257,11257,,37,9,17,26
11258,11258,,0,12,12,24
11259,11259,,3,3,8,11
11260,11260,,37,2,6,8
9408116,9408116,,54,4,7,11
11261,11261,,3,4,20,24
11262,11262,,0,15,6,21
11263,11263,,6,1,3,4
9412019,9412019,,6,3,1,4
11264,11264,,2,12,19,31
11265,11265,,11,1,1,2
11266,11266,,34,2,3,5
9405093,9405093,,7,8,9,17
9406111,9406111,,7,3,7,10
11268,11268,,3,2,3,5
11269,11269,,54,34,32,66
11270,11270,,34,1,4,5
9701049,9701049,,34,1,0,1
11271,11271,,2,2,23,25
11272,11272,,2,2,8,10
9706036,9706036,,16,1,2,3
9910157,9910157,,2,2,16,18
9407123,9407123,,16,3,2,5
9906037,9906037,,16,2,5,7
11273,11273,,0,1,10,11
11275,11275,,11,1,2,3
11276,11276,,16,9,15,24
103186,103186,,16,11,8,19
105267,105267,,16,9,15,24
106082,106082,,16,6,28,34
9303042,9303042,,16,4,1,5
9307063,9307063,,37,8,4,12
9404174,9404174,,16,8,7,15
11278,11278,,0,10,2,12
11280,11280,,11,0,2,2
9706084,9706084,,11,2,1,3
9910024,9910024,,11,1,3,4
9810241,9810241,,11,2,1,3
9812146,9812146,,11,1,1,2
9812150,9812150,,11,1,0,1
11281,11281,,54,6,33,39
9911019,9911019,,54,2,18,20
11282,11282,,3,20,55,75
11283,11283,,3,10,83,93
11284,11284,,34,4,6,10
11285,11285,,4,0,24,24
11286,11286,,2,0,13,13
11287,11287,,34,2,5,7
11289,11289,,54,16,12,28
11290,11290,,0,14,17,31
11291,11291,,3,0,1,1
11292,11292,,34,1,30,31
9804167,9804167,,37,4,7,11
11293,11293,,19,0,3,3
9611001,9611001,,19,5,3,8
9611002,9611002,,19,5,1,6
11294,11294,,54,1,16,17
12001,12001,,25,0,1,1
12002,12002,,7,2,6,8
12003,12003,,6,4,4,8
12004,12004,,11,0,5,5
12005,12005,,11,0,4,4
12006,12006,,1,0,4,4
12007,12007,,4,11,22,33
12008,12008,,62,0,14,14
12009,12009,,3,30,36,66
12010,12010,,2,5,11,16
9406150,9406150,,2,4,3,7
12011,12011,,34,52,22,74
12012,12012,,16,0,10,10
9411008,9411008,,16,3,1,4
12013,12013,,0,9,13,22
12014,12014,,0,7,6,13
12015,12015,,0,1,5,6
9911069,9911069,,34,1,3,4
12016,12016,,2,6,6,12
12017,12017,,25,1,9,10
12018,12018,,3,4,9,13
12019,12019,,25,0,3,3
12020,12020,,2,0,3,3
12021,12021,,62,3,7,10
9911100,9911100,,62,6,11,17
9812251,9812251,,62,5,9,14
9911027,9911027,,62,1,6,7
12022,12022,,14,0,9,9
12023,12023,,7,18,21,39
9609193,9609193,,7,4,3,7
9511138,9511138,,7,12,1,13
9603103,9603103,,7,3,3,6
12024,12024,,3,14,68,82
12025,12025,,34,19,20,39
12026,12026,,1,3,21,24
12027,12027,,11,0,2,2
12028,12028,,16,5,8,13
12238,12238,,7,34,3,37
12216,12216,,8,7,6,13
12029,12029,,0,2,30,32
12030,12030,,37,1,29,30
12031,12031,,25,4,12,16
12032,12032,,2,7,11,18
9910020,9910020,,2,3,18,21
9702039,9702039,,2,3,13,16
9807012,9807012,,2,4,17,21
12033,12033,,0,12,34,46
12034,12034,,34,24,25,49
12042,12042,,0,10,58,68
12036,12036,,0,2,1,3
12037,12037,,4,22,19,41
12039,12039,,19,4,3,7
12040,12040,,16,0,1,1
12041,12041,,37,56,18,74
12043,12043,,19,4,9,13
12045,12045,,65,0,9,9
12046,12046,,4,12,5,17
12047,12047,,0,0,1,1
12048,12048,,25,7,6,13
12049,12049,,0,7,33,40
12050,12050,,37,5,32,37
12051,12051,,2,3,21,24
9712055,9712055,,2,1,11,12
12052,12052,,34,59,11,70
12053,12053,,25,3,28,31
9505104,9505104,,25,3,4,7
12055,12055,,2,2,1,3
12056,12056,,3,6,8,14
9405076,9405076,,3,4,1,5
9310027,9310027,,7,2,0,2
12057,12057,,9,5,7,12
12058,12058,,7,1,21,22
9904167,9904167,,7,2,7,9
9602107,9602107,,7,7,12,19
9701097,9701097,,7,1,11,12
12059,12059,,2,2,21,23
9307159,9307159,,14,2,2,4
12060,12060,,19,19,12,31
9608128,9608128,,25,1,3,4
9405147,9405147,,19,5,0,5
9612156,9612156,,19,2,2,4
9703130,9703130,,11,1,1,2
12061,12061,,2,5,24,29
101071,101071,,2,14,17,31
12062,12062,,25,2,77,79
2095,2095,,25,1,0,1
9312021,9312021,,25,3,5,8
9406037,9406037,,25,1,0,1
9407139,9407139,,25,2,0,2
9504032,9504032,,54,2,8,10
9610027,9610027,,25,2,0,2
9705230,9705230,,11,3,3,6
9706098,9706098,,7,1,4,5
9807129,9807129,,6,2,2,4
9808165,9808165,,11,1,1,2
9812123,9812123,,25,1,0,1
9902006,9902006,,25,1,0,1
9904079,9904079,,25,2,0,2
9904080,9904080,,25,1,1,2
9904178,9904178,,37,2,1,3
9905113,9905113,,0,1,4,5
9409199,9409199,,54,4,1,5
9506188,9506188,,9,5,2,7
9808092,9808092,,37,2,0,2
9708165,9708165,,11,1,6,7
9306120,9306120,,37,8,0,8
9904023,9904023,,0,2,4,6
12064,12064,,0,1,5,6
12065,12065,,3,12,25,37
12066,12066,,7,0,3,3
12067,12067,,2,4,19,23
9712231,9712231,,2,3,15,18
12068,12068,,37,4,15,19
12069,12069,,11,8,7,15
9706062,9706062,,11,9,9,18
9412181,9412181,,11,4,2,6
9504014,9504014,,25,2,7,9
9607093,9607093,,62,1,2,3
12071,12071,,54,15,16,31
12072,12072,,4,73,20,93
12073,12073,,0,10,21,31
12074,12074,,0,8,9,17
12076,12076,,34,6,37,43
9503175,9503175,,1,1,39,40
9804112,9804112,,37,1,8,9
9608107,9608107,,62,3,13,16
9704119,9704119,,62,1,8,9
12078,12078,,37,1,20,21
12079,12079,,37,6,38,44
12080,12080,,4,17,45,62
9609173,9609173,,2,4,6,10
12081,12081,,4,38,52,90
12082,12082,,0,2,15,17
12083,12083,,11,1,6,7
9812228,9812228,,25,1,2,3
12084,12084,,11,2,7,9
9503068,9503068,,11,3,1,4
9601062,9601062,,11,3,3,6
9604150,9604150,,11,2,7,9
9607176,9607176,,11,2,5,7
9403172,9403172,,11,4,0,4
9404001,9404001,,11,4,1,5
9410238,9410238,,11,3,3,6
9612225,9612225,,19,3,4,7
12085,12085,,6,8,10,18
12086,12086,,6,0,1,1
12087,12087,,3,4,5,9
12088,12088,,54,0,2,2
12089,12089,,4,8,5,13
12090,12090,,6,4,7,11
9907092,9907092,,6,5,3,8
9908188,9908188,,6,2,18,20
9411041,9411041,,34,3,3,6
9608143,9608143,,6,3,2,5
9807088,9807088,,6,2,3,5
12091,12091,,0,5,30,35
12092,12092,,3,12,25,37
9906134,9906134,,2,8,14,22
12093,12093,,3,15,34,49
12094,12094,,2,0,7,7
12095,12095,,16,1,8,9
12096,12096,,54,0,19,19
12097,12097,,34,1,19,20
12098,12098,,2,1,10,11
9707056,9707056,,2,3,8,11
9908084,9908084,,54,2,6,8
12099,12099,,65,0,5,5
12100,12100,,0,6,21,27
9806017,9806017,,2,3,18,21
9809029,9809029,,0,5,0,5
12101,12101,,2,2,7,9
12102,12102,,0,4,38,42
12103,12103,,11,5,2,7
9505164,9505164,,54,3,5,8
12105,12105,,0,2,26,28
12106,12106,,0,9,8,17
12107,12107,,11,0,4,4
9706088,9706088,,11,1,4,5
12108,12108,,2,2,9,11
103146,103146,,2,9,14,23
12109,12109,,26,0,1,1
9907009,9907009,,26,2,0,2
12110,12110,,54,12,17,29
12111,12111,,11,2,26,28
9902049,9902049,,34,5,4,9
12112,12112,,3,10,6,16
12113,12113,,6,0,5,5
12114,12114,,8,4,6,10
12115,12115,,6,0,22,22
9709092,9709092,,16,4,1,5
9812096,9812096,,25,4,11,15
9912234,9912234,,6,2,17,19
9402095,9402095,,25,1,9,10
12116,12116,,0,6,16,22
12117,12117,,1,3,46,49
12118,12118,,54,8,54,62
9812215,9812215,,54,1,0,1
12119,12119,,25,0,1,1
12120,12120,,9,1,4,5
12121,12121,,2,2,20,22
9711024,9711024,,6,1,9,10
9308110,9308110,,6,2,0,2
9610123,9610123,,6,1,1,2
9709163,9709163,,6,1,5,6
12122,12122,,37,0,35,35
12124,12124,,54,1,16,17
12125,12125,,34,2,8,10
12126,12126,,16,0,1,1
12129,12129,,0,14,50,64
12130,12130,,9,0,5,5
12131,12131,,37,11,39,50
12132,12132,,0,3,7,10
12133,12133,,37,7,11,18
9906023,9906023,,37,1,77,78
9705166,9705166,,37,4,70,74
12134,12134,,34,7,6,13
9604151,9604151,,34,6,0,6
9907001,9907001,,34,18,2,20
12135,12135,,34,4,33,37
12136,12136,,37,29,12,41
12137,12137,,2,12,59,71
12138,12138,,11,2,4,6
9905129,9905129,,11,1,0,1
12139,12139,,34,2,16,18
12140,12140,,25,3,7,10
12141,12141,,3,21,48,69
12142,12142,,3,2,22,24
12143,12143,,0,59,36,95
12144,12144,,16,2,16,18
12145,12145,,3,50,70,120
6012,6012,,7,3,0,3
12146,12146,,9,4,12,16
12147,12147,,11,1,1,2
12148,12148,,0,46,19,65
12149,12149,,8,10,8,18
12150,12150,,4,8,15,23
12151,12151,,31,2,8,10
12152,12152,,54,8,18,26
12153,12153,,34,8,12,20
12154,12154,,3,5,15,20
12155,12155,,3,17,3,20
12156,12156,,54,66,31,97
12157,12157,,54,19,16,35
12158,12158,,54,18,44,62
12159,12159,,34,3,8,11
12160,12160,,0,1,6,7
12161,12161,,6,0,4,4
12162,12162,,37,1,6,7
9808054,9808054,,37,5,17,22
9810192,9810192,,37,5,10,15
9903092,9903092,,37,1,35,36
9406081,9406081,,37,11,0,11
9604021,9604021,,37,8,8,16
9709186,9709186,,37,3,15,18
9810020,9810020,,37,1,6,7
9503221,9503221,,37,3,0,3
12163,12163,,54,13,5,18
12164,12164,,65,42,51,93
12165,12165,,0,14,58,72
12166,12166,,25,2,4,6
12174,12174,,19,6,5,11
9508031,9508031,,8,3,4,7
12167,12167,,4,0,19,19
12170,12170,,3,12,23,35
12171,12171,,3,30,15,45
12172,12172,,2,19,6,25
12173,12173,,19,2,8,10
12176,12176,,11,2,8,10
12177,12177,,7,2,5,7
204108,204108,,7,3,13,16
9311110,9311110,,16,8,0,8
12178,12178,,0,18,23,41
12179,12179,,37,35,70,105
12180,12180,,2,5,27,32
12181,12181,,19,7,5,12
12182,12182,,0,5,18,23
12183,12183,,3,18,48,66
12184,12184,,3,7,9,16
12185,12185,,25,9,16,25
12186,12186,,2,1,2,3
12188,12188,,19,4,16,20
12189,12189,,9,4,14,18
9912149,9912149,,9,2,3,5
12190,12190,,62,0,8,8
12191,12191,,0,1,6,7
12192,12192,,54,3,6,9
12194,12194,,2,14,51,65
9707071,9707071,,37,3,24,27
12196,12196,,34,7,18,25
12197,12197,,34,2,2,4
12198,12198,,4,89,48,137
12210,12210,,4,83,64,147
12199,12199,,2,5,25,30
12201,12201,,2,0,27,27
12202,12202,,0,6,15,21
12203,12203,,34,3,8,11
12204,12204,,54,0,1,1
12206,12206,,2,0,1,1
9506129,9506129,,2,3,0,3
12208,12208,,11,1,3,4
9910167,9910167,,11,3,0,3
12209,12209,,7,1,1,2
12211,12211,,4,2,27,29
12212,12212,,6,4,4,8
12213,12213,,54,56,47,103
12214,12214,,34,2,24,26
12215,12215,,11,8,4,12
9709221,9709221,,11,3,2,5
12217,12217,,3,4,27,31
12218,12218,,3,33,43,76
12219,12219,,25,4,28,32
9807101,9807101,,25,5,13,18
9309062,9309062,,25,2,0,2
9803257,9803257,,2,3,14,17
9807003,9807003,,25,3,6,9
12220,12220,,2,2,14,16
9711172,9711172,,14,2,6,8
12221,12221,,0,6,26,32
12222,12222,,4,18,23,41
12223,12223,,62,5,8,13
12224,12224,,65,1,7,8
9212067,9212067,,62,1,2,3
9409027,9409027,,7,1,2,3
9203035,9203035,,62,9,0,9
12225,12225,,3,7,14,21
12226,12226,,0,11,6,17
12227,12227,,0,2,6,8
105300,105300,,0,6,21,27
102042,102042,,34,75,37,112
102159,102159,,34,21,12,33
103078,103078,,34,39,33,72
103138,103138,,0,7,9,16
105048,105048,,0,28,67,95
105052,105052,,34,26,24,50
105117,105117,,34,34,43,77
105151,105151,,0,3,40,43
105160,105160,,34,12,62,74
105256,105256,,0,8,50,58
12229,12229,,19,0,5,5
9212091,9212091,,19,5,1,6
12230,12230,,8,4,13,17
9911194,9911194,,8,4,7,11
12231,12231,,0,2,15,17
12232,12232,,54,1,10,11
12233,12233,,54,4,7,11
12234,12234,,65,44,69,113
12236,12236,,2,12,13,25
12237,12237,,11,3,18,21
9909078,9909078,,11,1,0,1
12239,12239,,3,2,32,34
12240,12240,,34,7,5,12
12242,12242,,37,5,7,12
12244,12244,,7,2,1,3
12245,12245,,2,1,1,2
12246,12246,,0,1,10,11
12247,12247,,2,4,30,34
12248,12248,,0,33,17,50
12249,12249,,0,3,32,35
12250,12250,,37,14,18,32
12251,12251,,4,115,69,184
12252,12252,,25,2,10,12
9603166,9603166,,7,2,0,2
12253,12253,,7,2,1,3
12254,12254,,37,3,14,17
12255,12255,,0,1,17,18
12256,12256,,19,0,12,12
9309047,9309047,,19,4,0,4
9511224,9511224,,19,1,5,6
9907089,9907089,,19,2,4,6
9909052,9909052,,19,2,2,4
9605115,9605115,,6,1,3,4
9809112,9809112,,19,3,0,3
12257,12257,,8,1,2,3
12258,12258,,1,18,12,30
12259,12259,,3,16,15,31
12260,12260,,1,2,8,10
101138,101138,,25,6,4,10
9803158,9803158,,1,3,2,5
9811148,9811148,,1,2,1,3
12261,12261,,37,0,3,3
12262,12262,,3,6,18,24
12263,12263,,2,4,28,32
9706015,9706015,,2,1,0,1
12264,12264,,25,4,7,11
12265,12265,,0,0,41,41
12266,12266,,3,15,33,48
9503091,9503091,,3,2,3,5
9501035,9501035,,7,2,1,3
12267,12267,,2,0,52,52
9610022,9610022,,54,3,7,10
12268,12268,,3,3,13,16
9205093,9205093,,1,5,0,5
12269,12269,,6,4,1,5
9608138,9608138,,6,7,1,8
9705077,9705077,,6,5,3,8
12270,12270,,54,2,8,10
101001,101001,,4,11,32,43
101002,101002,,4,2,30,32
101003,101003,,0,11,44,55
101004,101004,,31,0,3,3
101005,101005,,16,3,7,10
101006,101006,,34,0,5,5
101007,101007,,34,17,18,35
101008,101008,,19,2,1,3
101010,101010,,4,5,16,21
101011,101011,,1,27,26,53
9611170,9611170,,16,4,16,20
9211079,9211079,,25,2,0,2
9309100,9309100,,16,5,5,10
9404096,9404096,,16,2,3,5
9501039,9501039,,25,3,6,9
9503172,9503172,,25,4,15,19
101013,101013,,34,20,37,57
101014,101014,,4,24,34,58
101015,101015,,3,1,3,4
101016,101016,,3,16,40,56
101017,101017,,7,1,14,15
101018,101018,,2,2,18,20
101019,101019,,0,5,9,14
101020,101020,,34,25,42,67
102105,102105,,34,24,16,40
102172,102172,,34,23,23,46
101043,101043,,34,21,38,59
101021,101021,,37,1,10,11
101022,101022,,7,2,16,18
9805079,9805079,,7,3,3,6
9207080,9207080,,7,4,0,4
9306100,9306100,,7,3,1,4
101023,101023,,54,0,11,11
101025,101025,,8,2,10,12
101026,101026,,34,6,46,52
101027,101027,,0,14,24,38
101028,101028,,34,1,19,20
101030,101030,,0,1,7,8
101031,101031,,2,3,26,29
101032,101032,,3,4,9,13
9504051,9504051,,3,1,0,1
9608130,9608130,,2,3,3,6
9409052,9409052,,3,1,0,1
101033,101033,,4,1,18,19
9712031,9712031,,65,2,1,3
101034,101034,,62,5,9,14
101035,101035,,16,4,19,23
101036,101036,,8,12,73,85
2079,2079,,8,1,0,1
9211076,9211076,,8,9,0,9
9306148,9306148,,8,6,0,6
9404078,9404078,,11,4,0,4
9409128,9409128,,16,2,6,8
9809053,9809053,,8,6,23,29
9812213,9812213,,8,1,21,22
9906068,9906068,,8,1,15,16
9303021,9303021,,16,1,0,1
9409083,9409083,,8,1,0,1
9512068,9512068,,8,1,9,10
9707085,9707085,,19,1,2,3
101037,101037,,54,9,6,15
9809064,9809064,,6,3,9,12
101038,101038,,0,4,45,49
101040,101040,,3,0,35,35
101041,101041,,19,1,6,7
104204,104204,,19,1,16,17
9706042,9706042,,16,2,1,3
9808187,9808187,,37,2,28,30
101042,101042,,0,3,43,46
101044,101044,,2,2,9,11
101045,101045,,3,1,17,18
101046,101046,,3,2,3,5
101047,101047,,0,0,4,4
101048,101048,,6,0,5,5
101049,101049,,54,13,25,38
101050,101050,,34,0,8,8
101051,101051,,16,1,11,12
9701105,9701105,,16,3,7,10
101052,101052,,16,0,10,10
101053,101053,,7,3,6,9
9703024,9703024,,7,2,7,9
9605126,9605126,,8,5,8,13
101055,101055,,6,8,2,10
101056,101056,,34,2,14,16
101057,101057,,0,0,21,21
101058,101058,,3,4,16,20
101059,101059,,3,0,5,5
101060,101060,,0,10,20,30
101061,101061,,0,5,10,15
101064,101064,,34,2,26,28
101065,101065,,6,6,13,19
101066,101066,,34,1,11,12
101067,101067,,3,4,4,8
9606101,9606101,,3,6,6,12
9811038,9811038,,3,6,8,14
9903075,9903075,,3,5,2,7
9407098,9407098,,16,1,6,7
9510077,9510077,,3,2,3,5
9206058,9206058,,37,1,1,2
101069,101069,,3,3,25,28
101070,101070,,7,6,18,24
101072,101072,,16,0,9,9
9311066,9311066,,16,2,1,3
9411236,9411236,,7,1,1,2
9412204,9412204,,16,5,1,6
101073,101073,,34,44,27,71
101076,101076,,34,49,15,64
101083,101083,,34,40,20,60
9910185,9910185,,34,7,20,27
9911157,9911157,,34,5,16,21
101074,101074,,54,8,44,52
101075,101075,,2,2,17,19
9502054,9502054,,2,4,11,15
9610121,9610121,,2,4,5,9
9711086,9711086,,2,1,19,20
9806086,9806086,,2,1,25,26
9406126,9406126,,2,2,4,6
101077,101077,,4,0,17,17
101078,101078,,11,10,9,19
101079,101079,,6,3,4,7
101080,101080,,54,1,25,26
101082,101082,,3,12,21,33
101084,101084,,2,4,12,16
101085,101085,,54,2,22,24
9612060,9612060,,65,1,5,6
101087,101087,,4,9,40,49
101088,101088,,34,6,14,20
101090,101090,,7,2,17,19
101091,101091,,0,18,16,34
101092,101092,,3,4,8,12
101094,101094,,0,0,8,8
101095,101095,,3,4,19,23
101096,101096,,34,20,26,46
101097,101097,,19,12,10,22
9912251,9912251,,19,1,3,4
101098,101098,,9,1,3,4
9905086,9905086,,9,4,3,7
9404085,9404085,,9,5,0,5
9612193,9612193,,9,3,1,4
101099,101099,,34,1,60,61
101100,101100,,34,4,18,22
101101,101101,,11,2,21,23
101102,101102,,3,37,40,77
101145,101145,,65,22,31,53
101103,101103,,16,1,9,10
9406070,9406070,,16,5,0,5
9804047,9804047,,16,4,5,9
9807025,9807025,,16,5,2,7
9907004,9907004,,16,1,3,4
101104,101104,,54,2,21,23
101105,101105,,0,16,22,38
9801054,9801054,,25,3,8,11
101106,101106,,62,1,25,26
9909153,9909153,,62,6,5,11
101107,101107,,2,0,7,7
9507097,9507097,,6,3,0,3
9709011,9709011,,2,1,0,1
101108,101108,,11,6,7,13
101109,101109,,3,15,30,45
101140,101140,,62,1,2,3
101110,101110,,11,0,27,27
101111,101111,,3,2,8,10
9706189,9706189,,3,3,3,6
9607073,9607073,,7,2,1,3
101112,101112,,8,1,7,8
101113,101113,,2,14,22,36
101114,101114,,37,9,57,66
101115,101115,,4,6,17,23
101116,101116,,37,8,5,13
9405025,9405025,,8,2,5,7
9201030,9201030,,8,1,0,1
9209030,9209030,,8,5,0,5
9307031,9307031,,8,6,6,12
9506159,9506159,,8,6,46,52
101117,101117,,34,5,4,9
101118,101118,,34,6,33,39
9311025,9311025,,34,1,0,1
101119,101119,,34,13,42,55
101120,101120,,16,8,15,23
101121,101121,,27,0,1,1
9911059,9911059,,27,4,0,4
101122,101122,,54,1,43,44
101123,101123,,2,5,23,28
9810118,9810118,,2,1,0,1
101124,101124,,7,0,2,2
101125,101125,,4,6,24,30
101126,101126,,2,60,274,334
9711109,9711109,,2,2,19,21
9902043,9902043,,2,1,15,16
9709037,9709037,,2,1,17,18
9705065,9705065,,2,2,14,16
9709006,9709006,,2,1,22,23
9710242,9710242,,2,2,14,16
101127,101127,,37,10,13,23
101128,101128,,25,0,3,3
101129,101129,,54,3,7,10
101130,101130,,3,2,7,9
101131,101131,,25,4,2,6
101132,101132,,2,3,17,20
101133,101133,,34,9,4,13
101134,101134,,34,8,9,17
101135,101135,,37,14,44,58
101136,101136,,34,3,13,16
101137,101137,,2,0,1,1
101139,101139,,37,0,12,12
101141,101141,,16,0,5,5
101143,101143,,37,7,35,42
101144,101144,,34,0,22,22
101146,101146,,0,0,3,3
9407011,9407011,,0,3,0,3
101147,101147,,37,0,25,25
101148,101148,,9,2,1,3
101149,101149,,25,2,3,5
101150,101150,,37,1,10,11
9908177,9908177,,37,1,0,1
101151,101151,,65,17,16,33
9209029,9209029,,8,7,0,7
101152,101152,,1,17,14,31
101153,101153,,6,4,3,7
9701005,9701005,,62,8,1,9
101154,101154,,0,5,18,23
105111,105111,,0,33,16,49
104010,104010,,3,2,8,10
104071,104071,,0,31,14,45
101155,101155,,25,5,8,13
101156,101156,,6,0,2,2
9608193,9608193,,6,3,0,3
101157,101157,,11,0,16,16
101158,101158,,34,1,8,9
9504162,9504162,,25,6,8,14
9610129,9610129,,25,2,11,13
101159,101159,,3,10,22,32
102101,102101,,3,16,26,42
107022,107022,,3,13,28,41
109222,109222,,3,14,20,34
102022,102022,,3,11,62,73
102070,102070,,3,15,8,23
104217,104217,,3,30,24,54
103069,103069,,3,30,40,70
103131,103131,,3,6,10,16
104190,104190,,3,11,20,31
106048,106048,,3,220,175,395
101160,101160,,0,4,8,12
10011,10011,,0,1,0,1
101161,101161,,54,17,29,46
9608074,9608074,,7,1,2,3
9710072,9710072,,2,2,7,9
9709048,9709048,,2,2,5,7
101162,101162,,4,34,33,67
101163,101163,,7,5,8,13
101165,101165,,6,3,3,6
101166,101166,,6,2,5,7
9701024,9701024,,6,1,3,4
9501080,9501080,,19,5,4,9
101167,101167,,6,1,5,6
101169,101169,,34,1,18,19
9907116,9907116,,34,5,38,43
101170,101170,,65,8,14,22
101171,101171,,11,7,3,10
101173,101173,,34,0,2,2
101174,101174,,62,0,26,26
9212007,9212007,,62,22,0,22
101175,101175,,11,0,2,2
9407166,9407166,,16,2,3,5
101176,101176,,34,18,4,22
101177,101177,,3,11,29,40
101178,101178,,46,8,1,9
12235,12235,,46,5,0,5
101179,101179,,2,1,14,15
101180,101180,,62,3,8,11
101181,101181,,34,1,9,10
101182,101182,,16,1,18,19
101183,101183,,7,1,2,3
9612125,9612125,,7,3,2,5
101184,101184,,3,0,7,7
101185,101185,,0,5,11,16
101186,101186,,54,2,34,36
101187,101187,,65,12,17,29
5104,5104,,65,2,0,2
101188,101188,,7,4,11,15
101189,101189,,3,8,6,14
105087,105087,,3,12,34,46
106269,106269,,65,4,28,32
101190,101190,,7,2,8,10
101191,101191,,11,1,12,13
9705096,9705096,,11,1,2,3
101192,101192,,2,22,14,36
101194,101194,,34,16,19,35
101195,101195,,2,13,15,28
101196,101196,,3,4,23,27
9804022,9804022,,6,3,4,7
9902014,9902014,,6,4,4,8
101197,101197,,9,1,1,2
9901068,9901068,,9,3,1,4
101198,101198,,0,16,19,35
9309046,9309046,,25,1,3,4
101199,101199,,3,25,53,78
101200,101200,,4,18,20,38
101201,101201,,34,13,11,24
9704132,9704132,,34,2,0,2
101202,101202,,34,9,11,20
101203,101203,,0,4,8,12
101204,101204,,34,0,3,3
101205,101205,,37,0,20,20
101206,101206,,37,27,5,32
101207,101207,,4,15,10,25
101208,101208,,54,0,12,12
101209,101209,,3,16,21,37
101210,101210,,54,3,32,35
101211,101211,,65,14,68,82
101212,101212,,34,4,46,50
101213,101213,,4,2,13,15
101214,101214,,0,4,15,19
101215,101215,,6,0,19,19
101216,101216,,3,3,19,22
101217,101217,,3,1,9,10
101218,101218,,37,9,10,19
101219,101219,,3,39,50,89
101220,101220,,65,1,27,28
9610081,9610081,,65,6,7,13
101221,101221,,2,5,5,10
101222,101222,,3,0,6,6
101224,101224,,37,1,7,8
9401049,9401049,,37,2,1,3
9502161,9502161,,65,4,1,5
101225,101225,,34,8,12,20
9702188,9702188,,37,3,12,15
9311097,9311097,,25,7,1,8
101226,101226,,3,5,17,22
101227,101227,,62,2,2,4
9412130,9412130,,62,4,0,4
101228,101228,,0,8,12,20
101229,101229,,4,6,8,14
101230,101230,,11,1,3,4
101231,101231,,62,2,6,8
9508084,9508084,,62,3,13,16
101232,101232,,34,1,39,40
101233,101233,,54,22,3,25
101234,101234,,0,26,13,39
101235,101235,,34,6,12,18
101236,101236,,3,2,33,35
102001,102001,,34,7,17,24
102002,102002,,2,1,10,11
102005,102005,,37,3,16,19
9907169,9907169,,34,3,17,20
9910125,9910125,,37,3,18,21
9804007,9804007,,37,2,16,18
102007,102007,,3,28,38,66
102008,102008,,7,3,7,10
9506175,9506175,,7,3,1,4
9512050,9512050,,7,2,2,4
9707218,9707218,,7,2,2,4
102009,102009,,2,21,16,37
102010,102010,,62,7,20,27
9412169,9412169,,62,5,7,12
9806053,9806053,,62,2,1,3
9806107,9806107,,62,2,4,6
9304144,9304144,,62,2,0,2
102011,102011,,11,2,14,16
102012,102012,,34,3,1,4
102013,102013,,6,6,6,12
102014,102014,,7,6,5,11
102015,102015,,0,4,8,12
102016,102016,,3,16,28,44
102017,102017,,4,2,12,14
102018,102018,,37,10,38,48
102020,102020,,16,0,16,16
102021,102021,,19,11,19,30
102108,102108,,19,3,23,26
11274,11274,,19,1,0,1
102096,102096,,19,4,3,7
9210140,9210140,,34,2,0,2
9605162,9605162,,34,3,2,5
102023,102023,,0,19,20,39
102024,102024,,62,2,18,20
9904194,9904194,,62,3,6,9
9910128,9910128,,62,1,9,10
102026,102026,,11,13,14,27
102027,102027,,11,1,5,6
102028,102028,,11,6,8,14
102029,102029,,8,0,10,10
9407036,9407036,,8,3,0,3
9809013,9809013,,11,1,2,3
102030,102030,,7,1,9,10
102031,102031,,54,1,19,20
102032,102032,,0,5,34,39
102033,102033,,0,2,15,17
102034,102034,,0,1,2,3
102035,102035,,0,23,31,54
102036,102036,,37,1,16,17
102037,102037,,11,0,5,5
102038,102038,,37,1,17,18
102039,102039,,7,5,12,17
9812157,9812157,,7,5,5,10
9405104,9405104,,7,5,1,6
9409178,9409178,,7,1,0,1
9410163,9410163,,7,2,1,3
9505060,9505060,,7,1,3,4
9806006,9806006,,7,4,3,7
9806192,9806192,,7,2,1,3
102040,102040,,25,2,15,17
9809050,9809050,,25,3,10,13
9809098,9809098,,25,2,11,13
9310141,9310141,,25,2,2,4
9803157,9803157,,25,7,0,7
102041,102041,,37,9,40,49
102043,102043,,34,11,14,25
102044,102044,,3,29,10,39
102045,102045,,3,20,23,43
102048,102048,,3,1,2,3
102049,102049,,1,2,3,5
9906065,9906065,,7,2,6,8
9506008,9506008,,7,5,4,9
9508011,9508011,,7,5,3,8
9806057,9806057,,7,1,18,19
102050,102050,,3,6,2,8
102051,102051,,34,14,7,21
102052,102052,,1,0,5,5
9505129,9505129,,1,4,21,25
9503222,9503222,,1,17,12,29
102053,102053,,2,0,5,5
102054,102054,,11,3,4,7
102055,102055,,3,0,2,2
9801088,9801088,,3,5,4,9
9911162,9911162,,3,2,1,3
102056,102056,,3,13,28,41
102057,102057,,16,1,10,11
102059,102059,,11,0,2,2
102060,102060,,2,9,16,25
102061,102061,,25,11,2,13
102062,102062,,0,0,14,14
102063,102063,,4,3,55,58
102064,102064,,34,2,28,30
102065,102065,,31,0,11,11
102066,102066,,3,4,11,15
102067,102067,,7,2,3,5
9912205,9912205,,8,10,12,22
102069,102069,,37,0,9,9
9401117,9401117,,37,3,0,3
9503010,9503010,,19,3,0,3
9709207,9709207,,37,3,8,11
9406078,9406078,,37,7,1,8
102071,102071,,4,15,39,54
102072,102072,,0,0,1,1
9508102,9508102,,0,4,1,5
9802146,9802146,,19,2,1,3
102073,102073,,0,7,1,8
9811012,9811012,,0,6,2,8
9409018,9409018,,0,2,0,2
9506049,9506049,,0,1,0,1
102074,102074,,65,3,3,6
102075,102075,,11,1,3,4
102076,102076,,3,87,84,171
102077,102077,,34,59,22,81
9505170,9505170,,2,8,11,19
102078,102078,,1,0,11,11
9503042,9503042,,8,7,16,23
9708100,9708100,,8,1,2,3
9810059,9810059,,8,3,16,19
9301040,9301040,,8,8,0,8
9403012,9403012,,8,6,7,13
9406005,9406005,,8,14,1,15
9410005,9410005,,8,8,15,23
9411168,9411168,,8,11,5,16
9501084,9501084,,8,1,4,5
102079,102079,,62,9,12,21
102080,102080,,2,24,52,76
9209063,9209063,,19,4,0,4
102081,102081,,11,1,5,6
9902076,9902076,,11,1,1,2
102082,102082,,0,2,13,15
102083,102083,,7,3,8,11
102084,102084,,2,1,16,17
102085,102085,,4,74,104,178
102086,102086,,3,1,7,8
6082,6082,,3,1,0,1
102087,102087,,11,3,9,12
102088,102088,,19,1,3,4
102089,102089,,65,2,18,20
102090,102090,,31,1,15,16
102091,102091,,25,3,12,15
102092,102092,,3,13,29,42
102181,102181,,3,38,10,48
102137,102137,,3,10,41,51
102093,102093,,0,14,5,19
102094,102094,,16,0,23,23
102095,102095,,4,10,22,32
102097,102097,,34,2,21,23
9905220,9905220,,34,5,8,13
9910158,9910158,,34,6,2,8
9910247,9910247,,34,5,3,8
9911062,9911062,,34,1,12,13
9611212,9611212,,34,1,1,2
9605114,9605114,,34,4,2,6
9610008,9610008,,34,5,4,9
9706170,9706170,,34,4,8,12
9810245,9810245,,34,3,9,12
102098,102098,,7,16,3,19
102099,102099,,54,7,28,35
9703025,9703025,,54,2,0,2
102100,102100,,62,1,13,14
103020,103020,,3,9,8,17
104097,104097,,3,25,16,41
102103,102103,,3,15,5,20
102104,102104,,2,7,11,18
9607090,9607090,,2,6,8,14
102107,102107,,34,1,3,4
102109,102109,,2,2,21,23
9705201,9705201,,37,1,6,7
9707007,9707007,,2,3,13,16
9711199,9711199,,2,2,9,11
9310135,9310135,,2,6,1,7
102110,102110,,2,12,39,51
102111,102111,,7,2,19,21
9701180,9701180,,7,1,2,3
9911171,9911171,,7,2,3,5
102112,102112,,4,94,36,130
102113,102113,,34,51,20,71
102114,102114,,2,12,78,90
102115,102115,,0,0,2,2
102116,102116,,6,1,25,26
102117,102117,,0,0,1,1
102120,102120,,11,3,23,26
102121,102121,,37,4,58,62
102122,102122,,37,11,26,37
102123,102123,,54,10,25,35
102124,102124,,7,1,6,7
102125,102125,,54,6,50,56
102126,102126,,0,1,14,15
102127,102127,,2,1,7,8
9305018,9305018,,2,1,0,1
102128,102128,,54,11,34,45
102129,102129,,3,23,35,58
102130,102130,,34,0,24,24
102131,102131,,0,0,3,3
9807217,9807217,,0,8,2,10
9902065,9902065,,0,4,1,5
9912285,9912285,,6,1,11,12
102132,102132,,4,0,26,26
102133,102133,,54,1,16,17
102134,102134,,2,2,5,7
102135,102135,,0,7,13,20
102136,102136,,34,0,4,4
9310099,9310099,,19,2,0,2
102138,102138,,34,39,25,64
102139,102139,,0,0,2,2
102140,102140,,25,3,37,40
9610061,9610061,,25,1,2,3
102141,102141,,3,0,18,18
102142,102142,,0,3,4,7
102143,102143,,25,0,1,1
102144,102144,,0,9,11,20
102145,102145,,54,17,36,53
102146,102146,,37,6,35,41
102147,102147,,0,10,23,33
102148,102148,,62,1,18,19
102149,102149,,0,8,7,15
9909158,9909158,,37,1,2,3
102150,102150,,37,0,16,16
102151,102151,,2,4,42,46
102152,102152,,11,0,6,6
102153,102153,,37,2,14,16
102154,102154,,0,2,30,32
102155,102155,,34,7,53,60
9708072,9708072,,34,2,3,5
102156,102156,,8,12,37,49
9411040,9411040,,16,2,1,3
9208016,9208016,,7,2,0,2
102158,102158,,3,5,26,31
102160,102160,,3,3,14,17
102161,102161,,0,6,10,16
102162,102162,,34,3,6,9
102163,102163,,62,2,15,17
9409076,9409076,,62,15,20,35
102164,102164,,3,1,31,32
102165,102165,,2,2,4,6
102166,102166,,34,16,3,19
102167,102167,,25,1,2,3
102168,102168,,2,22,23,45
102169,102169,,37,0,23,23
102173,102173,,4,9,54,63
102174,102174,,4,15,43,58
102175,102175,,6,0,9,9
9906001,9906001,,8,2,2,4
9907181,9907181,,7,1,1,2
9911108,9911108,,7,1,2,3
102176,102176,,37,7,19,26
102177,102177,,19,1,2,3
102178,102178,,65,5,11,16
102179,102179,,0,1,5,6
102180,102180,,62,2,11,13
9310084,9310084,,62,2,0,2
9212050,9212050,,62,17,0,17
102183,102183,,37,15,22,37
102184,102184,,34,23,18,41
102185,102185,,37,32,28,60
9910003,9910003,,37,5,8,13
102186,102186,,8,2,11,13
102187,102187,,4,1,1,2
102188,102188,,3,25,24,49
102189,102189,,11,1,2,3
102190,102190,,37,5,11,16
102191,102191,,6,3,6,9
102192,102192,,4,15,26,41
102193,102193,,25,3,9,12
102194,102194,,0,6,10,16
102195,102195,,6,1,9,10
102196,102196,,28,0,1,1
3260,3260,,28,1,0,1
102197,102197,,4,3,4,7
102198,102198,,37,8,26,34
102199,102199,,11,2,22,24
9601165,9601165,,11,1,2,3
9603164,9603164,,11,1,6,7
9611062,9611062,,11,4,2,6
9501040,9501040,,11,4,2,6
102200,102200,,2,3,25,28
102201,102201,,3,10,22,32
102202,102202,,54,13,74,87
102203,102203,,8,0,3,3
9302039,9302039,,8,4,1,5
9205117,9205117,,62,3,0,3
9210117,9210117,,8,8,0,8
9210118,9210118,,8,2,0,2
102207,102207,,0,3,76,79
102208,102208,,6,11,4,15
102209,102209,,62,0,8,8
102210,102210,,0,3,17,20
102211,102211,,37,6,14,20
102212,102212,,3,18,16,34
103001,103001,,2,6,26,32
103002,103002,,16,0,3,3
9805049,9805049,,16,1,5,6
103003,103003,,2,8,18,26
103004,103004,,37,6,22,28
9704074,9704074,,37,3,5,8
103006,103006,,16,2,9,11
9410016,9410016,,16,7,7,14
9311170,9311170,,16,3,1,4
9406177,9406177,,16,2,9,11
103007,103007,,65,13,21,34
103008,103008,,54,2,7,9
103009,103009,,0,3,16,19
103010,103010,,0,8,6,14
103011,103011,,37,34,44,78
103012,103012,,3,2,5,7
103013,103013,,3,66,31,97
103014,103014,,62,5,20,25
9809074,9809074,,62,2,16,18
9909174,9909174,,62,3,20,23
103015,103015,,2,11,23,34
103016,103016,,25,0,4,4
9205098,9205098,,25,2,0,2
9206100,9206100,,25,2,0,2
103017,103017,,11,1,2,3
103018,103018,,3,5,6,11
103019,103019,,31,2,4,6
103021,103021,,4,8,70,78
103022,103022,,34,12,19,31
103023,103023,,3,19,25,44
9607101,9607101,,3,2,0,2
103024,103024,,3,6,12,18
103025,103025,,4,3,5,8
9203010,9203010,,8,1,0,1
103026,103026,,11,9,9,18
103027,103027,,29,0,1,1
9910141,9910141,,29,1,0,1
103028,103028,,34,7,12,19
103029,103029,,62,10,16,26
103030,103030,,2,43,9,52
103031,103031,,0,8,60,68
103032,103032,,34,15,19,34
103033,103033,,1,6,38,44
103034,103034,,6,0,6,6
103035,103035,,0,0,8,8
103036,103036,,34,0,15,15
9603043,9603043,,25,4,8,12
9806223,9806223,,34,5,0,5
103037,103037,,25,4,10,14
103038,103038,,14,3,7,10
103040,103040,,7,1,10,11
9903102,9903102,,7,2,7,9
9807143,9807143,,7,4,2,6
103041,103041,,0,2,28,30
103042,103042,,2,10,19,29
104135,104135,,2,8,28,36
103043,103043,,11,1,5,6
103044,103044,,1,2,10,12
103045,103045,,0,2,13,15
103046,103046,,11,1,3,4
9708146,9708146,,11,2,1,3
9412146,9412146,,11,5,1,6
103047,103047,,37,1,39,40
103048,103048,,3,2,6,8
103049,103049,,8,2,14,16
9506036,9506036,,1,1,10,11
103050,103050,,25,1,6,7
103051,103051,,7,20,12,32
104119,104119,,7,12,9,21
103052,103052,,0,10,10,20
103054,103054,,7,7,2,9
103055,103055,,62,1,28,29
103056,103056,,4,10,24,34
103057,103057,,11,0,3,3
103058,103058,,34,9,22,31
103059,103059,,54,0,5,5
103060,103060,,0,0,15,15
103061,103061,,19,6,10,16
9903255,9903255,,19,5,0,5
103062,103062,,0,5,3,8
103063,103063,,3,7,10,17
9305169,9305169,,16,2,1,3
9505093,9505093,,62,13,22,35
9511091,9511091,,62,3,7,10
9712081,9712081,,62,5,3,8
9210029,9210029,,62,9,1,10
9307071,9307071,,62,7,2,9
9307119,9307119,,62,2,0,2
9403019,9403019,,62,18,1,19
9403129,9403129,,37,2,11,13
9405111,9405111,,62,8,6,14
9406214,9406214,,62,14,9,23
9408049,9408049,,62,8,6,14
9504030,9504030,,62,9,14,23
9505041,9505041,,62,4,11,15
103066,103066,,65,1,22,23
105038,105038,,65,66,44,110
9805072,9805072,,65,2,6,8
104043,104043,,65,12,20,32
104054,104054,,65,12,30,42
103067,103067,,37,106,40,146
103068,103068,,54,23,23,46
103070,103070,,3,1,3,4
103071,103071,,0,8,23,31
103072,103072,,7,0,2,2
1095,1095,,7,1,0,1
103073,103073,,8,1,6,7
103074,103074,,3,11,15,26
103075,103075,,11,5,10,15
103076,103076,,16,0,3,3
103077,103077,,0,8,6,14
103079,103079,,4,1,43,44
103080,103080,,34,32,42,74
103167,103167,,37,68,30,98
103115,103115,,37,55,41,96
103081,103081,,54,0,32,32
103082,103082,,34,2,18,20
103083,103083,,3,3,8,11
9202040,9202040,,8,10,0,10
103084,103084,,37,0,16,16
103085,103085,,4,45,20,65
103086,103086,,54,4,44,48
103087,103087,,25,3,1,4
103088,103088,,1,2,23,25
103089,103089,,4,31,26,57
103090,103090,,3,13,50,63
103091,103091,,3,0,3,3
103092,103092,,11,2,8,10
103093,103093,,34,3,24,27
9406122,9406122,,34,3,0,3
9712198,9712198,,34,1,0,1
9805138,9805138,,34,3,1,4
9910168,9910168,,34,1,2,3
9910180,9910180,,7,3,5,8
9502111,9502111,,25,8,4,12
9503132,9503132,,25,11,3,14
103094,103094,,2,24,6,30
9909150,9909150,,2,6,28,34
103095,103095,,31,2,33,35
103096,103096,,62,3,2,5
103097,103097,,65,1,7,8
9911037,9911037,,37,1,37,38
103098,103098,,2,9,24,33
103099,103099,,54,19,29,48
103100,103100,,37,10,4,14
103101,103101,,2,9,29,38
9706114,9706114,,1,3,0,3
103102,103102,,4,35,15,50
9704191,9704191,,2,2,6,8
103103,103103,,4,21,40,61
103104,103104,,11,0,14,14
103105,103105,,7,0,5,5
103106,103106,,34,5,37,42
103107,103107,,3,4,14,18
103108,103108,,34,34,21,55
103109,103109,,11,1,10,11
103110,103110,,6,4,23,27
103111,103111,,34,13,39,52
103112,103112,,34,11,66,77
103113,103113,,7,0,3,3
103114,103114,,37,8,23,31
103116,103116,,2,5,36,41
103117,103117,,37,1,23,24
103118,103118,,65,2,11,13
9307188,9307188,,65,2,0,2
103119,103119,,37,0,2,2
9909034,9909034,,37,1,4,5
9812241,9812241,,37,1,2,3
103120,103120,,3,3,5,8
103121,103121,,16,0,1,1
103122,103122,,8,1,8,9
9805120,9805120,,8,11,33,44
103123,103123,,2,2,10,12
103124,103124,,3,19,71,90
103125,103125,,19,1,1,2
103126,103126,,11,1,3,4
103127,103127,,7,2,7,9
9412114,9412114,,7,8,4,12
9406146,9406146,,7,5,1,6
9411033,9411033,,7,2,2,4
103128,103128,,3,2,29,31
103129,103129,,7,0,11,11
9404134,9404134,,7,13,0,13
9601047,9601047,,7,6,0,6
9905125,9905125,,7,1,15,16
9509058,9509058,,7,3,4,7
9605021,9605021,,7,3,3,6
103130,103130,,16,1,1,2
1181,1181,,16,1,0,1
103132,103132,,8,0,10,10
103133,103133,,34,12,18,30
103136,103136,,2,13,20,33
103152,103152,,2,9,32,41
103139,103139,,3,13,26,39
103140,103140,,3,0,5,5
9410173,9410173,,3,4,2,6
9503025,9503025,,3,2,2,4
9707004,9707004,,3,4,3,7
9302005,9302005,,7,3,0,3
103141,103141,,11,1,11,12
103142,103142,,65,1,41,42
103143,103143,,34,7,12,19
103144,103144,,62,2,8,10
103145,103145,,2,1,25,26
103147,103147,,0,1,15,16
9603055,9603055,,25,2,9,11
103148,103148,,2,32,20,52
103149,103149,,2,2,14,16
103150,103150,,3,2,15,17
103151,103151,,0,0,5,5
103153,103153,,54,17,33,50
104056,104056,,34,30,44,74
103233,103233,,2,17,32,49
103154,103154,,1,7,39,46
103155,103155,,37,50,19,69
103156,103156,,31,3,24,27
103157,103157,,37,1,25,26
9904214,9904214,,37,2,13,15
103158,103158,,0,2,14,16
103159,103159,,2,9,33,42
103161,103161,,2,5,12,17
103162,103162,,34,4,59,63
103163,103163,,34,20,67,87
103164,103164,,3,6,16,22
9301092,9301092,,7,3,0,3
9404054,9404054,,7,3,3,6
9312129,9312129,,7,2,0,2
9404029,9404029,,7,2,1,3
9412058,9412058,,7,3,2,5
103165,103165,,2,6,24,30
103166,103166,,0,3,10,13
9905184,9905184,,0,6,6,12
103168,103168,,3,13,37,50
9804057,9804057,,16,4,24,28
9903014,9903014,,34,3,17,20
9903021,9903021,,16,1,20,21
9303076,9303076,,62,5,1,6
103169,103169,,34,10,29,39
103170,103170,,54,28,73,101
103183,103183,,4,19,22,41
9303131,9303131,,19,17,2,19
9307139,9307139,,19,6,2,8
9502079,9502079,,19,2,2,4
9502080,9502080,,19,2,5,7
103171,103171,,34,75,37,112
103172,103172,,11,1,5,6
103173,103173,,54,0,2,2
103174,103174,,37,0,12,12
103175,103175,,6,0,9,9
103176,103176,,16,1,1,2
103177,103177,,37,4,39,43
103178,103178,,7,5,19,24
9411017,9411017,,7,1,5,6
103179,103179,,3,42,12,54
103180,103180,,25,1,2,3
9704039,9704039,,25,2,4,6
9509072,9509072,,8,5,8,13
9609038,9609038,,8,2,7,9
9701063,9701063,,25,1,1,2
103181,103181,,37,2,28,30
9911255,9911255,,37,6,18,24
103182,103182,,2,0,13,13
103184,103184,,0,4,20,24
103185,103185,,6,1,7,8
103187,103187,,34,10,36,46
103188,103188,,3,15,47,62
103189,103189,,11,2,1,3
103190,103190,,7,4,13,17
103191,103191,,2,9,34,43
104236,104236,,2,25,21,46
103192,103192,,3,12,34,46
103193,103193,,0,0,11,11
106230,106230,,11,8,13,21
103196,103196,,3,16,43,59
9604126,9604126,,3,9,0,9
9802122,9802122,,3,6,1,7
9312192,9312192,,7,9,3,12
103198,103198,,34,18,11,29
103199,103199,,3,7,21,28
103200,103200,,0,0,9,9
103201,103201,,2,0,2,2
103202,103202,,9,0,3,3
103203,103203,,3,2,34,36
103204,103204,,37,3,18,21
103205,103205,,0,5,23,28
103206,103206,,3,2,16,18
9405180,9405180,,7,1,2,3
9608188,9608188,,7,2,5,7
9208005,9208005,,7,4,0,4
103207,103207,,0,0,10,10
103208,103208,,34,11,19,30
103209,103209,,3,16,25,41
103212,103212,,19,0,5,5
103213,103213,,4,1,5,6
103214,103214,,62,3,4,7
103215,103215,,19,5,12,17
9809012,9809012,,25,2,0,2
103216,103216,,30,0,1,1
103039,103039,,30,1,0,1
103217,103217,,3,15,6,21
103218,103218,,7,0,6,6
103219,103219,,34,7,41,48
103220,103220,,34,16,47,63
103221,103221,,19,3,13,16
9904032,9904032,,19,3,13,16
9306092,9306092,,19,5,0,5
103222,103222,,37,7,31,38
103223,103223,,37,33,25,58
103224,103224,,54,5,14,19
103225,103225,,8,1,5,6
103226,103226,,3,1,12,13
103227,103227,,7,3,2,5
103228,103228,,19,0,5,5
103229,103229,,3,9,29,38
9801181,9801181,,2,3,30,33
9903105,9903105,,2,2,25,27
9201052,9201052,,4,2,0,2
9308156,9308156,,4,1,6,7
103230,103230,,34,30,32,62
103231,103231,,34,9,22,31
103232,103232,,65,6,7,13
103235,103235,,11,16,25,41
103236,103236,,6,0,2,2
9507030,9507030,,6,4,1,5
103237,103237,,34,5,19,24
103238,103238,,19,2,3,5
9401120,9401120,,19,3,1,4
9409042,9409042,,19,2,0,2
9409109,9409109,,19,2,0,2
103239,103239,,54,109,66,175
104073,104073,,54,47,34,81
105032,105032,,4,49,15,64
108187,108187,,4,79,24,103
109050,109050,,31,33,4,37
105199,105199,,54,14,25,39
105212,105212,,54,19,10,29
106179,106179,,4,17,8,25
106241,106241,,54,28,41,69
106097,106097,,0,8,8,16
108075,108075,,4,73,30,103
109004,109004,,31,28,23,51
103240,103240,,0,8,17,25
103241,103241,,34,28,26,54
204218,204218,,34,15,33,48
104262,104262,,0,13,23,36
105070,105070,,34,35,29,64
105249,105249,,34,21,29,50
106086,106086,,34,24,33,57
107108,107108,,0,10,57,67
108052,108052,,34,6,37,43
111085,111085,,34,39,26,65
111247,111247,,34,24,18,42
112009,112009,,34,10,22,32
204190,204190,,0,8,22,30
103242,103242,,16,4,21,25
103243,103243,,54,1,29,30
9307145,9307145,,54,8,5,13
9412033,9412033,,54,5,12,17
9505120,9505120,,54,1,10,11
9305103,9305103,,54,2,0,2
9404176,9404176,,54,2,3,5
103244,103244,,34,0,19,19
103245,103245,,6,0,7,7
9503193,9503193,,6,1,3,4
103246,103246,,37,4,29,33
103254,103254,,37,2,2,4
9502089,9502089,,37,2,8,10
103247,103247,,34,29,16,45
103248,103248,,0,4,22,26
103249,103249,,34,1,11,12
103250,103250,,62,1,5,6
103251,103251,,19,1,1,2
103053,103053,,19,2,0,2
103252,103252,,62,4,9,13
103253,103253,,16,0,1,1
103255,103255,,34,13,4,17
103256,103256,,3,37,30,67
103257,103257,,0,3,22,25
103258,103258,,7,3,12,15
9403103,9403103,,7,2,0,2
9405157,9405157,,7,1,2,3
103259,103259,,0,2,10,12
103260,103260,,65,5,10,15
103261,103261,,2,3,10,13
103262,103262,,2,2,24,26
103263,103263,,62,4,14,18
103264,103264,,0,0,7,7
9401113,9401113,,34,3,1,4
9204101,9204101,,34,4,0,4
103265,103265,,0,6,15,21
104002,104002,,62,7,17,24
9412142,9412142,,62,3,1,4
9412237,9412237,,62,5,7,12
104003,104003,,8,3,8,11
9912179,9912179,,6,4,8,12
9412244,9412244,,6,1,2,3
9909039,9909039,,6,4,4,8
104004,104004,,3,1,6,7
104005,104005,,54,67,3,70
104006,104006,,14,0,1,1
104007,104007,,11,3,1,4
104008,104008,,62,3,2,5
9901142,9901142,,16,3,9,12
9204047,9204047,,16,3,0,3
9606167,9606167,,16,5,6,11
9809006,9809006,,16,3,2,5
9809066,9809066,,16,2,5,7
104009,104009,,0,1,20,21
9412065,9412065,,1,1,8,9
9801194,9801194,,2,2,23,25
9411129,9411129,,11,7,1,8
9411061,9411061,,11,7,4,11
9504060,9504060,,11,4,6,10
9512209,9512209,,11,3,6,9
104011,104011,,34,3,24,27
104012,104012,,16,1,7,8
9711129,9711129,,16,1,5,6
104013,104013,,16,0,1,1
9903188,9903188,,16,1,2,3
104014,104014,,6,0,4,4
104015,104015,,4,4,6,10
8021,8021,,4,1,0,1
104016,104016,,34,29,50,79
104017,104017,,3,19,22,41
104018,104018,,62,1,5,6
104020,104020,,0,1,7,8
104021,104021,,3,7,55,62
104022,104022,,19,3,9,12
9612025,9612025,,16,2,7,9
9306051,9306051,,16,1,0,1
104023,104023,,0,16,22,38
104025,104025,,25,2,2,4
104026,104026,,34,22,43,65
104027,104027,,25,2,5,7
9501026,9501026,,25,5,1,6
9509079,9509079,,25,7,0,7
104028,104028,,16,2,30,32
104029,104029,,11,13,9,22
104047,104047,,11,7,6,13
104030,104030,,37,0,1,1
104031,104031,,2,1,122,123
104032,104032,,37,8,18,26
103135,103135,,54,16,0,16
104033,104033,,37,0,7,7
104034,104034,,2,1,5,6
104035,104035,,54,43,6,49
104036,104036,,3,45,30,75
104045,104045,,3,33,22,55
104139,104139,,3,32,37,69
104037,104037,,37,48,48,96
9806170,9806170,,37,3,22,25
9806224,9806224,,37,2,32,34
9808125,9808125,,37,4,13,17
104038,104038,,3,4,7,11
104039,104039,,34,1,20,21
9204103,9204103,,34,4,0,4
104040,104040,,7,0,1,1
104042,104042,,4,4,22,26
104044,104044,,34,3,35,38
104046,104046,,2,0,31,31
104048,104048,,2,4,33,37
104049,104049,,0,12,22,34
104050,104050,,2,12,30,42
9403028,9403028,,1,3,2,5
9807044,9807044,,1,3,2,5
104052,104052,,62,1,1,2
9810085,9810085,,62,2,0,2
104055,104055,,6,1,8,9
9808003,9808003,,6,3,11,14
9907135,9907135,,6,1,6,7
104057,104057,,0,3,29,32
104058,104058,,11,0,7,7
104059,104059,,3,0,42,42
9504017,9504017,,16,3,6,9
9512015,9512015,,16,5,1,6
9807178,9807178,,16,3,0,3
104061,104061,,4,6,9,15
104062,104062,,2,1,5,6
104063,104063,,2,0,3,3
104064,104064,,37,8,23,31
104065,104065,,34,7,17,24
104066,104066,,34,8,15,23
9606031,9606031,,2,4,20,24
104067,104067,,0,5,14,19
104068,104068,,2,6,39,45
3209,3209,,2,4,0,4
104169,104169,,3,16,54,70
9706104,9706104,,2,1,0,1
104133,104133,,3,20,38,58
9210005,9210005,,2,1,0,1
9502117,9502117,,16,3,4,7
9503203,9503203,,16,2,6,8
104069,104069,,34,5,17,22
105203,105203,,4,39,3,42
105204,105204,,4,61,25,86
105061,105061,,54,3,19,22
106051,106051,,54,12,15,27
106190,106190,,0,6,27,33
104075,104075,,7,3,11,14
9807214,9807214,,0,8,4,12
9810229,9810229,,0,2,5,7
9607194,9607194,,0,5,1,6
9607195,9607195,,0,5,0,5
9607196,9607196,,0,5,0,5
9611034,9611034,,0,4,4,8
104076,104076,,3,6,25,31
9711041,9711041,,2,1,0,1
104077,104077,,37,1,6,7
104078,104078,,54,7,6,13
9810005,9810005,,54,3,3,6
104079,104079,,62,4,13,17
9811188,9811188,,62,4,3,7
9905105,9905105,,62,4,8,12
9612070,9612070,,8,4,6,10
9803242,9803242,,8,3,8,11
9803243,9803243,,8,5,13,18
104080,104080,,25,7,2,9
104081,104081,,2,23,9,32
9906106,9906106,,2,1,10,11
104082,104082,,65,9,47,56
9912177,9912177,,2,3,39,42
104084,104084,,11,1,7,8
9801041,9801041,,11,2,2,4
104085,104085,,2,1,8,9
104086,104086,,3,0,20,20
104087,104087,,6,5,7,12
104089,104089,,2,2,22,24
10019,10019,,3,2,0,2
9506086,9506086,,2,1,13,14
9910043,9910043,,2,3,11,14
104090,104090,,3,18,30,48
104091,104091,,3,4,21,25
104092,104092,,62,4,2,6
9904028,9904028,,37,2,2,4
104093,104093,,7,13,13,26
104094,104094,,25,7,9,16
104095,104095,,3,5,41,46
104153,104153,,3,42,10,52
104098,104098,,6,5,12,17
104152,104152,,6,11,8,19
104099,104099,,4,21,29,50
105115,105115,,4,15,58,73
105247,105247,,4,11,23,34
105264,105264,,4,7,18,25
106033,106033,,4,10,26,36
104143,104143,,3,20,42,62
104164,104164,,4,19,21,40
105098,105098,,4,20,28,48
105227,105227,,4,26,39,65
9507053,9507053,,62,2,7,9
105228,105228,,4,13,31,44
105238,105238,,4,17,34,51
105245,105245,,4,14,33,47
104100,104100,,37,10,15,25
104101,104101,,31,2,6,8
104102,104102,,7,36,10,46
104103,104103,,54,1,20,21
104104,104104,,2,2,6,8
104105,104105,,37,16,20,36
104106,104106,,3,8,37,45
104107,104107,,6,2,7,9
9507052,9507052,,6,4,3,7
9511095,9511095,,6,1,4,5
104108,104108,,3,3,11,14
9712183,9712183,,3,1,6,7
9607096,9607096,,3,5,6,11
9809051,9809051,,16,3,2,5
9901141,9901141,,16,2,4,6
104109,104109,,2,0,1,1
104110,104110,,6,0,14,14
9711171,9711171,,6,1,7,8
104111,104111,,34,1,17,18
104112,104112,,2,6,41,47
104113,104113,,34,7,19,26
104130,104130,,34,8,13,21
104114,104114,,8,1,6,7
104115,104115,,6,9,17,26
9707210,9707210,,6,1,6,7
104116,104116,,19,3,6,9
104117,104117,,1,1,1,2
104118,104118,,0,12,16,28
104120,104120,,62,0,5,5
9204003,9204003,,8,9,0,9
9303095,9303095,,62,4,0,4
104121,104121,,7,0,3,3
104122,104122,,0,8,20,28
9407071,9407071,,0,2,2,4
9211029,9211029,,0,3,0,3
9305122,9305122,,0,2,0,2
104123,104123,,11,3,2,5
104124,104124,,37,26,16,42
104125,104125,,0,7,21,28
104126,104126,,37,14,39,53
104127,104127,,25,0,1,1
104128,104128,,25,1,13,14
104129,104129,,6,0,1,1
104131,104131,,0,3,16,19
104132,104132,,54,4,25,29
104134,104134,,0,0,16,16
104136,104136,,4,66,16,82
104137,104137,,6,0,1,1
9702060,9702060,,6,1,8,9
104138,104138,,1,6,21,27
104140,104140,,0,2,1,3
104060,104060,,0,1,0,1
104141,104141,,34,32,31,63
104142,104142,,7,1,3,4
104144,104144,,8,1,1,2
9502068,9502068,,8,1,1,2
104145,104145,,32,0,1,1
9909162,9909162,,32,1,0,1
9511223,9511223,,54,5,3,8
104147,104147,,37,31,32,63
104149,104149,,0,0,3,3
104150,104150,,0,7,34,41
104154,104154,,3,4,13,17
104155,104155,,54,5,12,17
104156,104156,,34,9,19,28
105108,105108,,0,22,12,34
104157,104157,,2,0,1,1
104158,104158,,1,25,19,44
9204053,9204053,,1,1,1,2
104159,104159,,34,17,27,44
104160,104160,,25,3,5,8
2179,2179,,25,5,0,5
104161,104161,,14,2,2,4
104162,104162,,7,2,9,11
9706190,9706190,,7,6,17,23
9707153,9707153,,7,3,8,11
9707201,9707201,,7,1,5,6
9801031,9801031,,25,3,2,5
9311103,9311103,,14,8,3,11
9406129,9406129,,7,3,3,6
9512047,9512047,,25,2,11,13
9704118,9704118,,7,3,21,24
9602149,9602149,,7,3,2,5
9612145,9612145,,7,1,10,11
9612137,9612137,,25,2,0,2
104163,104163,,54,3,24,27
104166,104166,,31,1,4,5
104167,104167,,3,4,17,21
104168,104168,,3,10,27,37
9506117,9506117,,25,6,2,8
104171,104171,,37,8,13,21
104173,104173,,4,10,42,52
104174,104174,,0,7,7,14
104175,104175,,7,1,5,6
9403113,9403113,,25,4,1,5
104176,104176,,4,9,21,30
104177,104177,,0,11,34,45
104178,104178,,2,3,23,26
104179,104179,,54,15,2,17
104180,104180,,34,70,13,83
104181,104181,,34,65,7,72
104182,104182,,11,1,1,2
104183,104183,,4,0,1,1
104184,104184,,34,6,2,8
104185,104185,,0,12,25,37
104188,104188,,37,1,20,21
9710095,9710095,,6,3,9,12
9609090,9609090,,8,1,15,16
9309084,9309084,,6,1,3,4
104191,104191,,3,2,8,10
104192,104192,,11,1,10,11
104193,104193,,19,0,13,13
104194,104194,,34,0,14,14
104195,104195,,0,2,17,19
104196,104196,,2,2,8,10
104197,104197,,62,1,3,4
104198,104198,,34,3,27,30
104199,104199,,4,0,2,2
104200,104200,,37,21,63,84
104201,104201,,0,6,16,22
104202,104202,,37,25,25,50
9409072,9409072,,54,1,8,9
104203,104203,,65,0,19,19
9408160,9408160,,8,2,5,7
9806130,9806130,,37,1,14,15
9806147,9806147,,37,5,17,22
104205,104205,,16,4,2,6
9908055,9908055,,16,1,8,9
9705158,9705158,,16,2,1,3
9806221,9806221,,16,2,9,11
104206,104206,,2,6,27,33
104207,104207,,62,1,4,5
9301123,9301123,,62,4,0,4
104208,104208,,37,15,12,27
104209,104209,,2,5,12,17
104210,104210,,2,1,13,14
104211,104211,,4,3,11,14
104212,104212,,62,7,30,37
9412031,9412031,,62,1,0,1
9509153,9509153,,62,5,9,14
9612150,9612150,,62,3,13,16
9806222,9806222,,62,3,5,8
9911178,9911178,,62,4,7,11
9511102,9511102,,62,3,2,5
9512011,9512011,,62,4,16,20
9212125,9212125,,62,3,1,4
104213,104213,,0,10,21,31
104215,104215,,54,10,13,23
104216,104216,,2,0,3,3
9510065,9510065,,2,1,0,1
9610194,9610194,,2,1,0,1
104218,104218,,4,6,56,62
104219,104219,,25,6,2,8
104220,104220,,62,2,13,15
104222,104222,,11,1,10,11
104223,104223,,2,3,10,13
104224,104224,,3,18,19,37
104225,104225,,11,0,1,1
104226,104226,,0,11,22,33
104227,104227,,0,21,53,74
106100,106100,,0,12,42,54
106019,106019,,0,8,18,26
106203,106203,,0,12,18,30
107233,107233,,0,11,26,37
112045,112045,,34,40,59,99
112227,112227,,34,6,44,50
202198,202198,,0,14,46,60
104228,104228,,16,0,3,3
9308103,9308103,,16,2,0,2
104229,104229,,4,5,24,29
104230,104230,,4,9,39,48
104231,104231,,6,3,3,6
104232,104232,,3,3,36,39
104233,104233,,11,0,1,1
104234,104234,,8,2,18,20
104235,104235,,2,1,14,15
104237,104237,,54,0,5,5
9409049,9409049,,54,1,0,1
104238,104238,,4,41,28,69
9908132,9908132,,4,12,4,16
9601160,9601160,,11,2,6,8
104239,104239,,0,9,19,28
104240,104240,,8,5,3,8
9212084,9212084,,8,1,0,1
104241,104241,,54,7,6,13
9506073,9506073,,54,1,0,1
104242,104242,,16,1,1,2
8158,8158,,16,1,0,1
104243,104243,,3,2,23,25
104244,104244,,3,9,21,30
104245,104245,,37,0,1,1
104246,104246,,34,20,9,29
104247,104247,,1,21,9,30
104248,104248,,34,0,2,2
104249,104249,,7,5,3,8
9704203,9704203,,7,4,0,4
9902143,9902143,,7,1,1,2
104250,104250,,3,0,2,2
104251,104251,,34,2,15,17
104252,104252,,11,0,2,2
104253,104253,,37,2,11,13
104254,104254,,37,8,28,36
104255,104255,,11,1,7,8
104256,104256,,11,0,2,2
9701136,9701136,,11,3,0,3
104257,104257,,25,1,16,17
104258,104258,,25,0,3,3
9810139,9810139,,25,2,3,5
9511184,9511184,,25,3,5,8
104259,104259,,37,19,20,39
104260,104260,,2,13,22,35
104261,104261,,25,1,11,12
104263,104263,,4,8,6,14
104264,104264,,3,13,29,42
104265,104265,,16,0,6,6
104266,104266,,0,0,7,7
9907197,9907197,,11,1,2,3
9709187,9709187,,11,2,3,5
104267,104267,,7,0,7,7
105001,105001,,34,28,17,45
105002,105002,,3,2,5,7
105003,105003,,7,0,2,2
9604008,9604008,,7,1,3,4
9605204,9605204,,7,5,2,7
9303132,9303132,,7,3,0,3
9304120,9304120,,7,5,0,5
9311057,9311057,,7,5,0,5
105004,105004,,7,0,1,1
105005,105005,,34,8,36,44
105006,105006,,2,15,38,53
105007,105007,,0,7,23,30
105008,105008,,0,9,6,15
105009,105009,,0,2,4,6
105010,105010,,6,7,10,17
105011,105011,,3,1,2,3
105012,105012,,3,13,17,30
105013,105013,,7,4,14,18
105014,105014,,37,10,30,40
105015,105015,,62,0,10,10
9303045,9303045,,62,2,4,6
105016,105016,,2,7,21,28
9508132,9508132,,2,2,26,28
105017,105017,,34,6,11,17
105019,105019,,34,25,27,52
105020,105020,,37,3,7,10
105021,105021,,2,0,1,1
105022,105022,,11,1,4,5
9904195,9904195,,11,2,5,7
105023,105023,,4,52,35,87
106206,106206,,4,22,29,51
105062,105062,,4,36,29,65
105220,105220,,4,11,13,24
105024,105024,,4,43,44,87
105025,105025,,2,0,2,2
105026,105026,,6,0,2,2
105027,105027,,7,5,13,18
105028,105028,,6,6,4,10
9907120,9907120,,6,6,0,6
105029,105029,,2,1,9,10
106197,106197,,2,1,11,12
105031,105031,,2,1,5,6
4016,4016,,0,2,0,2
105033,105033,,62,3,6,9
9306049,9306049,,62,8,1,9
9810034,9810034,,62,1,2,3
105034,105034,,0,0,1,1
105035,105035,,2,7,34,41
105036,105036,,34,21,12,33
105037,105037,,19,6,11,17
105039,105039,,34,0,23,23
105040,105040,,8,1,8,9
9408071,9408071,,7,7,0,7
9904192,9904192,,8,3,5,8
105041,105041,,37,1,20,21
105043,105043,,7,5,11,16
9510239,9510239,,7,3,12,15
9611167,9611167,,7,5,5,10
9412194,9412194,,7,1,2,3
105044,105044,,34,2,17,19
105045,105045,,37,43,34,77
105046,105046,,8,11,36,47
9508105,9508105,,65,3,5,8
9312065,9312065,,8,1,0,1
105047,105047,,34,14,11,25
105049,105049,,34,30,35,65
105050,105050,,1,17,4,21
105051,105051,,3,0,28,28
111090,111090,,37,13,12,25
106175,106175,,37,8,23,31
106185,106185,,37,10,4,14
111078,111078,,37,10,27,37
105053,105053,,0,2,4,6
9504164,9504164,,11,2,2,4
9905100,9905100,,54,6,12,18
9406026,9406026,,11,2,0,2
9409198,9409198,,11,2,2,4
9809214,9809214,,25,4,7,11
105054,105054,,4,7,25,32
105055,105055,,34,0,17,17
105056,105056,,3,1,15,16
105057,105057,,11,10,2,12
9805166,9805166,,11,3,0,3
9910221,9910221,,11,2,1,3
9403169,9403169,,11,2,0,2
105058,105058,,4,83,13,96
105059,105059,,4,81,81,162
105060,105060,,11,7,9,16
105063,105063,,37,9,19,28
105064,105064,,6,0,8,8
105065,105065,,2,0,5,5
105066,105066,,37,40,44,84
105067,105067,,2,2,2,4
105068,105068,,0,4,46,50
105069,105069,,25,0,14,14
105072,105072,,4,0,4,4
105074,105074,,11,0,4,4
9802137,9802137,,11,1,0,1
9502048,9502048,,11,2,0,2
105075,105075,,37,7,25,32
105076,105076,,4,14,20,34
105077,105077,,2,23,20,43
105159,105159,,2,18,32,50
106038,106038,,2,6,40,46
105078,105078,,62,3,9,12
105079,105079,,3,10,33,43
105080,105080,,0,0,3,3
105081,105081,,14,4,8,12
105082,105082,,3,36,12,48
105083,105083,,3,7,47,54
105084,105084,,37,0,5,5
105086,105086,,54,6,3,9
9508138,9508138,,6,2,1,3
105242,105242,,3,29,32,61
106194,106194,,4,13,19,32
105088,105088,,0,1,6,7
105089,105089,,3,9,38,47
105090,105090,,2,10,43,53
105091,105091,,0,12,26,38
105092,105092,,62,0,2,2
105093,105093,,34,22,19,41
105094,105094,,3,5,47,52
107115,107115,,3,9,62,71
106030,106030,,3,3,8,11
107037,107037,,3,16,18,34
9310053,9310053,,3,3,0,3
105095,105095,,2,21,14,35
105136,105136,,2,22,30,52
106012,106012,,2,29,14,43
105096,105096,,37,13,36,49
105097,105097,,54,93,43,136
106014,106014,,34,34,57,91
105100,105100,,0,10,16,26
105101,105101,,4,6,33,39
106267,106267,,4,8,25,33
105102,105102,,2,4,32,36
105103,105103,,4,0,6,6
5200,5200,,4,1,0,1
105030,105030,,4,1,0,1
105104,105104,,34,1,11,12
105105,105105,,25,7,5,12
105106,105106,,65,1,21,22
9903081,9903081,,2,3,21,24
9805107,9805107,,37,1,25,26
105107,105107,,7,2,3,5
105109,105109,,6,2,7,9
9512099,9512099,,6,3,0,3
9704088,9704088,,6,4,1,5
9901082,9901082,,6,1,0,1
9901083,9901083,,6,1,0,1
9901097,9901097,,6,2,0,2
105110,105110,,2,5,6,11
105244,105244,,2,4,12,16
110086,110086,,2,5,20,25
105112,105112,,34,4,8,12
105113,105113,,34,4,29,33
9411153,9411153,,25,2,17,19
105114,105114,,6,2,9,11
105129,105129,,4,44,18,62
105168,105168,,4,74,63,137
105116,105116,,0,0,8,8
105118,105118,,37,2,4,6
105119,105119,,3,1,4,5
12123,12123,,3,5,0,5
105120,105120,,7,6,11,17
105121,105121,,37,8,22,30
105122,105122,,0,2,3,5
105123,105123,,8,11,17,28
105124,105124,,11,2,2,4
105125,105125,,2,0,19,19
105126,105126,,3,1,7,8
105127,105127,,3,5,17,22
12207,12207,,3,1,0,1
105128,105128,,0,11,1,12
102047,102047,,0,7,0,7
105130,105130,,7,0,2,2
105131,105131,,34,0,4,4
105133,105133,,0,0,2,2
105134,105134,,34,7,21,28
105135,105135,,7,16,21,37
9509057,9509057,,7,4,1,5
9606159,9606159,,7,5,4,9
105137,105137,,54,3,30,33
105138,105138,,54,2,20,22
105139,105139,,3,4,40,44
105141,105141,,11,7,7,14
9811176,9811176,,11,3,7,10
105142,105142,,34,3,4,7
9712089,9712089,,7,6,0,6
105143,105143,,37,0,7,7
105144,105144,,62,1,3,4
105145,105145,,3,0,13,13
105146,105146,,6,1,5,6
105148,105148,,62,2,10,12
9309117,9309117,,62,1,1,2
105149,105149,,1,17,2,19
105153,105153,,54,8,8,16
105154,105154,,3,1,30,31
105155,105155,,54,76,52,128
9411022,9411022,,54,2,11,13
105156,105156,,4,10,19,29
105157,105157,,11,0,2,2
105158,105158,,34,7,34,41
105161,105161,,2,4,7,11
105163,105163,,11,8,15,23
105164,105164,,37,5,12,17
105165,105165,,2,0,2,2
105166,105166,,3,4,58,62
105167,105167,,54,0,7,7
9305166,9305166,,4,8,0,8
105169,105169,,37,2,5,7
105170,105170,,34,1,7,8
105171,105171,,2,11,31,42
108006,108006,,2,4,25,29
105284,105284,,2,9,28,37
105172,105172,,33,0,1,1
9069,9069,,33,1,0,1
105173,105173,,3,3,3,6
105174,105174,,37,1,35,36
105175,105175,,4,25,19,44
105176,105176,,2,4,36,40
105177,105177,,62,5,24,29
9307007,9307007,,62,3,5,8
9509119,9509119,,8,8,32,40
9305135,9305135,,62,2,1,3
9307008,9307008,,62,1,6,7
9312060,9312060,,62,4,1,5
9405201,9405201,,62,2,2,4
9203044,9203044,,8,2,0,2
9303164,9303164,,8,6,3,9
9309041,9309041,,8,8,8,16
9411221,9411221,,8,2,9,11
9508125,9508125,,8,1,5,6
105178,105178,,62,7,11,18
105179,105179,,11,4,3,7
105180,105180,,0,2,18,20
105181,105181,,34,10,6,16
105182,105182,,0,13,39,52
105183,105183,,34,2,13,15
9601166,9601166,,25,6,12,18
9511189,9511189,,34,2,5,7
9611179,9611179,,34,2,2,4
105184,105184,,4,28,32,60
105185,105185,,3,7,18,25
105186,105186,,0,7,14,21
105187,105187,,3,9,22,31
105188,105188,,3,4,15,19
105189,105189,,2,0,4,4
9407020,9407020,,6,6,4,10
9612002,9612002,,2,1,0,1
9301120,9301120,,6,7,1,8
105190,105190,,6,3,5,8
105191,105191,,3,6,20,26
105192,105192,,3,18,9,27
105193,105193,,9,1,6,7
9603145,9603145,,9,1,0,1
105194,105194,,37,3,19,22
105195,105195,,25,0,20,20
105196,105196,,0,3,7,10
105197,105197,,37,1,8,9
105198,105198,,11,9,14,23
105200,105200,,1,10,26,36
105201,105201,,7,0,5,5
105202,105202,,0,0,5,5
105205,105205,,4,3,18,21
105206,105206,,8,9,11,20
105207,105207,,34,10,30,40
105208,105208,,54,34,40,74
105209,105209,,4,1,11,12
105210,105210,,2,8,29,37
105211,105211,,37,3,9,12
108029,108029,,37,2,3,5
105213,105213,,19,1,3,4
105214,105214,,34,21,43,64
105215,105215,,6,3,22,25
105216,105216,,37,4,27,31
105217,105217,,1,7,20,27
105218,105218,,34,11,43,54
105219,105219,,34,5,9,14
105221,105221,,3,4,20,24
105222,105222,,11,1,9,10
105223,105223,,7,2,2,4
105224,105224,,34,1,8,9
105225,105225,,37,43,28,71
105226,105226,,3,4,7,11
105229,105229,,37,12,55,67
105230,105230,,4,22,19,41
105232,105232,,6,0,8,8
105233,105233,,65,0,10,10
105234,105234,,6,1,4,5
105235,105235,,34,8,34,42
105236,105236,,25,4,12,16
105237,105237,,34,1,47,48
105239,105239,,65,2,5,7
105240,105240,,0,3,11,14
105243,105243,,0,17,15,32
105246,105246,,4,3,41,44
105250,105250,,34,26,28,54
105251,105251,,3,11,9,20
105252,105252,,65,19,16,35
105253,105253,,2,3,11,14
105254,105254,,34,21,63,84
105255,105255,,0,13,35,48
105257,105257,,3,17,34,51
105258,105258,,34,22,49,71
105259,105259,,9,5,7,12
9310100,9310100,,9,1,0,1
105260,105260,,37,12,14,26
9505140,9505140,,25,2,12,14
105261,105261,,0,3,13,16
105262,105262,,11,4,4,8
105263,105263,,2,4,24,28
105265,105265,,3,7,21,28
105266,105266,,65,3,2,5
105268,105268,,11,8,8,16
105269,105269,,0,6,16,22
105270,105270,,34,10,30,40
105271,105271,,3,3,11,14
1160,1160,,3,4,0,4
105272,105272,,4,8,17,25
105274,105274,,2,19,14,33
105275,105275,,11,4,5,9
105276,105276,,34,23,43,66
105277,105277,,2,14,14,28
105278,105278,,7,0,1,1
105279,105279,,25,2,11,13
105280,105280,,50,0,1,1
203114,203114,,50,3,0,3
105281,105281,,2,0,9,9
105282,105282,,25,1,7,8
9803032,9803032,,25,1,0,1
105283,105283,,1,5,38,43
105286,105286,,25,7,25,32
105288,105288,,2,7,47,54
105289,105289,,37,7,16,23
9608097,9608097,,11,1,3,4
105291,105291,,54,1,31,32
105292,105292,,2,1,22,23
105293,105293,,0,2,7,9
105294,105294,,8,5,8,13
105295,105295,,0,0,2,2
105296,105296,,0,4,25,29
105297,105297,,7,0,1,1
105298,105298,,2,2,22,24
105299,105299,,11,26,15,41
105018,105018,,11,18,0,18
105301,105301,,6,2,4,6
9403063,9403063,,6,5,0,5
105302,105302,,37,2,44,46
9507042,9507042,,9,1,1,2
105303,105303,,3,7,9,16
105304,105304,,0,6,8,14
105305,105305,,65,6,12,18
105306,105306,,62,4,3,7
9412176,9412176,,1,5,12,17
9307097,9307097,,1,1,1,2
105307,105307,,3,2,46,48
105308,105308,,1,77,17,94
105309,105309,,34,26,23,49
9710107,9710107,,16,1,15,16
9310136,9310136,,16,6,6,12
9401143,9401143,,16,3,7,10
9411013,9411013,,16,4,6,10
9609008,9609008,,16,4,16,20
9201077,9201077,,16,1,0,1
105310,105310,,19,4,1,5
105311,105311,,3,21,64,85
105312,105312,,4,9,55,64
105313,105313,,1,3,4,7
9703224,9703224,,62,6,13,19
9204023,9204023,,62,12,0,12
9508005,9508005,,8,7,19,26
9611108,9611108,,62,4,8,12
105314,105314,,4,4,9,13
105315,105315,,9,0,17,17
105316,105316,,7,5,5,10
105317,105317,,62,0,2,2
105318,105318,,0,0,9,9
105319,105319,,4,9,26,35
105320,105320,,0,7,62,69
9704193,9704193,,2,1,26,27
9609190,9609190,,2,2,8,10
105321,105321,,8,1,16,17
9704065,9704065,,8,6,18,24
9909067,9909067,,8,1,6,7
9206054,9206054,,8,2,0,2
9402083,9402083,,37,8,2,10
106001,106001,,0,28,11,39
106002,106002,,4,4,29,33
106201,106201,,4,14,121,135
106112,106112,,34,39,25,64
9806225,9806225,,2,4,29,33
106003,106003,,7,0,5,5
106004,106004,,1,13,34,47
106005,106005,,1,24,30,54
106006,106006,,3,4,8,12
106007,106007,,6,0,2,2
106008,106008,,34,1,22,23
106009,106009,,11,0,9,9
106010,106010,,4,58,80,138
106011,106011,,3,18,30,48
106072,106072,,3,13,15,28
106016,106016,,3,17,6,23
106013,106013,,2,6,31,37
106015,106015,,34,11,30,41
106018,106018,,3,3,15,18
106020,106020,,34,10,37,47
106021,106021,,2,6,33,39
106022,106022,,0,5,23,28
106023,106023,,54,5,11,16
106024,106024,,3,12,32,44
106025,106025,,6,0,10,10
9711182,9711182,,6,1,11,12
9308013,9308013,,6,2,1,3
106026,106026,,37,37,13,50
106027,106027,,4,20,25,45
106028,106028,,7,7,22,29
9506063,9506063,,37,1,11,12
106029,106029,,16,1,7,8
9311155,9311155,,16,3,1,4
9604117,9604117,,65,1,5,6
9309136,9309136,,16,3,3,6
9310164,9310164,,16,2,0,2
9311082,9311082,,16,1,2,3
9405126,9405126,,65,3,2,5
106031,106031,,34,4,26,30
106032,106032,,34,9,12,21
106034,106034,,37,71,29,100
106035,106035,,19,2,11,13
106036,106036,,4,58,29,87
106037,106037,,0,1,3,4
106039,106039,,6,0,2,2
106040,106040,,37,36,52,88
106041,106041,,0,10,21,31
106042,106042,,3,4,7,11
106043,106043,,37,1,31,32
106044,106044,,3,33,11,44
106045,106045,,37,0,53,53
106046,106046,,3,8,26,34
106047,106047,,3,8,19,27
106049,106049,,19,0,3,3
106052,106052,,8,1,12,13
9303064,9303064,,8,4,1,5
9310061,9310061,,8,4,5,9
9403036,9403036,,8,4,4,8
9206009,9206009,,8,3,0,3
106053,106053,,16,6,12,18
106054,106054,,0,8,46,54
106055,106055,,37,36,31,67
106056,106056,,3,0,7,7
9402069,9402069,,3,1,0,1
9401019,9401019,,7,1,1,2
106057,106057,,11,1,3,4
9602092,9602092,,11,1,0,1
9808121,9808121,,11,2,0,2
106058,106058,,0,15,25,40
9910229,9910229,,0,1,12,13
9902191,9902191,,34,2,17,19
106059,106059,,2,5,7,12
106060,106060,,62,1,3,4
106061,106061,,37,10,56,66
9809107,9809107,,37,1,13,14
106062,106062,,2,17,10,27
106063,106063,,34,0,8,8
106064,106064,,62,9,12,21
106065,106065,,6,2,14,16
106066,106066,,62,3,6,9
106068,106068,,4,5,48,53
106069,106069,,62,8,14,22
106070,106070,,62,7,8,15
106071,106071,,16,0,12,12
9406195,9406195,,16,3,4,7
9302072,9302072,,16,3,1,4
9501001,9501001,,16,1,0,1
9401107,9401107,,16,2,3,5
106073,106073,,62,5,12,17
106074,106074,,3,7,10,17
106075,106075,,3,3,13,16
106076,106076,,0,14,23,37
106077,106077,,25,0,3,3
9907223,9907223,,25,1,5,6
106078,106078,,4,2,40,42
106103,106103,,4,8,24,32
106079,106079,,4,18,21,39
106080,106080,,34,0,15,15
106081,106081,,0,3,53,56
9908133,9908133,,2,4,7,11
9412227,9412227,,16,2,7,9
106083,106083,,0,2,15,17
106087,106087,,6,4,3,7
105099,105099,,6,4,0,4
106088,106088,,3,4,16,20
106089,106089,,3,25,14,39
106138,106138,,3,28,9,37
106092,106092,,34,7,24,31
106093,106093,,37,4,14,18
106094,106094,,37,0,21,21
9607217,9607217,,25,1,7,8
9406193,9406193,,25,4,5,9
9511025,9511025,,25,2,0,2
106095,106095,,6,0,2,2
106096,106096,,4,0,22,22
106098,106098,,6,1,3,4
106106,106106,,6,1,1,2
106099,106099,,7,2,12,14
106127,106127,,0,16,95,111
106131,106131,,0,8,16,24
106109,106109,,34,153,10,163
106113,106113,,34,193,21,214
106151,106151,,34,37,31,68
106184,106184,,34,35,26,61
106191,106191,,34,64,33,97
106247,106247,,34,76,25,101
107134,107134,,34,56,54,110
107169,107169,,34,32,20,52
108150,108150,,4,51,22,73
108172,108172,,34,36,149,185
109057,109057,,34,41,22,63
109122,109122,,34,11,59,70
109133,109133,,34,20,16,36
109213,109213,,34,69,30,99
110007,110007,,34,96,35,131
110031,110031,,34,39,36,75
110062,110062,,34,32,26,58
110064,110064,,34,23,35,58
110108,110108,,34,106,59,165
110123,110123,,34,33,19,52
110143,110143,,0,16,42,58
110169,110169,,34,23,19,42
110234,110234,,34,48,26,74
110238,110238,,34,5,32,37
110265,110265,,34,43,22,65
111008,111008,,34,37,52,89
111093,111093,,34,56,58,114
111182,111182,,34,18,82,100
111201,111201,,34,8,20,28
111217,111217,,34,40,24,64
111238,111238,,34,20,85,105
111276,111276,,34,18,25,43
108194,108194,,0,4,20,24
111007,111007,,3,2,16,18
108013,108013,,0,12,20,32
111153,111153,,4,37,10,47
201268,201268,,34,10,30,40
202060,202060,,0,13,28,41
202107,202107,,0,13,20,33
202140,202140,,34,9,50,59
106101,106101,,0,4,2,6
106102,106102,,11,0,8,8
9908178,9908178,,11,1,9,10
106104,106104,,54,2,18,20
106105,106105,,65,12,13,25
9511040,9511040,,65,3,3,6
106107,106107,,4,12,32,44
9902178,9902178,,4,8,2,10
106108,106108,,34,5,12,17
106110,106110,,3,9,8,17
106111,106111,,7,6,3,9
9601132,9601132,,34,1,0,1
106114,106114,,1,3,23,26
106116,106116,,1,2,13,15
106117,106117,,34,47,33,80
106118,106118,,6,0,5,5
106120,106120,,0,32,64,96
106121,106121,,3,16,20,36
106122,106122,,7,1,6,7
106123,106123,,65,1,2,3
9808158,9808158,,65,1,3,4
106125,106125,,3,13,22,35
106126,106126,,54,11,13,24
106128,106128,,0,4,35,39
106129,106129,,65,20,24,44
106133,106133,,11,7,16,23
108040,108040,,11,18,22,40
9808070,9808070,,25,2,6,8
106134,106134,,0,4,7,11
106135,106135,,7,3,3,6
106136,106136,,3,3,19,22
9304033,9304033,,7,4,2,6
106137,106137,,11,1,2,3
106139,106139,,62,3,2,5
106140,106140,,0,14,37,51
106141,106141,,3,5,8,13
106142,106142,,4,5,31,36
106143,106143,,0,7,8,15
106144,106144,,19,8,3,11
106145,106145,,0,9,12,21
106148,106148,,34,2,22,24
106149,106149,,34,28,47,75
106200,106200,,34,21,30,51
107040,107040,,34,5,5,10
111119,111119,,34,11,28,39
201226,201226,,34,9,25,34
203115,203115,,34,7,8,15
206068,206068,,34,6,17,23
9806243,9806243,,8,5,5,10
107149,107149,,2,15,8,23
107186,107186,,34,14,13,27
108192,108192,,34,6,7,13
109067,109067,,34,10,27,37
201112,201112,,1,15,33,48
205131,205131,,34,28,66,94
106150,106150,,54,0,8,8
106152,106152,,7,2,5,7
106085,106085,,7,3,0,3
106153,106153,,34,9,11,20
106155,106155,,54,26,44,70
9511048,9511048,,54,1,22,23
106156,106156,,3,0,1,1
106157,106157,,4,39,11,50
106158,106158,,1,0,7,7
9907185,9907185,,1,3,6,9
9910242,9910242,,1,1,6,7
106159,106159,,3,3,14,17
106160,106160,,34,40,26,66
106161,106161,,34,5,32,37
106162,106162,,37,20,25,45
106163,106163,,0,0,10,10
106164,106164,,2,1,15,16
106165,106165,,2,2,20,22
106166,106166,,11,1,3,4
106167,106167,,2,2,17,19
106168,106168,,25,0,7,7
106170,106170,,3,2,7,9
106171,106171,,34,13,42,55
106172,106172,,65,0,20,20
106173,106173,,6,3,7,10
106177,106177,,34,12,37,49
106178,106178,,2,4,77,81
106180,106180,,3,8,45,53
106181,106181,,3,6,25,31
110057,110057,,3,24,5,29
111122,111122,,3,8,6,14
108045,108045,,3,17,11,28
111049,111049,,3,3,8,11
106182,106182,,65,6,10,16
106183,106183,,37,1,5,6
106186,106186,,34,14,41,55
106187,106187,,4,2,22,24
106188,106188,,6,7,21,28
106189,106189,,3,2,29,31
211074,211074,,34,2,27,29
110173,110173,,2,12,56,68
201253,201253,,34,39,226,265
205061,205061,,34,3,28,31
106192,106192,,37,14,23,37
106193,106193,,16,13,21,34
9301006,9301006,,16,4,1,5
106195,106195,,4,3,38,41
106196,106196,,3,0,12,12
9710086,9710086,,8,1,8,9
106198,106198,,3,0,1,1
106199,106199,,6,4,10,14
106202,106202,,1,4,16,20
106204,106204,,34,0,2,2
106205,106205,,3,18,19,37
106207,106207,,62,5,8,13
106208,106208,,0,0,1,1
106209,106209,,34,32,27,59
106210,106210,,2,0,13,13
106211,106211,,65,2,43,45
106212,106212,,2,7,28,35
106213,106213,,3,19,47,66
106214,106214,,3,2,6,8
106215,106215,,6,5,11,16
106216,106216,,25,0,3,3
106217,106217,,3,7,30,37
106218,106218,,2,3,23,26
106220,106220,,0,11,7,18
106221,106221,,1,0,2,2
9904015,9904015,,1,5,5,10
9906009,9906009,,1,5,1,6
106222,106222,,2,0,10,10
106223,106223,,62,4,14,18
106225,106225,,0,0,4,4
106226,106226,,25,2,3,5
104165,104165,,25,2,0,2
106227,106227,,14,7,9,16
108129,108129,,14,9,13,22
9508114,9508114,,14,6,1,7
106228,106228,,0,2,8,10
106231,106231,,4,3,32,35
106232,106232,,3,0,15,15
106233,106233,,0,1,12,13
9405154,9405154,,0,1,0,1
9408058,9408058,,0,1,0,1
106234,106234,,65,7,48,55
106235,106235,,54,9,10,19
106236,106236,,0,1,2,3
106237,106237,,0,4,10,14
106238,106238,,34,18,27,45
106239,106239,,11,3,3,6
106240,106240,,0,1,13,14
9310016,9310016,,31,1,6,7
106242,106242,,4,12,9,21
106243,106243,,0,1,24,25
106244,106244,,2,2,8,10
106245,106245,,0,14,19,33
106246,106246,,37,0,21,21
106248,106248,,2,0,3,3
106249,106249,,34,15,31,46
106250,106250,,6,1,5,6
9404119,9404119,,6,5,1,6
106252,106252,,2,0,6,6
106253,106253,,2,2,26,28
106254,106254,,37,1,3,4
9904177,9904177,,37,2,1,3
106255,106255,,0,8,26,34
106256,106256,,54,15,27,42
106257,106257,,7,1,4,5
106258,106258,,11,5,11,16
106260,106260,,7,3,46,49
9202080,9202080,,7,2,0,2
9203068,9203068,,2,1,0,1
9206040,9206040,,8,3,0,3
106261,106261,,0,9,14,23
106262,106262,,37,2,23,25
106263,106263,,0,2,17,19
106264,106264,,11,2,9,11
106265,106265,,34,4,10,14
106266,106266,,37,6,23,29
106268,106268,,62,0,17,17
106271,106271,,0,5,9,14
106272,106272,,1,0,6,6
9503176,9503176,,2,3,3,6
106273,106273,,62,3,4,7
106274,106274,,4,21,13,34
106275,106275,,62,3,15,18
106276,106276,,34,5,19,24
106277,106277,,37,0,4,4
106278,106278,,3,1,10,11
9803073,9803073,,34,2,1,3
9812191,9812191,,37,1,5,6
106279,106279,,3,3,4,7
106280,106280,,3,11,16,27
106281,106281,,3,4,45,49
106282,106282,,0,7,21,28
106283,106283,,49,3,2,5
10089,10089,,49,1,0,1
106284,106284,,62,0,16,16
106285,106285,,54,8,36,44
106286,106286,,0,1,13,14
106287,106287,,8,3,7,10
107001,107001,,65,6,4,10
107002,107002,,4,19,21,40
107003,107003,,35,0,1,1
9911009,9911009,,35,1,0,1
107005,107005,,25,0,9,9
107006,107006,,0,2,3,5
107007,107007,,4,16,31,47
107008,107008,,65,0,2,2
107009,107009,,2,1,6,7
107010,107010,,3,1,15,16
107011,107011,,0,13,10,23
107012,107012,,8,3,8,11
9812249,9812249,,37,1,7,8
107013,107013,,6,1,2,3
9703112,9703112,,16,3,1,4
107014,107014,,3,1,15,16
107015,107015,,62,6,15,21
9602053,9602053,,62,1,0,1
9704212,9704212,,2,1,1,2
107016,107016,,37,2,29,31
107017,107017,,9,2,4,6
107018,107018,,0,0,25,25
107019,107019,,25,3,4,7
107021,107021,,25,2,4,6
107023,107023,,25,0,13,13
107024,107024,,25,2,12,14
107025,107025,,0,9,28,37
107027,107027,,11,1,3,4
107028,107028,,34,6,14,20
9909040,9909040,,34,3,12,15
107029,107029,,11,1,11,12
9205050,9205050,,11,1,0,1
9304071,9304071,,11,5,1,6
107030,107030,,11,0,3,3
107031,107031,,34,20,27,47
107067,107067,,34,22,39,61
107183,107183,,34,3,12,15
107032,107032,,34,0,76,76
107033,107033,,3,3,14,17
107034,107034,,0,5,6,11
107035,107035,,65,4,17,21
9701173,9701173,,1,7,11,18
9606166,9606166,,1,1,1,2
107036,107036,,54,20,40,60
107038,107038,,2,0,31,31
9211020,9211020,,2,1,0,1
9503148,9503148,,25,1,5,6
9910049,9910049,,2,4,16,20
9508081,9508081,,2,1,0,1
107039,107039,,7,29,7,36
107041,107041,,2,2,1,3
107042,107042,,0,2,1,3
107043,107043,,4,4,6,10
9903009,9903009,,4,1,0,1
107044,107044,,54,21,21,42
107045,107045,,25,5,3,8
9703042,9703042,,25,2,0,2
107046,107046,,4,18,18,36
107047,107047,,7,0,2,2
105140,105140,,7,1,0,1
107048,107048,,7,10,10,20
9412093,9412093,,7,2,0,2
9204059,9204059,,7,3,0,3
9403106,9403106,,7,1,1,2
9507103,9507103,,7,1,1,2
107049,107049,,25,2,11,13
107050,107050,,62,4,12,16
107052,107052,,54,0,4,4
107053,107053,,7,0,9,9
107054,107054,,7,9,9,18
107055,107055,,3,19,33,52
107056,107056,,62,2,6,8
107057,107057,,34,27,49,76
107058,107058,,19,0,2,2
11150,11150,,19,1,0,1
107059,107059,,54,0,5,5
107060,107060,,2,3,11,14
107061,107061,,2,13,18,31
107062,107062,,3,1,9,10
107063,107063,,37,6,25,31
9406120,9406120,,37,3,1,4
9607132,9607132,,16,4,0,4
107064,107064,,6,1,6,7
107065,107065,,0,4,20,24
107066,107066,,2,2,15,17
9804148,9804148,,11,1,3,4
107068,107068,,3,2,14,16
107069,107069,,11,0,1,1
107070,107070,,4,1,22,23
107071,107071,,34,12,28,40
107072,107072,,37,1,24,25
107073,107073,,9,2,6,8
9507155,9507155,,9,10,3,13
9507156,9507156,,9,3,1,4
107074,107074,,11,4,5,9
107075,107075,,4,0,20,20
107078,107078,,3,8,11,19
107079,107079,,37,1,24,25
107080,107080,,11,3,3,6
107081,107081,,54,5,115,120
107090,107090,,54,7,58,65
107082,107082,,62,1,11,12
107083,107083,,25,1,19,20
107084,107084,,34,8,35,43
107085,107085,,0,0,7,7
107086,107086,,0,15,45,60
107087,107087,,3,4,34,38
107088,107088,,34,8,1,9
107089,107089,,25,1,25,26
209034,209034,,4,21,71,92
203211,203211,,4,109,63,172
203265,203265,,4,96,18,114
204008,204008,,4,67,12,79
204070,204070,,4,54,6,60
204084,204084,,4,49,26,75
204140,204140,,4,44,13,57
204143,204143,,4,80,45,125
204150,204150,,4,45,11,56
204187,204187,,4,44,10,54
204198,204198,,34,3,25,28
204203,204203,,4,24,72,96
204204,204204,,4,41,25,66
204252,204252,,4,25,8,33
205003,205003,,4,47,20,67
205055,205055,,4,20,14,34
205085,205085,,4,41,29,70
205098,205098,,4,39,30,69
205121,205121,,4,41,32,73
205140,205140,,4,20,14,34
205146,205146,,4,29,17,46
205179,205179,,4,34,34,68
206102,206102,,4,20,25,45
206212,206212,,4,23,37,60
207105,207105,,4,46,104,150
207119,207119,,4,32,27,59
207146,207146,,4,18,14,32
207156,207156,,4,34,55,89
208019,208019,,4,28,21,49
208023,208023,,4,14,28,42
208094,208094,,4,26,38,64
208124,208124,,4,18,19,37
208142,208142,,4,27,124,151
208217,208217,,4,13,44,57
107091,107091,,34,18,3,21
107092,107092,,2,0,10,10
107093,107093,,11,5,12,17
9906061,9906061,,11,11,13,24
9705073,9705073,,11,1,9,10
107095,107095,,11,0,5,5
107096,107096,,37,8,20,28
9812029,9812029,,37,3,2,5
9505131,9505131,,16,1,2,3
107097,107097,,2,5,10,15
107098,107098,,4,2,42,44
107099,107099,,3,16,29,45
107100,107100,,34,6,9,15
107101,107101,,4,28,16,44
9306029,9306029,,4,8,1,9
107102,107102,,0,5,16,21
107103,107103,,2,5,8,13
107104,107104,,6,4,15,19
107105,107105,,3,1,20,21
107106,107106,,3,15,33,48
107107,107107,,8,0,4,4
9607152,9607152,,8,1,2,3
9701040,9701040,,8,2,0,2
9410099,9410099,,37,2,8,10
107109,107109,,6,2,7,9
9609231,9609231,,6,4,8,12
107110,107110,,3,11,33,44
9604146,9604146,,3,3,4,7
9607086,9607086,,3,4,6,10
9704184,9704184,,3,3,5,8
107111,107111,,0,2,29,31
9601082,9601082,,54,3,2,5
107112,107112,,34,1,7,8
107113,107113,,2,3,23,26
107114,107114,,37,3,34,37
107116,107116,,4,17,35,52
107117,107117,,62,2,4,6
107118,107118,,1,4,9,13
107119,107119,,2,20,46,66
107120,107120,,19,5,16,21
107121,107121,,3,7,20,27
107122,107122,,8,0,1,1
103194,103194,,8,4,0,4
107123,107123,,2,4,14,18
107124,107124,,8,9,24,33
107125,107125,,25,2,2,4
107126,107126,,0,14,30,44
107127,107127,,3,1,21,22
107128,107128,,54,19,13,32
107004,107004,,54,22,0,22
107129,107129,,3,0,12,12
107130,107130,,54,8,4,12
107131,107131,,1,8,12,20
107132,107132,,34,0,10,10
107133,107133,,25,0,6,6
107136,107136,,54,8,1,9
107137,107137,,25,3,16,19
107138,107138,,54,64,38,102
107140,107140,,25,10,33,43
107141,107141,,0,3,10,13
107142,107142,,2,7,32,39
107143,107143,,54,73,39,112
9604183,9604183,,54,4,11,15
9704113,9704113,,54,4,10,14
9707249,9707249,,54,2,21,23
9708023,9708023,,54,1,13,14
107145,107145,,2,4,27,31
9609043,9609043,,2,3,7,10
107146,107146,,2,4,6,10
9612210,9612210,,2,4,3,7
9610182,9610182,,2,4,4,8
107147,107147,,3,10,28,38
107148,107148,,0,9,8,17
107151,107151,,37,0,57,57
9801187,9801187,,37,1,19,20
9812015,9812015,,37,1,1,2
9904210,9904210,,37,1,22,23
107152,107152,,37,6,69,75
107153,107153,,37,3,36,39
107154,107154,,3,1,3,4
107155,107155,,3,3,19,22
107216,107216,,3,7,12,19
107156,107156,,0,3,15,18
107157,107157,,16,1,9,10
9209027,9209027,,16,7,0,7
9705103,9705103,,16,6,8,14
107158,107158,,1,3,7,10
107159,107159,,54,10,15,25
107161,107161,,8,1,5,6
107162,107162,,37,9,21,30
107163,107163,,34,9,35,44
9412232,9412232,,34,3,5,8
9612197,9612197,,25,9,0,9
9912224,9912224,,2,1,11,12
107164,107164,,37,1,16,17
9605038,9605038,,1,2,0,2
107165,107165,,4,2,16,18
9908030,9908030,,4,1,5,6
107166,107166,,54,89,82,171
9409184,9409184,,54,1,1,2
9609137,9609137,,19,1,22,23
107167,107167,,54,3,60,63
107168,107168,,3,8,8,16
107170,107170,,101,1,1,2
107171,107171,,25,1,1,2
107172,107172,,3,6,59,65
107173,107173,,34,12,15,27
107174,107174,,0,2,9,11
107175,107175,,0,9,11,20
107176,107176,,54,3,37,40
107177,107177,,37,109,57,166
107178,107178,,3,11,34,45
107200,107200,,3,16,15,31
107179,107179,,3,5,21,26
107180,107180,,3,5,36,41
107181,107181,,2,9,6,15
107182,107182,,6,0,5,5
107184,107184,,3,3,27,30
107185,107185,,2,11,45,56
107187,107187,,11,1,18,19
107188,107188,,16,2,5,7
107189,107189,,1,12,33,45
107190,107190,,2,0,9,9
107191,107191,,7,0,11,11
9406109,9406109,,7,3,3,6
9508112,9508112,,7,2,2,4
107192,107192,,11,0,1,1
107193,107193,,62,6,10,16
9508025,9508025,,62,14,1,15
9610208,9610208,,62,5,5,10
9802100,9802100,,62,8,5,13
9908179,9908179,,62,2,4,6
9507056,9507056,,62,6,2,8
9511210,9511210,,62,5,4,9
9609123,9609123,,37,8,29,37
9611025,9611025,,62,1,4,5
107194,107194,,34,4,7,11
107195,107195,,37,5,12,17
107196,107196,,11,6,15,21
107197,107197,,4,7,40,47
107198,107198,,0,7,18,25
107199,107199,,3,8,27,35
107201,107201,,0,1,5,6
107203,107203,,4,1,7,8
107204,107204,,0,13,21,34
107205,107205,,7,1,9,10
107206,107206,,2,1,4,5
107207,107207,,16,2,7,9
107208,107208,,25,0,12,12
9811039,9811039,,25,2,5,7
9910038,9910038,,25,4,16,20
9908037,9908037,,25,2,5,7
107209,107209,,2,4,8,12
107210,107210,,7,0,6,6
9402059,9402059,,7,1,1,2
107211,107211,,8,0,2,2
107212,107212,,34,11,56,67
107213,107213,,34,0,27,27
107214,107214,,2,4,19,23
107215,107215,,3,5,24,29
107217,107217,,37,2,18,20
107218,107218,,34,1,6,7
107220,107220,,34,7,29,36
107221,107221,,11,3,6,9
9906034,9906034,,11,3,8,11
9906062,9906062,,11,1,0,1
9908158,9908158,,11,2,6,8
9312007,9312007,,11,2,0,2
9712123,9712123,,11,4,1,5
9712244,9712244,,11,4,0,4
9802136,9802136,,11,3,4,7
9805035,9805035,,11,1,2,3
107222,107222,,54,3,14,17
107223,107223,,0,5,7,12
107224,107224,,34,5,5,10
107225,107225,,3,8,13,21
107226,107226,,3,0,31,31
107227,107227,,0,3,24,27
107228,107228,,0,2,9,11
107229,107229,,2,4,21,25
9506192,9506192,,2,2,11,13
9505147,9505147,,2,3,6,9
107230,107230,,0,2,1,3
107231,107231,,4,1,4,5
107232,107232,,0,0,19,19
107234,107234,,34,5,27,32
9907052,9907052,,25,1,9,10
9811058,9811058,,25,1,5,6
107235,107235,,16,2,1,3
102068,102068,,16,1,0,1
107236,107236,,62,1,5,6
107237,107237,,3,0,1,1
204149,204149,,3,9,16,25
107251,107251,,3,36,62,98
108216,108216,,3,2,15,17
112127,112127,,3,6,37,43
203260,203260,,3,11,31,42
107238,107238,,34,9,19,28
107239,107239,,6,10,7,17
107240,107240,,19,0,1,1
107241,107241,,0,1,15,16
9411031,9411031,,7,2,1,3
9412053,9412053,,7,1,10,11
107243,107243,,34,9,8,17
107244,107244,,0,4,23,27
107245,107245,,54,12,6,18
107246,107246,,16,4,4,8
107247,107247,,25,4,21,25
9407096,9407096,,25,5,2,7
9506089,9506089,,25,2,26,28
9210106,9210106,,25,2,0,2
9403080,9403080,,7,4,1,5
9406056,9406056,,25,5,13,18
9410157,9410157,,25,2,9,11
9411069,9411069,,7,1,2,3
9502058,9502058,,25,1,8,9
107248,107248,,62,1,19,20
107250,107250,,3,2,19,21
107252,107252,,7,1,11,12
107253,107253,,54,0,5,5
107255,107255,,7,4,14,18
9505167,9505167,,2,3,9,12
9411076,9411076,,2,3,7,10
9505151,9505151,,2,2,8,10
107256,107256,,62,1,4,5
107257,107257,,54,7,8,15
107258,107258,,7,0,8,8
9707101,9707101,,7,7,1,8
9812173,9812173,,7,2,1,3
9706166,9706166,,7,5,1,6
107259,107259,,34,1,21,22
107260,107260,,65,3,5,8
9703202,9703202,,65,3,5,8
107261,107261,,34,12,26,38
107262,107262,,34,1,13,14
107263,107263,,54,1,22,23
9308149,9308149,,54,1,0,1
107264,107264,,54,24,13,37
107265,107265,,65,2,22,24
107266,107266,,7,1,2,3
107267,107267,,3,2,20,22
108001,108001,,1,14,27,41
108002,108002,,65,2,26,28
108003,108003,,0,15,32,47
108017,108017,,0,5,22,27
108004,108004,,25,1,12,13
108005,108005,,54,5,7,12
108007,108007,,3,21,29,50
109121,109121,,3,14,20,34
109070,109070,,3,20,53,73
108008,108008,,8,1,53,54
108009,108009,,62,0,6,6
108010,108010,,54,21,17,38
108011,108011,,34,1,17,18
108014,108014,,3,0,8,8
108015,108015,,62,0,4,4
106270,106270,,62,1,0,1
108016,108016,,34,8,40,48
108018,108018,,11,1,17,18
108020,108020,,37,6,20,26
108021,108021,,7,1,8,9
108022,108022,,16,0,4,4
9811225,9811225,,16,5,9,14
108023,108023,,37,2,13,15
108024,108024,,16,0,4,4
108025,108025,,0,4,20,24
108026,108026,,2,1,8,9
108027,108027,,7,0,2,2
108028,108028,,54,1,9,10
9606076,9606076,,54,2,4,6
9509054,9509054,,54,4,2,6
9510073,9510073,,54,1,0,1
108030,108030,,0,0,1,1
101009,101009,,0,5,0,5
108031,108031,,11,1,14,15
108032,108032,,25,0,12,12
108034,108034,,11,12,11,23
108035,108035,,65,3,18,21
108036,108036,,25,3,18,21
108037,108037,,65,0,13,13
108038,108038,,3,0,14,14
108039,108039,,62,2,9,11
9704070,9704070,,62,2,8,10
108041,108041,,2,4,13,17
111102,111102,,2,17,22,39
204240,204240,,2,12,18,30
108070,108070,,2,8,16,24
108042,108042,,37,3,10,13
108043,108043,,4,8,82,90
108044,108044,,65,27,11,38
108046,108046,,2,2,10,12
108047,108047,,11,0,13,13
108050,108050,,25,2,25,27
9810050,9810050,,2,3,17,20
108051,108051,,11,0,25,25
108053,108053,,25,0,12,12
108054,108054,,1,0,6,6
108055,108055,,0,11,57,68
108056,108056,,0,2,20,22
108057,108057,,7,3,1,4
108058,108058,,37,4,5,9
108059,108059,,37,0,11,11
9304039,9304039,,25,6,1,7
108060,108060,,25,0,1,1
108061,108061,,16,9,9,18
111176,111176,,16,7,3,10
9210033,9210033,,16,2,4,6
9202022,9202022,,16,1,1,2
108062,108062,,6,2,15,17
108063,108063,,62,2,14,16
108064,108064,,37,14,10,24
108065,108065,,0,8,13,21
108066,108066,,6,0,4,4
9512003,9512003,,6,1,1,2
9609226,9609226,,6,1,8,9
9407177,9407177,,6,2,3,5
108067,108067,,0,0,3,3
104051,104051,,0,1,0,1
9807148,9807148,,34,5,2,7
108068,108068,,0,4,22,26
9302055,9302055,,0,4,1,5
9402110,9402110,,0,2,2,4
9405020,9405020,,0,3,1,4
9208052,9208052,,0,3,0,3
9303128,9303128,,0,5,1,6
108069,108069,,2,0,12,12
108071,108071,,62,0,3,3
108072,108072,,3,3,9,12
108073,108073,,0,3,9,12
108074,108074,,8,0,4,4
108076,108076,,3,6,10,16
108077,108077,,62,1,20,21
108078,108078,,54,9,11,20
108079,108079,,3,0,10,10
108080,108080,,34,23,24,47
108081,108081,,0,0,12,12
108082,108082,,11,1,11,12
9905009,9905009,,11,3,5,8
9901075,9901075,,11,2,6,8
9906063,9906063,,11,2,7,9
108083,108083,,6,0,24,24
108084,108084,,34,6,17,23
108085,108085,,4,10,46,56
108087,108087,,1,1,7,8
108089,108089,,54,14,2,16
108090,108090,,16,6,1,7
108091,108091,,37,20,23,43
108092,108092,,34,4,37,41
108012,108012,,34,1,0,1
108093,108093,,1,8,8,16
108094,108094,,54,5,35,40
108095,108095,,65,4,18,22
108096,108096,,3,5,14,19
108097,108097,,11,2,10,12
108098,108098,,34,2,13,15
108099,108099,,16,0,9,9
107094,107094,,34,9,0,9
108100,108100,,65,35,32,67
108101,108101,,34,28,41,69
108102,108102,,65,15,12,27
108103,108103,,3,0,15,15
9911203,9911203,,3,1,20,21
108104,108104,,3,3,14,17
108105,108105,,6,5,6,11
108106,108106,,34,12,20,32
108107,108107,,19,0,18,18
9602171,9602171,,19,3,3,6
9306094,9306094,,19,3,0,3
9310106,9310106,,19,2,0,2
9412119,9412119,,19,7,4,11
108108,108108,,4,0,2,2
108109,108109,,0,3,8,11
108110,108110,,37,6,4,10
108111,108111,,7,4,5,9
108113,108113,,3,3,36,39
108114,108114,,34,13,17,30
108115,108115,,34,13,12,25
108116,108116,,25,1,8,9
9902130,9902130,,25,2,7,9
108117,108117,,54,5,8,13
9410101,9410101,,25,1,4,5
9310093,9310093,,25,3,0,3
108118,108118,,3,19,22,41
108119,108119,,34,32,26,58
110048,110048,,34,11,15,26
110087,110087,,34,73,18,91
111072,111072,,34,19,13,32
112218,112218,,34,70,48,118
112223,112223,,34,46,66,112
112226,112226,,34,24,56,80
202127,202127,,34,14,34,48
203191,203191,,34,9,52,61
203235,203235,,34,8,38,46
203268,203268,,34,16,49,65
205119,205119,,34,14,17,31
205315,205315,,34,6,27,33
205316,205316,,34,15,21,36
109096,109096,,34,8,15,23
109168,109168,,34,23,11,34
109010,109010,,34,11,11,22
110089,110089,,34,25,10,35
110189,110189,,34,11,41,52
112002,112002,,34,17,28,45
112066,112066,,34,10,33,43
112079,112079,,0,18,23,41
112140,112140,,34,19,45,64
112152,112152,,34,14,51,65
112093,112093,,34,19,30,49
110196,110196,,1,35,8,43
110271,110271,,4,39,22,61
201158,201158,,7,27,32,59
202028,202028,,31,3,23,26
202094,202094,,34,22,40,62
110072,110072,,34,24,10,34
112253,112253,,34,24,33,57
201174,201174,,34,13,34,47
201176,201176,,34,12,43,55
201210,201210,,34,9,81,90
202008,202008,,34,12,52,64
202073,202073,,34,7,18,25
202096,202096,,34,9,15,24
202098,202098,,34,7,13,20
202161,202161,,34,3,7,10
202163,202163,,34,37,3,40
202193,202193,,34,6,59,65
203003,203003,,34,10,15,25
203083,203083,,34,10,42,52
203101,203101,,34,32,107,139
112147,112147,,4,39,32,71
201004,201004,,34,21,57,78
203019,203019,,4,35,39,74
203208,203208,,34,7,38,45
203219,203219,,34,7,15,22
112177,112177,,2,10,25,35
203074,203074,,2,3,8,11
203206,203206,,54,19,9,28
204156,204156,,34,14,7,21
111025,111025,,4,28,32,60
202112,202112,,34,2,8,10
202124,202124,,54,36,31,67
203163,203163,,4,27,35,62
112197,112197,,54,12,28,40
201028,201028,,54,47,29,76
201029,201029,,54,31,27,58
204027,204027,,34,13,18,31
205080,205080,,34,8,29,37
205101,205101,,4,35,33,68
205177,205177,,34,10,37,47
108120,108120,,37,37,30,67
108121,108121,,1,8,8,16
108122,108122,,34,3,24,27
108123,108123,,2,2,19,21
9702123,9702123,,2,1,12,13
108124,108124,,7,4,11,15
108125,108125,,3,0,12,12
108126,108126,,65,7,38,45
108127,108127,,54,3,15,18
108128,108128,,2,3,34,37
9410178,9410178,,14,2,1,3
108130,108130,,16,0,21,21
108131,108131,,54,32,13,45
108132,108132,,0,1,5,6
108133,108133,,0,10,25,35
108134,108134,,25,0,14,14
108135,108135,,54,11,35,46
108136,108136,,9,0,3,3
9804169,9804169,,3,2,2,4
108137,108137,,37,15,29,44
108138,108138,,11,2,8,10
108140,108140,,4,16,22,38
108141,108141,,16,2,16,18
108142,108142,,65,20,15,35
108143,108143,,3,7,18,25
108144,108144,,2,0,9,9
108145,108145,,3,4,10,14
108146,108146,,11,0,1,1
108147,108147,,34,5,16,21
108148,108148,,65,0,4,4
108149,108149,,2,0,9,9
9806002,9806002,,2,6,12,18
9503104,9503104,,8,5,27,32
9507007,9507007,,2,5,5,10
9508103,9508103,,16,6,4,10
108151,108151,,7,2,10,12
108152,108152,,65,14,44,58
108153,108153,,0,7,12,19
108154,108154,,3,1,18,19
108155,108155,,37,0,5,5
108156,108156,,0,4,31,35
108157,108157,,62,7,22,29
108158,108158,,3,7,27,34
108159,108159,,9,0,7,7
9609045,9609045,,9,7,2,9
9801196,9801196,,9,3,11,14
9903073,9903073,,9,2,3,5
9905088,9905088,,9,1,9,10
9612097,9612097,,9,3,5,8
9701104,9701104,,9,4,10,14
108160,108160,,7,0,5,5
108161,108161,,2,2,48,50
9901059,9901059,,2,1,27,28
9205033,9205033,,2,2,0,2
108162,108162,,1,1,5,6
108163,108163,,11,3,2,5
108164,108164,,0,3,7,10
108165,108165,,37,50,18,68
108166,108166,,16,1,8,9
108167,108167,,2,6,26,32
9602066,9602066,,2,4,0,4
9702177,9702177,,2,3,1,4
9703001,9703001,,2,2,2,4
108168,108168,,34,0,20,20
108169,108169,,2,17,22,39
108170,108170,,34,6,6,12
108171,108171,,6,0,1,1
108173,108173,,7,0,3,3
108174,108174,,2,2,24,26
108175,108175,,11,0,1,1
9510063,9510063,,11,1,1,2
108176,108176,,2,14,22,36
108177,108177,,16,0,6,6
9809080,9809080,,16,1,2,3
9902139,9902139,,16,2,0,2
9910187,9910187,,16,1,1,2
9403146,9403146,,11,6,2,8
108178,108178,,4,2,22,24
108179,108179,,0,11,30,41
108180,108180,,0,1,5,6
108181,108181,,2,1,15,16
108182,108182,,34,8,14,22
108183,108183,,54,13,27,40
108184,108184,,54,18,5,23
108185,108185,,54,13,6,19
9911075,9911075,,54,2,3,5
108186,108186,,3,4,12,16
108188,108188,,37,0,2,2
9907153,9907153,,37,1,0,1
108189,108189,,2,1,15,16
108190,108190,,7,5,7,12
108191,108191,,2,9,30,39
108193,108193,,0,0,19,19
108196,108196,,4,22,26,48
108197,108197,,3,1,5,6
108198,108198,,2,0,38,38
9806201,9806201,,2,1,13,14
108199,108199,,25,0,15,15
108201,108201,,65,14,8,22
108202,108202,,4,2,29,31
108203,108203,,62,6,15,21
108204,108204,,6,3,20,23
108205,108205,,34,17,46,63
108206,108206,,65,4,9,13
9304042,9304042,,62,6,0,6
108207,108207,,2,12,18,30
108208,108208,,0,2,10,12
108209,108209,,34,1,8,9
108210,108210,,0,1,2,3
108211,108211,,62,0,19,19
108212,108212,,34,0,7,7
108213,108213,,8,3,2,5
9811113,9811113,,8,2,1,3
108214,108214,,62,2,3,5
9205105,9205105,,62,3,0,3
108215,108215,,0,14,36,50
108217,108217,,16,0,2,2
9601176,9601176,,16,2,0,2
108218,108218,,54,6,7,13
9206083,9206083,,54,8,1,9
9210030,9210030,,54,1,0,1
108219,108219,,37,15,11,26
108220,108220,,54,8,27,35
9911197,9911197,,34,2,13,15
108221,108221,,37,14,24,38
108222,108222,,3,1,9,10
108223,108223,,25,0,6,6
9704166,9704166,,25,1,6,7
9602169,9602169,,25,2,6,8
108225,108225,,19,1,13,14
9809141,9809141,,11,4,2,6
108226,108226,,37,19,14,33
108228,108228,,3,4,4,8
108229,108229,,37,22,46,68
108230,108230,,54,2,25,27
108231,108231,,37,0,34,34
108232,108232,,65,1,10,11
108233,108233,,2,0,24,24
108234,108234,,37,15,30,45
108235,108235,,34,5,18,23
108236,108236,,65,6,7,13
108237,108237,,0,3,8,11
108238,108238,,4,20,15,35
108239,108239,,34,3,15,18
108240,108240,,25,2,13,15
9411065,9411065,,25,2,0,2
9411109,9411109,,25,6,0,6
9910068,9910068,,25,4,4,8
9807043,9807043,,25,4,1,5
108242,108242,,6,0,10,10
108243,108243,,7,0,4,4
108244,108244,,54,6,25,31
9806157,9806157,,54,3,11,14
108245,108245,,37,38,36,74
109025,109025,,37,29,44,73
109001,109001,,7,0,1,1
109002,109002,,7,2,5,7
109003,109003,,19,5,3,8
109005,109005,,2,2,7,9
9210153,9210153,,1,1,0,1
109006,109006,,7,1,3,4
9711004,9711004,,7,3,1,4
9509156,9509156,,7,1,1,2
109007,109007,,7,0,4,4
109008,109008,,7,6,16,22
9510066,9510066,,7,2,1,3
109009,109009,,8,4,3,7
109011,109011,,11,0,3,3
109013,109013,,37,2,44,46
9210142,9210142,,54,2,0,2
109014,109014,,9,1,6,7
9502019,9502019,,9,2,2,4
9408107,9408107,,9,1,0,1
109015,109015,,3,1,9,10
109016,109016,,11,0,1,1
109017,109017,,0,15,30,45
109210,109210,,34,1,2,3
109018,109018,,3,4,8,12
109019,109019,,4,14,20,34
109020,109020,,3,5,12,17
109021,109021,,65,11,14,25
109022,109022,,7,4,7,11
109023,109023,,11,2,3,5
109024,109024,,0,4,16,20
109027,109027,,2,0,6,6
109028,109028,,3,0,1,1
109029,109029,,4,1,40,41
109030,109030,,2,11,18,29
109031,109031,,2,0,12,12
109032,109032,,4,5,32,37
109034,109034,,14,0,4,4
109035,109035,,3,0,3,3
109036,109036,,1,1,6,7
109037,109037,,8,0,1,1
109038,109038,,0,3,33,36
109039,109039,,34,18,24,42
109040,109040,,0,2,11,13
109041,109041,,2,2,3,5
109042,109042,,46,2,2,4
109043,109043,,16,1,8,9
9205073,9205073,,16,7,0,7
9304059,9304059,,16,1,3,4
9312111,9312111,,54,1,2,3
109044,109044,,4,0,10,10
109045,109045,,16,1,16,17
109046,109046,,8,0,3,3
109047,109047,,2,0,4,4
109048,109048,,37,6,13,19
109049,109049,,4,1,25,26
109051,109051,,1,9,7,16
109052,109052,,7,0,9,9
109053,109053,,37,25,18,43
109054,109054,,54,8,64,72
109055,109055,,54,4,47,51
109056,109056,,9,2,2,4
9902039,9902039,,9,4,0,4
109058,109058,,4,2,17,19
109059,109059,,1,2,26,28
109060,109060,,11,0,7,7
109062,109062,,62,0,5,5
109063,109063,,37,23,32,55
9712225,9712225,,37,1,5,6
109064,109064,,34,13,28,41
109065,109065,,34,13,36,49
109066,109066,,3,0,11,11
109068,109068,,54,5,5,10
109069,109069,,37,9,52,61
109071,109071,,11,2,3,5
109072,109072,,8,0,6,6
9409160,9409160,,8,5,4,9
109073,109073,,2,5,5,10
109074,109074,,54,0,9,9
109075,109075,,37,11,18,29
109076,109076,,37,5,37,42
109077,109077,,9,4,14,18
109078,109078,,62,0,3,3
109079,109079,,3,7,16,23
109080,109080,,2,0,1,1
109081,109081,,34,1,20,21
109082,109082,,54,15,12,27
109083,109083,,65,2,5,7
109084,109084,,3,13,22,35
109085,109085,,62,0,8,8
9510185,9510185,,62,7,8,15
9903198,9903198,,62,1,7,8
9211014,9211014,,62,3,0,3
9303073,9303073,,62,2,2,4
9304152,9304152,,62,8,4,12
9310062,9310062,,62,2,3,5
9305059,9305059,,62,2,1,3
9502076,9502076,,62,1,1,2
9811223,9811223,,6,2,6,8
109086,109086,,0,6,7,13
109087,109087,,0,6,6,12
109088,109088,,8,0,1,1
109089,109089,,6,4,7,11
109090,109090,,0,6,8,14
109091,109091,,3,2,27,29
109092,109092,,34,1,109,110
109094,109094,,34,11,17,28
109095,109095,,3,2,9,11
109097,109097,,37,5,16,21
205025,205025,,37,7,16,23
9905025,9905025,,37,2,2,4
110178,110178,,3,2,34,36
202172,202172,,37,5,26,31
109098,109098,,37,7,7,14
109099,109099,,0,4,50,54
109100,109100,,4,6,21,27
109101,109101,,54,3,9,12
109102,109102,,3,6,40,46
109103,109103,,2,0,5,5
9912043,9912043,,2,1,11,12
109104,109104,,34,1,3,4
9507095,9507095,,34,1,1,2
109105,109105,,19,0,13,13
109106,109106,,7,2,11,13
109107,109107,,3,7,40,47
109108,109108,,34,3,7,10
109109,109109,,2,1,5,6
109110,109110,,0,10,5,15
109111,109111,,3,10,15,25
109112,109112,,2,0,18,18
109113,109113,,8,0,3,3
109114,109114,,0,4,31,35
109115,109115,,62,4,7,11
109117,109117,,62,2,7,9
109118,109118,,6,1,4,5
104148,104148,,6,2,0,2
109119,109119,,0,9,10,19
112037,112037,,34,4,37,41
201128,201128,,34,12,28,40
204065,204065,,0,6,3,9
204066,204066,,0,18,21,39
204083,204083,,34,6,56,62
109198,109198,,34,7,15,22
9207012,9207012,,34,1,1,2
110213,110213,,34,4,24,28
111027,111027,,3,4,29,33
110105,110105,,2,1,8,9
111136,111136,,34,2,35,37
201117,201117,,34,6,5,11
111190,111190,,37,4,21,25
112196,112196,,34,2,15,17
201247,201247,,34,7,40,47
202048,202048,,34,7,30,37
202052,202052,,34,3,34,37
110001,110001,,34,3,3,6
112258,112258,,34,23,20,43
203258,203258,,34,4,1,5
204014,204014,,34,6,9,15
204030,204030,,34,8,13,21
109123,109123,,7,1,12,13
9903264,9903264,,7,1,3,4
109124,109124,,3,1,9,10
109125,109125,,3,2,18,20
109126,109126,,37,4,18,22
109127,109127,,34,10,48,58
109128,109128,,7,12,4,16
109129,109129,,34,1,21,22
109130,109130,,3,4,33,37
109131,109131,,4,1,32,33
109132,109132,,3,8,5,13
109134,109134,,3,1,5,6
109136,109136,,8,1,4,5
109137,109137,,31,2,23,25
109138,109138,,65,0,1,1
109139,109139,,2,1,9,10
9702036,9702036,,2,2,2,4
109140,109140,,0,1,11,12
109141,109141,,37,2,10,12
109142,109142,,16,0,3,3
109143,109143,,19,0,1,1
9404144,9404144,,19,3,1,4
9310010,9310010,,19,2,0,2
109144,109144,,0,0,2,2
109145,109145,,6,7,1,8
109146,109146,,3,2,9,11
109147,109147,,2,6,42,48
109148,109148,,11,3,15,18
109149,109149,,2,0,15,15
109150,109150,,1,14,25,39
109151,109151,,2,1,32,33
9912127,9912127,,2,2,10,12
9606041,9606041,,2,1,11,12
9606042,9606042,,2,1,17,18
9608021,9608021,,16,1,10,11
109152,109152,,37,65,14,79
109153,109153,,2,2,6,8
109154,109154,,34,9,46,55
9209036,9209036,,25,3,3,6
9211085,9211085,,25,4,0,4
109155,109155,,54,0,33,33
9904155,9904155,,54,1,21,22
109156,109156,,11,1,2,3
109157,109157,,3,0,11,11
109158,109158,,3,0,4,4
109159,109159,,37,6,8,14
109160,109160,,2,1,25,26
109161,109161,,3,1,8,9
9707165,9707165,,6,2,1,3
109162,109162,,3,105,212,317
110113,110113,,3,18,40,58
110066,110066,,3,11,30,41
110093,110093,,3,25,25,50
109163,109163,,3,3,11,14
109164,109164,,37,0,17,17
109165,109165,,31,18,7,25
109166,109166,,25,1,2,3
109167,109167,,11,0,2,2
9606137,9606137,,11,1,4,5
9212022,9212022,,25,4,0,4
9310038,9310038,,37,3,0,3
109169,109169,,11,0,1,1
109170,109170,,37,0,24,24
109171,109171,,6,1,3,4
109172,109172,,6,6,1,7
109173,109173,,54,5,30,35
109174,109174,,34,22,24,46
109175,109175,,54,11,18,29
109176,109176,,3,8,57,65
109177,109177,,34,21,24,45
109178,109178,,0,3,2,5
109179,109179,,7,3,15,18
109180,109180,,0,1,14,15
109182,109182,,4,23,69,92
109183,109183,,2,5,21,26
109184,109184,,8,0,25,25
9308038,9308038,,8,2,3,5
9411185,9411185,,8,1,4,5
109185,109185,,7,1,1,2
109186,109186,,3,5,24,29
109187,109187,,4,5,30,35
109189,109189,,11,5,3,8
109190,109190,,7,0,8,8
109191,109191,,3,9,28,37
109192,109192,,2,2,24,26
109193,109193,,2,2,10,12
109194,109194,,0,1,23,24
109195,109195,,3,1,18,19
109196,109196,,2,2,15,17
109197,109197,,54,1,25,26
109200,109200,,1,8,22,30
109201,109201,,34,3,2,5
109202,109202,,11,1,11,12
109203,109203,,6,0,1,1
109204,109204,,3,8,14,22
109205,109205,,11,1,2,3
9510196,9510196,,11,2,0,2
109207,109207,,34,0,4,4
109208,109208,,16,1,3,4
109209,109209,,3,18,43,61
109211,109211,,54,0,6,6
109212,109212,,62,0,101,101
9802070,9802070,,62,2,5,7
9208079,9208079,,62,7,0,7
9209015,9209015,,62,4,0,4
9304140,9304140,,62,1,0,1
9501138,9501138,,62,1,3,4
9505180,9505180,,62,1,0,1
9612029,9612029,,62,2,16,18
9612252,9612252,,62,2,1,3
9712249,9712249,,62,1,19,20
9708047,9708047,,2,3,7,10
9710096,9710096,,2,1,14,15
109214,109214,,37,11,19,30
109215,109215,,16,0,6,6
9907049,9907049,,16,1,4,5
9401063,9401063,,16,1,0,1
9504125,9504125,,16,5,0,5
9505165,9505165,,16,2,1,3
109216,109216,,0,1,28,29
109217,109217,,37,5,39,44
109218,109218,,11,2,4,6
109219,109219,,8,4,10,14
109220,109220,,6,3,15,18
109223,109223,,62,1,5,6
109224,109224,,11,7,5,12
9410019,9410019,,11,3,0,3
110002,110002,,4,5,38,43
110003,110003,,11,0,2,2
9706220,9706220,,11,3,4,7
9607199,9607199,,11,2,1,3
9610240,9610240,,11,2,3,5
110004,110004,,11,2,10,12
110005,110005,,3,1,39,40
110006,110006,,3,7,31,38
110008,110008,,65,1,19,20
110009,110009,,16,0,1,1
110010,110010,,11,0,5,5
110011,110011,,2,0,4,4
9801203,9801203,,25,1,1,2
110013,110013,,0,0,7,7
110015,110015,,0,0,2,2
110016,110016,,11,1,4,5
9811070,9811070,,11,2,11,13
9806210,9806210,,6,1,5,6
110017,110017,,8,0,5,5
110018,110018,,0,4,17,21
9808110,9808110,,14,3,3,6
9907025,9907025,,14,2,5,7
9306015,9306015,,0,1,5,6
9312034,9312034,,14,2,0,2
110019,110019,,3,1,22,23
110020,110020,,7,2,22,24
110021,110021,,11,13,23,36
110022,110022,,54,7,17,24
110023,110023,,6,2,1,3
9504009,9504009,,62,3,3,6
110024,110024,,34,4,20,24
110025,110025,,54,1,15,16
110026,110026,,11,6,48,54
110027,110027,,34,0,4,4
110028,110028,,37,60,74,134
9411183,9411183,,54,1,8,9
110029,110029,,25,2,8,10
110030,110030,,2,0,5,5
109120,109120,,6,2,0,2
110032,110032,,25,0,18,18
110033,110033,,11,0,5,5
110034,110034,,34,32,30,62
110035,110035,,3,11,22,33
206013,206013,,3,8,31,39
110101,110101,,3,6,8,14
110177,110177,,3,8,7,15
111006,111006,,3,3,12,15
112027,112027,,3,3,22,25
201251,201251,,3,6,3,9
202065,202065,,3,5,50,55
205094,205094,,3,3,6,9
206014,206014,,3,5,10,15
110036,110036,,54,1,33,34
110038,110038,,6,0,1,1
110039,110039,,2,23,22,45
110040,110040,,7,4,4,8
110041,110041,,4,6,42,48
110042,110042,,11,0,2,2
9704084,9704084,,11,3,2,5
9906050,9906050,,11,2,0,2
110043,110043,,19,0,5,5
110044,110044,,25,2,5,7
110045,110045,,6,0,3,3
110046,110046,,3,7,32,39
9907162,9907162,,2,1,1,2
110047,110047,,11,0,8,8
110049,110049,,0,6,19,25
110117,110117,,0,5,21,26
110050,110050,,37,36,50,86
110051,110051,,25,2,7,9
9502016,9502016,,25,5,0,5
110052,110052,,7,0,3,3
9707030,9707030,,7,2,1,3
110053,110053,,2,2,4,6
110054,110054,,11,8,21,29
110055,110055,,0,5,302,307
9309064,9309064,,4,5,0,5
9309101,9309101,,65,1,2,3
9507055,9507055,,11,1,2,3
9704110,9704110,,2,1,61,62
9510068,9510068,,2,4,0,4
110056,110056,,34,1,3,4
110058,110058,,16,1,20,21
110059,110059,,3,5,15,20
110061,110061,,34,1,1,2
104019,104019,,34,1,0,1
110063,110063,,54,5,16,21
110065,110065,,54,3,9,12
110067,110067,,19,3,33,36
110068,110068,,3,0,11,11
9310147,9310147,,3,1,0,1
110069,110069,,2,8,18,26
110070,110070,,0,12,13,25
110071,110071,,37,17,35,52
110073,110073,,54,17,5,22
110074,110074,,2,5,17,22
110075,110075,,49,2,1,3
110076,110076,,11,0,14,14
110077,110077,,4,24,18,42
110078,110078,,11,0,2,2
9805010,9805010,,19,1,9,10
9611102,9611102,,19,1,7,8
110079,110079,,7,7,15,22
111257,111257,,7,2,4,6
110080,110080,,14,5,6,11
9808010,9808010,,14,2,2,4
110081,110081,,62,2,8,10
110082,110082,,25,2,1,3
12243,12243,,25,3,0,3
110084,110084,,2,0,96,96
9909184,9909184,,2,2,24,26
110085,110085,,34,0,14,14
110088,110088,,0,0,21,21
110090,110090,,3,0,9,9
110091,110091,,25,0,6,6
110092,110092,,4,4,13,17
110094,110094,,4,1,16,17
110096,110096,,2,7,19,26
110097,110097,,62,2,4,6
110098,110098,,37,3,15,18
110099,110099,,4,27,32,59
110107,110107,,4,26,39,65
110200,110200,,4,18,67,85
110170,110170,,4,31,24,55
110186,110186,,4,18,33,51
110100,110100,,3,0,11,11
110102,110102,,46,5,1,6
110103,110103,,0,4,25,29
110104,110104,,37,0,9,9
110106,110106,,2,2,10,12
110109,110109,,34,11,26,37
110110,110110,,54,1,20,21
9506056,9506056,,54,1,4,5
110111,110111,,0,4,38,42
110112,110112,,3,5,43,48
110114,110114,,3,17,16,33
9611126,9611126,,11,3,1,4
9702125,9702125,,11,3,1,4
9703006,9703006,,11,2,2,4
9703018,9703018,,11,2,2,4
110115,110115,,37,17,52,69
110116,110116,,62,4,8,12
9601049,9601049,,62,2,10,12
110118,110118,,0,2,31,33
110119,110119,,3,1,18,19
110120,110120,,11,1,2,3
9902114,9902114,,11,2,5,7
110121,110121,,54,5,24,29
110122,110122,,3,4,18,22
302221,302221,,54,8,56,64
201205,201205,,54,35,59,94
202024,202024,,54,15,35,50
203160,203160,,54,33,50,83
203187,203187,,54,29,56,85
204037,204037,,3,3,25,28
206038,206038,,54,42,135,177
208014,208014,,54,17,80,97
208103,208103,,54,16,28,44
209064,209064,,54,7,25,32
209202,209202,,54,16,45,61
210083,210083,,54,13,77,90
210088,210088,,54,8,46,54
210200,210200,,54,13,52,65
210227,210227,,54,2,25,27
211059,211059,,54,18,57,75
211269,211269,,37,15,22,37
212177,212177,,54,13,49,62
110124,110124,,4,33,10,43
110125,110125,,62,0,4,4
110126,110126,,62,0,1,1
110127,110127,,11,2,10,12
110129,110129,,34,5,10,15
110131,110131,,37,0,13,13
110132,110132,,54,4,29,33
110133,110133,,65,9,15,24
9212154,9212154,,65,10,0,10
9308043,9308043,,65,4,1,5
9205031,9205031,,65,9,0,9
110134,110134,,3,5,26,31
110135,110135,,19,3,8,11
110136,110136,,4,22,29,51
110137,110137,,0,1,4,5
110138,110138,,3,0,3,3
110139,110139,,65,0,4,4
110140,110140,,6,4,10,14
110141,110141,,0,4,15,19
110142,110142,,34,1,25,26
110145,110145,,19,0,7,7
110146,110146,,54,19,29,48
110147,110147,,3,6,22,28
110149,110149,,0,10,4,14
110150,110150,,0,1,2,3
109135,109135,,0,5,0,5
110151,110151,,37,3,6,9
110152,110152,,3,4,13,17
110153,110153,,11,2,11,13
110154,110154,,0,0,4,4
110155,110155,,8,1,1,2
110156,110156,,16,0,7,7
9707086,9707086,,16,1,1,2
110157,110157,,16,0,10,10
110158,110158,,65,5,7,12
110159,110159,,37,2,4,6
110160,110160,,19,3,13,16
110161,110161,,34,0,8,8
110162,110162,,0,6,19,25
110163,110163,,54,0,1,1
110164,110164,,4,9,16,25
110165,110165,,62,2,3,5
9306134,9306134,,8,6,1,7
110167,110167,,7,16,16,32
109033,109033,,7,4,0,4
9902127,9902127,,7,3,0,3
9502130,9502130,,31,4,3,7
110168,110168,,1,0,12,12
9604120,9604120,,1,2,9,11
110171,110171,,37,22,44,66
110172,110172,,2,7,26,33
9709201,9709201,,8,3,3,6
9503160,9503160,,8,3,1,4
110174,110174,,34,8,45,53
203230,203230,,34,1,0,1
110175,110175,,34,1,19,20
110176,110176,,19,2,13,15
110179,110179,,8,0,3,3
9412069,9412069,,8,1,5,6
9401151,9401151,,8,1,0,1
9408114,9408114,,8,3,1,4
9411087,9411087,,7,1,6,7
110180,110180,,16,2,3,5
9209033,9209033,,25,2,0,2
9209081,9209081,,2,3,1,4
110181,110181,,62,0,4,4
110182,110182,,25,0,11,11
9310132,9310132,,25,2,0,2
110183,110183,,3,7,15,22
110184,110184,,37,4,38,42
110185,110185,,16,3,3,6
110187,110187,,54,15,33,48
110188,110188,,37,10,48,58
9704092,9704092,,37,1,9,10
9910017,9910017,,34,3,25,28
110190,110190,,0,0,4,4
110191,110191,,3,12,32,44
110192,110192,,34,0,45,45
9806175,9806175,,2,3,19,22
110193,110193,,0,18,8,26
110195,110195,,34,5,7,12
110198,110198,,34,3,7,10
110199,110199,,16,1,1,2
110201,110201,,54,1,54,55
110202,110202,,34,5,8,13
110203,110203,,3,3,31,34
110204,110204,,4,19,13,32
110206,110206,,2,3,20,23
110207,110207,,2,2,12,14
9806154,9806154,,2,7,20,27
9811189,9811189,,2,7,12,19
9608140,9608140,,2,2,15,17
9806247,9806247,,2,1,4,5
9807009,9807009,,2,2,11,13
9604175,9604175,,2,6,7,13
9610222,9610222,,2,3,13,16
110208,110208,,31,0,2,2
110209,110209,,37,4,39,43
110210,110210,,62,0,1,1
110211,110211,,6,3,8,11
110212,110212,,19,0,5,5
110214,110214,,34,1,19,20
9708080,9708080,,16,5,15,20
9701138,9701138,,16,2,8,10
110215,110215,,3,11,29,40
110216,110216,,34,6,26,32
110217,110217,,25,0,6,6
110218,110218,,62,2,17,19
110219,110219,,65,12,24,36
110220,110220,,36,1,1,2
12127,12127,,36,2,0,2
110221,110221,,7,3,4,7
110222,110222,,34,0,6,6
110223,110223,,8,1,7,8
110224,110224,,11,0,2,2
110225,110225,,31,10,21,31
110226,110226,,7,25,4,29
110227,110227,,2,1,11,12
110229,110229,,11,0,2,2
110230,110230,,34,1,5,6
110231,110231,,3,5,4,9
110232,110232,,37,22,44,66
9301089,9301089,,54,3,0,3
9604140,9604140,,54,7,13,20
110233,110233,,38,0,1,1
9810196,9810196,,38,1,0,1
110235,110235,,34,3,12,15
110252,110252,,34,9,23,32
110236,110236,,37,0,3,3
9709149,9709149,,37,1,2,3
110237,110237,,19,0,1,1
104096,104096,,19,2,0,2
110239,110239,,34,1,10,11
110240,110240,,37,5,25,30
110241,110241,,11,7,13,20
110242,110242,,1,205,10,215
110243,110243,,16,2,7,9
110244,110244,,1,16,9,25
110245,110245,,2,0,13,13
110246,110246,,7,0,15,15
110247,110247,,54,16,10,26
110248,110248,,2,4,12,16
110249,110249,,19,1,9,10
110250,110250,,0,7,35,42
9411089,9411089,,0,2,1,3
110251,110251,,8,2,1,3
110255,110255,,0,1,16,17
110256,110256,,37,1,3,4
110257,110257,,2,1,2,3
110258,110258,,0,12,14,26
110260,110260,,0,27,8,35
110259,110259,,16,1,7,8
110261,110261,,62,0,36,36
110262,110262,,1,1,17,18
9202005,9202005,,1,4,0,4
9312154,9312154,,1,3,12,15
9701131,9701131,,1,3,8,11
9704146,9704146,,1,3,8,11
9906218,9906218,,1,4,17,21
110263,110263,,54,2,28,30
110264,110264,,6,2,7,9
9911244,9911244,,6,1,10,11
110266,110266,,65,2,7,9
9911078,9911078,,65,2,3,5
9402126,9402126,,65,2,0,2
9511120,9511120,,65,3,1,4
110267,110267,,65,12,19,31
110268,110268,,3,0,6,6
110269,110269,,0,6,9,15
110270,110270,,65,1,14,15
110272,110272,,0,3,4,7
110273,110273,,0,0,15,15
110274,110274,,2,11,120,131
9804102,9804102,,2,1,7,8
9904077,9904077,,2,4,17,21
9606030,9606030,,2,1,2,3
110275,110275,,9,0,2,2
9605120,9605120,,11,2,3,5
110276,110276,,8,0,10,10
110277,110277,,54,11,30,41
110278,110278,,19,3,8,11
110279,110279,,19,3,18,21
110280,110280,,54,8,15,23
110281,110281,,34,1,42,43
110282,110282,,62,1,4,5
110283,110283,,54,13,11,24
110284,110284,,0,3,15,18
110285,110285,,25,1,1,2
110286,110286,,0,7,58,65
111089,111089,,0,7,21,28
112028,112028,,0,6,13,19
111030,111030,,31,28,8,36
110287,110287,,8,1,12,13
110288,110288,,37,2,25,27
110289,110289,,34,2,18,20
110290,110290,,25,1,1,2
110291,110291,,3,3,26,29
110292,110292,,34,3,8,11
110293,110293,,3,9,41,50
110294,110294,,25,2,11,13
110295,110295,,11,0,5,5
9410038,9410038,,11,3,0,3
110296,110296,,2,0,1,1
110297,110297,,3,3,9,12
110298,110298,,0,10,59,69
110299,110299,,0,4,18,22
110300,110300,,7,2,14,16
110301,110301,,34,6,9,15
110302,110302,,37,15,19,34
9209042,9209042,,65,8,0,8
9211073,9211073,,65,2,1,3
111001,111001,,34,17,15,32
9704179,9704179,,25,3,2,5
9602044,9602044,,25,7,1,8
111002,111002,,65,13,32,45
111004,111004,,4,11,14,25
111005,111005,,3,1,9,10
108019,108019,,25,3,0,3
111009,111009,,16,1,2,3
111010,111010,,16,0,1,1
111011,111011,,34,2,3,5
111012,111012,,37,15,28,43
208165,208165,,4,13,45,58
201039,201039,,4,30,12,42
201081,201081,,1,212,10,222
202187,202187,,4,49,28,77
202210,202210,,4,89,19,108
203031,203031,,4,53,29,82
203112,203112,,4,46,10,56
203201,203201,,4,37,11,48
204071,204071,,4,41,36,77
204144,204144,,4,37,30,67
204158,204158,,4,39,42,81
204168,204168,,4,63,18,81
204189,204189,,4,43,27,70
204261,204261,,4,37,34,71
205246,205246,,34,12,14,26
205288,205288,,4,27,17,44
205290,205290,,4,18,19,37
206057,206057,,4,22,23,45
206182,206182,,4,47,29,76
206196,206196,,4,35,47,82
206228,206228,,4,39,22,61
207123,207123,,34,5,46,51
207214,207214,,4,15,55,70
208107,208107,,4,11,67,78
208108,208108,,4,5,11,16
208126,208126,,4,18,14,32
9908192,9908192,,34,5,15,20
111013,111013,,3,6,45,51
111014,111014,,8,0,7,7
111015,111015,,0,2,21,23
111016,111016,,54,10,2,12
111017,111017,,34,4,23,27
111018,111018,,11,1,4,5
111019,111019,,0,0,8,8
111020,111020,,3,4,14,18
111022,111022,,11,0,4,4
9712041,9712041,,11,1,1,2
9212033,9212033,,11,1,1,2
111023,111023,,7,0,5,5
111024,111024,,54,0,3,3
111026,111026,,2,4,14,18
112073,112073,,2,6,30,36
111028,111028,,25,2,3,5
111029,111029,,11,0,3,3
111031,111031,,1,13,3,16
111032,111032,,0,0,2,2
111033,111033,,3,0,13,13
111034,111034,,4,40,17,57
111035,111035,,25,1,6,7
111036,111036,,2,6,14,20
111037,111037,,25,0,2,2
111038,111038,,3,3,14,17
111039,111039,,19,1,9,10
107076,107076,,19,1,0,1
111040,111040,,54,10,4,14
111041,111041,,3,5,10,15
111042,111042,,0,1,3,4
111043,111043,,37,0,4,4
111044,111044,,2,1,49,50
111045,111045,,0,1,9,10
111046,111046,,54,1,21,22
111047,111047,,25,0,5,5
111048,111048,,37,11,42,53
111050,111050,,37,6,40,46
111051,111051,,4,32,25,57
111052,111052,,0,0,14,14
111053,111053,,62,1,5,6
9506215,9506215,,62,2,12,14
111054,111054,,3,1,18,19
111055,111055,,31,4,17,21
111056,111056,,0,1,2,3
111057,111057,,0,17,33,50
111059,111059,,3,4,33,37
111060,111060,,34,18,30,48
111061,111061,,3,5,11,16
111062,111062,,37,5,24,29
111063,111063,,11,3,1,4
111064,111064,,3,3,19,22
111065,111065,,34,0,1,1
111066,111066,,37,2,28,30
111068,111068,,2,13,9,22
111069,111069,,4,40,31,71
111070,111070,,0,1,23,24
111073,111073,,25,1,19,20
111074,111074,,11,2,2,4
111075,111075,,13,0,2,2
9905119,9905119,,13,1,1,2
111076,111076,,3,0,4,4
111077,111077,,3,1,16,17
111079,111079,,3,1,48,49
111080,111080,,54,5,8,13
111081,111081,,0,2,10,12
111082,111082,,34,5,36,41
111084,111084,,25,1,1,2
111086,111086,,37,3,32,35
111087,111087,,4,29,19,48
111088,111088,,39,0,1,1
5216,5216,,39,1,0,1
111091,111091,,25,4,31,35
111092,111092,,4,26,19,45
111094,111094,,3,1,16,17
111095,111095,,3,0,8,8
9905047,9905047,,3,1,5,6
9706200,9706200,,3,2,6,8
111096,111096,,37,15,18,33
9505141,9505141,,37,2,1,3
111097,111097,,34,1,18,19
9411042,9411042,,34,1,0,1
111098,111098,,31,32,14,46
111277,111277,,0,13,15,28
204091,204091,,4,22,26,48
112026,112026,,31,7,6,13
112128,112128,,31,16,22,38
112249,112249,,31,14,26,40
203013,203013,,31,14,25,39
111099,111099,,2,3,14,17
111100,111100,,37,0,7,7
9406170,9406170,,37,1,0,1
111101,111101,,6,2,18,20
111103,111103,,3,1,9,10
111104,111104,,34,0,20,20
111105,111105,,2,0,3,3
111106,111106,,2,8,31,39
111107,111107,,0,3,19,22
111108,111108,,7,1,3,4
111109,111109,,3,1,21,22
111110,111110,,7,3,12,15
111111,111111,,3,0,5,5
111112,111112,,11,0,4,4
111113,111113,,37,13,35,48
111114,111114,,65,0,5,5
111116,111116,,62,2,2,4
111117,111117,,37,2,5,7
111118,111118,,0,0,11,11
111120,111120,,9,1,2,3
111121,111121,,2,9,24,33
111123,111123,,4,2,6,8
111124,111124,,65,0,9,9
111125,111125,,16,0,3,3
111126,111126,,2,6,16,22
111127,111127,,0,7,30,37
111128,111128,,37,5,37,42
111129,111129,,4,65,58,123
111130,111130,,2,7,23,30
111131,111131,,25,1,8,9
9611030,9611030,,25,1,1,2
111132,111132,,0,2,7,9
111133,111133,,3,1,15,16
111134,111134,,8,4,9,13
111135,111135,,34,36,23,59
111180,111180,,1,29,32,61
111210,111210,,65,29,35,64
203020,203020,,1,17,22,39
111161,111161,,65,10,8,18
9708135,9708135,,62,6,8,14
111138,111138,,25,3,4,7
111140,111140,,56,1,1,2
3107,3107,,56,2,0,2
111141,111141,,25,1,7,8
111142,111142,,34,9,18,27
111143,111143,,7,0,1,1
111144,111144,,62,0,11,11
111145,111145,,3,5,28,33
111146,111146,,19,2,16,18
111148,111148,,16,0,5,5
9801186,9801186,,16,2,0,2
9804054,9804054,,16,2,0,2
9904057,9904057,,16,1,5,6
9710131,9710131,,16,3,0,3
9710132,9710132,,16,3,1,4
111149,111149,,2,5,46,51
111150,111150,,2,2,9,11
111151,111151,,4,2,45,47
111152,111152,,11,0,5,5
9904093,9904093,,11,1,8,9
111154,111154,,4,38,43,81
111155,111155,,4,20,11,31
111156,111156,,34,7,29,36
112180,112180,,2,11,42,53
111157,111157,,65,2,6,8
111083,111083,,65,2,0,2
111158,111158,,2,2,16,18
9606029,9606029,,19,3,13,16
111159,111159,,11,8,25,33
111160,111160,,3,8,29,37
9303109,9303109,,25,2,4,6
9207117,9207117,,25,8,1,9
9210081,9210081,,25,3,1,4
9210082,9210082,,25,1,1,2
111162,111162,,6,2,7,9
111163,111163,,34,6,23,29
111165,111165,,37,28,65,93
9802193,9802193,,54,1,13,14
111166,111166,,0,0,15,15
111167,111167,,0,3,1,4
202105,202105,,0,1,1,2
111168,111168,,0,11,9,20
111169,111169,,4,5,21,26
111171,111171,,9,3,2,5
111172,111172,,7,0,3,3
111173,111173,,3,1,5,6
111174,111174,,3,3,2,5
111175,111175,,8,0,8,8
111177,111177,,4,10,29,39
111178,111178,,34,4,15,19
111179,111179,,54,30,57,87
111181,111181,,34,7,31,38
201017,201017,,34,7,34,41
204049,204049,,34,6,42,48
201187,201187,,34,6,25,31
202173,202173,,2,5,22,27
111183,111183,,0,1,20,21
111184,111184,,11,0,2,2
105150,105150,,11,1,0,1
111185,111185,,0,1,2,3
111186,111186,,62,1,4,5
111187,111187,,54,2,53,55
111188,111188,,62,0,7,7
111189,111189,,65,20,43,63
111205,111205,,65,6,7,13
111191,111191,,11,9,10,19
202188,202188,,11,6,25,31
112087,112087,,11,2,11,13
202167,202167,,11,1,19,20
203005,203005,,11,7,30,37
203006,203006,,11,6,29,35
111192,111192,,9,2,13,15
111194,111194,,11,0,3,3
103065,103065,,11,1,0,1
107249,107249,,11,1,0,1
111195,111195,,62,0,6,6
111198,111198,,37,8,26,34
111199,111199,,4,15,44,59
111212,111212,,4,31,36,67
111200,111200,,3,10,11,21
201070,201070,,3,11,37,48
111249,111249,,3,12,22,34
112114,112114,,3,12,21,33
111202,111202,,14,0,9,9
111203,111203,,16,4,4,8
111204,111204,,3,0,1,1
111206,111206,,0,5,2,7
111207,111207,,0,1,20,21
111208,111208,,3,42,200,242
9902176,9902176,,3,1,0,1
9911149,9911149,,2,2,23,25
9404110,9404110,,7,2,8,10
111209,111209,,54,9,51,60
9709111,9709111,,54,3,0,3
9801003,9801003,,54,1,1,2
9703085,9703085,,62,7,4,11
111211,111211,,6,2,12,14
9605084,9605084,,6,4,0,4
9712053,9712053,,6,2,9,11
9801096,9801096,,6,4,3,7
9506163,9506163,,6,2,4,6
111213,111213,,7,1,3,4
111214,111214,,11,0,2,2
9802166,9802166,,11,2,1,3
9904158,9904158,,11,1,1,2
111215,111215,,2,1,23,24
111216,111216,,6,1,6,7
111218,111218,,0,1,19,20
111219,111219,,2,1,10,11
111220,111220,,37,3,11,14
111221,111221,,65,11,15,26
111222,111222,,2,14,40,54
111223,111223,,11,2,3,5
111224,111224,,34,5,30,35
9910213,9910213,,34,4,12,16
111225,111225,,34,0,30,30
111226,111226,,54,3,6,9
111227,111227,,34,5,6,11
9905068,9905068,,2,2,25,27
111229,111229,,34,2,16,18
111230,111230,,65,11,13,24
111231,111231,,54,2,16,18
111232,111232,,8,0,5,5
111233,111233,,62,0,2,2
111235,111235,,54,2,17,19
111236,111236,,3,0,38,38
111115,111115,,3,2,0,2
9709009,9709009,,3,1,7,8
9610114,9610114,,3,3,5,8
111237,111237,,2,0,1,1
111239,111239,,37,1,19,20
9704159,9704159,,25,1,5,6
9401060,9401060,,25,3,1,4
111240,111240,,2,0,2,2
111241,111241,,16,0,4,4
111242,111242,,25,0,6,6
111243,111243,,62,2,2,4
111244,111244,,11,2,6,8
111245,111245,,65,0,13,13
111246,111246,,6,6,13,19
111248,111248,,16,0,7,7
111251,111251,,0,0,1,1
111252,111252,,65,2,2,4
111253,111253,,6,5,8,13
111254,111254,,54,1,31,32
111255,111255,,34,0,6,6
111256,111256,,11,18,16,34
111258,111258,,6,1,29,30
111273,111273,,6,1,12,13
9609108,9609108,,6,1,2,3
9803029,9803029,,6,2,13,15
111259,111259,,34,1,9,10
9211141,9211141,,16,5,0,5
9901040,9901040,,34,3,2,5
9901047,9901047,,34,3,1,4
9902167,9902167,,34,3,10,13
9602025,9602025,,16,5,0,5
9607039,9607039,,16,3,0,3
111260,111260,,8,11,42,53
9209001,9209001,,8,1,0,1
111261,111261,,62,3,33,36
9805197,9805197,,62,2,4,6
9908184,9908184,,62,1,7,8
111263,111263,,16,3,10,13
9410053,9410053,,16,3,9,12
9905072,9905072,,16,3,8,11
9806019,9806019,,2,3,18,21
9810233,9810233,,16,3,5,8
111264,111264,,54,3,4,7
111265,111265,,6,1,6,7
111266,111266,,0,12,25,37
111267,111267,,3,8,10,18
111268,111268,,0,1,7,8
111269,111269,,54,5,14,19
111270,111270,,6,0,7,7
111271,111271,,2,0,1,1
111272,111272,,6,0,1,1
111274,111274,,37,21,10,31
111275,111275,,8,4,28,32
111278,111278,,2,12,18,30
111279,111279,,0,6,40,46
111280,111280,,16,2,8,10
9903131,9903131,,16,4,7,11
9907151,9907151,,16,1,4,5
111281,111281,,4,50,16,66
111282,111282,,16,0,4,4
111283,111283,,46,0,3,3
111284,111284,,54,1,108,109
111285,111285,,3,5,6,11
111286,111286,,6,0,3,3
111287,111287,,0,2,13,15
111288,111288,,54,1,8,9
111289,111289,,62,0,6,6
111290,111290,,34,7,29,36
111291,111291,,0,1,11,12
112004,112004,,37,3,11,14
112005,112005,,37,4,33,37
112006,112006,,54,0,17,17
112008,112008,,8,11,46,57
112010,112010,,34,4,8,12
112011,112011,,7,2,1,3
112012,112012,,54,6,22,28
112013,112013,,0,13,29,42
112115,112115,,0,10,19,29
112205,112205,,0,10,22,32
112014,112014,,11,5,6,11
112015,112015,,54,11,21,32
112016,112016,,19,1,2,3
112018,112018,,16,0,2,2
112019,112019,,0,5,36,41
112020,112020,,0,1,13,14
112021,112021,,0,0,1,1
112022,112022,,2,2,6,8
9512057,9512057,,2,4,2,6
9501031,9501031,,2,3,2,5
112023,112023,,62,5,20,25
112024,112024,,8,1,6,7
112025,112025,,3,2,11,13
9401032,9401032,,3,3,0,3
112029,112029,,37,1,25,26
112030,112030,,19,1,10,11
112032,112032,,11,0,29,29
112033,112033,,19,2,2,4
112034,112034,,2,13,12,25
112035,112035,,34,2,11,13
112038,112038,,14,3,40,43
9909018,9909018,,34,1,8,9
9909160,9909160,,14,1,5,6
112039,112039,,37,7,2,9
112040,112040,,37,19,75,94
112041,112041,,34,16,8,24
112042,112042,,2,1,15,16
112043,112043,,2,3,44,47
112044,112044,,1,242,20,262
9701141,9701141,,1,3,7,10
112046,112046,,54,4,6,10
112047,112047,,0,7,44,51
112048,112048,,2,1,26,27
112049,112049,,3,4,8,12
112050,112050,,3,14,34,48
112051,112051,,11,0,8,8
9704155,9704155,,11,1,0,1
112052,112052,,46,2,4,6
112053,112053,,3,4,27,31
112054,112054,,2,25,13,38
112055,112055,,34,17,10,27
112056,112056,,25,4,27,31
112057,112057,,6,1,5,6
9712210,9712210,,6,3,4,7
9207003,9207003,,6,2,0,2
112058,112058,,34,1,27,28
112059,112059,,34,5,45,50
112154,112154,,34,11,39,50
112119,112119,,34,21,36,57
112150,112150,,34,6,33,39
112060,112060,,7,1,1,2
112061,112061,,31,0,4,4
112062,112062,,6,2,1,3
112063,112063,,1,3,17,20
112064,112064,,3,9,26,35
112065,112065,,54,0,26,26
112068,112068,,25,0,6,6
9209021,9209021,,25,3,1,4
112069,112069,,7,1,10,11
112070,112070,,6,1,6,7
112071,112071,,2,8,35,43
112072,112072,,2,4,19,23
112074,112074,,3,1,10,11
112075,112075,,2,2,21,23
112077,112077,,0,4,7,11
112078,112078,,65,8,21,29
112080,112080,,0,10,31,41
112081,112081,,2,3,31,34
112082,112082,,37,1,13,14
112083,112083,,3,0,16,16
112084,112084,,4,6,20,26
112085,112085,,0,1,34,35
112086,112086,,25,1,12,13
9911239,9911239,,65,1,12,13
112088,112088,,4,1,14,15
112089,112089,,11,3,10,13
112090,112090,,7,32,3,35
112091,112091,,62,0,3,3
112092,112092,,3,10,17,27
112094,112094,,8,4,50,54
112095,112095,,8,4,31,35
9502133,9502133,,62,4,0,4
9502135,9502135,,8,3,0,3
9503011,9503011,,62,2,3,5
9703023,9703023,,62,3,9,12
9705180,9705180,,62,1,7,8
9708094,9708094,,8,3,6,9
9405138,9405138,,62,6,1,7
9410070,9410070,,62,1,0,1
9410071,9410071,,62,1,1,2
9604072,9604072,,62,4,3,7
9605141,9605141,,62,3,2,5
9511009,9511009,,62,1,3,4
9611117,9611117,,62,1,11,12
9611005,9611005,,62,2,5,7
9611006,9611006,,62,2,0,2
112096,112096,,37,1,9,10
112097,112097,,62,0,18,18
112098,112098,,37,22,11,33
112099,112099,,34,3,25,28
112100,112100,,34,12,18,30
112101,112101,,4,8,47,55
112102,112102,,14,2,9,11
112103,112103,,6,1,1,2
9704019,9704019,,6,2,1,3
112104,112104,,19,2,31,33
112105,112105,,16,1,2,3
112106,112106,,2,6,17,23
112107,112107,,34,0,16,16
112109,112109,,37,1,36,37
112110,112110,,7,5,1,6
201046,201046,,7,6,6,12
112111,112111,,19,1,7,8
9710159,9710159,,19,4,6,10
9906083,9906083,,19,3,9,12
9609146,9609146,,19,2,6,8
9609147,9609147,,19,4,4,8
112112,112112,,0,2,28,30
112113,112113,,37,32,36,68
112116,112116,,2,0,34,34
112117,112117,,37,6,20,26
112118,112118,,54,0,15,15
112120,112120,,7,2,2,4
112121,112121,,6,0,6,6
112122,112122,,7,19,10,29
112125,112125,,7,2,27,29
112158,112158,,7,7,16,23
202077,202077,,7,3,34,37
112126,112126,,34,18,44,62
203275,203275,,6,5,1,6
205180,205180,,34,16,25,41
112129,112129,,25,0,5,5
112130,112130,,65,1,9,10
112131,112131,,34,4,23,27
112132,112132,,2,2,22,24
112133,112133,,2,2,22,24
112134,112134,,3,1,13,14
112135,112135,,4,4,18,22
112136,112136,,34,20,38,58
112137,112137,,2,0,38,38
112138,112138,,37,24,10,34
112139,112139,,3,6,14,20
112141,112141,,7,0,18,18
112142,112142,,11,0,4,4
112143,112143,,2,0,3,3
112145,112145,,34,3,53,56
112146,112146,,9,2,4,6
112148,112148,,0,2,11,13
101142,101142,,0,2,0,2
112149,112149,,6,0,5,5
112151,112151,,16,7,23,30
112153,112153,,3,2,26,28
112155,112155,,2,0,58,58
9512102,9512102,,2,2,11,13
112156,112156,,101,0,2,2
112157,112157,,54,6,9,15
201080,201080,,7,5,9,14
204224,204224,,7,2,5,7
9601025,9601025,,7,4,0,4
9801101,9801101,,7,1,5,6
9509088,9509088,,8,4,5,9
9606014,9606014,,8,2,2,4
112159,112159,,6,0,13,13
112160,112160,,1,14,24,38
112161,112161,,54,2,3,5
112162,112162,,1,11,17,28
112163,112163,,62,0,6,6
112164,112164,,34,5,21,26
112165,112165,,0,6,10,16
112166,112166,,0,11,14,25
112167,112167,,62,3,11,14
112168,112168,,62,2,15,17
112169,112169,,4,32,41,73
112170,112170,,6,4,18,22
112171,112171,,22,0,1,1
112173,112173,,4,5,34,39
112174,112174,,54,11,27,38
112175,112175,,6,4,7,11
9706044,9706044,,6,2,8,10
112176,112176,,3,3,42,45
112178,112178,,34,15,27,42
112264,112264,,34,16,12,28
201100,201100,,34,6,9,15
201172,201172,,34,7,13,20
201258,201258,,34,4,35,39
203041,203041,,34,8,17,25
203168,203168,,34,5,13,18
112179,112179,,62,1,2,3
112181,112181,,3,0,4,4
112182,112182,,34,4,9,13
112183,112183,,11,7,5,12
9307136,9307136,,6,5,1,6
112184,112184,,11,6,2,8
112185,112185,,3,3,31,34
112186,112186,,3,0,19,19
112187,112187,,34,11,30,41
112188,112188,,1,19,26,45
112189,112189,,3,2,28,30
112190,112190,,34,1,23,24
112191,112191,,34,5,9,14
112192,112192,,54,6,21,27
112193,112193,,65,5,34,39
112194,112194,,6,0,2,2
112195,112195,,34,15,52,67
112198,112198,,1,24,36,60
112199,112199,,4,8,33,41
112200,112200,,54,3,28,31
112201,112201,,19,0,7,7
9408067,9408067,,19,5,5,10
9502047,9502047,,19,3,2,5
112202,112202,,4,13,9,22
112203,112203,,4,3,18,21
112204,112204,,34,14,7,21
112206,112206,,2,4,23,27
112207,112207,,2,6,8,14
112208,112208,,11,1,1,2
112209,112209,,9,0,5,5
112210,112210,,2,2,10,12
112211,112211,,37,5,13,18
112212,112212,,7,0,9,9
9710133,9710133,,7,1,2,3
9907045,9907045,,7,4,2,6
112214,112214,,4,17,42,59
112231,112231,,4,21,35,56
112215,112215,,11,8,5,13
112217,112217,,0,5,7,12
112219,112219,,2,2,24,26
9411011,9411011,,4,1,1,2
112220,112220,,3,2,13,15
112221,112221,,37,2,32,34
112222,112222,,65,2,32,34
112224,112224,,0,4,8,12
112228,112228,,4,2,29,31
9711045,9711045,,4,1,5,6
112229,112229,,34,2,7,9
110205,110205,,34,4,0,4
112230,112230,,11,2,17,19
112233,112233,,2,4,23,27
9801029,9801029,,2,3,7,10
9809118,9809118,,2,3,12,15
9907011,9907011,,2,5,22,27
112234,112234,,65,0,1,1
112235,112235,,37,4,18,22
9308054,9308054,,11,3,0,3
112236,112236,,34,29,21,50
112238,112238,,3,0,11,11
112239,112239,,0,1,4,5
112240,112240,,34,0,4,4
112241,112241,,11,0,3,3
112242,112242,,11,0,6,6
112243,112243,,19,2,1,3
112244,112244,,0,5,20,25
112245,112245,,34,0,2,2
9611236,9611236,,34,4,0,4
9906066,9906066,,34,2,1,3
112246,112246,,3,4,8,12
112247,112247,,54,14,4,18
112248,112248,,3,12,25,37
112250,112250,,54,0,2,2
112251,112251,,34,11,32,43
112252,112252,,7,0,12,12
112254,112254,,34,2,20,22
112255,112255,,54,2,7,9
112256,112256,,3,2,2,4
112257,112257,,19,0,9,9
9609148,9609148,,19,1,3,4
9609149,9609149,,19,1,3,4
9404145,9404145,,19,2,0,2
9411139,9411139,,19,2,0,2
112259,112259,,54,2,12,14
112260,112260,,6,4,12,16
112261,112261,,2,7,5,12
112262,112262,,3,2,6,8
112263,112263,,11,2,7,9
201001,201001,,62,0,3,3
106130,106130,,62,1,0,1
9310158,9310158,,62,4,2,6
201002,201002,,3,0,18,18
9506082,9506082,,3,1,0,1
201003,201003,,14,0,2,2
9903097,9903097,,14,1,1,2
201005,201005,,6,1,10,11
201006,201006,,37,1,5,6
9911130,9911130,,37,2,6,8
201007,201007,,3,11,16,27
201008,201008,,62,2,19,21
201009,201009,,31,1,8,9
9805164,9805164,,31,1,5,6
201010,201010,,4,1,20,21
201011,201011,,11,1,8,9
201012,201012,,0,1,21,22
201013,201013,,11,4,7,11
201014,201014,,3,0,2,2
201015,201015,,4,41,28,69
201016,201016,,3,15,25,40
201018,201018,,7,2,12,14
201019,201019,,34,17,14,31
201022,201022,,37,0,8,8
201023,201023,,6,2,14,16
201025,201025,,3,3,30,33
201026,201026,,0,0,5,5
201027,201027,,1,2,13,15
201030,201030,,34,3,2,5
201031,201031,,2,3,9,12
201032,201032,,54,7,86,93
201033,201033,,3,0,9,9
201034,201034,,3,0,11,11
201035,201035,,4,3,35,38
201036,201036,,34,3,15,18
9610051,9610051,,62,6,3,9
9709162,9709162,,62,2,1,3
9710040,9710040,,62,1,2,3
201037,201037,,54,25,47,72
201038,201038,,37,2,9,11
201040,201040,,54,2,25,27
201041,201041,,0,4,26,30
201042,201042,,4,1,12,13
201043,201043,,6,0,2,2
201044,201044,,19,0,1,1
9606155,9606155,,19,6,0,6
201045,201045,,62,8,1,9
201047,201047,,62,2,25,27
201048,201048,,2,4,6,10
201049,201049,,7,0,4,4
9701003,9701003,,7,1,3,4
9604132,9604132,,7,1,0,1
201050,201050,,14,0,6,6
201051,201051,,0,2,19,21
201130,201130,,0,3,14,17
201052,201052,,62,2,5,7
201053,201053,,62,0,1,1
110197,110197,,62,2,0,2
201054,201054,,4,9,25,34
201055,201055,,0,2,11,13
201056,201056,,7,4,11,15
201057,201057,,19,2,12,14
201058,201058,,34,2,6,8
201059,201059,,6,3,40,43
9303154,9303154,,6,7,3,10
9304094,9304094,,25,2,2,4
9710100,9710100,,25,2,4,6
201060,201060,,4,14,22,36
201061,201061,,4,3,30,33
201062,201062,,37,6,55,61
201063,201063,,0,8,13,21
201064,201064,,11,1,3,4
9805061,9805061,,11,3,1,4
9704188,9704188,,11,2,0,2
201065,201065,,8,0,1,1
201066,201066,,0,2,19,21
201067,201067,,2,5,10,15
201068,201068,,19,0,2,2
9503051,9503051,,19,2,1,3
9307061,9307061,,19,1,0,1
201069,201069,,11,0,7,7
201071,201071,,8,0,10,10
9403151,9403151,,54,1,3,4
9802086,9802086,,8,1,5,6
201072,201072,,4,1,16,17
201073,201073,,6,0,21,21
201074,201074,,6,0,1,1
9403138,9403138,,6,2,1,3
201075,201075,,37,8,41,49
201076,201076,,34,2,43,45
201078,201078,,16,0,5,5
201079,201079,,34,4,33,37
9407115,9407115,,6,1,1,2
9409137,9409137,,6,3,5,8
201084,201084,,0,4,9,13
201085,201085,,40,0,1,1
104053,104053,,40,2,0,2
201086,201086,,19,0,7,7
201088,201088,,6,0,3,3
201089,201089,,65,6,15,21
201090,201090,,7,1,1,2
201091,201091,,8,7,22,29
9209065,9209065,,8,5,0,5
9301099,9301099,,8,18,8,26
9302114,9302114,,8,10,0,10
9303051,9303051,,8,9,2,11
9303058,9303058,,8,1,0,1
9304115,9304115,,8,15,7,22
9306019,9306019,,8,7,4,11
9306079,9306079,,8,4,2,6
9306129,9306129,,8,2,0,2
9307046,9307046,,8,9,6,15
9308114,9308114,,8,8,6,14
9309029,9309029,,8,1,0,1
9311084,9311084,,8,9,13,22
9402133,9402133,,8,5,2,7
9403185,9403185,,8,2,13,15
201093,201093,,37,8,29,37
201094,201094,,2,3,8,11
201095,201095,,4,21,31,52
201096,201096,,34,3,20,23
201097,201097,,4,0,7,7
201098,201098,,54,0,6,6
201099,201099,,8,5,28,33
201101,201101,,11,1,1,2
201102,201102,,37,0,14,14
201103,201103,,3,11,7,18
201104,201104,,16,3,7,10
201105,201105,,25,0,5,5
201106,201106,,2,3,17,20
201107,201107,,2,0,16,16
201108,201108,,62,0,20,20
201109,201109,,37,4,18,22
9206019,9206019,,37,5,0,5
9609207,9609207,,8,2,9,11
201110,201110,,11,0,6,6
201111,201111,,7,4,13,17
201113,201113,,4,4,36,40
201114,201114,,37,5,12,17
201116,201116,,34,3,1,4
9809016,9809016,,11,1,3,4
9710090,9710090,,11,1,2,3
201118,201118,,2,0,8,8
201119,201119,,25,0,1,1
201120,201120,,6,1,6,7
201121,201121,,0,4,22,26
201122,201122,,6,2,5,7
201123,201123,,62,0,2,2
9906212,9906212,,62,2,1,3
201124,201124,,6,4,5,9
201125,201125,,6,1,17,18
9912269,9912269,,6,2,13,15
201126,201126,,2,2,14,16
9702152,9702152,,2,2,6,8
9612139,9612139,,2,2,10,12
201127,201127,,0,14,36,50
201129,201129,,2,1,20,21
201131,201131,,6,1,2,3
201132,201132,,4,7,15,22
201133,201133,,25,3,13,16
201134,201134,,62,1,1,2
201135,201135,,3,2,34,36
201136,201136,,4,35,30,65
201137,201137,,2,0,4,4
201138,201138,,2,3,21,24
201139,201139,,6,4,11,15
201140,201140,,3,4,66,70
201141,201141,,14,1,6,7
201142,201142,,62,7,25,32
201144,201144,,3,15,37,52
201145,201145,,34,7,59,66
201146,201146,,65,3,14,17
201147,201147,,25,0,8,8
9812223,9812223,,25,1,1,2
201148,201148,,0,9,19,28
201149,201149,,4,17,14,31
201150,201150,,0,0,1,1
201151,201151,,1,10,18,28
201152,201152,,25,0,11,11
201153,201153,,4,0,9,9
201154,201154,,6,1,26,27
201155,201155,,37,3,19,22
201156,201156,,62,2,11,13
9301039,9301039,,62,2,1,3
9805160,9805160,,8,5,5,10
201157,201157,,9,4,3,7
9904176,9904176,,7,6,1,7
9904075,9904075,,4,17,3,20
201159,201159,,4,13,36,49
201160,201160,,19,0,1,1
9609143,9609143,,19,1,5,6
201161,201161,,3,1,12,13
201162,201162,,34,0,7,7
201163,201163,,2,0,5,5
201164,201164,,25,3,5,8
201165,201165,,16,3,21,24
9409066,9409066,,37,2,6,8
201166,201166,,2,0,10,10
201167,201167,,16,1,5,6
201168,201168,,6,3,1,4
201169,201169,,11,0,1,1
201170,201170,,34,2,6,8
201171,201171,,3,2,23,25
201173,201173,,65,8,43,51
201175,201175,,65,6,41,47
201177,201177,,4,19,17,36
201178,201178,,3,1,57,58
201179,201179,,11,7,20,27
201180,201180,,1,0,17,17
201181,201181,,16,0,14,14
201182,201182,,2,5,38,43
201183,201183,,2,5,24,29
205213,205213,,1,35,44,79
202021,202021,,1,328,34,362
202109,202109,,1,204,25,229
202153,202153,,1,81,21,102
202179,202179,,1,99,37,136
203028,203028,,1,65,27,92
203093,203093,,1,54,26,80
203124,203124,,1,63,80,143
203134,203134,,1,49,40,89
203140,203140,,1,56,49,105
203164,203164,,1,59,25,84
203186,203186,,1,50,35,85
203229,203229,,1,63,32,95
203249,203249,,1,59,24,83
203255,203255,,1,45,25,70
203257,203257,,1,54,33,87
204001,204001,,1,24,34,58
204004,204004,,1,62,56,118
204051,204051,,1,76,24,100
204054,204054,,1,81,73,154
204147,204147,,1,35,39,74
204174,204174,,1,29,42,71
204196,204196,,1,34,42,76
205006,205006,,1,18,25,43
205033,205033,,1,97,14,111
205048,205048,,1,79,49,128
205066,205066,,1,79,37,116
205067,205067,,1,23,80,103
205089,205089,,1,96,46,142
205174,205174,,1,32,20,52
205183,205183,,1,51,11,62
205185,205185,,1,45,23,68
201184,201184,,4,0,1,1
201185,201185,,4,9,34,43
201186,201186,,11,0,6,6
201188,201188,,31,1,12,13
201189,201189,,7,15,8,23
201190,201190,,65,0,7,7
201191,201191,,0,5,24,29
9510112,9510112,,0,3,0,3
201192,201192,,16,0,12,12
9301132,9301132,,7,5,0,5
9903148,9903148,,16,1,3,4
9903150,9903150,,16,1,2,3
201193,201193,,16,0,7,7
9906060,9906060,,2,2,13,15
201194,201194,,2,3,7,10
201195,201195,,8,0,1,1
201196,201196,,3,9,19,28
201197,201197,,4,12,56,68
203227,203227,,4,6,53,59
208009,208009,,4,5,41,46
201229,201229,,4,9,17,26
202030,202030,,4,18,30,48
202045,202045,,4,14,29,43
202087,202087,,4,35,16,51
202139,202139,,4,13,22,35
202151,202151,,4,22,44,66
202176,202176,,4,17,21,38
203089,203089,,4,8,13,21
203071,203071,,4,6,18,24
204012,204012,,4,20,46,66
204138,204138,,4,6,36,42
204155,204155,,4,9,32,41
204172,204172,,4,4,27,31
206208,206208,,4,7,24,31
201198,201198,,37,5,13,18
201199,201199,,16,0,12,12
201200,201200,,0,9,8,17
201201,201201,,0,2,6,8
201202,201202,,4,0,9,9
201203,201203,,3,1,4,5
201204,201204,,6,2,7,9
9804048,9804048,,6,1,5,6
9401012,9401012,,6,2,2,4
201206,201206,,2,4,26,30
201207,201207,,19,1,3,4
201208,201208,,7,0,1,1
201209,201209,,1,0,39,39
201212,201212,,14,0,2,2
9212092,9212092,,14,2,0,2
201213,201213,,25,0,12,12
201214,201214,,1,0,3,3
9411152,9411152,,1,4,4,8
201215,201215,,34,5,37,42
201216,201216,,4,2,8,10
201218,201218,,3,2,35,37
201219,201219,,25,0,5,5
201220,201220,,11,1,2,3
7084,7084,,11,1,0,1
201221,201221,,54,13,45,58
201222,201222,,3,25,5,30
201223,201223,,3,1,10,11
201224,201224,,34,12,28,40
201225,201225,,7,0,12,12
201227,201227,,37,11,55,66
201228,201228,,3,7,21,28
201231,201231,,1,0,7,7
201232,201232,,3,1,33,34
9903142,9903142,,34,1,18,19
201233,201233,,2,1,15,16
201234,201234,,54,1,3,4
201235,201235,,16,0,4,4
9506100,9506100,,16,2,3,5
201236,201236,,34,1,16,17
201237,201237,,11,4,11,15
201238,201238,,19,0,4,4
201239,201239,,65,6,5,11
201240,201240,,62,0,5,5
201241,201241,,0,12,16,28
201242,201242,,7,1,2,3
9701058,9701058,,6,2,3,5
201243,201243,,2,2,37,39
201244,201244,,2,1,17,18
201245,201245,,7,8,9,17
201246,201246,,11,1,4,5
201248,201248,,2,1,31,32
201249,201249,,4,3,18,21
201250,201250,,16,0,4,4
201252,201252,,16,1,9,10
9905186,9905186,,34,1,7,8
201254,201254,,4,3,17,20
201255,201255,,25,3,7,10
201256,201256,,54,3,23,26
201257,201257,,3,7,36,43
201259,201259,,3,2,14,16
201260,201260,,2,3,6,9
201261,201261,,0,1,4,5
201263,201263,,6,0,6,6
201265,201265,,34,3,10,13
201266,201266,,2,0,21,21
201267,201267,,37,5,25,30
201269,201269,,2,0,2,2
201270,201270,,34,5,29,34
201271,201271,,37,1,22,23
201272,201272,,34,4,31,35
202001,202001,,37,1,2,3
202002,202002,,37,5,26,31
202003,202003,,34,10,35,45
202004,202004,,11,0,1,1
202005,202005,,25,1,27,28
202006,202006,,2,0,10,10
9809137,9809137,,2,1,8,9
202007,202007,,37,2,13,15
202009,202009,,0,3,9,12
202010,202010,,25,1,15,16
202011,202011,,3,9,34,43
202012,202012,,0,10,23,33
202013,202013,,41,0,1,1
201217,201217,,41,1,0,1
202014,202014,,3,2,58,60
202015,202015,,3,1,2,3
202016,202016,,0,0,7,7
202017,202017,,31,18,22,40
202018,202018,,16,2,5,7
202019,202019,,0,0,3,3
202022,202022,,4,2,37,39
202023,202023,,9,4,9,13
202025,202025,,3,3,17,20
202027,202027,,2,4,16,20
202029,202029,,0,1,6,7
204260,204260,,4,20,45,65
204164,204164,,4,19,13,32
204239,204239,,4,12,22,34
205218,205218,,1,19,35,54
202031,202031,,8,0,7,7
202032,202032,,1,4,13,17
9202089,9202089,,25,3,0,3
202033,202033,,19,0,12,12
202034,202034,,7,1,10,11
202035,202035,,62,1,1,2
202036,202036,,25,2,8,10
202037,202037,,0,4,22,26
202038,202038,,11,1,3,4
9408009,9408009,,11,1,0,1
9410107,9410107,,11,1,1,2
202039,202039,,3,3,24,27
202040,202040,,3,5,18,23
202041,202041,,62,4,11,15
202042,202042,,0,1,9,10
202043,202043,,1,3,15,18
202044,202044,,0,1,27,28
202047,202047,,37,3,5,8
202049,202049,,0,0,12,12
202050,202050,,3,2,6,8
202051,202051,,1,1,16,17
9503198,9503198,,1,5,7,12
9604131,9604131,,1,4,10,14
202053,202053,,37,0,23,23
202054,202054,,14,3,7,10
202055,202055,,34,2,17,19
202056,202056,,34,20,23,43
202057,202057,,4,5,31,36
9508098,9508098,,42,1,3,4
9206042,9206042,,42,4,0,4
9310178,9310178,,42,1,2,3
9312066,9312066,,42,1,2,3
202058,202058,,54,7,3,10
202059,202059,,3,1,4,5
202062,202062,,3,2,10,12
202063,202063,,7,0,14,14
202064,202064,,34,4,28,32
202066,202066,,2,0,10,10
202067,202067,,65,7,12,19
202068,202068,,25,1,6,7
202069,202069,,65,9,8,17
202070,202070,,11,1,1,2
202071,202071,,16,0,18,18
202072,202072,,2,3,10,13
202074,202074,,4,3,19,22
202075,202075,,34,3,25,28
202076,202076,,25,4,4,8
9602013,9602013,,7,1,6,7
202078,202078,,3,0,19,19
202079,202079,,4,10,30,40
202080,202080,,7,0,13,13
202081,202081,,62,0,7,7
202082,202082,,11,5,11,16
9302085,9302085,,34,4,1,5
202083,202083,,34,1,47,48
202084,202084,,54,4,49,53
202085,202085,,62,2,11,13
202086,202086,,43,0,1,1
110095,110095,,43,1,0,1
202088,202088,,34,2,11,13
202089,202089,,25,1,4,5
202090,202090,,37,1,44,45
202091,202091,,0,3,16,19
9311186,9311186,,54,2,3,5
202092,202092,,3,2,15,17
202093,202093,,3,5,7,12
202095,202095,,16,2,1,3
202097,202097,,4,6,17,23
202099,202099,,3,2,4,6
202100,202100,,0,1,17,18
202101,202101,,7,1,12,13
202102,202102,,11,1,3,4
202103,202103,,54,0,13,13
202104,202104,,37,4,39,43
202106,202106,,3,1,15,16
9603056,9603056,,19,4,6,10
202108,202108,,16,1,5,6
202110,202110,,9,1,22,23
202111,202111,,1,118,27,145
202113,202113,,11,0,6,6
202114,202114,,6,0,10,10
202116,202116,,54,13,22,35
9411096,9411096,,54,10,1,11
202117,202117,,34,1,8,9
202118,202118,,2,10,26,36
202121,202121,,65,2,8,10
9408097,9408097,,65,4,5,9
9305170,9305170,,14,1,1,2
9207026,9207026,,65,1,0,1
9302084,9302084,,65,1,0,1
202122,202122,,0,0,3,3
202123,202123,,1,10,10,20
202125,202125,,37,8,9,17
202126,202126,,37,18,59,77
202128,202128,,4,1,2,3
202129,202129,,1,5,37,42
202130,202130,,0,0,9,9
202131,202131,,3,7,36,43
9904141,9904141,,1,1,17,18
202132,202132,,2,3,8,11
101012,101012,,2,4,0,4
9509076,9509076,,2,6,9,15
9904169,9904169,,2,4,7,11
9310174,9310174,,2,5,2,7
9206018,9206018,,14,2,0,2
9306140,9306140,,25,2,2,4
202133,202133,,4,11,15,26
202134,202134,,6,2,8,10
9609029,9609029,,6,2,1,3
202135,202135,,37,18,57,75
202136,202136,,0,2,19,21
202137,202137,,3,9,16,25
203038,203038,,3,12,20,32
204117,204117,,3,8,19,27
202138,202138,,2,2,16,18
202141,202141,,14,1,2,3
202142,202142,,7,21,11,32
202144,202144,,54,14,2,16
202145,202145,,11,0,16,16
202146,202146,,11,0,11,11
202147,202147,,0,4,15,19
9303059,9303059,,1,2,9,11
202148,202148,,4,13,58,71
202149,202149,,54,1,8,9
202150,202150,,1,18,20,38
202152,202152,,54,1,20,21
202154,202154,,2,0,2,2
9205005,9205005,,6,1,0,1
202155,202155,,34,2,10,12
202156,202156,,34,5,48,53
202157,202157,,1,91,21,112
202158,202158,,2,1,6,7
202159,202159,,8,0,1,1
9304070,9304070,,8,2,0,2
202160,202160,,34,0,14,14
202162,202162,,11,0,3,3
9908074,9908074,,37,1,4,5
202164,202164,,0,1,2,3
9407095,9407095,,19,2,1,3
202165,202165,,4,1,21,22
202166,202166,,0,1,10,11
202168,202168,,54,24,30,54
202169,202169,,6,1,1,2
202170,202170,,16,1,15,16
202171,202171,,3,6,39,45
202174,202174,,0,17,28,45
202175,202175,,34,2,25,27
202177,202177,,2,0,22,22
202178,202178,,11,4,21,25
202180,202180,,34,2,25,27
202181,202181,,65,0,18,18
202182,202182,,37,1,6,7
202183,202183,,34,5,28,33
202184,202184,,34,12,30,42
202185,202185,,7,0,4,4
202186,202186,,1,85,26,111
9306090,9306090,,4,2,0,2
208216,208216,,11,1,27,28
202189,202189,,0,8,22,30
202190,202190,,1,45,16,61
202191,202191,,2,1,39,40
202192,202192,,6,0,15,15
202194,202194,,9,2,3,5
202195,202195,,34,10,16,26
202196,202196,,37,0,14,14
9807053,9807053,,6,1,5,6
9806207,9806207,,6,1,1,2
202197,202197,,37,6,25,31
202199,202199,,11,2,18,20
202200,202200,,3,0,56,56
202201,202201,,2,3,25,28
202203,202203,,2,5,13,18
202202,202202,,3,4,12,16
202204,202204,,19,2,3,5
202205,202205,,37,3,10,13
202206,202206,,54,0,15,15
202207,202207,,11,3,34,37
202208,202208,,37,18,25,43
202209,202209,,3,1,8,9
203001,203001,,2,0,9,9
203002,203002,,2,0,21,21
203004,203004,,34,11,13,24
203007,203007,,2,3,11,14
203008,203008,,34,0,3,3
203009,203009,,54,0,13,13
203012,203012,,11,4,6,10
205116,205116,,37,2,5,7
205037,205037,,34,8,56,64
205187,205187,,34,20,94,114
203014,203014,,0,11,11,22
203015,203015,,8,1,1,2
203016,203016,,54,2,12,14
203017,203017,,3,1,14,15
203018,203018,,1,56,26,82
210081,210081,,0,5,15,20
207120,207120,,0,6,11,17
207205,207205,,0,3,8,11
203021,203021,,34,1,44,45
203022,203022,,0,0,4,4
104151,104151,,0,1,0,1
203023,203023,,54,0,31,31
203024,203024,,7,3,13,16
203025,203025,,54,7,16,23
203026,203026,,34,3,7,10
3274,3274,,34,1,0,1
9508167,9508167,,25,1,3,4
203027,203027,,11,0,6,6
9812174,9812174,,11,1,5,6
203029,203029,,25,0,14,14
203030,203030,,1,3,30,33
203032,203032,,0,0,29,29
203033,203033,,25,0,3,3
203034,203034,,11,1,2,3
203035,203035,,0,2,14,16
203036,203036,,0,6,11,17
203037,203037,,37,1,1,2
203039,203039,,54,12,15,27
203040,203040,,7,21,8,29
203042,203042,,19,1,8,9
9609150,9609150,,19,1,1,2
203043,203043,,25,1,24,25
203044,203044,,11,0,3,3
9903220,9903220,,11,2,1,3
9904062,9904062,,11,1,4,5
9811026,9811026,,54,1,7,8
203046,203046,,54,1,26,27
203047,203047,,3,4,20,24
203048,203048,,2,14,142,156
9908004,9908004,,2,1,134,135
203049,203049,,34,4,33,37
203050,203050,,0,0,26,26
203051,203051,,3,6,13,19
203052,203052,,37,4,56,60
203053,203053,,11,4,12,16
203054,203054,,7,1,2,3
203055,203055,,54,7,6,13
203056,203056,,65,4,10,14
203057,203057,,34,5,32,37
203058,203058,,2,1,14,15
203059,203059,,16,0,8,8
9201069,9201069,,11,2,0,2
9204051,9204051,,25,2,0,2
9210159,9210159,,25,1,1,2
203060,203060,,37,4,18,22
203061,203061,,37,12,16,28
203062,203062,,6,0,3,3
203063,203063,,62,3,6,9
203064,203064,,34,1,51,52
203065,203065,,7,19,13,32
9310117,9310117,,7,7,1,8
9411115,9411115,,7,4,1,5
203066,203066,,0,14,14,28
203068,203068,,34,2,12,14
203069,203069,,34,0,13,13
9502092,9502092,,16,10,4,14
9512166,9512166,,16,5,8,13
203070,203070,,2,8,13,21
203072,203072,,11,1,2,3
203073,203073,,62,2,23,25
203075,203075,,62,0,4,4
203076,203076,,2,0,53,53
203077,203077,,3,1,17,18
203078,203078,,3,0,7,7
203079,203079,,7,6,3,9
9812130,9812130,,7,3,2,5
203080,203080,,1,55,15,70
203081,203081,,34,4,18,22
203082,203082,,1,70,26,96
203084,203084,,0,2,25,27
203085,203085,,62,2,29,31
9810202,9810202,,62,1,4,5
9802014,9802014,,62,1,0,1
203086,203086,,19,0,1,1
9707020,9707020,,19,2,2,4
9603202,9603202,,19,1,0,1
203087,203087,,0,1,4,5
203088,203088,,16,2,2,4
203090,203090,,0,1,1,2
203091,203091,,2,0,23,23
203092,203092,,37,5,13,18
203094,203094,,34,4,10,14
203095,203095,,3,11,14,25
203097,203097,,2,1,4,5
203098,203098,,54,2,9,11
203099,203099,,7,16,27,43
203100,203100,,2,0,20,20
9503120,9503120,,7,1,2,3
9310157,9310157,,25,2,11,13
9404172,9404172,,25,5,7,12
203102,203102,,34,1,20,21
203103,203103,,14,1,11,12
203104,203104,,8,1,12,13
203105,203105,,8,4,8,12
203106,203106,,2,0,9,9
203107,203107,,0,3,36,39
203108,203108,,4,3,88,91
203109,203109,,3,9,23,32
203110,203110,,65,0,28,28
203111,203111,,37,3,22,25
203113,203113,,7,11,10,21
203116,203116,,2,2,24,26
9705167,9705167,,2,2,15,17
203117,203117,,6,1,2,3
203118,203118,,11,3,5,8
203119,203119,,7,13,23,36
203120,203120,,54,3,11,14
203121,203121,,3,1,10,11
203122,203122,,50,1,1,2
203123,203123,,62,3,13,16
203125,203125,,3,9,18,27
203126,203126,,25,0,5,5
203127,203127,,7,0,3,3
203129,203129,,54,12,32,44
203130,203130,,62,2,9,11
9812179,9812179,,62,2,1,3
203131,203131,,62,1,18,19
203132,203132,,25,2,1,3
203135,203135,,62,1,11,12
203136,203136,,0,2,10,12
203137,203137,,0,7,19,26
203138,203138,,54,9,21,30
9809171,9809171,,2,2,6,8
203139,203139,,62,1,12,13
203141,203141,,3,1,18,19
203142,203142,,0,2,26,28
203143,203143,,7,2,7,9
203144,203144,,2,1,26,27
9709017,9709017,,2,2,45,47
9608185,9608185,,37,2,16,18
203145,203145,,0,2,5,7
203146,203146,,2,7,12,19
203202,203202,,2,8,29,37
203147,203147,,37,8,38,46
203148,203148,,6,0,5,5
203149,203149,,2,5,23,28
203150,203150,,34,0,1,1
203151,203151,,3,8,35,43
203155,203155,,3,2,15,17
203166,203166,,3,8,48,56
205210,205210,,3,6,21,27
203152,203152,,7,0,8,8
203153,203153,,1,15,13,28
203154,203154,,2,4,17,21
203156,203156,,2,0,3,3
9511165,9511165,,2,2,1,3
9805203,9805203,,2,1,6,7
9511094,9511094,,2,1,0,1
203157,203157,,54,1,121,122
203158,203158,,19,0,6,6
203159,203159,,37,0,1,1
203161,203161,,65,17,43,60
203162,203162,,16,3,12,15
203165,203165,,3,8,37,45
203167,203167,,34,4,5,9
203169,203169,,62,3,4,7
203170,203170,,0,0,4,4
203171,203171,,2,0,1,1
203172,203172,,34,0,13,13
9307092,9307092,,34,4,3,7
203173,203173,,37,5,33,38
203175,203175,,4,9,14,23
203176,203176,,3,0,24,24
203178,203178,,11,0,1,1
9910240,9910240,,11,1,2,3
203179,203179,,37,3,10,13
203181,203181,,0,3,10,13
203182,203182,,7,6,4,10
203183,203183,,16,0,4,4
203184,203184,,37,1,8,9
203185,203185,,4,1,16,17
205147,205147,,54,30,36,66
205074,205074,,54,30,55,85
206108,206108,,54,19,46,65
207234,207234,,54,24,48,72
203188,203188,,4,11,36,47
203204,203204,,4,8,24,32
203190,203190,,54,8,30,38
203192,203192,,37,0,3,3
203193,203193,,31,8,10,18
203194,203194,,7,4,5,9
203195,203195,,11,0,3,3
9804091,9804091,,11,6,1,7
9906184,9906184,,11,1,1,2
9810003,9810003,,11,1,1,2
203196,203196,,1,0,2,2
203197,203197,,6,1,5,6
9802115,9802115,,6,3,2,5
203198,203198,,7,21,11,32
203199,203199,,3,2,14,16
203200,203200,,6,1,8,9
203203,203203,,34,8,46,54
203205,203205,,0,5,13,18
203207,203207,,8,2,11,13
203209,203209,,16,0,7,7
203210,203210,,34,0,4,4
203212,203212,,9,1,14,15
203213,203213,,54,3,14,17
203215,203215,,11,1,14,15
9309126,9309126,,11,1,0,1
9901074,9901074,,11,2,2,4
203216,203216,,2,0,16,16
203217,203217,,37,13,19,32
203218,203218,,4,3,19,22
203221,203221,,34,2,3,5
111196,111196,,34,3,0,3
203222,203222,,2,1,43,44
9611052,9611052,,2,2,7,9
203223,203223,,2,1,8,9
203224,203224,,0,0,8,8
203226,203226,,44,0,1,1
9612107,9612107,,44,1,0,1
203228,203228,,7,0,12,12
9606059,9606059,,7,2,4,6
9705097,9705097,,7,1,7,8
9710071,9710071,,7,1,1,2
203231,203231,,1,71,29,100
203232,203232,,34,1,5,6
203233,203233,,34,0,34,34
203234,203234,,6,0,10,10
203236,203236,,37,5,23,28
203237,203237,,37,6,40,46
203238,203238,,2,3,13,16
203239,203239,,2,0,25,25
203240,203240,,7,0,4,4
203241,203241,,8,6,17,23
203242,203242,,65,1,14,15
203243,203243,,4,7,50,57
204079,204079,,4,13,65,78
204061,204061,,37,10,35,45
203244,203244,,34,0,11,11
203245,203245,,7,2,21,23
203246,203246,,54,3,17,20
203247,203247,,54,6,40,46
203250,203250,,25,0,20,20
203251,203251,,7,2,18,20
203252,203252,,7,1,7,8
203253,203253,,11,1,7,8
9611183,9611183,,11,1,1,2
9811238,9811238,,11,1,1,2
9911056,9911056,,11,1,2,3
9601172,9601172,,11,1,1,2
9403120,9403120,,11,1,0,1
203254,203254,,0,0,3,3
203256,203256,,37,11,6,17
203248,203248,,1,24,0,24
203259,203259,,3,6,23,29
203261,203261,,19,1,13,14
203263,203263,,62,1,7,8
203264,203264,,3,10,8,18
203266,203266,,37,2,37,39
203267,203267,,54,10,54,64
203269,203269,,3,3,27,30
203270,203270,,37,1,12,13
203271,203271,,0,2,19,21
203272,203272,,37,6,62,68
203273,203273,,6,1,4,5
203274,203274,,0,7,11,18
203276,203276,,54,5,18,23
203277,203277,,2,3,25,28
204002,204002,,1,27,36,63
9401098,9401098,,1,6,12,18
204005,204005,,31,1,9,10
204006,204006,,7,0,2,2
203067,203067,,7,4,0,4
204009,204009,,1,2,28,30
204011,204011,,65,0,8,8
204013,204013,,3,3,20,23
204015,204015,,6,3,13,16
204016,204016,,25,0,3,3
204017,204017,,31,0,21,21
204018,204018,,6,0,3,3
204019,204019,,8,0,1,1
204020,204020,,3,0,11,11
204021,204021,,34,0,5,5
204023,204023,,37,4,42,46
204024,204024,,19,1,7,8
204025,204025,,1,53,21,74
204026,204026,,1,42,27,69
204028,204028,,16,0,5,5
204029,204029,,34,2,18,20
204031,204031,,4,5,19,24
204032,204032,,3,4,23,27
204033,204033,,1,50,34,84
204034,204034,,34,1,8,9
204035,204035,,6,0,5,5
204036,204036,,11,0,2,2
204038,204038,,34,1,23,24
204039,204039,,37,1,17,18
204040,204040,,14,0,4,4
9503171,9503171,,19,1,0,1
9601157,9601157,,19,1,1,2
204041,204041,,54,5,27,32
204042,204042,,0,3,8,11
204043,204043,,37,3,21,24
204045,204045,,37,6,15,21
204046,204046,,16,1,7,8
9803237,9803237,,16,6,12,18
9312138,9312138,,16,1,0,1
9801018,9801018,,16,6,4,10
9802036,9802036,,11,3,2,5
204047,204047,,0,9,33,42
204050,204050,,37,1,16,17
204052,204052,,2,0,11,11
204053,204053,,11,3,5,8
9702057,9702057,,3,5,1,6
204055,204055,,3,0,26,26
204056,204056,,34,2,5,7
204057,204057,,6,0,16,16
204058,204058,,34,7,19,26
204059,204059,,16,0,4,4
204060,204060,,34,0,1,1
204062,204062,,2,16,7,23
204063,204063,,11,0,9,9
9907159,9907159,,11,3,8,11
204064,204064,,37,6,18,24
204067,204067,,19,0,7,7
204068,204068,,16,5,11,16
204069,204069,,9,1,1,2
204072,204072,,62,0,7,7
204073,204073,,8,0,5,5
204074,204074,,4,24,21,45
204075,204075,,54,0,9,9
204076,204076,,62,2,9,11
204077,204077,,0,0,3,3
204078,204078,,2,3,11,14
204080,204080,,54,7,28,35
204081,204081,,34,2,10,12
204082,204082,,19,1,12,13
204085,204085,,1,4,21,25
204086,204086,,11,1,13,14
204087,204087,,11,1,9,10
9905167,9905167,,6,1,8,9
9512033,9512033,,6,2,0,2
9606024,9606024,,6,2,2,4
9903135,9903135,,6,3,5,8
204088,204088,,62,2,15,17
204089,204089,,54,32,246,278
9511178,9511178,,2,1,33,34
9702098,9702098,,2,2,42,44
9702189,9702189,,54,1,30,31
9711198,9711198,,37,1,1,2
9712141,9712141,,54,1,41,42
204090,204090,,62,1,20,21
204119,204119,,4,1,9,10
205209,205209,,4,19,39,58
205198,205198,,4,20,19,39
206175,206175,,34,12,64,76
204092,204092,,6,1,6,7
204093,204093,,54,0,29,29
204094,204094,,54,0,13,13
204096,204096,,3,2,13,15
204097,204097,,62,2,10,12
204099,204099,,31,12,4,16
204100,204100,,54,3,12,15
204101,204101,,2,0,15,15
204102,204102,,3,2,17,19
204103,204103,,2,9,46,55
204104,204104,,34,0,3,3
204105,204105,,6,2,8,10
106090,106090,,6,4,0,4
204106,204106,,0,0,4,4
204107,204107,,34,3,6,9
9907002,9907002,,25,1,10,11
204109,204109,,3,2,14,16
204110,204110,,7,14,15,29
204111,204111,,19,0,8,8
9412180,9412180,,19,6,6,12
9812103,9812103,,19,2,5,7
9403127,9403127,,19,2,1,3
204112,204112,,34,7,58,65
204113,204113,,0,6,15,21
204114,204114,,11,5,9,14
204115,204115,,8,0,16,16
204116,204116,,16,1,4,5
204118,204118,,19,0,1,1
204120,204120,,4,6,26,32
204121,204121,,1,9,7,16
204122,204122,,0,3,21,24
9707024,9707024,,19,2,2,4
204123,204123,,62,1,12,13
204124,204124,,62,4,14,18
9402010,9402010,,34,7,3,10
9604162,9604162,,62,1,6,7
204125,204125,,37,1,3,4
204127,204127,,37,0,24,24
204128,204128,,54,0,21,21
204129,204129,,7,15,13,28
204130,204130,,9,0,3,3
204132,204132,,54,5,5,10
204133,204133,,1,1,1,2
9811075,9811075,,1,3,4,7
204136,204136,,0,2,21,23
204137,204137,,34,6,17,23
204139,204139,,16,0,3,3
9403020,9403020,,16,2,0,2
9911133,9911133,,16,1,2,3
204141,204141,,34,3,7,10
204142,204142,,1,0,3,3
204145,204145,,54,16,23,39
204146,204146,,1,79,37,116
204200,204200,,1,17,20,37
204226,204226,,1,50,23,73
204234,204234,,1,22,72,94
204148,204148,,65,8,48,56
9508041,9508041,,65,1,2,3
204151,204151,,11,2,8,10
204152,204152,,3,1,14,15
204153,204153,,54,3,18,21
204154,204154,,8,4,21,25
204157,204157,,37,1,37,38
204159,204159,,3,0,10,10
9606081,9606081,,11,1,2,3
204160,204160,,34,9,9,18
204161,204161,,2,7,13,20
204162,204162,,3,1,8,9
9907136,9907136,,62,1,1,2
204163,204163,,3,2,53,55
9704090,9704090,,37,1,5,6
9610039,9610039,,62,2,9,11
204165,204165,,3,0,13,13
204166,204166,,11,2,6,8
204167,204167,,34,4,36,40
204169,204169,,8,4,38,42
204170,204170,,3,1,16,17
204171,204171,,16,2,9,11
9411007,9411007,,16,2,2,4
204173,204173,,3,0,7,7
204175,204175,,0,3,2,5
204176,204176,,62,1,2,3
9811099,9811099,,62,2,1,3
204177,204177,,45,0,1,1
9911074,9911074,,45,1,0,1
204178,204178,,37,0,17,17
9605067,9605067,,2,7,2,9
9703019,9703019,,2,4,7,11
9612186,9612186,,2,2,5,7
204179,204179,,34,3,30,33
204180,204180,,34,0,11,11
204181,204181,,62,2,10,12
204182,204182,,7,1,27,28
204183,204183,,37,8,50,58
9902031,9902031,,62,1,6,7
9902147,9902147,,62,1,7,8
9403082,9403082,,62,6,1,7
9404158,9404158,,62,3,2,5
9407085,9407085,,62,3,2,5
204184,204184,,25,1,4,5
9902124,9902124,,25,1,1,2
204185,204185,,3,7,33,40
204186,204186,,37,6,32,38
9603155,9603155,,19,2,1,3
9209110,9209110,,19,3,0,3
9409145,9409145,,19,2,2,4
204188,204188,,6,3,18,21
9201009,9201009,,31,3,0,3
204191,204191,,4,7,35,42
204192,204192,,3,4,21,25
204193,204193,,34,0,17,17
203096,203096,,34,1,0,1
204194,204194,,11,0,6,6
204195,204195,,54,5,17,22
204197,204197,,3,1,31,32
204199,204199,,4,2,6,8
204201,204201,,34,1,38,39
204202,204202,,37,1,5,6
9206110,9206110,,37,1,0,1
204205,204205,,0,1,14,15
204206,204206,,4,2,75,77
204207,204207,,2,2,8,10
204208,204208,,9,0,2,2
204209,204209,,34,2,12,14
204210,204210,,16,2,11,13
9203007,9203007,,16,1,0,1
204211,204211,,11,2,3,5
204212,204212,,34,2,9,11
204213,204213,,37,3,13,16
204214,204214,,0,2,5,7
204215,204215,,7,1,14,15
204216,204216,,11,3,14,17
204219,204219,,3,2,11,13
204220,204220,,7,2,6,8
204221,204221,,3,10,16,26
204222,204222,,31,8,13,21
204223,204223,,54,5,7,12
204225,204225,,2,4,31,35
204227,204227,,31,4,16,20
204228,204228,,54,1,34,35
204229,204229,,8,0,10,10
9801044,9801044,,8,3,6,9
9809046,9809046,,8,2,7,9
9608064,9608064,,8,8,3,11
9610196,9610196,,8,3,1,4
204231,204231,,37,0,21,21
204232,204232,,19,3,12,15
204233,204233,,4,7,31,38
205043,205043,,1,13,12,25
9407004,9407004,,54,1,17,18
204235,204235,,0,3,10,13
204237,204237,,11,6,3,9
204238,204238,,3,0,2,2
204241,204241,,11,0,4,4
204242,204242,,0,2,4,6
204243,204243,,2,1,18,19
204244,204244,,65,1,5,6
204245,204245,,7,14,13,27
204246,204246,,16,5,17,22
204247,204247,,1,4,12,16
204248,204248,,3,3,15,18
204249,204249,,37,11,20,31
9701112,9701112,,37,2,1,3
204250,204250,,34,0,15,15
204251,204251,,6,2,15,17
9502078,9502078,,25,2,9,11
9503074,9503074,,6,3,1,4
9504011,9504011,,25,3,5,8
9510147,9510147,,25,6,3,9
9602023,9602023,,1,2,3,5
9611031,9611031,,25,1,2,3
9703044,9703044,,25,2,11,13
9303049,9303049,,25,5,0,5
9503075,9503075,,6,3,0,3
9407100,9407100,,25,3,2,5
9504021,9504021,,25,1,5,6
9406053,9406053,,25,2,3,5
9401155,9401155,,2,2,0,2
9712194,9712194,,25,2,19,21
9407002,9407002,,25,4,5,9
204254,204254,,54,23,33,56
204255,204255,,22,0,1,1
204256,204256,,2,11,28,39
204257,204257,,34,2,26,28
204258,204258,,11,0,6,6
204259,204259,,19,0,4,4
9704078,9704078,,11,1,0,1
205001,205001,,34,1,6,7
205002,205002,,2,2,25,27
9703122,9703122,,2,1,10,11
9905203,9905203,,19,3,3,6
9605226,9605226,,19,5,0,5
205004,205004,,8,3,15,18
205005,205005,,8,1,6,7
205007,205007,,37,1,5,6
205008,205008,,1,14,49,63
205009,205009,,0,3,15,18
205010,205010,,3,8,42,50
206001,206001,,3,6,36,42
205283,205283,,3,4,32,36
205011,205011,,65,8,9,17
205012,205012,,54,10,12,22
205013,205013,,6,1,5,6
205014,205014,,4,3,22,25
205015,205015,,1,22,33,55
205016,205016,,8,3,13,16
205017,205017,,7,5,39,44
204022,204022,,7,1,0,1
9611087,9611087,,7,1,1,2
9611187,9611187,,7,1,0,1
205018,205018,,6,3,7,10
9602127,9602127,,6,1,6,7
9408045,9408045,,6,1,0,1
9503177,9503177,,6,1,0,1
205019,205019,,31,4,20,24
205020,205020,,1,24,27,51
205021,205021,,65,1,8,9
9310054,9310054,,65,1,1,2
9804130,9804130,,19,3,1,4
205022,205022,,19,1,4,5
204048,204048,,19,1,0,1
9906181,9906181,,19,3,3,6
9706030,9706030,,19,2,1,3
205023,205023,,7,0,4,4
205024,205024,,3,11,23,34
205026,205026,,11,6,24,30
205027,205027,,54,1,1,2
205028,205028,,7,1,17,18
9511096,9511096,,7,1,0,1
205029,205029,,34,0,2,2
205030,205030,,8,0,2,2
205031,205031,,54,3,18,21
205032,205032,,11,2,19,21
205034,205034,,37,2,57,59
205035,205035,,19,0,2,2
9902135,9902135,,19,1,0,1
205036,205036,,34,3,7,10
205038,205038,,19,3,4,7
205039,205039,,34,3,9,12
205041,205041,,0,4,37,41
205042,205042,,54,1,10,11
205044,205044,,2,1,8,9
205045,205045,,11,1,10,11
205047,205047,,3,2,15,17
205050,205050,,34,19,19,38
205051,205051,,34,15,23,38
205052,205052,,34,10,14,24
9909186,9909186,,34,3,24,27
205053,205053,,0,0,8,8
205054,205054,,3,0,6,6
205056,205056,,34,1,7,8
9712242,9712242,,31,1,6,7
205057,205057,,11,5,21,26
205058,205058,,3,2,17,19
205059,205059,,11,0,1,1
205060,205060,,37,0,106,106
9703014,9703014,,16,1,9,10
9410012,9410012,,25,1,7,8
205062,205062,,11,1,34,35
205063,205063,,2,4,13,17
203225,203225,,2,4,0,4
205064,205064,,37,1,24,25
205065,205065,,7,4,19,23
205068,205068,,2,6,5,11
205069,205069,,0,7,15,22
205070,205070,,37,11,26,37
205071,205071,,62,0,3,3
205072,205072,,6,2,10,12
205073,205073,,54,0,29,29
205075,205075,,34,4,35,39
205076,205076,,62,3,19,22
9311073,9311073,,62,3,0,3
205077,205077,,54,4,24,28
205078,205078,,3,3,50,53
205079,205079,,25,8,22,30
205081,205081,,25,1,6,7
205082,205082,,34,2,27,29
205083,205083,,37,4,49,53
205084,205084,,0,4,36,40
205087,205087,,0,0,34,34
205088,205088,,0,1,7,8
205090,205090,,34,4,20,24
205091,205091,,65,1,11,12
205092,205092,,1,6,25,31
205093,205093,,3,1,17,18
205095,205095,,11,1,3,4
205096,205096,,4,2,36,38
205097,205097,,65,6,21,27
205099,205099,,34,9,27,36
205100,205100,,34,11,70,81
205102,205102,,0,0,1,1
205103,205103,,34,9,39,48
207104,207104,,4,14,51,65
207235,207235,,4,22,17,39
207245,207245,,34,18,79,97
211025,211025,,34,3,34,37
211031,211031,,4,5,11,16
211090,211090,,4,13,34,47
206202,206202,,34,13,18,31
207107,207107,,4,34,51,85
208013,208013,,34,20,16,36
210160,210160,,34,7,7,14
209261,209261,,0,11,79,90
210217,210217,,0,3,64,67
210292,210292,,4,14,180,194
207004,207004,,4,19,27,46
207089,207089,,4,11,25,36
208101,208101,,4,10,26,36
208196,208196,,4,27,36,63
209090,209090,,4,27,19,46
209222,209222,,4,14,41,55
205104,205104,,7,6,42,48
205106,205106,,1,32,42,74
205107,205107,,4,13,17,30
205108,205108,,54,6,20,26
205109,205109,,1,12,56,68
205110,205110,,3,5,15,20
205111,205111,,31,2,3,5
205112,205112,,25,0,1,1
205113,205113,,7,1,25,26
205114,205114,,19,2,7,9
9311162,9311162,,19,4,4,8
205115,205115,,34,2,15,17
205117,205117,,19,1,2,3
205122,205122,,54,0,2,2
205123,205123,,65,7,48,55
205124,205124,,14,0,10,10
205125,205125,,7,2,6,8
205126,205126,,16,0,3,3
9404046,9404046,,16,2,0,2
205127,205127,,2,0,3,3
205128,205128,,7,1,9,10
205129,205129,,34,9,41,50
205132,205132,,34,9,18,27
205133,205133,,9,3,11,14
205134,205134,,1,33,58,91
205135,205135,,6,2,21,23
205136,205136,,1,10,8,18
205137,205137,,0,1,10,11
9401167,9401167,,62,11,1,12
205138,205138,,2,0,21,21
205139,205139,,0,4,20,24
205141,205141,,34,0,10,10
205142,205142,,34,7,7,14
205143,205143,,65,3,8,11
205144,205144,,37,11,25,36
205145,205145,,34,1,1,2
206087,206087,,54,13,32,45
205148,205148,,0,1,13,14
205149,205149,,54,3,17,20
205150,205150,,2,8,13,21
205151,205151,,37,5,17,22
205152,205152,,19,2,1,3
205153,205153,,3,4,24,28
205154,205154,,1,7,18,25
205155,205155,,37,9,47,56
205156,205156,,11,0,8,8
205157,205157,,14,2,3,5
205158,205158,,11,0,4,4
205159,205159,,0,2,4,6
205160,205160,,34,3,44,47
205161,205161,,65,9,20,29
9209068,9209068,,1,1,2,3
205162,205162,,54,2,47,49
205163,205163,,4,3,29,32
205164,205164,,34,6,14,20
205165,205165,,2,5,25,30
205166,205166,,54,6,9,15
205167,205167,,7,1,2,3
205168,205168,,7,0,4,4
9806135,9806135,,7,1,7,8
205169,205169,,62,1,1,2
205170,205170,,8,3,61,64
205171,205171,,37,3,20,23
205172,205172,,37,3,10,13
205173,205173,,0,0,6,6
205175,205175,,7,2,18,20
9308157,9308157,,7,1,0,1
9512120,9512120,,7,2,0,2
9410213,9410213,,7,1,0,1
205176,205176,,0,0,5,5
205178,205178,,46,3,4,7
206100,206100,,4,14,12,26
205181,205181,,7,0,3,3
205182,205182,,8,2,17,19
205184,205184,,37,11,25,36
205186,205186,,3,0,21,21
205188,205188,,0,10,39,49
207029,207029,,0,8,32,40
206155,206155,,0,10,38,48
205189,205189,,2,0,4,4
205190,205190,,54,3,38,41
205191,205191,,19,3,12,15
205192,205192,,25,1,12,13
9601042,9601042,,25,2,9,11
205193,205193,,3,8,11,19
205194,205194,,2,2,11,13
208012,208012,,2,3,23,26
205195,205195,,0,2,26,28
207051,207051,,0,5,18,23
205312,205312,,0,1,3,4
206229,206229,,0,3,17,20
205199,205199,,25,2,7,9
205200,205200,,1,29,93,122
205201,205201,,34,0,15,15
205202,205202,,37,0,33,33
205203,205203,,0,3,10,13
205204,205204,,34,29,51,80
205216,205216,,34,10,12,22
205205,205205,,25,3,4,7
205206,205206,,54,0,11,11
205208,205208,,0,0,12,12
205211,205211,,34,6,17,23
205214,205214,,3,6,24,30
205215,205215,,16,2,14,16
205217,205217,,1,3,10,13
205219,205219,,65,0,14,14
9902194,9902194,,65,1,7,8
205220,205220,,0,6,35,41
205221,205221,,34,5,37,42
205222,205222,,0,4,29,33
205223,205223,,34,1,3,4
205224,205224,,47,1,1,2
205226,205226,,14,0,1,1
9312079,9312079,,14,3,1,4
205227,205227,,34,17,52,69
205228,205228,,62,0,22,22
205229,205229,,7,1,7,8
205230,205230,,34,6,50,56
205231,205231,,0,0,17,17
205232,205232,,6,1,3,4
205233,205233,,65,7,20,27
205234,205234,,37,9,34,43
205235,205235,,2,0,9,9
205236,205236,,34,9,37,46
205237,205237,,3,0,14,14
205238,205238,,62,2,16,18
9203003,9203003,,62,3,0,3
205239,205239,,6,0,2,2
205240,205240,,37,1,5,6
205242,205242,,3,4,10,14
205243,205243,,6,2,2,4
9805024,9805024,,6,2,0,2
205244,205244,,1,25,28,53
205245,205245,,65,2,27,29
205247,205247,,0,2,19,21
205248,205248,,25,0,7,7
9810242,9810242,,25,1,3,4
205249,205249,,11,3,4,7
205250,205250,,11,0,5,5
205251,205251,,34,5,66,71
205252,205252,,11,0,7,7
205253,205253,,2,3,14,17
205254,205254,,2,7,43,50
205255,205255,,0,0,16,16
205256,205256,,8,1,3,4
205257,205257,,11,0,19,19
205258,205258,,1,27,26,53
205259,205259,,54,8,42,50
205261,205261,,37,0,9,9
205263,205263,,2,1,1,2
205264,205264,,4,0,6,6
205265,205265,,2,4,32,36
206185,206185,,2,3,20,23
205274,205274,,37,1,18,19
206041,206041,,2,4,11,15
205266,205266,,1,15,61,76
205267,205267,,34,0,6,6
205268,205268,,16,1,2,3
205269,205269,,3,10,11,21
205270,205270,,1,18,13,31
205271,205271,,7,2,19,21
9608182,9608182,,2,3,3,6
205272,205272,,8,1,6,7
205273,205273,,6,1,18,19
205275,205275,,4,7,20,27
205276,205276,,3,0,10,10
9703035,9703035,,25,1,2,3
205277,205277,,0,10,11,21
205278,205278,,34,2,4,6
205279,205279,,1,46,54,100
205280,205280,,1,21,18,39
205281,205281,,54,5,28,33
205282,205282,,11,0,5,5
205284,205284,,7,0,6,6
9912061,9912061,,8,1,6,7
205285,205285,,2,1,6,7
205286,205286,,3,1,21,22
205287,205287,,3,2,9,11
9307068,9307068,,4,1,0,1
205289,205289,,6,0,3,3
9502008,9502008,,11,4,0,4
205291,205291,,1,15,30,45
205292,205292,,3,1,11,12
205293,205293,,37,2,18,20
205294,205294,,3,3,31,34
9911038,9911038,,2,1,6,7
205295,205295,,54,4,29,33
205296,205296,,1,9,23,32
205297,205297,,37,30,29,59
205298,205298,,8,3,21,24
205299,205299,,0,5,60,65
205300,205300,,54,9,20,29
205301,205301,,37,16,56,72
205302,205302,,1,8,32,40
205303,205303,,1,13,62,75
205304,205304,,25,3,10,13
205305,205305,,0,1,15,16
205306,205306,,2,1,95,96
205307,205307,,37,4,4,8
205308,205308,,37,3,9,12
205309,205309,,2,1,10,11
205310,205310,,25,1,19,20
9603014,9603014,,25,3,2,5
9906074,9906074,,25,3,2,5
9811187,9811187,,25,1,0,1
205311,205311,,1,44,69,113
205314,205314,,1,33,22,55
206033,206033,,1,35,25,60
206045,206045,,1,35,55,90
205317,205317,,0,2,35,37
205318,205318,,34,3,2,5
205319,205319,,34,1,2,3
205320,205320,,0,4,19,23
205321,205321,,34,21,88,109
205322,205322,,8,1,14,15
206002,206002,,0,1,18,19
206003,206003,,3,4,14,18
206004,206004,,14,4,5,9
205046,205046,,14,7,0,7
206005,206005,,1,43,25,68
206006,206006,,3,2,54,56
9912170,9912170,,9,3,4,7
9605072,9605072,,3,2,3,5
9607094,9607094,,3,4,6,10
206007,206007,,3,2,34,36
206009,206009,,3,2,20,22
206010,206010,,1,19,86,105
206011,206011,,3,6,24,30
206012,206012,,37,2,9,11
106119,106119,,3,1,0,1
206015,206015,,62,0,5,5
206016,206016,,0,3,32,35
206017,206017,,37,53,11,64
206018,206018,,3,5,21,26
206019,206019,,3,0,9,9
206020,206020,,34,7,37,44
206021,206021,,49,0,3,3
206022,206022,,11,0,2,2
206023,206023,,3,0,13,13
206024,206024,,54,4,15,19
206025,206025,,4,0,16,16
206026,206026,,34,5,7,12
206027,206027,,34,0,3,3
206028,206028,,7,2,2,4
206029,206029,,1,5,89,94
206031,206031,,0,2,24,26
206032,206032,,0,1,16,17
206034,206034,,11,3,5,8
206035,206035,,3,3,17,20
206036,206036,,62,0,3,3
206037,206037,,7,0,2,2
206039,206039,,3,0,4,4
206040,206040,,2,0,1,1
9812243,9812243,,2,1,2,3
9212102,9212102,,2,2,0,2
9310052,9310052,,2,1,2,3
206042,206042,,0,5,29,34
206044,206044,,0,3,14,17
206043,206043,,2,0,18,18
206046,206046,,0,2,11,13
206047,206047,,0,2,10,12
206048,206048,,3,0,2,2
206049,206049,,2,9,6,15
106219,106219,,2,1,0,1
206050,206050,,0,1,18,19
206051,206051,,37,4,23,27
206052,206052,,1,3,24,27
206053,206053,,11,5,3,8
206054,206054,,37,2,7,9
206055,206055,,6,0,6,6
206056,206056,,11,0,1,1
206058,206058,,3,1,28,29
206059,206059,,1,51,24,75
9707048,9707048,,2,9,6,15
206060,206060,,3,0,33,33
206061,206061,,48,0,1,1
9805057,9805057,,48,1,0,1
206062,206062,,1,10,88,98
206063,206063,,37,16,146,162
206064,206064,,37,2,34,36
206065,206065,,1,31,23,54
206073,206073,,1,51,16,67
206194,206194,,1,4,21,25
206221,206221,,1,28,25,53
208178,208178,,1,52,29,81
206079,206079,,1,58,11,69
206066,206066,,3,5,13,18
206067,206067,,49,0,2,2
206069,206069,,2,0,13,13
206070,206070,,1,23,27,50
206071,206071,,37,1,53,54
206072,206072,,37,1,46,47
206167,206167,,1,19,33,52
206248,206248,,1,14,34,48
207067,207067,,1,7,23,30
208010,208010,,1,14,25,39
208041,208041,,1,29,19,48
208148,208148,,1,30,22,52
206074,206074,,11,0,7,7
206075,206075,,3,4,24,28
206076,206076,,62,0,10,10
9208061,9208061,,62,2,0,2
9303118,9303118,,62,2,0,2
206077,206077,,3,1,23,24
206078,206078,,62,3,9,12
206080,206080,,1,1,22,23
206081,206081,,34,0,25,25
206082,206082,,6,1,6,7
206083,206083,,7,0,4,4
206084,206084,,34,1,14,15
206085,206085,,34,0,14,14
206086,206086,,16,3,18,21
206088,206088,,31,4,2,6
206089,206089,,0,10,24,34
206090,206090,,1,24,27,51
206091,206091,,1,2,28,30
206092,206092,,4,0,32,32
206093,206093,,62,0,7,7
206094,206094,,1,4,66,70
206095,206095,,3,0,24,24
206096,206096,,34,2,5,7
206097,206097,,2,1,18,19
9705126,9705126,,2,1,11,12
206098,206098,,34,4,25,29
206101,206101,,4,2,15,17
206103,206103,,1,16,41,57
206104,206104,,1,9,44,53
9504160,9504160,,8,2,16,18
9512201,9512201,,8,1,10,11
9411150,9411150,,8,4,3,7
9307176,9307176,,8,6,6,12
206105,206105,,34,0,6,6
206106,206106,,0,6,10,16
206107,206107,,1,13,30,43
206109,206109,,37,2,20,22
206110,206110,,2,0,12,12
206111,206111,,11,4,9,13
206112,206112,,31,1,21,22
206113,206113,,34,0,15,15
206114,206114,,25,2,5,7
206115,206115,,54,20,28,48
206116,206116,,2,1,26,27
206117,206117,,34,1,3,4
206118,206118,,1,6,41,47
206119,206119,,54,2,2,4
206121,206121,,16,0,3,3
206122,206122,,46,0,5,5
206123,206123,,4,1,20,21
206124,206124,,6,0,5,5
206125,206125,,2,3,8,11
206126,206126,,2,10,26,36
206127,206127,,11,2,11,13
206128,206128,,0,3,16,19
206129,206129,,2,3,19,22
206130,206130,,4,3,2,5
206131,206131,,1,20,19,39
206132,206132,,1,17,14,31
206133,206133,,7,3,4,7
206134,206134,,62,1,13,14
206135,206135,,16,0,2,2
204131,204131,,16,4,0,4
206136,206136,,2,5,3,8
206137,206137,,3,2,23,25
206138,206138,,31,5,26,31
206139,206139,,16,2,8,10
206141,206141,,34,7,68,75
206142,206142,,3,0,3,3
206143,206143,,25,0,8,8
9811062,9811062,,8,1,3,4
206144,206144,,2,1,21,22
206145,206145,,11,1,26,27
206146,206146,,0,7,7,14
206147,206147,,0,5,28,33
206148,206148,,2,4,30,34
206149,206149,,7,5,15,20
206151,206151,,37,4,23,27
206152,206152,,37,8,38,46
206153,206153,,34,2,15,17
206154,206154,,37,5,66,71
206156,206156,,50,0,2,2
206157,206157,,2,0,12,12
206158,206158,,4,2,36,38
206159,206159,,2,3,1,4
206160,206160,,11,0,9,9
206161,206161,,37,17,50,67
206162,206162,,65,0,3,3
206163,206163,,37,9,36,45
206164,206164,,37,16,49,65
206165,206165,,54,3,15,18
206166,206166,,1,14,20,34
206168,206168,,16,0,3,3
206169,206169,,2,0,16,16
206170,206170,,3,0,12,12
206171,206171,,4,0,22,22
206172,206172,,37,1,8,9
206173,206173,,11,7,52,59
9903251,9903251,,11,1,10,11
9902027,9902027,,11,2,4,6
9903060,9903060,,11,1,1,2
206174,206174,,4,0,15,15
206176,206176,,1,0,24,24
206178,206178,,2,1,10,11
206179,206179,,65,0,9,9
9607009,9607009,,65,2,2,4
206180,206180,,34,1,25,26
206181,206181,,7,3,20,23
206183,206183,,4,1,45,46
206186,206186,,6,2,22,24
9601174,9601174,,25,1,5,6
206187,206187,,0,0,14,14
9911079,9911079,,0,1,5,6
206188,206188,,0,5,36,41
206189,206189,,34,0,3,3
206190,206190,,3,2,2,4
206191,206191,,4,0,18,18
206192,206192,,2,3,24,27
9512001,9512001,,2,2,2,4
9612036,9612036,,2,2,5,7
206193,206193,,0,3,16,19
206195,206195,,1,22,24,46
206150,206150,,1,1,0,1
206197,206197,,16,3,19,22
206198,206198,,0,0,9,9
206199,206199,,0,1,5,6
206200,206200,,1,4,48,52
206201,206201,,16,0,5,5
206203,206203,,54,3,41,44
206204,206204,,1,17,22,39
206205,206205,,34,2,6,8
206206,206206,,37,3,21,24
206207,206207,,34,0,24,24
206209,206209,,54,1,15,16
9709148,9709148,,1,2,4,6
9912080,9912080,,54,1,9,10
206210,206210,,1,1,4,5
206211,206211,,11,0,6,6
206213,206213,,37,5,9,14
206214,206214,,1,4,50,54
9901067,9901067,,2,1,5,6
206215,206215,,3,0,7,7
9806035,9806035,,3,1,1,2
206216,206216,,1,8,21,29
206217,206217,,0,0,9,9
206218,206218,,1,3,17,20
206219,206219,,0,1,2,3
206220,206220,,0,13,27,40
206222,206222,,34,0,11,11
206224,206224,,62,0,12,12
206225,206225,,0,0,6,6
206226,206226,,2,0,51,51
9211038,9211038,,2,2,0,2
9512211,9512211,,16,3,15,18
206227,206227,,11,0,1,1
206230,206230,,11,0,2,2
206231,206231,,3,1,20,21
206232,206232,,1,0,9,9
9707229,9707229,,1,1,3,4
206233,206233,,34,2,6,8
206234,206234,,2,3,14,17
206236,206236,,11,2,5,7
112237,112237,,11,4,0,4
9602121,9602121,,11,3,0,3
206237,206237,,1,14,30,44
206238,206238,,65,4,17,21
206239,206239,,1,4,18,22
206240,206240,,16,0,6,6
206241,206241,,54,19,36,55
206242,206242,,37,5,16,21
206243,206243,,2,1,30,31
206244,206244,,11,2,7,9
206245,206245,,25,0,4,4
206246,206246,,11,1,4,5
206247,206247,,34,5,40,45
206249,206249,,54,1,13,14
206250,206250,,3,0,1,1
206251,206251,,11,10,10,20
206252,206252,,14,1,8,9
206253,206253,,0,0,16,16
206254,206254,,0,3,12,15
206255,206255,,37,97,26,123
207001,207001,,4,3,34,37
207002,207002,,34,15,9,24
207003,207003,,0,5,16,21
207005,207005,,0,0,15,15
207006,207006,,37,6,27,33
207007,207007,,3,3,10,13
207008,207008,,25,0,2,2
112123,112123,,25,1,0,1
207009,207009,,34,6,27,33
207010,207010,,37,0,1,1
9511142,9511142,,37,2,4,6
207011,207011,,9,0,2,2
207012,207012,,62,1,15,16
207013,207013,,6,0,1,1
207014,207014,,54,2,37,39
207015,207015,,2,4,12,16
207016,207016,,2,4,16,20
9202051,9202051,,54,2,0,2
207017,207017,,4,2,19,21
207020,207020,,37,6,12,18
207021,207021,,6,0,1,1
207022,207022,,7,7,12,19
207023,207023,,54,1,13,14
9412071,9412071,,54,2,3,5
207024,207024,,34,1,15,16
207025,207025,,3,2,4,6
207026,207026,,54,7,13,20
9502046,9502046,,54,1,0,1
207027,207027,,37,10,43,53
207028,207028,,11,3,12,15
207031,207031,,7,5,6,11
207032,207032,,2,1,15,16
9705144,9705144,,2,3,4,7
9703084,9703084,,2,3,9,12
207033,207033,,11,4,8,12
207034,207034,,1,21,13,34
207061,207061,,1,21,17,38
207050,207050,,1,20,13,33
207035,207035,,51,0,1,1
203011,203011,,51,1,0,1
207036,207036,,62,0,8,8
9810220,9810220,,62,3,5,8
207037,207037,,1,17,66,83
207038,207038,,25,2,20,22
207039,207039,,34,10,8,18
207040,207040,,7,4,11,15
207041,207041,,62,1,9,10
207042,207042,,19,0,2,2
207043,207043,,14,0,5,5
207044,207044,,4,4,25,29
207045,207045,,14,0,1,1
207046,207046,,7,0,9,9
207047,207047,,7,4,3,7
207048,207048,,9,0,7,7
9912220,9912220,,9,1,3,4
9912221,9912221,,9,1,8,9
207049,207049,,11,2,14,16
207052,207052,,2,0,38,38
207053,207053,,34,0,19,19
207054,207054,,2,1,12,13
207055,207055,,2,0,18,18
207057,207057,,62,0,4,4
207058,207058,,34,0,7,7
207059,207059,,31,0,14,14
9510013,9510013,,16,5,6,11
207060,207060,,0,4,19,23
207062,207062,,19,2,4,6
9911121,9911121,,19,1,0,1
207064,207064,,0,1,12,13
207065,207065,,0,1,2,3
207066,207066,,37,0,3,3
207068,207068,,37,1,23,24
207070,207070,,54,1,17,18
207071,207071,,34,4,21,25
207072,207072,,34,4,23,27
9608162,9608162,,2,3,4,7
207073,207073,,25,1,8,9
9303062,9303062,,25,1,0,1
207074,207074,,37,1,20,21
207075,207075,,3,1,10,11
207076,207076,,34,4,33,37
207077,207077,,65,2,8,10
207078,207078,,3,0,4,4
207079,207079,,62,1,10,11
207080,207080,,2,0,8,8
207081,207081,,11,1,20,21
105152,105152,,11,1,0,1
9902001,9902001,,16,1,15,16
9407058,9407058,,16,7,4,11
9411232,9411232,,16,4,10,14
9708033,9708033,,16,1,14,15
207082,207082,,3,1,4,5
207083,207083,,34,1,28,29
207084,207084,,0,3,7,10
207086,207086,,3,1,39,40
207090,207090,,34,0,9,9
207091,207091,,34,7,49,56
207092,207092,,11,0,12,12
207093,207093,,4,0,10,10
207094,207094,,65,3,21,24
207096,207096,,37,6,16,22
207097,207097,,3,1,28,29
207098,207098,,4,0,19,19
207099,207099,,62,1,24,25
207100,207100,,11,1,9,10
207101,207101,,34,11,16,27
207102,207102,,54,4,18,22
207103,207103,,0,1,18,19
207106,207106,,37,87,37,124
207108,207108,,3,5,16,21
207109,207109,,25,0,19,19
9608089,9608089,,25,1,5,6
207111,207111,,2,6,28,34
207112,207112,,7,2,3,5
207113,207113,,7,5,10,15
207114,207114,,37,2,29,31
207115,207115,,3,6,28,34
207116,207116,,34,0,211,211
9912139,9912139,,34,1,12,13
207117,207117,,37,8,39,47
207118,207118,,3,2,13,15
207121,207121,,34,1,1,2
207110,207110,,34,2,0,2
207122,207122,,16,0,13,13
207124,207124,,1,8,67,75
207125,207125,,1,1,27,28
207126,207126,,54,0,8,8
207127,207127,,34,6,51,57
207128,207128,,34,3,28,31
207129,207129,,2,4,12,16
207130,207130,,31,21,154,175
9403091,9403091,,31,1,0,1
9707053,9707053,,31,1,4,5
9709188,9709188,,31,1,13,14
9911086,9911086,,31,2,23,25
207131,207131,,4,3,21,24
207132,207132,,4,10,40,50
207133,207133,,34,5,19,24
207134,207134,,11,1,2,3
207135,207135,,54,15,25,40
207136,207136,,2,7,14,21
207137,207137,,16,0,7,7
207138,207138,,0,5,22,27
207139,207139,,2,4,33,37
207140,207140,,0,0,37,37
207141,207141,,37,2,9,11
207142,207142,,2,2,28,30
207143,207143,,11,1,23,24
9402065,9402065,,11,2,0,2
9512019,9512019,,2,1,4,5
9605124,9605124,,8,3,9,12
207144,207144,,34,4,12,16
207145,207145,,34,4,38,42
207147,207147,,2,0,2,2
207148,207148,,3,2,17,19
207149,207149,,3,4,22,26
207150,207150,,54,0,1,1
207151,207151,,37,0,23,23
9903199,9903199,,37,1,6,7
9712167,9712167,,37,2,19,21
207152,207152,,62,0,17,17
207153,207153,,11,0,15,15
207154,207154,,11,0,6,6
207155,207155,,0,1,7,8
207157,207157,,1,3,37,40
207158,207158,,3,4,7,11
207159,207159,,0,5,13,18
207160,207160,,3,1,24,25
207161,207161,,37,4,26,30
207162,207162,,54,2,15,17
207163,207163,,34,5,24,29
207164,207164,,19,4,3,7
207165,207165,,0,0,5,5
207166,207166,,3,4,17,21
207167,207167,,11,0,2,2
207168,207168,,31,7,14,21
207169,207169,,25,1,12,13
207170,207170,,0,0,8,8
207171,207171,,34,6,27,33
207172,207172,,4,0,17,17
207173,207173,,0,6,54,60
207174,207174,,4,11,23,34
207175,207175,,1,2,70,72
207176,207176,,62,3,12,15
208111,208111,,62,3,8,11
208202,208202,,62,1,41,42
207177,207177,,65,4,26,30
207178,207178,,54,2,21,23
207180,207180,,3,2,18,20
207181,207181,,8,0,19,19
207182,207182,,52,0,1,1
108227,108227,,52,1,0,1
207183,207183,,34,0,23,23
207184,207184,,37,0,13,13
207185,207185,,0,0,7,7
207186,207186,,25,0,1,1
207187,207187,,2,2,7,9
207188,207188,,54,2,59,61
207189,207189,,0,0,10,10
207190,207190,,1,9,22,31
207191,207191,,3,1,7,8
201087,201087,,3,2,0,2
207192,207192,,62,2,1,3
207193,207193,,0,0,4,4
207194,207194,,34,3,21,24
207195,207195,,54,0,7,7
207196,207196,,37,1,4,5
207197,207197,,2,0,20,20
207198,207198,,0,1,1,2
207199,207199,,2,3,24,27
207200,207200,,16,3,7,10
207201,207201,,8,6,21,27
207202,207202,,25,1,9,10
207203,207203,,0,1,3,4
207204,207204,,0,0,5,5
207206,207206,,34,3,16,19
207207,207207,,0,2,14,16
207208,207208,,37,2,56,58
207209,207209,,2,2,11,13
207211,207211,,3,2,11,13
207212,207212,,34,6,46,52
207213,207213,,31,2,11,13
207215,207215,,37,0,12,12
207216,207216,,1,0,3,3
207217,207217,,9,6,2,8
207218,207218,,11,0,6,6
207219,207219,,34,0,4,4
207220,207220,,3,6,19,25
207221,207221,,1,1,21,22
207222,207222,,3,4,18,22
207223,207223,,1,16,18,34
207224,207224,,11,1,12,13
207225,207225,,3,0,5,5
207226,207226,,34,1,13,14
207227,207227,,9,1,2,3
207228,207228,,31,7,36,43
9711134,9711134,,31,2,5,7
207230,207230,,19,0,2,2
207231,207231,,7,1,19,20
9211129,9211129,,7,1,0,1
207232,207232,,37,1,7,8
207233,207233,,7,0,6,6
109026,109026,,7,1,0,1
9310140,9310140,,7,5,0,5
9404052,9404052,,7,1,1,2
9406098,9406098,,7,2,0,2
9412083,9412083,,7,2,2,4
9312068,9312068,,7,4,2,6
207236,207236,,3,1,15,16
207237,207237,,25,0,7,7
9312017,9312017,,25,4,6,10
207238,207238,,54,4,11,15
207239,207239,,6,0,3,3
207240,207240,,25,0,3,3
207241,207241,,34,5,18,23
207242,207242,,3,1,11,12
207243,207243,,34,0,21,21
207244,207244,,37,3,45,48
207246,207246,,2,7,20,27
207247,207247,,34,2,34,36
207248,207248,,34,0,6,6
9310088,9310088,,8,5,3,8
9303130,9303130,,8,2,0,2
9306152,9306152,,8,2,0,2
9307144,9307144,,8,1,0,1
9307091,9307091,,8,4,7,11
9307180,9307180,,8,2,9,11
9405077,9405077,,8,2,1,3
9508097,9508097,,8,1,2,3
9512128,9512128,,8,7,2,9
9606156,9606156,,8,1,2,3
9607230,9607230,,8,2,0,2
9610080,9610080,,8,5,2,7
207249,207249,,2,0,65,65
207250,207250,,68,1,1,2
9704144,9704144,,68,2,0,2
207251,207251,,0,1,3,4
207252,207252,,1,1,16,17
207253,207253,,34,2,5,7
207254,207254,,6,4,4,8
207255,207255,,0,0,26,26
207257,207257,,1,8,65,73
207258,207258,,0,0,7,7
207259,207259,,37,3,16,19
207260,207260,,0,1,8,9
207261,207261,,16,0,4,4
207262,207262,,37,0,1,1
207263,207263,,0,4,6,10
207264,207264,,1,12,33,45
207265,207265,,34,2,12,14
207266,207266,,4,6,8,14
207267,207267,,2,13,12,25
207268,207268,,25,0,4,4
207269,207269,,3,0,1,1
207270,207270,,4,1,14,15
207271,207271,,37,1,7,8
207272,207272,,54,2,6,8
207273,207273,,8,1,42,43
207274,207274,,3,3,5,8
207275,207275,,11,1,5,6
207276,207276,,6,0,12,12
207277,207277,,6,0,7,7
207278,207278,,4,16,32,48
207279,207279,,7,8,14,22
207280,207280,,31,2,13,15
207281,207281,,54,2,20,22
207282,207282,,11,0,2,2
207283,207283,,0,3,70,73
207284,207284,,1,40,14,54
208001,208001,,19,1,3,4
208002,208002,,34,6,17,23
208003,208003,,4,9,42,51
208004,208004,,25,0,12,12
208005,208005,,62,3,21,24
208006,208006,,11,2,4,6
208007,208007,,3,0,9,9
208008,208008,,0,2,14,16
9910140,9910140,,0,2,2,4
9309051,9309051,,0,2,0,2
208011,208011,,4,2,23,25
208046,208046,,34,1,7,8
208015,208015,,34,1,11,12
208016,208016,,62,0,12,12
208018,208018,,34,3,52,55
208021,208021,,16,0,19,19
208022,208022,,37,1,30,31
208024,208024,,34,1,4,5
208025,208025,,0,1,8,9
208026,208026,,2,0,10,10
208028,208028,,4,8,34,42
208029,208029,,1,16,34,50
208030,208030,,54,1,28,29
208031,208031,,0,2,13,15
208032,208032,,54,0,30,30
208033,208033,,0,0,33,33
208034,208034,,25,0,14,14
208035,208035,,9,0,10,10
208036,208036,,8,1,8,9
9712209,9712209,,2,1,13,14
208037,208037,,0,5,13,18
208038,208038,,1,21,11,32
208039,208039,,37,6,51,57
208040,208040,,3,0,13,13
208042,208042,,1,15,40,55
208043,208043,,3,0,24,24
208044,208044,,2,6,23,29
208045,208045,,7,1,1,2
9404105,9404105,,7,1,4,5
9306071,9306071,,7,3,0,3
208047,208047,,34,4,19,23
208048,208048,,37,104,45,149
208050,208050,,7,0,34,34
9907160,9907160,,7,2,16,18
9810174,9810174,,7,1,1,2
208051,208051,,37,1,16,17
208052,208052,,25,2,23,25
7004,7004,,25,1,0,1
7005,7005,,25,1,0,1
208055,208055,,0,0,12,12
208056,208056,,0,4,10,14
208057,208057,,16,0,1,1
208058,208058,,34,14,9,23
208059,208059,,3,1,15,16
208060,208060,,34,6,12,18
208061,208061,,19,1,4,5
208062,208062,,7,3,9,12
208063,208063,,34,1,15,16
208064,208064,,7,1,5,6
208065,208065,,34,4,25,29
208066,208066,,1,10,22,32
208067,208067,,4,5,18,23
208068,208068,,4,1,29,30
208069,208069,,2,2,5,7
208070,208070,,37,0,8,8
208071,208071,,34,4,13,17
208072,208072,,3,5,7,12
208073,208073,,37,3,14,17
208074,208074,,1,12,32,44
208075,208075,,31,0,7,7
208076,208076,,2,0,17,17
208077,208077,,1,6,10,16
208078,208078,,1,3,12,15
208079,208079,,1,1,39,40
208080,208080,,0,3,32,35
208081,208081,,1,8,31,39
208082,208082,,34,0,11,11
208083,208083,,2,0,15,15
208084,208084,,19,0,9,9
208085,208085,,65,1,9,10
208086,208086,,34,6,38,44
208087,208087,,65,2,14,16
208088,208088,,11,1,3,4
208089,208089,,7,0,1,1
9411200,9411200,,7,1,6,7
9304074,9304074,,7,2,0,2
9308119,9308119,,16,4,4,8
9407054,9407054,,7,2,0,2
9409161,9409161,,7,1,1,2
208090,208090,,16,0,9,9
208091,208091,,2,0,10,10
208092,208092,,1,16,14,30
208095,208095,,37,3,26,29
208096,208096,,0,6,15,21
208097,208097,,34,4,13,17
208098,208098,,3,0,15,15
208099,208099,,2,1,19,20
9608187,9608187,,2,1,2,3
208100,208100,,2,0,29,29
208102,208102,,0,2,3,5
208104,208104,,37,6,19,25
208105,208105,,2,0,7,7
208106,208106,,6,2,7,9
208109,208109,,0,1,9,10
208093,208093,,25,4,0,4
208110,208110,,2,3,37,40
208112,208112,,2,0,26,26
208113,208113,,62,3,8,11
208114,208114,,1,29,27,56
208115,208115,,3,0,21,21
208116,208116,,11,0,3,3
208117,208117,,11,2,23,25
208118,208118,,9,1,3,4
208119,208119,,65,5,40,45
208120,208120,,34,4,9,13
208121,208121,,2,3,6,9
208122,208122,,31,2,1,3
208123,208123,,54,12,23,35
208125,208125,,54,2,55,57
9511093,9511093,,54,1,5,6
208127,208127,,0,3,34,37
208129,208129,,31,0,4,4
208130,208130,,25,1,7,8
208131,208131,,9,1,3,4
208132,208132,,7,2,16,18
9401165,9401165,,37,1,3,4
208135,208135,,34,0,8,8
208136,208136,,7,1,4,5
208137,208137,,34,1,10,11
208138,208138,,7,3,19,22
208139,208139,,37,0,19,19
208140,208140,,0,0,8,8
208141,208141,,65,2,51,53
208143,208143,,65,1,4,5
208144,208144,,3,2,32,34
9609125,9609125,,62,2,6,8
9509045,9509045,,62,3,2,5
9603040,9603040,,62,2,4,6
208145,208145,,54,4,20,24
208146,208146,,54,4,19,23
208147,208147,,62,1,9,10
208149,208149,,4,5,8,13
208150,208150,,16,0,5,5
208151,208151,,37,0,11,11
208152,208152,,2,0,3,3
208153,208153,,34,4,27,31
208154,208154,,34,2,23,25
208155,208155,,34,10,12,22
208156,208156,,34,8,18,26
208157,208157,,0,4,9,13
208158,208158,,2,1,18,19
208159,208159,,19,0,8,8
110060,110060,,19,2,0,2
208160,208160,,19,0,3,3
208161,208161,,1,11,27,38
208162,208162,,3,5,22,27
208163,208163,,1,9,62,71
208164,208164,,53,0,1,1
9602091,9602091,,53,1,0,1
208166,208166,,16,1,21,22
208167,208167,,7,10,10,20
208168,208168,,11,0,5,5
9905171,9905171,,11,2,1,3
9905151,9905151,,11,1,0,1
208169,208169,,0,0,8,8
208170,208170,,9,0,3,3
208171,208171,,34,0,19,19
208172,208172,,62,1,4,5
208173,208173,,3,0,10,10
208174,208174,,54,9,29,38
208175,208175,,2,1,13,14
208176,208176,,37,7,14,21
208177,208177,,37,1,11,12
208179,208179,,1,20,8,28
208180,208180,,9,0,11,11
208181,208181,,11,0,3,3
103134,103134,,11,1,0,1
208182,208182,,3,0,11,11
208183,208183,,25,0,4,4
208184,208184,,0,3,30,33
208185,208185,,2,0,1,1
208186,208186,,19,0,8,8
9706184,9706184,,19,3,9,12
208187,208187,,4,10,56,66
208188,208188,,31,6,9,15
208190,208190,,37,0,37,37
208191,208191,,37,0,4,4
208192,208192,,16,2,12,14
208193,208193,,16,1,4,5
208195,208195,,62,0,7,7
208197,208197,,1,15,21,36
208198,208198,,2,0,9,9
208199,208199,,3,2,8,10
208200,208200,,3,1,15,16
9310113,9310113,,62,1,15,16
208201,208201,,3,1,13,14
208203,208203,,3,2,35,37
208204,208204,,3,0,19,19
208205,208205,,0,3,21,24
208207,208207,,0,2,28,30
209051,209051,,0,13,29,42
208208,208208,,37,0,4,4
208209,208209,,1,28,25,53
208211,208211,,11,0,12,12
208212,208212,,1,0,1,1
208213,208213,,3,1,21,22
208214,208214,,4,1,11,12
208215,208215,,11,1,16,17
208218,208218,,34,0,2,2
208219,208219,,54,2,26,28
208220,208220,,2,0,6,6
208221,208221,,7,0,2,2
208222,208222,,37,4,34,38
208225,208225,,2,1,17,18
208226,208226,,0,0,10,10
208227,208227,,4,0,44,44
208228,208228,,6,0,1,1
208229,208229,,34,1,10,11
9712045,9712045,,34,1,2,3
208230,208230,,57,1,1,2
5057,5057,,57,1,0,1
208231,208231,,1,34,18,52
208232,208232,,1,18,32,50
209002,209002,,1,41,21,62
209215,209215,,1,29,25,54
209001,209001,,62,3,4,7
209003,209003,,54,6,30,36
209004,209004,,1,14,25,39
209005,209005,,3,0,3,3
209006,209006,,16,0,1,1
9705231,9705231,,16,3,0,3
209007,209007,,7,0,3,3
209008,209008,,3,3,8,11
209009,209009,,1,7,24,31
209010,209010,,37,2,14,16
209011,209011,,1,13,23,36
209013,209013,,4,0,23,23
209015,209015,,1,0,12,12
209016,209016,,1,0,6,6
209017,209017,,7,4,14,18
209018,209018,,4,0,32,32
209019,209019,,6,1,4,5
209020,209020,,8,0,12,12
209021,209021,,19,0,2,2
209022,209022,,31,0,14,14
209023,209023,,6,1,12,13
209024,209024,,7,0,7,7
209025,209025,,11,9,21,30
209026,209026,,1,6,11,17
209027,209027,,4,0,23,23
209028,209028,,16,3,9,12
209029,209029,,34,2,36,38
9910225,9910225,,34,1,4,5
209030,209030,,54,1,34,35
209031,209031,,65,0,4,4
209032,209032,,11,0,10,10
209033,209033,,19,0,5,5
209035,209035,,54,0,5,5
209036,209036,,0,2,2,4
209037,209037,,62,0,15,15
209038,209038,,37,3,12,15
209039,209039,,25,2,15,17
209040,209040,,2,1,5,6
209041,209041,,4,13,23,36
209042,209042,,25,1,22,23
209043,209043,,1,7,29,36
209044,209044,,2,3,9,12
209045,209045,,11,1,1,2
209046,209046,,54,2,18,20
209047,209047,,1,13,34,47
209048,209048,,65,2,5,7
209049,209049,,2,1,3,4
209050,209050,,34,1,35,36
209052,209052,,62,2,8,10
209053,209053,,9,0,4,4
104024,104024,,9,2,0,2
209054,209054,,1,7,34,41
209055,209055,,8,0,10,10
209056,209056,,34,4,34,38
209057,209057,,2,4,31,35
209058,209058,,11,1,2,3
209059,209059,,1,5,41,46
209060,209060,,54,0,18,18
209061,209061,,14,0,15,15
209062,209062,,7,0,7,7
209063,209063,,54,0,8,8
209065,209065,,3,0,20,20
9307182,9307182,,11,9,0,9
9401134,9401134,,34,2,1,3
209066,209066,,0,3,21,24
209067,209067,,34,9,70,79
209068,209068,,4,10,57,67
209069,209069,,2,2,9,11
209070,209070,,11,0,8,8
209071,209071,,37,4,2,6
9210089,9210089,,62,1,0,1
209072,209072,,37,0,3,3
209073,209073,,11,0,10,10
209074,209074,,7,1,2,3
209075,209075,,54,1,4,5
9404177,9404177,,54,2,0,2
209076,209076,,0,2,22,24
209077,209077,,54,12,33,45
209078,209078,,11,0,1,1
209079,209079,,16,3,51,54
209080,209080,,34,1,16,17
209081,209081,,1,6,29,35
209082,209082,,3,1,15,16
209084,209084,,1,2,16,18
209085,209085,,37,41,21,62
209086,209086,,54,1,1,2
9712065,9712065,,54,1,1,2
209088,209088,,54,0,11,11
209089,209089,,37,53,17,70
209091,209091,,14,1,3,4
209093,209093,,14,0,3,3
209094,209094,,14,0,8,8
209095,209095,,1,5,19,24
209096,209096,,54,0,2,2
209097,209097,,2,0,4,4
209098,209098,,65,10,14,24
9905141,9905141,,2,2,10,12
9801080,9801080,,2,1,7,8
209099,209099,,37,49,11,60
209100,209100,,54,1,4,5
209101,209101,,0,1,17,18
209102,209102,,34,1,13,14
207179,207179,,34,1,0,1
209103,209103,,34,0,18,18
209104,209104,,3,5,7,12
209105,209105,,3,2,10,12
209106,209106,,2,1,38,39
9701052,9701052,,19,2,5,7
209107,209107,,37,1,4,5
9311102,9311102,,16,2,5,7
9512038,9512038,,7,3,7,10
209108,209108,,16,0,2,2
209109,209109,,6,1,9,10
209110,209110,,7,0,16,16
9311028,9311028,,7,1,5,6
209111,209111,,3,2,17,19
209113,209113,,7,12,1,13
209114,209114,,2,16,35,51
209115,209115,,37,2,17,19
9504144,9504144,,37,1,5,6
9606002,9606002,,54,1,7,8
9607206,9607206,,54,1,5,6
9207115,9207115,,37,1,1,2
9506164,9506164,,54,2,6,8
209116,209116,,1,16,45,61
209117,209117,,3,1,25,26
209119,209119,,34,0,9,9
9308025,9308025,,34,1,0,1
209120,209120,,34,6,17,23
209121,209121,,34,0,9,9
209122,209122,,4,31,68,99
209124,209124,,34,0,7,7
209125,209125,,25,0,10,10
209126,209126,,2,0,3,3
209127,209127,,37,1,38,39
209128,209128,,34,0,15,15
209129,209129,,7,2,21,23
209130,209130,,11,0,13,13
209131,209131,,3,2,10,12
209132,209132,,6,1,5,6
9303144,9303144,,6,1,0,1
209133,209133,,0,2,17,19
209134,209134,,16,0,3,3
209135,209135,,34,0,5,5
209136,209136,,6,1,27,28
209137,209137,,3,5,30,35
209223,209223,,3,4,33,37
209138,209138,,37,18,12,30
209139,209139,,3,4,26,30
209140,209140,,2,0,13,13
209141,209141,,37,1,17,18
9905029,9905029,,37,1,26,27
209142,209142,,0,1,7,8
209144,209144,,7,0,6,6
209145,209145,,1,12,76,88
209146,209146,,8,0,16,16
9209112,9209112,,25,4,0,4
209147,209147,,7,0,6,6
9508061,9508061,,7,4,6,10
9506153,9506153,,7,2,2,4
209148,209148,,3,3,31,34
209149,209149,,34,0,7,7
209150,209150,,34,8,57,65
209152,209152,,0,2,17,19
209153,209153,,3,5,53,58
209154,209154,,8,2,14,16
209155,209155,,1,5,31,36
209156,209156,,34,0,11,11
209157,209157,,65,5,39,44
209158,209158,,0,5,32,37
209159,209159,,7,12,20,32
209160,209160,,1,8,63,71
209161,209161,,37,2,32,34
209162,209162,,11,1,17,18
209163,209163,,34,4,26,30
209164,209164,,1,0,43,43
209165,209165,,46,1,3,4
209166,209166,,3,3,14,17
209167,209167,,11,0,2,2
209168,209168,,37,0,1,1
209169,209169,,2,1,96,97
9905073,9905073,,2,3,24,27
209170,209170,,2,1,3,4
209171,209171,,25,0,6,6
209172,209172,,7,0,9,9
9409172,9409172,,7,1,5,6
9209060,9209060,,62,2,0,2
9211032,9211032,,7,5,0,5
9309036,9309036,,62,3,4,7
209174,209174,,7,0,15,15
209175,209175,,2,2,11,13
209176,209176,,54,5,44,49
209177,209177,,55,0,1,1
9811181,9811181,,55,1,0,1
209178,209178,,54,0,7,7
209179,209179,,1,2,24,26
209180,209180,,6,2,4,6
209181,209181,,0,1,20,21
209182,209182,,3,3,11,14
209183,209183,,11,0,11,11
209184,209184,,34,0,10,10
209185,209185,,34,0,8,8
209186,209186,,4,4,20,24
209187,209187,,37,2,14,16
209188,209188,,34,0,49,49
209189,209189,,34,0,13,13
209190,209190,,54,5,29,34
209191,209191,,34,2,36,38
209192,209192,,4,0,8,8
209193,209193,,1,17,13,30
209194,209194,,34,1,44,45
209195,209195,,1,3,41,44
209196,209196,,7,1,1,2
209197,209197,,4,3,26,29
209198,209198,,3,2,4,6
209199,209199,,3,0,5,5
209200,209200,,54,2,25,27
209201,209201,,1,11,55,66
209203,209203,,34,2,37,39
209204,209204,,7,0,1,1
209205,209205,,2,6,28,34
209206,209206,,54,6,28,34
209207,209207,,54,1,13,14
209208,209208,,11,1,17,18
209209,209209,,25,0,12,12
209210,209210,,4,1,30,31
209211,209211,,34,5,18,23
209212,209212,,34,0,24,24
209213,209213,,7,0,6,6
209214,209214,,3,1,16,17
209217,209217,,4,6,32,38
209218,209218,,1,3,24,27
209219,209219,,1,7,35,42
209220,209220,,34,0,13,13
209221,209221,,3,0,15,15
209224,209224,,1,11,22,33
209225,209225,,1,12,41,53
209226,209226,,34,5,25,30
209227,209227,,0,5,8,13
209228,209228,,37,3,30,33
209229,209229,,62,0,3,3
209230,209230,,37,4,198,202
209231,209231,,7,16,21,37
209232,209232,,4,5,48,53
209233,209233,,9,1,1,2
209234,209234,,3,3,10,13
209235,209235,,34,0,59,59
209236,209236,,11,2,10,12
209237,209237,,11,2,11,13
209238,209238,,34,2,24,26
209239,209239,,2,7,20,27
209240,209240,,3,2,24,26
209241,209241,,65,7,177,184
209242,209242,,0,9,19,28
209244,209244,,1,11,17,28
209245,209245,,54,1,12,13
209246,209246,,62,1,3,4
209247,209247,,1,4,22,26
209248,209248,,34,1,19,20
209249,209249,,25,2,1,3
209251,209251,,1,7,26,33
209252,209252,,34,1,13,14
209253,209253,,3,3,8,11
209254,209254,,3,4,28,32
209255,209255,,4,9,77,86
209256,209256,,34,3,10,13
209257,209257,,34,0,41,41
209258,209258,,34,0,16,16
209259,209259,,3,0,1,1
209260,209260,,2,0,10,10
209262,209262,,7,0,9,9
209263,209263,,1,14,21,35
209264,209264,,7,2,17,19
209265,209265,,1,5,17,22
9807159,9807159,,6,2,5,7
9710050,9710050,,6,2,5,7
209266,209266,,37,1,13,14
209267,209267,,37,0,12,12
210001,210001,,31,3,1,4
210002,210002,,0,0,2,2
210003,210003,,7,0,2,2
9903247,9903247,,7,1,0,1
210004,210004,,54,3,9,12
210005,210005,,0,2,27,29
210006,210006,,0,0,8,8
210007,210007,,37,2,29,31
210008,210008,,54,0,6,6
210009,210009,,11,0,35,35
210010,210010,,3,1,16,17
210011,210011,,2,2,26,28
210012,210012,,2,0,30,30
210014,210014,,65,0,28,28
210016,210016,,31,2,6,8
210017,210017,,34,2,29,31
210019,210019,,62,0,5,5
210020,210020,,19,0,19,19
9608038,9608038,,19,2,0,2
9610183,9610183,,19,2,0,2
9712036,9712036,,19,3,5,8
9510051,9510051,,19,1,0,1
9510052,9510052,,19,1,0,1
210022,210022,,37,0,22,22
210023,210023,,62,0,3,3
210025,210025,,54,1,16,17
210026,210026,,54,0,11,11
210027,210027,,3,0,1,1
112213,112213,,3,2,0,2
210028,210028,,3,0,12,12
210029,210029,,0,5,40,45
210030,210030,,4,10,15,25
210031,210031,,6,1,1,2
210032,210032,,65,0,13,13
210033,210033,,0,3,13,16
210034,210034,,34,0,6,6
210035,210035,,1,5,44,49
210036,210036,,11,5,11,16
210037,210037,,1,0,2,2
210038,210038,,1,0,6,6
210039,210039,,0,0,16,16
210040,210040,,3,0,13,13
210041,210041,,34,4,18,22
210042,210042,,3,3,20,23
210043,210043,,65,4,6,10
210044,210044,,37,1,40,41
9507087,9507087,,62,4,3,7
210046,210046,,34,3,53,56
210047,210047,,37,2,8,10
210048,210048,,34,0,37,37
210049,210049,,2,2,10,12
210050,210050,,34,1,8,9
210051,210051,,34,2,7,9
210052,210052,,0,0,2,2
210053,210053,,54,3,28,31
210054,210054,,4,3,18,21
210055,210055,,34,0,14,14
210056,210056,,34,2,15,17
210057,210057,,37,1,4,5
210058,210058,,7,10,25,35
210059,210059,,3,1,12,13
210060,210060,,1,1,14,15
9404157,9404157,,25,4,37,41
9207096,9207096,,37,11,0,11
9308036,9308036,,25,5,3,8
9309157,9309157,,25,2,0,2
9312190,9312190,,25,2,7,9
210061,210061,,7,0,11,11
9702130,9702130,,7,2,0,2
210062,210062,,7,1,12,13
210063,210063,,34,0,8,8
210064,210064,,1,0,19,19
210065,210065,,0,0,4,4
210066,210066,,0,4,17,21
210067,210067,,3,1,20,21
210068,210068,,34,5,37,42
210070,210070,,8,1,82,83
210071,210071,,65,0,2,2
9910070,9910070,,65,1,6,7
9907137,9907137,,65,1,4,5
210072,210072,,1,5,37,42
210073,210073,,3,1,23,24
210074,210074,,6,0,6,6
210075,210075,,4,2,29,31
210076,210076,,54,1,7,8
210077,210077,,11,4,16,20
210078,210078,,1,4,21,25
210079,210079,,8,0,36,36
210080,210080,,54,2,28,30
210082,210082,,11,0,3,3
210084,210084,,3,0,6,6
210085,210085,,6,2,17,19
9807106,9807106,,11,4,9,13
9707234,9707234,,16,3,5,8
210086,210086,,0,0,5,5
210087,210087,,62,0,3,3
210089,210089,,34,0,33,33
210090,210090,,4,0,15,15
210091,210091,,1,7,20,27
210092,210092,,6,0,2,2
210093,210093,,34,7,25,32
210094,210094,,34,0,25,25
210095,210095,,65,1,11,12
210096,210096,,37,6,13,19
210097,210097,,9,1,4,5
210098,210098,,11,1,7,8
210099,210099,,25,0,2,2
9812236,9812236,,25,1,4,5
210100,210100,,1,0,9,9
210101,210101,,4,10,38,48
210102,210102,,1,25,27,52
210103,210103,,2,0,3,3
210104,210104,,11,1,7,8
210105,210105,,2,3,38,41
210107,210107,,3,3,5,8
210108,210108,,4,1,13,14
210109,210109,,7,2,1,3
210110,210110,,16,0,2,2
210111,210111,,7,2,6,8
207085,207085,,7,2,0,2
210112,210112,,3,0,7,7
210113,210113,,3,0,2,2
7003,7003,,3,1,0,1
210114,210114,,34,17,25,42
210115,210115,,34,7,12,19
210116,210116,,2,0,11,11
210117,210117,,0,0,13,13
210118,210118,,34,0,8,8
210119,210119,,6,0,3,3
210120,210120,,56,0,2,2
210121,210121,,3,0,5,5
210122,210122,,1,7,28,35
210123,210123,,34,2,6,8
210124,210124,,34,2,14,16
210125,210125,,11,0,6,6
9309098,9309098,,11,2,1,3
9511113,9511113,,11,1,0,1
9305147,9305147,,11,1,0,1
210126,210126,,34,5,13,18
210127,210127,,37,3,32,35
210128,210128,,7,1,8,9
210129,210129,,25,0,3,3
210130,210130,,2,0,1,1
210131,210131,,54,3,25,28
210132,210132,,37,2,33,35
9211042,9211042,,37,1,0,1
210133,210133,,2,1,32,33
210134,210134,,2,0,93,93
210135,210135,,37,50,27,77
210136,210136,,62,0,5,5
9612081,9612081,,62,2,4,6
210137,210137,,65,0,26,26
9804040,9804040,,65,1,7,8
210138,210138,,19,0,10,10
210139,210139,,4,1,19,20
210141,210141,,7,0,6,6
210143,210143,,11,1,2,3
210144,210144,,62,1,4,5
210145,210145,,37,2,60,62
210146,210146,,2,3,28,31
210147,210147,,11,1,6,7
210148,210148,,37,42,24,66
210149,210149,,36,0,2,2
210150,210150,,54,0,34,34
210151,210151,,25,0,5,5
9906143,9906143,,6,1,10,11
210152,210152,,2,2,22,24
210153,210153,,1,25,31,56
210154,210154,,11,1,6,7
210155,210155,,4,4,10,14
210156,210156,,7,0,1,1
210157,210157,,2,4,289,293
210230,210230,,1,7,33,40
210158,210158,,1,6,42,48
210159,210159,,37,3,9,12
210161,210161,,62,0,1,1
210162,210162,,3,1,3,4
210163,210163,,3,2,16,18
210164,210164,,3,1,10,11
210165,210165,,0,0,1,1
210166,210166,,3,0,14,14
209118,209118,,3,4,0,4
210167,210167,,3,0,63,63
210168,210168,,34,0,16,16
210169,210169,,4,2,6,8
210170,210170,,2,1,6,7
210171,210171,,3,0,9,9
210173,210173,,3,1,20,21
210174,210174,,34,0,10,10
210175,210175,,4,0,18,18
210176,210176,,0,0,2,2
210177,210177,,54,1,6,7
210178,210178,,2,6,22,28
210179,210179,,16,0,6,6
210180,210180,,8,0,1,1
210181,210181,,54,0,22,22
210182,210182,,8,0,7,7
210183,210183,,37,46,40,86
210184,210184,,0,11,10,21
210185,210185,,14,1,7,8
210186,210186,,7,4,23,27
210187,210187,,34,4,42,46
210188,210188,,7,1,3,4
210189,210189,,0,0,9,9
210190,210190,,7,0,6,6
210192,210192,,37,0,4,4
210193,210193,,2,1,27,28
210194,210194,,3,0,10,10
210195,210195,,34,3,13,16
210196,210196,,7,8,15,23
210197,210197,,14,0,5,5
210198,210198,,7,5,38,43
210199,210199,,4,2,8,10
210201,210201,,0,0,1,1
210202,210202,,34,0,5,5
210203,210203,,3,4,28,32
210205,210205,,0,2,9,11
210206,210206,,4,8,31,39
210207,210207,,6,2,25,27
210208,210208,,1,1,8,9
9906116,9906116,,1,1,7,8
210209,210209,,54,9,43,52
210210,210210,,11,0,6,6
210211,210211,,31,0,17,17
210212,210212,,2,3,20,23
210213,210213,,7,1,8,9
210215,210215,,8,0,4,4
9707069,9707069,,8,1,7,8
210216,210216,,62,0,8,8
210218,210218,,1,5,50,55
210219,210219,,54,11,28,39
210220,210220,,34,4,11,15
210221,210221,,4,2,34,36
210222,210222,,34,0,9,9
210223,210223,,2,1,8,9
210224,210224,,4,2,169,171
210246,210246,,1,24,29,53
210313,210313,,4,3,59,62
211017,211017,,37,68,4,72
211170,211170,,37,70,26,96
211220,211220,,1,11,23,34
212269,212269,,1,12,32,44
301117,301117,,4,10,28,38
210238,210238,,37,55,30,85
210281,210281,,37,41,22,63
211100,211100,,37,37,32,69
211123,211123,,37,39,44,83
211188,211188,,1,12,20,32
211198,211198,,1,17,16,33
211032,211032,,1,16,41,57
212118,212118,,1,8,20,28
212208,212208,,1,11,47,58
212256,212256,,2,5,27,32
301024,301024,,34,1,8,9
210225,210225,,62,0,20,20
210226,210226,,9,0,1,1
210228,210228,,54,1,21,22
210229,210229,,1,5,40,45
210231,210231,,4,6,39,45
210232,210232,,0,1,5,6
210233,210233,,7,2,18,20
210234,210234,,1,12,20,32
210235,210235,,54,0,6,6
210236,210236,,14,3,3,6
210237,210237,,3,0,4,4
9205057,9205057,,16,2,0,2
210239,210239,,37,37,24,61
210240,210240,,8,1,10,11
210241,210241,,37,2,29,31
210242,210242,,11,0,2,2
210243,210243,,2,0,14,14
210244,210244,,2,1,10,11
210245,210245,,2,1,3,4
210247,210247,,0,0,6,6
210248,210248,,1,1,8,9
210249,210249,,65,0,108,108
210250,210250,,0,3,23,26
210251,210251,,25,2,9,11
210252,210252,,34,4,37,41
210253,210253,,3,0,21,21
210254,210254,,54,6,35,41
210255,210255,,19,0,3,3
210191,210191,,19,1,0,1
9302079,9302079,,19,2,2,4
210256,210256,,34,2,17,19
210257,210257,,0,1,18,19
210258,210258,,0,1,11,12
210261,210261,,2,1,9,10
210262,210262,,1,10,49,59
210263,210263,,54,1,25,26
210264,210264,,7,1,13,14
210265,210265,,34,2,35,37
210266,210266,,34,0,6,6
210267,210267,,62,0,16,16
9906186,9906186,,62,1,4,5
9308137,9308137,,62,1,0,1
210268,210268,,37,1,8,9
210269,210269,,4,13,30,43
210270,210270,,4,0,26,26
210271,210271,,3,0,13,13
210272,210272,,34,4,43,47
210274,210274,,34,0,13,13
210275,210275,,25,0,13,13
210276,210276,,2,0,5,5
210277,210277,,11,0,3,3
210278,210278,,6,6,34,40
210279,210279,,0,1,15,16
210280,210280,,34,0,11,11
210282,210282,,25,2,15,17
210283,210283,,11,0,2,2
210285,210285,,34,0,15,15
210286,210286,,34,0,7,7
210287,210287,,11,1,6,7
210288,210288,,3,3,10,13
210289,210289,,0,0,14,14
210290,210290,,54,0,12,12
210291,210291,,37,46,19,65
210293,210293,,11,0,6,6
210294,210294,,54,0,28,28
210295,210295,,34,1,7,8
210296,210296,,37,0,17,17
210297,210297,,3,1,8,9
9904171,9904171,,3,2,7,9
210298,210298,,11,1,3,4
9408163,9408163,,11,4,0,4
210299,210299,,11,0,14,14
9705213,9705213,,11,1,3,4
210300,210300,,34,0,17,17
210301,210301,,65,1,16,17
210302,210302,,65,2,39,41
9310082,9310082,,65,1,9,10
9204100,9204100,,37,5,0,5
210303,210303,,0,1,6,7
210304,210304,,7,0,1,1
210305,210305,,1,0,40,40
210306,210306,,2,3,12,15
210307,210307,,19,0,4,4
210308,210308,,1,11,43,54
210309,210309,,1,14,23,37
210310,210310,,11,1,15,16
9802124,9802124,,11,1,4,5
210311,210311,,4,0,21,21
210312,210312,,19,0,6,6
9304017,9304017,,19,3,0,3
211001,211001,,62,2,9,11
211003,211003,,65,1,12,13
211004,211004,,16,0,2,2
211005,211005,,25,0,8,8
211006,211006,,7,5,27,32
211007,211007,,11,2,13,15
211008,211008,,2,6,13,19
211009,211009,,37,43,34,77
211010,211010,,37,1,16,17
211011,211011,,1,18,34,52
211012,211012,,4,7,83,90
211013,211013,,0,0,16,16
211014,211014,,11,1,25,26
211015,211015,,2,0,3,3
211016,211016,,37,0,13,13
211018,211018,,34,1,20,21
211019,211019,,54,1,18,19
211020,211020,,34,1,20,21
211021,211021,,2,0,15,15
9812098,9812098,,2,1,5,6
9912096,9912096,,34,1,14,15
211022,211022,,7,3,7,10
211023,211023,,34,1,32,33
211024,211024,,34,4,15,19
211026,211026,,16,1,5,6
211027,211027,,54,7,14,21
211028,211028,,0,9,28,37
211029,211029,,1,6,42,48
211030,211030,,2,2,25,27
211033,211033,,2,0,11,11
211034,211034,,2,0,8,8
211035,211035,,0,0,9,9
211036,211036,,6,0,30,30
211037,211037,,34,0,4,4
211038,211038,,65,2,16,18
211039,211039,,54,0,14,14
211040,211040,,4,0,21,21
211041,211041,,3,5,43,48
211042,211042,,2,11,51,62
211043,211043,,54,0,15,15
211044,211044,,34,0,12,12
211045,211045,,16,0,2,2
211046,211046,,57,0,1,1
211047,211047,,2,0,12,12
211048,211048,,0,2,7,9
211049,211049,,37,2,20,22
211050,211050,,37,0,11,11
211051,211051,,7,1,7,8
211052,211052,,37,40,16,56
211053,211053,,7,0,21,21
211054,211054,,16,1,16,17
211055,211055,,11,1,18,19
7093,7093,,11,1,0,1
211056,211056,,3,2,27,29
211057,211057,,7,3,15,18
211058,211058,,0,2,15,17
211060,211060,,3,1,14,15
211061,211061,,37,2,16,18
211062,211062,,1,0,3,3
9905154,9905154,,25,2,0,2
211063,211063,,4,5,11,16
211064,211064,,7,0,2,2
211065,211065,,2,2,16,18
211066,211066,,14,0,10,10
211067,211067,,37,1,23,24
211068,211068,,3,1,45,46
211069,211069,,37,38,29,67
211070,211070,,3,2,22,24
9406130,9406130,,3,4,1,5
9508137,9508137,,3,5,1,6
9604197,9604197,,3,3,1,4
9712235,9712235,,3,2,4,6
9601093,9601093,,3,2,3,5
211071,211071,,11,1,3,4
211072,211072,,11,1,7,8
211073,211073,,1,4,20,24
211075,211075,,37,41,24,65
211076,211076,,3,2,39,41
211078,211078,,7,0,3,3
211080,211080,,25,2,11,13
211081,211081,,0,0,12,12
211082,211082,,37,41,17,58
211083,211083,,2,0,7,7
211084,211084,,6,1,5,6
211085,211085,,6,0,5,5
211086,211086,,37,0,32,32
211087,211087,,0,0,16,16
211088,211088,,7,1,2,3
111137,111137,,7,2,0,2
211089,211089,,1,3,19,22
211091,211091,,54,3,24,27
211092,211092,,34,3,10,13
211093,211093,,1,1,14,15
211094,211094,,62,1,18,19
211095,211095,,1,2,17,19
211097,211097,,2,3,26,29
211098,211098,,37,25,33,58
211099,211099,,27,0,1,1
211101,211101,,2,0,20,20
211102,211102,,54,16,53,69
211103,211103,,0,5,38,43
211104,211104,,11,0,4,4
211105,211105,,3,0,17,17
211106,211106,,34,0,4,4
211107,211107,,34,2,6,8
211108,211108,,37,1,32,33
211250,211250,,34,2,32,34
211109,211109,,0,1,4,5
211110,211110,,3,0,35,35
211111,211111,,54,6,24,30
211112,211112,,0,2,9,11
211113,211113,,34,6,12,18
211114,211114,,62,0,6,6
211115,211115,,2,2,20,22
211116,211116,,54,0,34,34
211118,211118,,54,15,48,63
211119,211119,,3,0,6,6
211120,211120,,34,0,17,17
211121,211121,,37,0,35,35
211122,211122,,1,12,19,31
211124,211124,,31,7,10,17
211125,211125,,3,1,7,8
211126,211126,,54,0,10,10
211127,211127,,4,2,27,29
211128,211128,,6,0,17,17
211129,211129,,3,3,33,36
211130,211130,,34,3,38,41
211131,211131,,4,6,35,41
211132,211132,,62,1,13,14
201230,201230,,62,1,0,1
211133,211133,,16,0,12,12
9601099,9601099,,16,1,7,8
211134,211134,,8,0,19,19
211135,211135,,34,0,41,41
211136,211136,,9,1,18,19
211137,211137,,1,3,18,21
211138,211138,,1,0,37,37
211139,211139,,1,5,21,26
211140,211140,,37,0,10,10
211141,211141,,34,2,26,28
211142,211142,,34,8,20,28
211143,211143,,65,0,4,4
9402137,9402137,,65,2,0,2
9905166,9905166,,65,1,4,5
211144,211144,,11,6,18,24
211145,211145,,16,0,2,2
9207083,9207083,,16,1,0,1
211146,211146,,37,0,22,22
211147,211147,,2,2,10,12
9610103,9610103,,2,2,6,8
211148,211148,,3,3,20,23
211149,211149,,0,3,15,18
211150,211150,,1,0,8,8
211151,211151,,6,0,3,3
9905051,9905051,,6,1,1,2
211152,211152,,2,3,20,23
211153,211153,,11,1,2,3
204003,204003,,11,3,0,3
206008,206008,,11,3,0,3
211154,211154,,65,1,16,17
211155,211155,,6,3,3,6
211156,211156,,3,0,29,29
211157,211157,,6,0,9,9
211158,211158,,6,2,33,35
211159,211159,,2,0,2,2
211160,211160,,34,3,20,23
211161,211161,,2,0,13,13
211162,211162,,34,0,39,39
211163,211163,,65,2,17,19
211164,211164,,3,2,35,37
211165,211165,,3,3,8,11
211167,211167,,7,1,11,12
211168,211168,,62,2,9,11
211169,211169,,3,1,21,22
211171,211171,,3,2,28,30
211172,211172,,4,1,28,29
211173,211173,,37,1,7,8
211174,211174,,62,0,25,25
211175,211175,,0,0,3,3
211176,211176,,3,1,22,23
211177,211177,,65,0,8,8
211178,211178,,1,5,170,175
211179,211179,,11,0,2,2
9810175,9810175,,11,1,1,2
9407140,9407140,,11,1,0,1
211180,211180,,4,6,36,42
211181,211181,,1,1,77,78
211182,211182,,54,15,48,63
211183,211183,,0,0,11,11
211184,211184,,1,0,22,22
211185,211185,,62,1,10,11
9312156,9312156,,62,3,2,5
9501005,9501005,,62,4,27,31
9204081,9204081,,62,1,0,1
9405041,9405041,,62,1,6,7
211186,211186,,62,0,4,4
211187,211187,,46,0,5,5
211189,211189,,37,34,22,56
211190,211190,,3,0,6,6
211191,211191,,34,1,18,19
211192,211192,,2,0,12,12
211193,211193,,3,3,11,14
211194,211194,,37,26,11,37
211195,211195,,1,8,40,48
211196,211196,,0,1,26,27
211197,211197,,1,4,25,29
211199,211199,,4,0,28,28
211200,211200,,0,3,8,11
211201,211201,,1,4,18,22
211202,211202,,37,35,33,68
211203,211203,,34,3,50,53
211204,211204,,37,3,18,21
211205,211205,,34,0,1,1
211206,211206,,1,6,24,30
211207,211207,,25,1,26,27
211208,211208,,6,1,7,8
9512151,9512151,,6,3,0,3
211209,211209,,3,1,23,24
211210,211210,,0,1,8,9
211211,211211,,2,0,1,1
211212,211212,,4,1,31,32
211213,211213,,54,2,22,24
211214,211214,,7,0,7,7
211216,211216,,37,31,33,64
211217,211217,,1,7,41,48
211218,211218,,4,6,27,33
211221,211221,,34,3,20,23
211222,211222,,0,6,40,46
211223,211223,,67,3,1,4
211224,211224,,11,0,11,11
211225,211225,,3,1,12,13
211226,211226,,1,0,4,4
211227,211227,,37,0,9,9
211228,211228,,37,1,4,5
211229,211229,,34,0,11,11
211230,211230,,54,0,5,5
211231,211231,,6,0,3,3
102204,102204,,6,1,0,1
102205,102205,,6,1,0,1
211232,211232,,3,2,43,45
211233,211233,,34,2,10,12
211234,211234,,37,32,36,68
211235,211235,,8,1,7,8
211236,211236,,37,15,34,49
211237,211237,,7,0,7,7
9303008,9303008,,7,1,0,1
211238,211238,,4,8,52,60
211239,211239,,6,0,5,5
211240,211240,,37,1,14,15
212125,212125,,37,1,5,6
211241,211241,,37,28,21,49
211242,211242,,6,1,8,9
211244,211244,,0,1,8,9
211245,211245,,37,26,156,182
211259,211259,,37,18,79,97
9810076,9810076,,37,2,0,2
9904103,9904103,,37,2,1,3
211249,211249,,37,29,13,42
211254,211254,,37,33,35,68
9308039,9308039,,4,1,4,5
9310086,9310086,,37,1,0,1
9511092,9511092,,6,1,3,4
9707064,9707064,,37,2,2,4
9711058,9711058,,37,1,5,6
211246,211246,,6,1,5,6
211247,211247,,2,0,3,3
211248,211248,,11,0,7,7
211252,211252,,34,4,31,35
211253,211253,,34,0,8,8
211256,211256,,34,0,4,4
211257,211257,,1,6,55,61
9405017,9405017,,1,1,0,1
211258,211258,,3,2,44,46
9301124,9301124,,3,2,1,3
211260,211260,,11,0,4,4
211261,211261,,37,27,21,48
211262,211262,,25,0,29,29
211263,211263,,3,2,61,63
211264,211264,,7,0,5,5
211265,211265,,37,0,3,3
211266,211266,,4,2,22,24
211267,211267,,11,0,5,5
211268,211268,,0,1,11,12
211271,211271,,37,26,55,81
211272,211272,,2,3,29,32
211273,211273,,37,0,4,4
9201035,9201035,,37,3,0,3
9308109,9308109,,37,4,0,4
9911054,9911054,,37,1,1,2
211274,211274,,37,16,31,47
211275,211275,,58,0,2,2
201020,201020,,58,1,0,1
205120,205120,,58,1,0,1
211276,211276,,11,0,7,7
211277,211277,,11,0,17,17
211278,211278,,34,0,19,19
211279,211279,,8,1,5,6
211280,211280,,6,0,4,4
211281,211281,,54,0,14,14
211282,211282,,37,1,22,23
211284,211284,,54,1,5,6
211285,211285,,1,1,43,44
211286,211286,,4,0,11,11
211287,211287,,37,24,40,64
211288,211288,,1,0,33,33
211289,211289,,1,15,40,55
211290,211290,,2,4,26,30
211291,211291,,37,30,69,99
212069,212069,,37,24,45,69
212010,212010,,37,24,61,85
211292,211292,,34,2,27,29
212001,212001,,2,0,1,1
212002,212002,,2,6,31,37
212003,212003,,54,0,42,42
212004,212004,,67,2,1,3
212006,212006,,65,0,13,13
9910112,9910112,,65,2,16,18
9912173,9912173,,65,1,11,12
9312042,9312042,,37,2,8,10
9808096,9808096,,65,1,3,4
212007,212007,,19,0,13,13
212008,212008,,34,11,19,30
212009,212009,,2,3,28,31
212012,212012,,2,1,23,24
212013,212013,,6,0,2,2
212014,212014,,0,1,16,17
212015,212015,,0,0,12,12
212016,212016,,8,1,17,18
212017,212017,,1,4,19,23
212018,212018,,37,0,16,16
9512049,9512049,,37,1,0,1
212019,212019,,6,0,10,10
9810048,9810048,,6,1,4,5
212020,212020,,37,1,32,33
9909032,9909032,,54,1,23,24
9505015,9505015,,37,2,0,2
212021,212021,,37,0,19,19
212022,212022,,7,0,2,2
212023,212023,,0,2,8,10
212024,212024,,2,4,14,18
212025,212025,,37,22,33,55
212026,212026,,6,1,9,10
212027,212027,,7,0,5,5
212028,212028,,19,0,4,4
212029,212029,,34,1,19,20
212030,212030,,2,1,9,10
212031,212031,,3,2,7,9
212032,212032,,37,14,71,85
212033,212033,,54,0,6,6
212034,212034,,62,0,1,1
212035,212035,,3,0,15,15
212036,212036,,0,1,9,10
212037,212037,,0,1,20,21
212038,212038,,6,0,5,5
212039,212039,,2,1,25,26
212041,212041,,1,2,8,10
212042,212042,,65,1,8,9
212043,212043,,2,0,22,22
206120,206120,,2,1,0,1
212044,212044,,2,1,14,15
212046,212046,,62,0,6,6
212047,212047,,34,1,43,44
212048,212048,,2,0,10,10
212049,212049,,9,0,4,4
212050,212050,,2,0,8,8
212051,212051,,16,1,27,28
212052,212052,,1,3,12,15
212053,212053,,11,0,3,3
212054,212054,,54,1,21,22
212055,212055,,4,0,57,57
212056,212056,,1,0,30,30
212057,212057,,34,3,29,32
212059,212059,,37,4,34,38
212060,212060,,54,0,35,35
212061,212061,,1,5,40,45
212062,212062,,3,1,6,7
212063,212063,,4,2,58,60
9705100,9705100,,25,4,6,10
212064,212064,,6,3,10,13
212065,212065,,37,8,21,29
212066,212066,,54,1,30,31
212067,212067,,0,2,23,25
9907218,9907218,,8,2,4,6
9812186,9812186,,8,1,8,9
212068,212068,,0,0,3,3
212070,212070,,6,2,24,26
212071,212071,,3,2,11,13
212072,212072,,34,7,13,20
212073,212073,,0,0,3,3
212074,212074,,1,0,17,17
212075,212075,,11,1,2,3
212076,212076,,11,0,3,3
212077,212077,,8,0,10,10
212079,212079,,37,14,49,63
212081,212081,,2,6,44,50
212082,212082,,37,13,35,48
212083,212083,,37,17,35,52
212084,212084,,62,0,12,12
212085,212085,,54,1,6,7
212086,212086,,0,0,11,11
212087,212087,,34,6,26,32
212088,212088,,3,0,36,36
212089,212089,,34,4,23,27
212090,212090,,3,0,25,25
212091,212091,,54,3,48,51
212092,212092,,34,2,20,22
212093,212093,,0,0,6,6
212094,212094,,3,1,5,6
212095,212095,,37,20,46,66
212096,212096,,34,1,30,31
212097,212097,,34,0,8,8
9411228,9411228,,0,8,0,8
212098,212098,,37,1,19,20
212099,212099,,2,1,16,17
212100,212100,,2,1,16,17
212101,212101,,0,2,8,10
212102,212102,,0,2,14,16
212103,212103,,3,1,19,20
212104,212104,,2,0,2,2
212105,212105,,25,1,5,6
212106,212106,,11,0,9,9
9404042,9404042,,37,1,4,5
212107,212107,,3,0,45,45
212108,212108,,0,0,12,12
212109,212109,,54,1,19,20
212110,212110,,7,0,4,4
212111,212111,,1,2,42,44
212112,212112,,54,8,35,43
212113,212113,,34,0,17,17
212114,212114,,37,1,77,78
212115,212115,,25,0,3,3
212116,212116,,34,3,41,44
212117,212117,,3,1,25,26
212119,212119,,65,1,21,22
212120,212120,,6,0,6,6
9802065,9802065,,6,2,2,4
9912256,9912256,,6,1,6,7
9303083,9303083,,6,1,0,1
212121,212121,,37,14,29,43
212122,212122,,3,1,10,11
212123,212123,,7,0,17,17
212124,212124,,0,1,11,12
212126,212126,,34,1,54,55
212127,212127,,62,0,1,1
9707098,9707098,,62,2,4,6
212128,212128,,37,1,14,15
212130,212130,,2,1,1,2
212131,212131,,34,0,14,14
212132,212132,,0,3,9,12
212133,212133,,3,0,20,20
212134,212134,,25,0,1,1
212135,212135,,1,6,48,54
212136,212136,,2,5,37,42
212137,212137,,2,0,9,9
212138,212138,,34,4,22,26
212139,212139,,34,3,17,20
212140,212140,,19,1,18,19
212141,212141,,54,2,14,16
212142,212142,,2,1,22,23
212143,212143,,0,0,7,7
212144,212144,,54,0,17,17
212145,212145,,2,1,37,38
212146,212146,,3,1,7,8
212147,212147,,1,5,20,25
212148,212148,,14,1,3,4
212149,212149,,34,0,5,5
212150,212150,,4,3,38,41
212151,212151,,31,3,16,19
212153,212153,,7,0,7,7
212154,212154,,6,0,1,1
212155,212155,,0,0,21,21
212156,212156,,6,0,6,6
212157,212157,,25,0,3,3
212159,212159,,2,5,10,15
212160,212160,,8,0,19,19
212161,212161,,9,0,1,1
212162,212162,,34,4,19,23
212163,212163,,4,1,7,8
212164,212164,,59,0,1,1
212129,212129,,59,2,0,2
212165,212165,,1,2,27,29
212166,212166,,1,1,18,19
212167,212167,,2,1,8,9
212168,212168,,34,1,12,13
212169,212169,,62,0,19,19
212170,212170,,3,0,22,22
212171,212171,,16,0,4,4
9806212,9806212,,16,1,15,16
9608176,9608176,,16,4,11,15
9712032,9712032,,16,5,7,12
212172,212172,,34,0,20,20
212174,212174,,2,1,18,19
212175,212175,,0,2,28,30
212176,212176,,3,0,5,5
209243,209243,,3,1,0,1
212178,212178,,62,0,7,7
212179,212179,,34,0,47,47
212180,212180,,6,1,5,6
212181,212181,,34,4,22,26
212182,212182,,11,3,4,7
212183,212183,,2,0,24,24
212184,212184,,1,9,21,30
212185,212185,,34,6,14,20
212186,212186,,34,2,23,25
212187,212187,,11,0,8,8
212188,212188,,4,2,56,58
212189,212189,,34,0,6,6
212190,212190,,34,1,22,23
212191,212191,,54,4,12,16
212198,212198,,54,4,16,20
212219,212219,,54,4,16,20
212192,212192,,0,1,3,4
212193,212193,,34,2,42,44
212194,212194,,1,1,5,6
212195,212195,,37,0,4,4
212196,212196,,4,2,6,8
212197,212197,,34,0,3,3
212199,212199,,65,1,24,25
212200,212200,,54,3,21,24
212201,212201,,2,1,12,13
212202,212202,,16,0,9,9
212203,212203,,34,1,10,11
212204,212204,,7,6,15,21
212205,212205,,34,1,6,7
212206,212206,,54,1,13,14
212207,212207,,34,0,16,16
212209,212209,,34,8,19,27
212210,212210,,2,4,32,36
212211,212211,,37,5,37,42
212233,212233,,37,2,39,41
212212,212212,,37,14,38,52
212213,212213,,11,0,9,9
212214,212214,,2,1,20,21
212215,212215,,4,10,46,56
212216,212216,,34,2,8,10
9503038,9503038,,2,1,9,10
212217,212217,,1,5,38,43
212218,212218,,37,3,17,20
212220,212220,,4,0,6,6
212221,212221,,54,2,8,10
212222,212222,,0,5,15,20
212223,212223,,4,4,56,60
9404018,9404018,,1,2,3,5
212224,212224,,6,0,4,4
212225,212225,,37,24,30,54
212226,212226,,11,0,9,9
212227,212227,,0,6,20,26
212228,212228,,2,1,21,22
212229,212229,,11,0,4,4
212230,212230,,11,1,3,4
212231,212231,,37,11,51,62
212234,212234,,11,2,4,6
212235,212235,,37,3,17,20
212236,212236,,54,2,36,38
212237,212237,,19,0,10,10
212238,212238,,3,3,15,18
212239,212239,,34,6,12,18
212245,212245,,2,3,53,56
212240,212240,,6,1,18,19
212242,212242,,4,4,29,33
212243,212243,,34,0,5,5
212244,212244,,65,0,20,20
212246,212246,,34,2,38,40
9302142,9302142,,25,1,0,1
212247,212247,,54,0,2,2
212248,212248,,4,18,18,36
212249,212249,,37,0,3,3
212250,212250,,2,0,26,26
201083,201083,,2,1,0,1
212251,212251,,3,0,4,4
212252,212252,,34,0,33,33
212253,212253,,37,7,104,111
212254,212254,,34,1,7,8
212255,212255,,54,1,37,38
212257,212257,,2,0,18,18
212258,212258,,3,4,28,32
212259,212259,,3,2,9,11
212260,212260,,37,0,19,19
212261,212261,,1,0,14,14
212262,212262,,3,1,12,13
212263,212263,,54,0,15,15
212264,212264,,11,0,2,2
212265,212265,,2,0,26,26
212266,212266,,3,0,10,10
212267,212267,,2,1,18,19
212268,212268,,16,0,1,1
212270,212270,,3,1,20,21
212271,212271,,54,0,10,10
212272,212272,,54,0,13,13
212274,212274,,37,11,51,62
212275,212275,,65,0,19,19
212276,212276,,7,0,17,17
9512002,9512002,,11,4,0,4
212277,212277,,34,5,47,52
212278,212278,,54,5,40,45
212279,212279,,37,1,25,26
212280,212280,,27,0,1,1
212281,212281,,54,3,49,52
212282,212282,,60,0,1,1
9705042,9705042,,60,1,0,1
212284,212284,,3,1,36,37
212285,212285,,19,1,7,8
212286,212286,,2,0,4,4
212287,212287,,34,0,5,5
212288,212288,,14,0,5,5
212289,212289,,6,0,2,2
201143,201143,,6,1,0,1
212290,212290,,4,4,40,44
212291,212291,,2,3,18,21
212292,212292,,34,3,4,7
212293,212293,,37,2,30,32
212294,212294,,37,4,38,42
212295,212295,,2,0,30,30
212296,212296,,34,0,21,21
212297,212297,,1,1,24,25
212298,212298,,25,0,23,23
9503216,9503216,,31,1,6,7
212299,212299,,37,2,12,14
212300,212300,,62,0,11,11
212302,212302,,11,1,2,3
212303,212303,,7,4,27,31
212305,212305,,62,0,6,6
212306,212306,,34,0,11,11
212307,212307,,54,5,16,21
212308,212308,,34,2,27,29
212309,212309,,7,0,1,1
212310,212310,,0,0,15,15
212311,212311,,2,0,8,8
212312,212312,,31,2,10,12
212313,212313,,37,2,91,93
9305039,9305039,,8,5,1,6
212314,212314,,34,1,101,102
212315,212315,,8,0,2,2
212316,212316,,1,1,28,29
212317,212317,,4,1,27,28
212318,212318,,65,0,6,6
212320,212320,,3,0,16,16
212321,212321,,3,1,4,5
212322,212322,,2,0,6,6
212323,212323,,34,1,21,22
212324,212324,,16,1,4,5
212326,212326,,34,1,10,11
9501130,9501130,,34,2,1,3
9410092,9410092,,34,1,0,1
212327,212327,,34,2,3,5
212328,212328,,37,1,14,15
212329,212329,,3,1,46,47
212330,212330,,19,2,4,6
212331,212331,,0,0,32,32
212332,212332,,34,1,51,52
212333,212333,,0,1,4,5
212334,212334,,25,0,9,9
212335,212335,,4,0,12,12
212336,212336,,8,1,4,5
212337,212337,,34,0,16,16
212338,212338,,65,0,9,9
212339,212339,,2,0,11,11
212340,212340,,16,0,18,18
212341,212341,,3,2,8,10
212342,212342,,62,0,16,16
212343,212343,,1,3,40,43
212344,212344,,54,1,34,35
212345,212345,,1,1,17,18
212346,212346,,2,2,12,14
212347,212347,,2,0,19,19
212348,212348,,65,0,13,13
301001,301001,,11,0,8,8
9612100,9612100,,11,1,0,1
301002,301002,,0,1,22,23
301003,301003,,1,1,24,25
301004,301004,,9,0,2,2
301005,301005,,2,1,22,23
301006,301006,,37,26,18,44
301007,301007,,7,0,8,8
301008,301008,,16,0,11,11
301009,301009,,1,2,40,42
301010,301010,,34,2,44,46
301011,301011,,37,9,63,72
301012,301012,,2,1,14,15
301013,301013,,11,0,18,18
301014,301014,,0,0,4,4
301015,301015,,9,0,12,12
301016,301016,,34,1,9,10
301017,301017,,2,1,13,14
301018,301018,,54,0,16,16
301019,301019,,0,0,4,4
9810156,9810156,,0,2,1,3
9905189,9905189,,0,1,1,2
301020,301020,,0,0,21,21
301021,301021,,2,0,21,21
301022,301022,,8,0,10,10
301023,301023,,34,1,4,5
301025,301025,,34,0,8,8
301026,301026,,34,1,4,5
9809041,9809041,,4,1,5,6
301027,301027,,34,0,8,8
301028,301028,,2,1,16,17
301029,301029,,2,0,12,12
301030,301030,,3,1,40,41
301031,301031,,31,1,11,12
301032,301032,,54,7,32,39
301033,301033,,7,0,6,6
9312099,9312099,,7,1,0,1
301034,301034,,37,0,5,5
301035,301035,,1,3,38,41
301036,301036,,1,10,41,51
301037,301037,,2,1,4,5
301038,301038,,4,13,22,35
301039,301039,,6,1,7,8
301040,301040,,65,0,29,29
301041,301041,,67,1,2,3
301042,301042,,62,1,7,8
301043,301043,,6,1,11,12
301044,301044,,0,0,5,5
301045,301045,,11,1,3,4
301046,301046,,0,0,7,7
301047,301047,,3,2,12,14
301048,301048,,37,0,13,13
301049,301049,,4,10,58,68
301050,301050,,34,0,6,6
301051,301051,,2,0,7,7
9404164,9404164,,8,1,0,1
301054,301054,,34,1,8,9
301055,301055,,2,0,40,40
301056,301056,,7,0,4,4
301057,301057,,62,0,5,5
301058,301058,,34,1,36,37
301059,301059,,1,0,28,28
301060,301060,,6,0,6,6
9503197,9503197,,6,1,0,1
9601013,9601013,,6,1,37,38
9303020,9303020,,6,2,1,3
9305098,9305098,,8,3,11,14
9505174,9505174,,54,3,4,7
301061,301061,,7,1,22,23
301062,301062,,7,2,20,22
9606028,9606028,,7,3,1,4
301063,301063,,34,2,7,9
301064,301064,,61,0,1,1
210015,210015,,61,1,0,1
301065,301065,,2,0,14,14
301066,301066,,3,1,35,36
210260,210260,,3,1,0,1
9309160,9309160,,7,3,1,4
301067,301067,,34,0,33,33
301068,301068,,34,1,11,12
301069,301069,,2,0,5,5
301070,301070,,37,0,21,21
301071,301071,,37,7,73,80
9202017,9202017,,37,1,0,1
301072,301072,,7,2,24,26
301073,301073,,34,0,20,20
301074,301074,,54,0,12,12
301075,301075,,62,0,12,12
301076,301076,,4,6,57,63
301077,301077,,9,0,1,1
301078,301078,,25,0,5,5
301079,301079,,4,2,12,14
301080,301080,,1,2,65,67
301081,301081,,34,2,9,11
301082,301082,,62,0,3,3
9511022,9511022,,62,2,2,4
301083,301083,,1,1,23,24
301084,301084,,3,0,20,20
301085,301085,,6,0,7,7
301086,301086,,37,0,6,6
301088,301088,,62,1,11,12
301089,301089,,1,5,18,23
301090,301090,,1,1,48,49
301091,301091,,3,3,81,84
303037,303037,,3,8,3,11
301092,301092,,65,0,13,13
301093,301093,,7,0,8,8
301094,301094,,4,6,90,96
301095,301095,,4,12,20,32
301096,301096,,6,0,41,41
9803181,9803181,,6,1,6,7
301097,301097,,11,1,8,9
301098,301098,,37,0,30,30
301099,301099,,3,1,34,35
301100,301100,,3,1,6,7
301101,301101,,4,8,35,43
301102,301102,,62,0,16,16
301103,301103,,34,0,9,9
301104,301104,,34,1,55,56
301105,301105,,37,0,41,41
301106,301106,,3,1,26,27
301107,301107,,62,0,5,5
301108,301108,,7,0,10,10
301109,301109,,2,0,6,6
301110,301110,,1,5,13,18
301111,301111,,6,0,1,1
301112,301112,,3,1,9,10
301113,301113,,7,1,5,6
301114,301114,,0,0,10,10
9905158,9905158,,0,1,0,1
301115,301115,,62,0,1,1
301116,301116,,0,2,19,21
301118,301118,,34,2,46,48
301119,301119,,4,0,30,30
301120,301120,,1,1,27,28
301121,301121,,37,0,10,10
301122,301122,,4,6,21,27
301123,301123,,34,1,22,23
301124,301124,,3,0,21,21
301125,301125,,54,2,36,38
301126,301126,,54,0,19,19
301127,301127,,3,0,4,4
301128,301128,,2,1,1,2
301129,301129,,31,0,9,9
301130,301130,,34,0,11,11
301131,301131,,25,0,9,9
301132,301132,,8,0,4,4
301133,301133,,3,0,28,28
301134,301134,,11,0,3,3
301135,301135,,37,6,64,70
301136,301136,,37,7,90,97
301137,301137,,4,4,23,27
301138,301138,,4,2,12,14
301139,301139,,54,9,38,47
301140,301140,,4,5,63,68
301142,301142,,4,7,48,55
301179,301179,,4,6,23,29
301141,301141,,63,0,1,1
9706016,9706016,,63,1,0,1
301143,301143,,25,0,13,13
9208033,9208033,,62,1,1,2
301144,301144,,34,2,32,34
301146,301146,,6,2,7,9
301147,301147,,54,1,24,25
301148,301148,,7,0,4,4
301149,301149,,0,0,19,19
301150,301150,,1,7,37,44
301151,301151,,0,0,13,13
301152,301152,,62,0,4,4
208189,208189,,62,1,0,1
9501095,9501095,,62,2,1,3
9410165,9410165,,62,1,8,9
301153,301153,,7,1,8,9
301154,301154,,16,0,9,9
301155,301155,,37,1,15,16
301157,301157,,37,7,18,25
301160,301160,,37,0,1,1
301161,301161,,54,6,41,47
301162,301162,,37,1,34,35
301163,301163,,2,0,11,11
301164,301164,,37,0,67,67
301165,301165,,0,3,25,28
301166,301166,,25,0,5,5
9911167,9911167,,25,1,6,7
301167,301167,,11,1,5,6
301168,301168,,0,1,10,11
301169,301169,,19,0,3,3
301170,301170,,62,0,2,2
9408117,9408117,,62,1,0,1
301171,301171,,34,2,38,40
301172,301172,,0,0,35,35
301173,301173,,34,5,4,9
301174,301174,,3,0,26,26
301175,301175,,0,0,3,3
301176,301176,,3,1,37,38
301177,301177,,54,2,7,9
206099,206099,,54,1,0,1
301178,301178,,1,3,35,38
301180,301180,,31,2,29,31
9305138,9305138,,31,2,3,5
301181,301181,,65,0,6,6
301182,301182,,34,1,24,25
301183,301183,,9,0,4,4
209151,209151,,9,1,0,1
301184,301184,,4,0,26,26
301185,301185,,11,0,4,4
301186,301186,,1,1,50,51
301187,301187,,1,1,41,42
301189,301189,,0,1,27,28
301190,301190,,34,0,19,19
301191,301191,,34,0,2,2
9701116,9701116,,2,1,5,6
9612249,9612249,,2,1,15,16
301192,301192,,25,0,10,10
301193,301193,,1,0,16,16
301195,301195,,65,0,7,7
301196,301196,,37,2,65,67
301197,301197,,16,0,1,1
301198,301198,,31,2,13,15
301199,301199,,7,0,1,1
301200,301200,,7,0,10,10
301202,301202,,25,0,6,6
301203,301203,,37,5,55,60
301204,301204,,11,0,1,1
9906003,9906003,,11,2,0,2
301206,301206,,1,5,37,42
301207,301207,,6,0,8,8
301209,301209,,62,0,9,9
203214,203214,,62,1,0,1
9607222,9607222,,62,1,1,2
9306149,9306149,,62,1,0,1
301210,301210,,0,0,3,3
301211,301211,,6,0,10,10
301212,301212,,2,0,11,11
9610176,9610176,,2,1,10,11
9606058,9606058,,2,1,7,8
301213,301213,,3,1,33,34
301214,301214,,8,0,7,7
301215,301215,,65,0,14,14
301216,301216,,0,0,2,2
301217,301217,,37,8,79,87
301218,301218,,54,3,7,10
301219,301219,,64,0,1,1
301194,301194,,64,1,0,1
301220,301220,,37,0,5,5
301221,301221,,1,0,20,20
301222,301222,,11,0,4,4
301223,301223,,3,0,21,21
301224,301224,,19,1,7,8
301225,301225,,8,0,2,2
108086,108086,,8,1,0,1
301226,301226,,37,6,67,73
301227,301227,,3,1,27,28
301228,301228,,0,0,2,2
301229,301229,,65,1,30,31
301230,301230,,37,0,19,19
301231,301231,,37,2,14,16
301232,301232,,54,0,7,7
301233,301233,,2,0,10,10
9712091,9712091,,31,1,41,42
301235,301235,,34,2,25,27
301236,301236,,2,0,10,10
301237,301237,,3,0,42,42
301238,301238,,25,0,4,4
301239,301239,,2,0,9,9
301240,301240,,54,17,52,69
301241,301241,,8,0,1,1
301242,301242,,3,0,18,18
301243,301243,,34,3,9,12
301244,301244,,7,1,16,17
301246,301246,,2,0,31,31
301247,301247,,34,0,14,14
301248,301248,,3,1,12,13
301249,301249,,2,0,37,37
301250,301250,,1,7,43,50
301251,301251,,7,1,6,7
301252,301252,,11,0,7,7
301253,301253,,1,4,24,28
301255,301255,,2,1,8,9
302001,302001,,54,0,7,7
302002,302002,,11,0,3,3
302003,302003,,7,0,8,8
302004,302004,,7,0,1,1
302005,302005,,1,1,49,50
302006,302006,,54,0,42,42
302007,302007,,7,1,2,3
9911102,9911102,,7,1,0,1
302008,302008,,34,0,52,52
9605004,9605004,,16,2,0,2
302009,302009,,6,2,4,6
302010,302010,,4,0,18,18
302011,302011,,37,14,49,63
302012,302012,,34,0,11,11
302013,302013,,11,1,4,5
302014,302014,,19,0,7,7
9503100,9503100,,19,1,1,2
9802159,9802159,,19,2,2,4
9505115,9505115,,19,3,3,6
9702029,9702029,,19,4,1,5
9703184,9703184,,19,3,1,4
9802062,9802062,,19,2,5,7
302015,302015,,11,2,12,14
302017,302017,,0,3,28,31
302018,302018,,19,0,5,5
9609049,9609049,,19,1,7,8
302019,302019,,34,0,37,37
302020,302020,,1,1,16,17
302021,302021,,37,3,5,8
302022,302022,,0,0,6,6
302023,302023,,54,0,14,14
302024,302024,,54,0,12,12
302026,302026,,34,0,25,25
302027,302027,,1,0,56,56
302028,302028,,0,1,44,45
302029,302029,,54,0,2,2
302030,302030,,0,2,93,95
302031,302031,,11,0,3,3
302032,302032,,14,0,3,3
302033,302033,,2,0,8,8
301256,301256,,2,1,0,1
9309048,9309048,,8,1,3,4
302034,302034,,54,0,8,8
302035,302035,,34,0,6,6
302036,302036,,7,1,8,9
302037,302037,,6,0,22,22
302038,302038,,3,0,9,9
302039,302039,,25,0,4,4
302040,302040,,2,0,1,1
302041,302041,,0,0,9,9
302043,302043,,54,0,7,7
302044,302044,,11,0,2,2
302045,302045,,11,1,7,8
302046,302046,,7,0,3,3
9208073,9208073,,7,1,1,2
9304107,9304107,,7,3,0,3
302047,302047,,37,2,25,27
302049,302049,,3,1,30,31
302050,302050,,7,2,10,12
302052,302052,,2,1,26,27
302053,302053,,25,0,22,22
109221,109221,,25,2,0,2
302054,302054,,34,1,28,29
302055,302055,,3,0,7,7
302056,302056,,62,0,18,18
302057,302057,,34,0,13,13
302058,302058,,34,0,24,24
302059,302059,,37,0,32,32
302060,302060,,1,4,35,39
302062,302062,,7,1,1,2
302063,302063,,34,3,29,32
302064,302064,,1,4,35,39
302065,302065,,7,1,7,8
302066,302066,,54,0,7,7
302067,302067,,0,5,11,16
302069,302069,,0,2,13,15
302070,302070,,3,0,18,18
302071,302071,,2,1,32,33
302072,302072,,0,0,5,5
302073,302073,,1,0,16,16
302074,302074,,3,0,8,8
302075,302075,,8,0,68,68
302077,302077,,37,2,11,13
302078,302078,,3,3,18,21
9611067,9611067,,7,1,2,3
9212093,9212093,,7,1,1,2
9401141,9401141,,7,1,2,3
302081,302081,,4,2,17,19
302083,302083,,37,3,11,14
302084,302084,,1,0,8,8
204135,204135,,1,1,0,1
302085,302085,,0,1,10,11
302086,302086,,34,0,14,14
302087,302087,,34,0,42,42
302089,302089,,7,0,2,2
302090,302090,,34,2,6,8
302091,302091,,2,0,10,10
302092,302092,,16,1,3,4
302093,302093,,62,1,12,13
302094,302094,,62,0,1,1
302095,302095,,7,0,1,1
302096,302096,,4,0,13,13
302097,302097,,62,0,19,19
302098,302098,,34,0,16,16
302099,302099,,37,0,18,18
302100,302100,,11,0,5,5
302101,302101,,66,1,1,2
9706064,9706064,,66,1,0,1
302102,302102,,66,0,1,1
302103,302103,,6,0,1,1
302104,302104,,1,1,18,19
302105,302105,,54,9,60,69
302106,302106,,37,2,24,26
302107,302107,,34,0,16,16
302108,302108,,2,0,26,26
302109,302109,,37,4,25,29
302110,302110,,54,3,7,10
302111,302111,,16,1,2,3
302112,302112,,6,0,4,4
302113,302113,,2,0,16,16
302115,302115,,54,0,3,3
302116,302116,,9,2,5,7
302117,302117,,37,0,9,9
302118,302118,,31,0,21,21
302119,302119,,6,0,6,6
302120,302120,,3,0,8,8
302121,302121,,16,0,10,10
9911036,9911036,,16,2,7,9
9308046,9308046,,16,7,0,7
9312064,9312064,,16,5,0,5
9412205,9412205,,16,4,0,4
9412239,9412239,,16,4,2,6
9610044,9610044,,16,4,7,11
9610149,9610149,,16,4,8,12
302122,302122,,3,0,15,15
302123,302123,,25,1,5,6
302124,302124,,9,0,6,6
302125,302125,,4,0,122,122
302126,302126,,7,0,9,9
302127,302127,,1,0,48,48
302128,302128,,11,1,10,11
210204,210204,,11,3,0,3
302129,302129,,0,3,9,12
302130,302130,,6,0,11,11
302131,302131,,8,0,10,10
302132,302132,,34,0,44,44
9810043,9810043,,11,1,4,5
302133,302133,,67,0,4,4
302135,302135,,34,0,4,4
302136,302136,,54,0,26,26
302137,302137,,4,2,43,45
302138,302138,,2,1,8,9
302139,302139,,8,0,8,8
302079,302079,,8,1,0,1
302140,302140,,4,1,29,30
302141,302141,,11,1,23,24
302142,302142,,19,0,1,1
302143,302143,,0,3,17,20
302144,302144,,8,0,21,21
302145,302145,,2,2,14,16
302146,302146,,4,12,31,43
302147,302147,,1,0,17,17
302148,302148,,34,2,40,42
302149,302149,,11,0,2,2
302150,302150,,37,7,86,93
302151,302151,,4,3,38,41
302152,302152,,37,0,18,18
302153,302153,,1,0,15,15
302154,302154,,3,0,6,6
302155,302155,,34,0,16,16
302156,302156,,7,2,7,9
302157,302157,,7,0,9,9
302158,302158,,34,3,28,31
302159,302159,,1,2,35,37
302160,302160,,4,1,33,34
302161,302161,,31,0,1,1
302162,302162,,3,2,39,41
9707092,9707092,,16,1,9,10
302163,302163,,37,2,16,18
302164,302164,,2,0,18,18
302165,302165,,37,2,15,17
302167,302167,,3,0,7,7
302168,302168,,11,3,20,23
302169,302169,,19,0,3,3
302170,302170,,2,1,13,14
302171,302171,,0,1,30,31
302172,302172,,2,2,38,40
302173,302173,,9,0,11,11
302174,302174,,54,1,51,52
302175,302175,,3,0,18,18
302176,302176,,11,0,17,17
9511124,9511124,,6,1,2,3
302177,302177,,4,0,11,11
302178,302178,,25,0,2,2
302179,302179,,3,0,28,28
302180,302180,,3,1,26,27
302181,302181,,31,1,36,37
302182,302182,,4,3,30,33
302183,302183,,34,0,4,4
302184,302184,,7,1,9,10
302185,302185,,62,0,4,4
302186,302186,,25,0,13,13
302187,302187,,8,0,7,7
301052,301052,,8,1,0,1
9610221,9610221,,8,3,1,4
9606089,9606089,,8,1,2,3
302188,302188,,68,0,2,2
302189,302189,,11,0,3,3
302190,302190,,2,0,12,12
302191,302191,,37,0,92,92
302192,302192,,54,1,21,22
302193,302193,,2,0,8,8
9807147,9807147,,2,1,5,6
302194,302194,,37,5,6,11
302195,302195,,3,1,38,39
302196,302196,,0,1,19,20
302197,302197,,19,0,20,20
302198,302198,,34,0,21,21
302199,302199,,4,4,8,12
302200,302200,,65,1,10,11
302201,302201,,2,0,2,2
302202,302202,,6,0,18,18
302203,302203,,1,0,31,31
9708021,9708021,,2,1,13,14
302204,302204,,34,0,3,3
302205,302205,,37,1,20,21
302206,302206,,4,0,25,25
302207,302207,,34,0,16,16
302208,302208,,37,0,1,1
302209,302209,,54,0,1,1
302210,302210,,6,0,5,5
302211,302211,,1,0,13,13
302212,302212,,34,0,7,7
302213,302213,,6,0,15,15
302214,302214,,1,1,3,4
302215,302215,,11,0,7,7
9712250,9712250,,11,2,0,2
302216,302216,,0,0,9,9
9406004,9406004,,0,8,1,9
9409080,9409080,,0,8,0,8
9508160,9508160,,0,3,0,3
9609042,9609042,,0,1,1,2
9803187,9803187,,0,2,3,5
9809189,9809189,,0,2,5,7
9901108,9901108,,0,1,6,7
9210027,9210027,,0,2,0,2
9702064,9702064,,0,2,2,4
9702191,9702191,,0,2,9,11
9703181,9703181,,0,1,6,7
302217,302217,,1,1,13,14
302218,302218,,34,2,44,46
302219,302219,,34,5,10,15
302220,302220,,62,0,14,14
9512090,9512090,,62,1,2,3
9406133,9406133,,62,2,2,4
302222,302222,,4,3,22,25
302223,302223,,0,1,29,30
302224,302224,,3,0,22,22
302225,302225,,34,1,5,6
302226,302226,,37,0,19,19
302227,302227,,11,0,7,7
302228,302228,,1,0,17,17
302229,302229,,25,0,2,2
302230,302230,,34,0,37,37
303001,303001,,37,9,36,45
9510018,9510018,,37,1,8,9
303002,303002,,16,0,3,3
303003,303003,,0,0,8,8
303004,303004,,2,0,1,1
303005,303005,,7,1,6,7
303006,303006,,34,0,21,21
303007,303007,,1,2,24,26
303008,303008,,37,5,28,33
303032,303032,,37,8,46,54
9509124,9509124,,37,2,11,13
303009,303009,,54,2,14,16
9307172,9307172,,54,2,2,4
303010,303010,,34,0,11,11
303011,303011,,0,1,33,34
303012,303012,,25,0,5,5
303013,303013,,4,0,19,19
303014,303014,,6,0,6,6
303015,303015,,54,5,73,78
303016,303016,,54,2,56,58
303017,303017,,1,0,19,19
303018,303018,,37,0,4,4
303019,303019,,9,0,1,1
303020,303020,,54,1,11,12
303021,303021,,19,0,4,4
9910084,9910084,,19,1,0,1
9910239,9910239,,2,2,11,13
9705085,9705085,,1,2,5,7
9809011,9809011,,37,1,3,4
303022,303022,,3,0,11,11
303023,303023,,0,1,31,32
303024,303024,,54,1,73,74
303025,303025,,7,0,8,8
9212047,9212047,,7,5,0,5
9407053,9407053,,7,1,2,3
303026,303026,,16,0,3,3
303027,303027,,8,0,4,4
303029,303029,,34,1,2,3
303030,303030,,3,1,16,17
303031,303031,,34,1,23,24
303033,303033,,37,3,50,53
303034,303034,,34,1,56,57
303035,303035,,4,11,78,89
303139,303139,,4,13,36,49
303057,303057,,4,9,69,78
303036,303036,,34,1,23,24
303038,303038,,40,0,1,1
303039,303039,,1,1,19,20
303040,303040,,11,0,5,5
303041,303041,,65,0,34,34
9302057,9302057,,37,7,2,9
9512029,9512029,,8,2,2,4
303042,303042,,1,0,23,23
303043,303043,,1,0,6,6
303044,303044,,1,1,15,16
303045,303045,,2,0,3,3
303046,303046,,2,0,18,18
303047,303047,,37,0,21,21
303048,303048,,54,1,14,15
303049,303049,,54,0,49,49
303050,303050,,1,0,28,28
303051,303051,,4,2,7,9
303052,303052,,16,0,6,6
303053,303053,,37,1,11,12
9707084,9707084,,37,1,0,1
303054,303054,,37,1,25,26
303055,303055,,1,1,34,35
303056,303056,,9,0,10,10
303058,303058,,1,0,6,6
9705222,9705222,,1,1,5,6
9801001,9801001,,1,2,1,3
9903185,9903185,,1,1,5,6
9607116,9607116,,1,1,1,2
303059,303059,,6,1,2,3
303060,303060,,1,4,58,62
303061,303061,,7,0,1,1
303062,303062,,62,1,5,6
303063,303063,,37,3,19,22
303064,303064,,3,0,10,10
303065,303065,,37,5,34,39
303066,303066,,37,1,8,9
303067,303067,,34,2,9,11
303068,303068,,0,1,11,12
303069,303069,,37,1,7,8
303070,303070,,11,0,1,1
303072,303072,,2,1,121,122
303073,303073,,0,3,39,42
303074,303074,,37,2,27,29
303075,303075,,2,1,29,30
303076,303076,,4,0,6,6
303078,303078,,7,0,3,3
303079,303079,,6,1,18,19
303080,303080,,3,0,6,6
303081,303081,,54,0,19,19
303082,303082,,3,0,12,12
303083,303083,,54,3,36,39
303084,303084,,37,0,4,4
303085,303085,,34,0,3,3
303086,303086,,16,0,12,12
303087,303087,,34,1,49,50
303088,303088,,2,0,6,6
303089,303089,,34,1,38,39
303090,303090,,3,0,9,9
303091,303091,,3,0,20,20
303092,303092,,11,0,6,6
303093,303093,,7,0,2,2
303094,303094,,7,0,16,16
303095,303095,,0,1,103,104
303096,303096,,0,2,14,16
303097,303097,,4,7,6,13
304124,304124,,4,5,12,17
304177,304177,,4,3,7,10
303232,303232,,4,2,35,37
303238,303238,,4,6,10,16
304084,304084,,4,4,14,18
304089,304089,,4,4,7,11
303098,303098,,37,0,7,7
9604083,9604083,,37,1,2,3
9707178,9707178,,37,1,1,2
9811161,9811161,,37,1,7,8
9509041,9509041,,37,1,0,1
9605060,9605060,,37,2,1,3
9611118,9611118,,37,5,8,13
303099,303099,,3,0,10,10
303100,303100,,19,0,5,5
303101,303101,,54,0,14,14
303102,303102,,2,1,16,17
303103,303103,,7,0,18,18
303104,303104,,37,6,17,23
303105,303105,,34,0,12,12
303106,303106,,7,0,3,3
303107,303107,,1,3,26,29
303108,303108,,16,0,2,2
303109,303109,,34,1,27,28
303110,303110,,54,0,8,8
303111,303111,,54,0,18,18
303112,303112,,0,1,1,2
303113,303113,,34,1,22,23
303114,303114,,54,1,6,7
303115,303115,,37,2,63,65
303116,303116,,0,2,9,11
303117,303117,,34,2,3,5
303118,303118,,11,0,1,1
303119,303119,,3,0,20,20
303120,303120,,3,1,28,29
9504075,9504075,,25,2,6,8
303121,303121,,37,0,15,15
303122,303122,,19,0,22,22
303123,303123,,2,0,3,3
303124,303124,,54,2,30,32
303125,303125,,0,2,11,13
303126,303126,,8,0,2,2
212158,212158,,8,1,0,1
303127,303127,,37,0,18,18
303128,303128,,3,0,11,11
9405022,9405022,,3,4,1,5
303130,303130,,62,1,8,9
303132,303132,,62,1,8,9
9909057,9909057,,62,1,0,1
303131,303131,,0,0,14,14
303133,303133,,4,4,28,32
303134,303134,,7,0,9,9
303135,303135,,37,0,68,68
303137,303137,,0,0,4,4
303138,303138,,4,0,26,26
303140,303140,,2,2,20,22
303141,303141,,34,0,18,18
303143,303143,,3,1,4,5
303144,303144,,37,1,67,68
303145,303145,,6,0,4,4
303146,303146,,37,0,7,7
303147,303147,,0,0,9,9
9411064,9411064,,0,1,0,1
9506003,9506003,,0,3,2,5
303148,303148,,6,0,4,4
303149,303149,,34,0,5,5
303150,303150,,1,0,7,7
303151,303151,,37,1,37,38
303152,303152,,54,0,16,16
303153,303153,,1,0,32,32
303154,303154,,11,0,10,10
303155,303155,,54,0,12,12
303156,303156,,2,0,25,25
303157,303157,,34,0,29,29
303158,303158,,3,1,7,8
303159,303159,,0,0,4,4
303160,303160,,34,0,63,63
303161,303161,,16,0,7,7
303162,303162,,9,0,12,12
303163,303163,,9,0,6,6
303164,303164,,34,0,11,11
303165,303165,,37,1,10,11
303166,303166,,19,0,21,21
303167,303167,,54,0,14,14
303168,303168,,3,0,14,14
303169,303169,,16,0,1,1
9605005,9605005,,16,4,8,12
9512225,9512225,,16,3,9,12
9601022,9601022,,16,4,21,25
303170,303170,,4,1,26,27
303171,303171,,3,0,17,17
303172,303172,,4,3,96,99
303173,303173,,2,0,41,41
303174,303174,,2,0,4,4
303175,303175,,7,0,2,2
301053,301053,,7,1,0,1
303176,303176,,6,0,7,7
303177,303177,,9,0,10,10
303178,303178,,2,0,17,17
303179,303179,,2,1,1,2
303180,303180,,16,0,7,7
303181,303181,,37,0,13,13
303182,303182,,1,3,25,28
303183,303183,,2,0,27,27
303184,303184,,11,0,14,14
303185,303185,,16,0,120,120
303186,303186,,3,0,35,35
303187,303187,,62,0,16,16
303189,303189,,19,0,1,1
303190,303190,,25,0,18,18
303191,303191,,34,0,139,139
303192,303192,,2,0,13,13
303193,303193,,1,0,57,57
303194,303194,,37,4,54,58
303196,303196,,3,0,11,11
303197,303197,,54,2,34,36
303198,303198,,37,1,50,51
303199,303199,,4,0,49,49
303200,303200,,37,0,5,5
303201,303201,,69,0,1,1
9604108,9604108,,69,1,0,1
303202,303202,,34,0,22,22
303203,303203,,0,1,41,42
303204,303204,,4,3,39,42
303205,303205,,62,1,20,21
303206,303206,,7,0,3,3
303207,303207,,37,5,42,47
303208,303208,,54,1,51,52
303209,303209,,2,0,24,24
303210,303210,,37,2,21,23
303211,303211,,34,1,18,19
303212,303212,,1,2,20,22
303213,303213,,34,0,23,23
303214,303214,,1,1,54,55
303215,303215,,7,0,5,5
303216,303216,,3,0,5,5
9607103,9607103,,7,1,1,2
303217,303217,,65,0,2,2
102003,102003,,65,1,0,1
303218,303218,,54,0,27,27
303219,303219,,34,0,42,42
303220,303220,,1,2,33,35
303221,303221,,4,1,20,21
303222,303222,,1,2,75,77
303223,303223,,1,2,66,68
303224,303224,,7,0,3,3
303225,303225,,2,0,19,19
303226,303226,,19,0,1,1
303227,303227,,54,0,11,11
303228,303228,,1,0,6,6
9407059,9407059,,8,3,4,7
9309099,9309099,,62,3,1,4
303229,303229,,2,0,13,13
303230,303230,,37,0,26,26
303231,303231,,65,0,20,20
303233,303233,,3,0,27,27
303234,303234,,37,0,17,17
303235,303235,,3,0,29,29
303236,303236,,4,0,54,54
303237,303237,,1,0,30,30
303239,303239,,4,3,52,55
303240,303240,,2,0,3,3
303241,303241,,62,0,10,10
9901114,9901114,,11,1,4,5
303243,303243,,37,0,11,11
303244,303244,,11,0,7,7
303245,303245,,4,0,27,27
303246,303246,,4,0,13,13
303247,303247,,0,1,15,16
303248,303248,,2,0,22,22
303249,303249,,0,2,28,30
303251,303251,,11,1,37,38
9412040,9412040,,37,3,1,4
9511007,9511007,,37,2,4,6
9607045,9607045,,37,1,10,11
9412024,9412024,,37,1,2,3
303252,303252,,54,0,11,11
303253,303253,,2,0,34,34
303255,303255,,1,0,41,41
303256,303256,,3,1,136,137
303257,303257,,2,0,1,1
303258,303258,,6,0,4,4
303260,303260,,62,0,1,1
303261,303261,,11,0,2,2
303262,303262,,6,1,1,2
303263,303263,,62,0,13,13
9612046,9612046,,62,2,24,26
9402051,9402051,,62,1,4,5
9502040,9502040,,62,1,0,1
9509029,9509029,,7,3,1,4
303264,303264,,0,0,7,7
303265,303265,,6,0,2,2
303266,303266,,34,1,59,60
9910176,9910176,,2,1,7,8
9811088,9811088,,2,3,4,7
9907017,9907017,,2,1,14,15
303267,303267,,54,0,9,9
303268,303268,,37,4,34,38
303269,303269,,4,2,35,37
303270,303270,,2,0,25,25
304001,304001,,54,1,34,35
304002,304002,,2,0,21,21
304003,304003,,0,0,11,11
304004,304004,,0,0,26,26
304005,304005,,4,1,27,28
304006,304006,,7,0,12,12
304007,304007,,34,0,42,42
304008,304008,,25,0,11,11
304009,304009,,1,0,17,17
304010,304010,,19,0,2,2
304011,304011,,6,0,21,21
304012,304012,,34,0,8,8
304013,304013,,65,0,15,15
304014,304014,,34,0,19,19
304015,304015,,65,0,13,13
304018,304018,,4,2,89,91
304019,304019,,37,0,27,27
304020,304020,,34,0,22,22
304022,304022,,34,0,35,35
304023,304023,,6,0,9,9
304024,304024,,34,0,1,1
304025,304025,,1,4,45,49
304026,304026,,34,0,8,8
304027,304027,,7,1,16,17
304028,304028,,34,1,58,59
304029,304029,,14,0,2,2
304030,304030,,3,0,22,22
304031,304031,,62,0,4,4
304032,304032,,34,0,35,35
304033,304033,,34,0,35,35
304034,304034,,11,0,4,4
304035,304035,,1,0,35,35
304036,304036,,37,0,30,30
304037,304037,,3,0,11,11
304038,304038,,0,0,6,6
304039,304039,,3,0,14,14
304040,304040,,0,0,31,31
304041,304041,,25,0,5,5
304042,304042,,34,0,2,2
304043,304043,,0,0,1,1
304044,304044,,4,0,29,29
304045,304045,,4,5,39,44
304046,304046,,37,0,54,54
304047,304047,,34,0,4,4
304049,304049,,34,1,29,30
304050,304050,,34,0,2,2
304051,304051,,0,0,32,32
304052,304052,,37,0,4,4
304053,304053,,65,0,13,13
304056,304056,,0,0,15,15
304057,304057,,0,1,17,18
304058,304058,,0,0,7,7
304059,304059,,3,0,19,19
304060,304060,,34,0,57,57
304061,304061,,37,3,41,44
304062,304062,,1,2,26,28
6083,6083,,1,1,0,1
304063,304063,,62,0,2,2
304064,304064,,34,0,11,11
304065,304065,,11,0,1,1
304066,304066,,34,0,9,9
9808176,9808176,,25,1,2,3
304067,304067,,34,0,8,8
304068,304068,,16,0,17,17
304204,304204,,16,1,10,11
9910224,9910224,,16,1,14,15
304069,304069,,31,1,9,10
304070,304070,,0,0,24,24
304071,304071,,34,0,10,10
304072,304072,,34,0,54,54
304073,304073,,34,0,14,14
304074,304074,,16,0,4,4
304075,304075,,0,0,1,1
304076,304076,,34,0,20,20
304077,304077,,62,0,5,5
304078,304078,,0,0,5,5
304079,304079,,54,0,23,23
304080,304080,,34,0,7,7
304082,304082,,3,0,4,4
304083,304083,,11,0,7,7
304085,304085,,6,0,5,5
304086,304086,,6,0,6,6
304087,304087,,7,1,12,13
304088,304088,,8,0,14,14
9202031,9202031,,8,1,0,1
304090,304090,,3,0,29,29
304091,304091,,19,0,3,3
110083,110083,,19,1,0,1
304092,304092,,62,0,6,6
304093,304093,,34,1,33,34
304094,304094,,54,0,17,17
304095,304095,,16,0,22,22
209087,209087,,16,1,0,1
304096,304096,,37,0,10,10
304097,304097,,34,0,10,10
304098,304098,,4,0,10,10
304099,304099,,37,0,6,6
304100,304100,,11,0,11,11
304101,304101,,7,0,13,13
9409014,9409014,,7,2,4,6
304102,304102,,62,0,9,9
304103,304103,,2,0,5,5
304104,304104,,6,1,6,7
304105,304105,,3,0,22,22
304106,304106,,16,0,12,12
304107,304107,,1,2,7,9
304108,304108,,4,4,30,34
304109,304109,,54,0,8,8
304110,304110,,65,0,8,8
304111,304111,,62,0,11,11
304112,304112,,16,0,3,3
304113,304113,,54,0,3,3
304114,304114,,1,1,50,51
304115,304115,,37,0,18,18
304116,304116,,3,0,9,9
304117,304117,,11,0,14,14
304118,304118,,3,0,9,9
304119,304119,,37,2,32,34
304120,304120,,62,0,39,39
9804108,9804108,,37,1,13,14
304121,304121,,6,0,7,7
304122,304122,,19,0,4,4
304123,304123,,37,2,22,24
304125,304125,,0,0,20,20
304126,304126,,54,0,11,11
304127,304127,,37,0,31,31
304128,304128,,34,0,9,9
9905176,9905176,,34,1,11,12
304129,304129,,34,0,13,13
304130,304130,,54,0,5,5
304131,304131,,0,0,20,20
304132,304132,,34,0,9,9
304133,304133,,2,0,1,1
304134,304134,,11,0,12,12
304135,304135,,16,0,6,6
9907043,9907043,,16,2,1,3
304136,304136,,3,0,14,14
304138,304138,,37,1,22,23
304139,304139,,1,1,22,23
304140,304140,,11,0,6,6
304141,304141,,3,0,11,11
304142,304142,,6,0,3,3
304143,304143,,2,0,45,45
304144,304144,,7,0,1,1
304145,304145,,4,1,32,33
304146,304146,,11,0,7,7
9904123,9904123,,2,1,8,9
9910104,9910104,,1,1,8,9
9910073,9910073,,37,4,4,8
9705001,9705001,,1,1,3,4
9809014,9809014,,37,1,2,3
9809042,9809042,,1,1,7,8
304147,304147,,0,1,33,34
304148,304148,,0,0,11,11
304149,304149,,2,0,7,7
304150,304150,,34,0,28,28
304151,304151,,2,0,11,11
304152,304152,,34,0,13,13
9708136,9708136,,2,1,14,15
304153,304153,,4,1,20,21
304154,304154,,6,0,28,28
9702192,9702192,,37,1,6,7
304155,304155,,19,0,4,4
304156,304156,,34,0,8,8
304157,304157,,37,0,20,20
304158,304158,,4,0,18,18
304159,304159,,3,0,7,7
304160,304160,,34,0,26,26
9804045,9804045,,16,2,11,13
9711015,9711015,,16,2,14,16
304161,304161,,19,0,2,2
304162,304162,,19,0,4,4
304163,304163,,4,1,38,39
304164,304164,,54,0,6,6
304165,304165,,6,0,4,4
304166,304166,,19,0,9,9
304167,304167,,19,0,7,7
9709194,9709194,,19,1,1,2
304168,304168,,31,0,16,16
304169,304169,,1,1,44,45
304170,304170,,11,0,5,5
304171,304171,,4,0,29,29
304172,304172,,4,1,15,16
202119,202119,,4,1,0,1
304173,304173,,2,0,11,11
304174,304174,,7,0,4,4
304175,304175,,37,1,4,5
9604180,9604180,,7,2,0,2
9701111,9701111,,7,2,1,3
9804036,9804036,,7,2,4,6
304176,304176,,25,0,8,8
304178,304178,,37,0,69,69
9404156,9404156,,11,2,0,2
304179,304179,,62,0,1,1
304180,304180,,4,2,73,75
304181,304181,,1,1,15,16
304183,304183,,1,0,29,29
304184,304184,,37,0,41,41
9206091,9206091,,37,4,0,4
9608172,9608172,,16,2,2,4
9202081,9202081,,37,2,0,2
304185,304185,,59,0,1,1
304186,304186,,19,0,3,3
304187,304187,,4,0,38,38
304197,304197,,4,1,30,31
304188,304188,,4,1,15,16
9506176,9506176,,9,3,1,4
304189,304189,,19,0,2,2
304190,304190,,62,0,5,5
304191,304191,,1,0,23,23
304192,304192,,4,3,37,40
304193,304193,,6,0,4,4
304194,304194,,34,0,10,10
304195,304195,,0,0,25,25
304196,304196,,34,0,13,13
304198,304198,,1,1,23,24
304199,304199,,54,0,6,6
304200,304200,,54,0,15,15
304201,304201,,7,0,14,14
304202,304202,,34,0,19,19
304203,304203,,2,0,4,4
304205,304205,,62,0,5,5
9611216,9611216,,62,5,0,5
304206,304206,,2,2,37,39
304207,304207,,3,0,11,11
304208,304208,,34,0,29,29
304209,304209,,54,0,14,14
304210,304210,,2,0,20,20
304211,304211,,34,0,23,23
304212,304212,,54,0,10,10
304213,304213,,4,0,22,22
304214,304214,,62,0,5,5
304215,304215,,3,0,14,14
304216,304216,,31,0,18,18
304217,304217,,34,0,30,30
9903194,9903194,,34,1,26,27
304219,304219,,0,1,14,15
304220,304220,,34,0,40,40
304221,304221,,37,0,20,20
304222,304222,,11,0,15,15
304223,304223,,16,0,6,6
304224,304224,,4,0,36,36
304225,304225,,4,0,23,23
304226,304226,,4,0,42,42
304227,304227,,37,0,10,10
304228,304228,,2,0,11,11
304229,304229,,0,0,9,9
304230,304230,,1,1,22,23
304254,304254,,1,1,13,14
304231,304231,,34,0,41,41
304232,304232,,1,0,54,54
304233,304233,,2,0,14,14
304234,304234,,1,0,21,21
304235,304235,,37,0,7,7
304236,304236,,1,0,23,23
304237,304237,,4,0,27,27
304238,304238,,34,0,35,35
304239,304239,,1,0,19,19
304240,304240,,62,0,4,4
304241,304241,,4,0,39,39
304242,304242,,0,0,2,2
304243,304243,,54,0,3,3
304245,304245,,6,0,3,3
304246,304246,,2,0,12,12
9604155,9604155,,2,5,2,7
304247,304247,,37,0,34,34
304248,304248,,8,0,1,1
9803161,9803161,,8,2,4,6
304249,304249,,11,0,22,22
304250,304250,,34,0,36,36
304251,304251,,37,0,16,16
304252,304252,,25,0,11,11
304253,304253,,34,0,22,22
9504002,9504002,,2,1,0,1
9611095,9611095,,2,3,14,17
304255,304255,,1,0,31,31
304256,304256,,54,0,43,43
9906067,9906067,,25,1,2,3
304257,304257,,7,0,37,37
304258,304258,,54,0,45,45
304259,304259,,4,0,46,46
304260,304260,,62,0,21,21
304261,304261,,4,0,27,27
304262,304262,,0,0,23,23
304263,304263,,4,0,51,51
304264,304264,,11,0,4,4
9612053,9612053,,11,1,3,4
304265,304265,,34,0,2,2
304266,304266,,0,0,19,19
304267,304267,,0,0,14,14
304268,304268,,3,0,34,34
304269,304269,,7,0,14,14
304270,304270,,4,0,49,49
304271,304271,,37,0,58,58
9202067,9202067,,54,0,1,1
9203073,9203073,,19,0,1,1
9201042,9201042,,11,2,0,2
9205029,9205029,,54,0,1,1
9205038,9205038,,16,0,2,2
9202079,9202079,,16,1,0,1
9205104,9205104,,25,0,1,1
9202076,9202076,,37,2,0,2
9206079,9206079,,1,1,3,4
9207013,9207013,,62,1,1,2
9207028,9207028,,11,7,1,8
9207036,9207036,,7,0,1,1
9207059,9207059,,70,0,1,1
9204021,9204021,,70,1,0,1
9207063,9207063,,25,0,2,2
9207093,9207093,,71,0,1,1
9206073,9206073,,71,2,0,2
9208021,9208021,,62,0,1,1
9208022,9208022,,37,1,2,3
9208043,9208043,,72,0,2,2
9207029,9207029,,72,3,0,3
9207030,9207030,,72,2,0,2
9208054,9208054,,16,1,3,4
9208064,9208064,,25,5,1,6
9208068,9208068,,8,1,1,2
9208077,9208077,,8,5,1,6
9208081,9208081,,25,0,5,5
9204038,9204038,,25,2,0,2
9203024,9203024,,8,3,0,3
9202050,9202050,,25,8,0,8
9205013,9205013,,8,1,0,1
9209084,9209084,,62,0,1,1
9209092,9209092,,72,0,2,2
9209098,9209098,,11,0,1,1
9209108,9209108,,62,0,1,1
9210006,9210006,,0,0,2,2
9210066,9210066,,62,2,6,8
9203028,9203028,,62,2,0,2
9208065,9208065,,62,4,0,4
9210079,9210079,,1,1,3,4
9210080,9210080,,62,0,4,4
9210088,9210088,,25,0,1,1
9210101,9210101,,25,0,6,6
9210111,9210111,,19,0,1,1
9210113,9210113,,19,0,1,1
9210156,9210156,,73,0,1,1
9205026,9205026,,73,1,0,1
9210157,9210157,,7,1,2,3
9205001,9205001,,7,2,0,2
9205087,9205087,,7,5,0,5
9210165,9210165,,1,0,2,2
9211009,9211009,,7,1,3,4
9211013,9211013,,25,0,1,1
9211031,9211031,,74,0,1,1
9211002,9211002,,74,1,0,1
9211033,9211033,,62,1,3,4
9211036,9211036,,62,1,6,7
9211051,9211051,,4,0,1,1
9211058,9211058,,16,0,1,1
9205100,9205100,,16,4,0,4
9211068,9211068,,62,0,1,1
9211070,9211070,,62,3,3,6
9211077,9211077,,7,0,3,3
9211081,9211081,,65,0,3,3
9211087,9211087,,75,0,1,1
9205002,9205002,,75,1,0,1
9211098,9211098,,62,0,1,1
9211110,9211110,,54,0,4,4
9212002,9212002,,25,0,10,10
9209064,9209064,,25,1,0,1
9212013,9212013,,7,1,1,2
9212025,9212025,,4,0,1,1
9212044,9212044,,25,0,1,1
9212055,9212055,,72,0,1,1
9212061,9212061,,25,0,2,2
9212069,9212069,,16,2,2,4
9201037,9201037,,16,3,0,3
9212080,9212080,,25,0,1,1
9201068,9201068,,25,3,0,3
9212081,9212081,,8,2,3,5
9204016,9204016,,8,4,0,4
9212095,9212095,,31,1,4,5
9212100,9212100,,62,1,5,6
9206031,9206031,,8,3,0,3
9212114,9212114,,16,1,5,6
9212124,9212124,,62,0,1,1
9212137,9212137,,16,3,1,4
9212139,9212139,,25,0,5,5
9212158,9212158,,16,0,1,1
9301022,9301022,,4,0,3,3
9301028,9301028,,16,1,4,5
9207041,9207041,,16,3,0,3
9301065,9301065,,16,0,2,2
9301076,9301076,,37,1,1,2
9301051,9301051,,37,1,0,1
9301081,9301081,,16,0,2,2
9301104,9301104,,37,0,3,3
9210083,9210083,,37,1,0,1
9301108,9301108,,62,0,2,2
9301112,9301112,,16,0,2,2
9301125,9301125,,2,0,15,15
9206017,9206017,,2,1,0,1
9301126,9301126,,7,1,1,2
9301130,9301130,,3,0,1,1
9206001,9206001,,62,1,0,1
9302009,9302009,,25,0,3,3
9302011,9302011,,25,1,1,2
9302024,9302024,,25,1,7,8
9302030,9302030,,1,2,1,3
9302054,9302054,,76,0,1,1
9209039,9209039,,76,2,0,2
9302064,9302064,,7,2,1,3
9302065,9302065,,2,1,2,3
9302075,9302075,,25,6,1,7
9302077,9302077,,1,1,5,6
9207062,9207062,,8,1,0,1
9302092,9302092,,16,2,2,4
9302106,9302106,,4,0,2,2
9302108,9302108,,2,0,4,4
9302135,9302135,,65,0,1,1
9302143,9302143,,25,0,5,5
9303002,9303002,,25,1,3,4
9303003,9303003,,54,0,3,3
9303004,9303004,,7,0,1,1
9202090,9202090,,6,2,0,2
9303023,9303023,,6,0,1,1
9303031,9303031,,16,1,2,3
9303033,9303033,,8,4,2,6
9303078,9303078,,90,1,1,2
9204033,9204033,,90,2,0,2
9303079,9303079,,16,1,4,5
9303087,9303087,,62,2,1,3
9303089,9303089,,8,2,2,4
9303090,9303090,,16,9,5,14
9206099,9206099,,16,11,0,11
9206102,9206102,,16,8,0,8
9303094,9303094,,62,0,2,2
9204067,9204067,,62,2,0,2
9303110,9303110,,65,1,1,2
9303125,9303125,,25,1,1,2
9303126,9303126,,25,0,2,2
9303134,9303134,,25,0,1,1
9303135,9303135,,54,0,1,1
9303138,9303138,,16,0,3,3
9303157,9303157,,16,1,1,2
9303163,9303163,,19,0,1,1
9303169,9303169,,77,0,1,1
9302016,9302016,,77,1,0,1
9303173,9303173,,1,0,1,1
9303174,9303174,,7,1,1,2
9211024,9211024,,7,2,0,2
9303177,9303177,,37,2,1,3
9304001,9304001,,16,1,1,2
9304004,9304004,,8,2,2,4
9304010,9304010,,25,1,13,14
9304038,9304038,,8,3,1,4
9304044,9304044,,25,0,1,1
9304054,9304054,,2,0,1,1
9210146,9210146,,62,1,0,1
9304058,9304058,,78,0,1,1
9212132,9212132,,78,2,0,2
9207055,9207055,,16,2,0,2
9304066,9304066,,54,0,3,3
9304069,9304069,,16,0,2,2
9304077,9304077,,79,0,1,1
9203037,9203037,,79,1,0,1
9304083,9304083,,8,6,2,8
9207022,9207022,,8,2,0,2
9210125,9210125,,8,5,0,5
9304090,9304090,,16,4,3,7
9304093,9304093,,25,0,1,1
9304105,9304105,,0,0,2,2
9304109,9304109,,25,0,4,4
9304113,9304113,,71,0,1,1
9304129,9304129,,2,0,8,8
9304132,9304132,,8,1,1,2
9304134,9304134,,4,1,2,3
9301107,9301107,,4,2,0,2
9303084,9303084,,4,2,0,2
9304137,9304137,,7,0,2,2
9304162,9304162,,16,0,2,2
9305006,9305006,,16,0,1,1
9305008,9305008,,25,0,2,2
9305017,9305017,,62,3,2,5
9305019,9305019,,37,0,5,5
9305022,9305022,,65,0,1,1
9305034,9305034,,65,1,3,4
9305044,9305044,,62,0,1,1
9305049,9305049,,7,0,2,2
9305051,9305051,,16,1,1,2
9301091,9301091,,16,1,0,1
9305065,9305065,,0,0,2,2
9305070,9305070,,8,0,2,2
9305089,9305089,,2,0,4,4
9305096,9305096,,62,2,1,3
9303166,9303166,,62,3,0,3
9305101,9305101,,16,0,2,2
9305105,9305105,,4,0,3,3
9305106,9305106,,4,1,2,3
9305118,9305118,,7,0,1,1
9305124,9305124,,62,0,7,7
9305126,9305126,,16,1,1,2
9305127,9305127,,62,1,3,4
9305140,9305140,,8,1,1,2
9305164,9305164,,14,0,3,3
9206089,9206089,,8,5,0,5
9305176,9305176,,8,2,1,3
9305178,9305178,,11,1,1,2
9212040,9212040,,62,2,0,2
9306011,9306011,,1,1,4,5
9302113,9302113,,1,2,0,2
9305104,9305104,,1,1,0,1
9306020,9306020,,54,0,1,1
9306022,9306022,,7,0,1,1
9306024,9306024,,19,1,1,2
9306025,9306025,,11,2,1,3
9306026,9306026,,8,3,3,6
9306038,9306038,,8,0,1,1
9306045,9306045,,19,0,1,1
9306047,9306047,,54,0,1,1
9306059,9306059,,8,1,8,9
9306060,9306060,,76,0,1,1
9306070,9306070,,25,0,1,1
9306074,9306074,,16,1,1,2
9207099,9207099,,19,1,0,1
9306081,9306081,,16,0,2,2
9208019,9208019,,16,1,0,1
9306088,9306088,,62,3,1,4
9306099,9306099,,62,1,1,2
9306105,9306105,,6,0,4,4
9301117,9301117,,6,1,0,1
9306109,9306109,,2,0,3,3
9306112,9306112,,37,0,2,2
9306114,9306114,,6,0,2,2
9306136,9306136,,65,0,1,1
9203021,9203021,,25,1,0,1
9205032,9205032,,25,1,0,1
9306151,9306151,,1,1,2,3
9307005,9307005,,25,0,2,2
9303096,9303096,,62,3,0,3
9307016,9307016,,16,0,2,2
9206066,9206066,,16,2,0,2
9307017,9307017,,16,1,3,4
9307024,9307024,,4,1,2,3
9307029,9307029,,37,2,1,3
9307053,9307053,,16,0,4,4
9307054,9307054,,16,3,9,12
9307060,9307060,,8,0,1,1
9307064,9307064,,62,0,5,5
9307072,9307072,,25,0,2,2
9307073,9307073,,8,1,2,3
9307076,9307076,,65,1,2,3
9205067,9205067,,65,2,0,2
9210093,9210093,,8,2,0,2
9307103,9307103,,62,0,2,2
9307105,9307105,,25,0,2,2
9207081,9207081,,16,2,0,2
9307124,9307124,,62,0,2,2
9307125,9307125,,37,1,1,2
9307128,9307128,,80,0,1,1
9208050,9208050,,80,1,0,1
9307129,9307129,,62,0,2,2
9307130,9307130,,62,0,2,2
9307131,9307131,,25,0,1,1
9305113,9305113,,62,2,0,2
9306142,9306142,,62,2,0,2
9307149,9307149,,7,0,1,1
9307150,9307150,,7,0,1,1
9307154,9307154,,16,6,6,12
9208017,9208017,,19,2,0,2
9307179,9307179,,16,0,2,2
9307197,9307197,,62,1,2,3
9308008,9308008,,62,0,1,1
9308011,9308011,,25,0,7,7
9308016,9308016,,62,1,3,4
9308017,9308017,,8,1,4,5
9308021,9308021,,25,1,5,6
9308031,9308031,,11,0,1,1
9308040,9308040,,62,0,3,3
9308047,9308047,,7,0,3,3
9308049,9308049,,62,0,1,1
9308050,9308050,,25,1,1,2
9308051,9308051,,16,0,5,5
9308058,9308058,,16,1,1,2
9308059,9308059,,7,0,1,1
9202078,9202078,,25,2,0,2
9308072,9308072,,7,0,2,2
9308080,9308080,,1,0,12,12
9308081,9308081,,0,0,2,2
9308087,9308087,,6,0,1,1
9307095,9307095,,6,2,0,2
9308095,9308095,,25,0,8,8
9308097,9308097,,25,0,2,2
9308101,9308101,,62,0,1,1
9308107,9308107,,2,0,1,1
9308113,9308113,,16,0,3,3
9309001,9309001,,37,0,1,1
9309004,9309004,,6,0,1,1
9309005,9309005,,16,0,5,5
9309007,9309007,,62,1,3,4
9309008,9309008,,25,0,9,9
9309019,9309019,,34,0,5,5
9309037,9309037,,11,0,1,1
9309040,9309040,,25,1,7,8
9309043,9309043,,25,0,1,1
9309058,9309058,,62,0,6,6
9309063,9309063,,16,3,1,4
9309066,9309066,,8,0,1,1
9205007,9205007,,8,4,0,4
9305153,9305153,,16,1,0,1
9309068,9309068,,25,0,3,3
9309069,9309069,,54,2,2,4
9309070,9309070,,8,1,1,2
9309071,9309071,,62,0,1,1
9309072,9309072,,81,0,2,2
9307083,9307083,,81,1,0,1
9309032,9309032,,81,1,0,1
9309080,9309080,,6,0,1,1
9309082,9309082,,25,0,3,3
9309090,9309090,,0,3,1,4
9301054,9301054,,0,4,0,4
9309092,9309092,,62,1,2,3
9309102,9309102,,16,1,2,3
9309103,9309103,,6,2,10,12
9309108,9309108,,16,0,6,6
9309111,9309111,,6,1,3,4
9309114,9309114,,2,0,1,1
9309120,9309120,,7,0,1,1
9309121,9309121,,7,0,4,4
9309129,9309129,,1,3,3,6
9309138,9309138,,25,0,7,7
9309139,9309139,,16,2,2,4
9309141,9309141,,4,2,2,4
9309156,9309156,,25,0,2,2
9204086,9204086,,62,3,0,3
9310002,9310002,,25,1,3,4
9310005,9310005,,7,1,3,4
9310007,9310007,,16,2,1,3
9310012,9310012,,6,0,7,7
9310014,9310014,,8,1,1,2
9310023,9310023,,54,2,2,4
9310036,9310036,,25,0,1,1
9310048,9310048,,25,0,1,1
9310050,9310050,,8,0,1,1
9310057,9310057,,65,0,1,1
9310072,9310072,,8,0,4,4
9310075,9310075,,25,1,4,5
9310077,9310077,,8,0,6,6
9310079,9310079,,16,2,3,5
9310090,9310090,,82,0,2,2
9212128,9212128,,82,1,0,1
9212130,9212130,,82,1,0,1
9310092,9310092,,7,0,2,2
9310103,9310103,,7,2,1,3
9310107,9310107,,19,0,1,1
9310108,9310108,,62,0,2,2
9210162,9210162,,62,1,0,1
9212151,9212151,,62,2,0,2
9303148,9303148,,62,1,0,1
9310116,9310116,,8,0,4,4
9310119,9310119,,62,0,2,2
9310131,9310131,,19,2,6,8
9310133,9310133,,62,1,2,3
9310137,9310137,,16,0,10,10
9310143,9310143,,25,0,4,4
9310160,9310160,,19,2,4,6
9310163,9310163,,8,3,4,7
9212098,9212098,,8,4,0,4
9310168,9310168,,1,1,2,3
9302061,9302061,,1,7,0,7
9310169,9310169,,1,1,1,2
9202009,9202009,,42,3,0,3
9310180,9310180,,25,0,5,5
9310182,9310182,,19,0,1,1
9310190,9310190,,25,0,4,4
9310191,9310191,,16,0,17,17
9310192,9310192,,8,3,1,4
9311004,9311004,,62,0,3,3
9311006,9311006,,8,0,5,5
9311013,9311013,,7,0,1,1
9311016,9311016,,62,0,1,1
9305076,9305076,,62,2,0,2
9311020,9311020,,62,4,2,6
9305145,9305145,,62,7,0,7
9311034,9311034,,4,1,1,2
9311036,9311036,,83,0,2,2
9207088,9207088,,83,1,0,1
9207104,9207104,,83,1,0,1
9311039,9311039,,103,0,1,1
9308029,9308029,,103,4,0,4
9311041,9311041,,62,0,3,3
9304143,9304143,,62,1,0,1
9311054,9311054,,37,0,1,1
9311063,9311063,,19,0,1,1
9311068,9311068,,3,0,1,1
9311077,9311077,,0,0,2,2
9310129,9310129,,8,4,0,4
9311086,9311086,,16,0,7,7
9311088,9311088,,65,2,3,5
9210028,9210028,,65,2,0,2
9207058,9207058,,62,2,0,2
9311090,9311090,,8,3,1,4
9304147,9304147,,8,5,0,5
9311095,9311095,,7,0,1,1
9311099,9311099,,6,1,1,2
9312137,9312137,,6,2,3,5
9311104,9311104,,62,0,1,1
9311107,9311107,,62,1,1,2
9311109,9311109,,7,0,5,5
9311127,9311127,,54,3,3,6
9311131,9311131,,19,0,3,3
9311133,9311133,,25,0,5,5
9311138,9311138,,37,0,12,12
9311140,9311140,,25,0,2,2
9311141,9311141,,7,1,5,6
9311151,9311151,,7,1,1,2
9311163,9311163,,7,2,2,4
9305071,9305071,,7,4,0,4
9306016,9306016,,7,5,0,5
9311166,9311166,,54,0,6,6
9311171,9311171,,62,3,2,5
9311172,9311172,,4,0,1,1
9311176,9311176,,0,1,9,10
9311179,9311179,,3,1,1,2
9311182,9311182,,8,0,1,1
9311184,9311184,,7,0,2,2
9312006,9312006,,16,2,1,3
9312010,9312010,,8,3,7,10
9312011,9312011,,16,0,2,2
9312014,9312014,,14,0,1,1
9312025,9312025,,54,0,2,2
9312027,9312027,,16,1,4,5
9312035,9312035,,37,0,2,2
9312036,9312036,,25,1,9,10
9312037,9312037,,62,0,1,1
9312046,9312046,,7,0,1,1
9312057,9312057,,62,1,1,2
9312067,9312067,,7,0,1,1
9312070,9312070,,62,0,2,2
9312073,9312073,,7,1,2,3
9312074,9312074,,25,0,2,2
9312076,9312076,,7,0,2,2
9312084,9312084,,62,1,1,2
9312095,9312095,,37,4,5,9
9312098,9312098,,7,0,1,1
9312105,9312105,,62,2,1,3
9208003,9208003,,62,3,0,3
9312109,9312109,,19,0,1,1
9312120,9312120,,25,0,2,2
9312124,9312124,,84,0,1,1
9202019,9202019,,84,1,0,1
9312125,9312125,,7,2,1,3
9312134,9312134,,16,1,1,2
9312135,9312135,,16,0,1,1
9312136,9312136,,25,0,1,1
9312139,9312139,,62,1,2,3
9312140,9312140,,7,0,4,4
9312148,9312148,,54,1,1,2
9306062,9306062,,54,2,0,2
9312151,9312151,,14,1,2,3
9312160,9312160,,16,2,4,6
9312163,9312163,,8,0,1,1
9312176,9312176,,34,0,1,1
9312177,9312177,,62,0,2,2
9312181,9312181,,7,0,2,2
9212051,9212051,,7,5,0,5
9312201,9312201,,1,0,2,2
9312203,9312203,,65,0,3,3
9312204,9312204,,19,2,4,6
9301041,9301041,,19,3,0,3
9312205,9312205,,7,2,4,6
9401002,9401002,,11,6,2,8
9401005,9401005,,6,2,3,5
9211124,9211124,,6,1,0,1
9305186,9305186,,6,4,0,4
9401014,9401014,,16,6,2,8
9401024,9401024,,8,0,1,1
9401026,9401026,,8,0,2,2
9401034,9401034,,25,0,2,2
9210145,9210145,,25,3,0,3
9211086,9211086,,25,1,0,1
9401037,9401037,,62,0,1,1
9401064,9401064,,54,0,2,2
9401074,9401074,,19,0,1,1
9401084,9401084,,62,1,3,4
9401088,9401088,,3,1,1,2
9401090,9401090,,7,0,2,2
9401094,9401094,,65,0,6,6
9209061,9209061,,65,1,0,1
9401097,9401097,,11,1,1,2
9401101,9401101,,7,0,3,3
9302042,9302042,,7,1,0,1
9302043,9302043,,7,1,0,1
9305048,9305048,,7,3,0,3
9401109,9401109,,25,0,3,3
9401122,9401122,,19,2,3,5
9401126,9401126,,2,1,3,4
9401127,9401127,,7,4,4,8
9401128,9401128,,7,2,3,5
9401129,9401129,,16,2,1,3
9401144,9401144,,16,1,4,5
9401152,9401152,,7,1,5,6
9401156,9401156,,19,0,2,2
9401157,9401157,,16,0,3,3
9401158,9401158,,25,0,7,7
9401162,9401162,,7,0,1,1
9401164,9401164,,8,1,13,14
9402003,9402003,,1,1,1,2
9402009,9402009,,31,0,2,2
9402013,9402013,,7,0,3,3
9402014,9402014,,19,1,1,2
9402019,9402019,,16,0,1,1
9402024,9402024,,7,1,5,6
9402026,9402026,,37,1,1,2
9402050,9402050,,25,1,2,3
9208010,9208010,,7,2,0,2
9402062,9402062,,0,0,1,1
9402064,9402064,,8,4,1,5
9402071,9402071,,16,1,1,2
9309130,9309130,,16,6,0,6
9402076,9402076,,62,0,3,3
9303161,9303161,,62,3,0,3
9402079,9402079,,62,2,2,4
9402082,9402082,,2,0,3,3
9402086,9402086,,54,0,1,1
9402094,9402094,,62,0,1,1
9402105,9402105,,25,0,3,3
9302082,9302082,,25,2,0,2
9402109,9402109,,25,0,1,1
9402132,9402132,,1,0,6,6
9209090,9209090,,1,1,0,1
9402134,9402134,,7,0,4,4
9402135,9402135,,16,0,1,1
9402140,9402140,,16,0,1,1
9402141,9402141,,0,1,1,2
9402142,9402142,,7,1,3,4
9210042,9210042,,7,1,0,1
9402145,9402145,,62,0,4,4
9211105,9211105,,62,2,0,2
9310154,9310154,,62,2,0,2
9402146,9402146,,6,1,1,2
9402149,9402149,,2,1,6,7
9402150,9402150,,25,2,1,3
9402151,9402151,,8,1,2,3
9210058,9210058,,8,1,0,1
9403005,9403005,,8,0,1,1
9403006,9403006,,16,0,5,5
9403007,9403007,,1,0,3,3
9207068,9207068,,6,1,0,1
9207110,9207110,,6,1,0,1
9403011,9403011,,62,0,3,3
9305144,9305144,,62,1,0,1
9403014,9403014,,37,0,1,1
9403016,9403016,,62,0,2,2
9403022,9403022,,62,1,2,3
9403030,9403030,,62,0,1,1
9403035,9403035,,1,2,3,5
9403046,9403046,,11,0,2,2
9310039,9310039,,1,1,0,1
9403052,9403052,,37,0,5,5
9403057,9403057,,54,0,2,2
9403061,9403061,,62,2,8,10
9202033,9202033,,62,2,0,2
9403062,9403062,,25,0,3,3
9303061,9303061,,25,3,0,3
9403065,9403065,,19,0,1,1
9403079,9403079,,37,0,3,3
9309096,9309096,,37,1,0,1
9403083,9403083,,118,1,1,2
9211099,9211099,,118,2,0,2
9403085,9403085,,105,2,3,5
9204066,9204066,,105,3,0,3
9205019,9205019,,105,3,0,3
9206104,9206104,,105,3,0,3
9403093,9403093,,7,2,1,3
9403097,9403097,,8,2,2,4
9403128,9403128,,14,0,1,1
9403130,9403130,,62,0,5,5
9207116,9207116,,62,1,0,1
9312197,9312197,,62,1,0,1
9403139,9403139,,25,0,14,14
9403140,9403140,,62,0,2,2
9403145,9403145,,11,0,2,2
9403148,9403148,,4,0,1,1
9403152,9403152,,85,0,1,1
9311119,9311119,,85,1,0,1
9403153,9403153,,7,1,2,3
9403154,9403154,,7,0,11,11
9311096,9311096,,7,4,0,4
9403156,9403156,,19,1,1,2
9403160,9403160,,14,3,1,4
9403161,9403161,,1,0,1,1
9403165,9403165,,19,0,1,1
9403176,9403176,,7,0,1,1
9403178,9403178,,7,4,1,5
9402011,9402011,,7,2,0,2
9403194,9403194,,8,4,1,5
9404007,9404007,,7,2,1,3
9404014,9404014,,11,0,2,2
9404019,9404019,,16,0,3,3
9404021,9404021,,62,0,3,3
9404026,9404026,,78,0,1,1
9404027,9404027,,7,0,1,1
9301011,9301011,,8,1,0,1
9404040,9404040,,37,0,5,5
9404041,9404041,,7,3,10,13
9404049,9404049,,16,0,1,1
9311123,9311123,,7,1,0,1
9404066,9404066,,25,0,2,2
9404068,9404068,,7,1,5,6
9404069,9404069,,62,3,1,4
9404072,9404072,,62,1,1,2
9404076,9404076,,25,0,8,8
9404079,9404079,,16,1,2,3
9404090,9404090,,7,0,4,4
9404099,9404099,,25,1,2,3
9312092,9312092,,19,1,0,1
9404104,9404104,,19,1,4,5
9404117,9404117,,86,0,1,1
9404016,9404016,,86,2,0,2
9404123,9404123,,7,4,1,5
9404127,9404127,,1,0,1,1
9404130,9404130,,19,1,1,2
9404131,9404131,,8,1,6,7
9404133,9404133,,105,0,5,5
9404137,9404137,,87,0,1,1
9401067,9401067,,87,1,0,1
9404139,9404139,,8,4,9,13
9403068,9403068,,8,1,0,1
9404141,9404141,,62,0,4,4
9404148,9404148,,1,0,2,2
9404160,9404160,,88,0,1,1
9212018,9212018,,88,1,0,1
9404167,9404167,,89,0,1,1
9207047,9207047,,89,1,0,1
9404169,9404169,,16,1,2,3
9404179,9404179,,8,1,6,7
9301077,9301077,,8,3,0,3
9404182,9404182,,19,0,4,4
9404189,9404189,,16,0,1,1
9404193,9404193,,8,2,1,3
9405015,9405015,,25,1,5,6
9210051,9210051,,62,1,0,1
9405027,9405027,,90,0,2,2
9307113,9307113,,90,1,0,1
9405036,9405036,,11,0,1,1
9405037,9405037,,86,0,1,1
9405040,9405040,,11,0,1,1
9204077,9204077,,62,1,0,1
9405042,9405042,,97,0,1,1
9404178,9404178,,97,2,0,2
9405048,9405048,,7,0,3,3
9309061,9309061,,7,2,0,2
9405050,9405050,,1,0,3,3
9402130,9402130,,1,1,0,1
9405052,9405052,,25,0,12,12
9405056,9405056,,37,0,4,4
9405062,9405062,,91,0,1,1
9307132,9307132,,91,1,0,1
9405065,9405065,,54,1,5,6
9405071,9405071,,37,2,3,5
9311075,9311075,,7,1,0,1
9301032,9301032,,16,1,0,1
9405081,9405081,,4,0,8,8
9203034,9203034,,4,2,0,2
9405085,9405085,,37,0,2,2
9405088,9405088,,6,0,5,5
9405089,9405089,,8,4,8,12
9405091,9405091,,16,1,1,2
9405092,9405092,,19,0,2,2
9405099,9405099,,65,1,5,6
9405101,9405101,,8,1,1,2
9405115,9405115,,8,0,2,2
9405122,9405122,,37,0,2,2
9405130,9405130,,25,2,12,14
9405131,9405131,,62,1,2,3
9311029,9311029,,62,2,0,2
9405134,9405134,,16,1,8,9
9405142,9405142,,62,0,3,3
9301087,9301087,,62,5,0,5
9405159,9405159,,4,0,8,8
9210022,9210022,,11,6,0,6
9405167,9405167,,65,0,1,1
9405169,9405169,,0,1,1,2
9405172,9405172,,8,2,3,5
9405175,9405175,,54,0,4,4
9405182,9405182,,19,0,3,3
9405185,9405185,,25,2,7,9
9405186,9405186,,8,0,2,2
9405189,9405189,,34,0,1,1
9405192,9405192,,2,1,2,3
9405199,9405199,,34,0,1,1
9406007,9406007,,4,3,3,6
9406014,9406014,,8,0,3,3
9406016,9406016,,8,1,12,13
9406022,9406022,,4,4,4,8
9406035,9406035,,4,0,5,5
9406038,9406038,,19,0,1,1
9406043,9406043,,0,1,1,2
9406044,9406044,,7,0,4,4
9406064,9406064,,54,0,1,1
9406065,9406065,,65,0,1,1
9406066,9406066,,7,0,4,4
9303142,9303142,,7,3,0,3
9406072,9406072,,8,0,1,1
9406084,9406084,,7,0,5,5
9402090,9402090,,7,1,0,1
9406085,9406085,,25,0,4,4
9406087,9406087,,7,0,1,1
9406099,9406099,,7,0,6,6
9406102,9406102,,2,0,4,4
9406106,9406106,,1,0,2,2
9302062,9302062,,1,3,0,3
9406113,9406113,,16,0,2,2
9404168,9404168,,16,1,0,1
9406121,9406121,,16,2,4,6
9406123,9406123,,19,2,2,4
9406131,9406131,,8,3,6,9
9301085,9301085,,25,2,0,2
9406137,9406137,,7,0,1,1
9406138,9406138,,37,1,4,5
9405068,9405068,,8,3,0,3
9406139,9406139,,16,0,11,11
9406141,9406141,,62,0,3,3
9406142,9406142,,92,0,1,1
9310065,9310065,,92,1,0,1
9406153,9406153,,16,1,7,8
9406157,9406157,,7,0,5,5
9406159,9406159,,54,0,1,1
9406167,9406167,,16,0,1,1
9406169,9406169,,19,0,2,2
9406171,9406171,,25,1,7,8
9406181,9406181,,31,0,3,3
9406182,9406182,,1,1,2,3
9403107,9403107,,62,2,0,2
9406186,9406186,,62,0,7,7
9406187,9406187,,19,0,5,5
9406190,9406190,,65,1,1,2
9406194,9406194,,62,0,1,1
9308078,9308078,,16,1,0,1
9406200,9406200,,8,0,1,1
9406204,9406204,,8,3,1,4
9406205,9406205,,7,0,10,10
9407006,9407006,,6,1,2,3
9407024,9407024,,93,0,1,1
9305085,9305085,,93,1,0,1
9407030,9407030,,19,0,3,3
9407033,9407033,,19,4,6,10
9407034,9407034,,16,0,12,12
9407035,9407035,,16,0,1,1
9407040,9407040,,19,0,2,2
9403110,9403110,,19,1,0,1
9407048,9407048,,19,1,6,7
9407062,9407062,,62,0,5,5
9407063,9407063,,25,0,3,3
9407066,9407066,,16,0,1,1
9407082,9407082,,8,0,1,1
9407083,9407083,,65,0,2,2
9407086,9407086,,94,0,1,1
9303151,9303151,,94,3,0,3
9407090,9407090,,11,3,2,5
9407097,9407097,,6,1,1,2
9407107,9407107,,7,0,4,4
9407110,9407110,,7,0,4,4
9407127,9407127,,7,0,2,2
9210094,9210094,,65,2,0,2
9407132,9407132,,62,1,3,4
9407133,9407133,,2,0,2,2
9407136,9407136,,8,1,12,13
9306104,9306104,,8,2,0,2
9407138,9407138,,95,0,1,1
9312196,9312196,,95,1,0,1
9407144,9407144,,2,0,3,3
9407145,9407145,,7,0,1,1
9407146,9407146,,62,3,1,4
9407157,9407157,,8,2,3,5
9309112,9309112,,8,2,0,2
9407162,9407162,,7,1,1,2
9407163,9407163,,8,1,13,14
9407164,9407164,,25,1,4,5
9407165,9407165,,103,0,1,1
9407171,9407171,,103,0,1,1
9407172,9407172,,103,0,2,2
9311160,9311160,,103,2,0,2
9203032,9203032,,6,1,0,1
9407178,9407178,,16,0,1,1
9407184,9407184,,96,0,1,1
9304076,9304076,,96,1,0,1
9407187,9407187,,2,1,6,7
9406148,9406148,,2,1,0,1
9407195,9407195,,7,3,6,9
9407197,9407197,,2,0,1,1
9408011,9408011,,19,0,3,3
9408012,9408012,,65,1,1,2
9408015,9408015,,34,0,1,1
9408018,9408018,,16,0,6,6
9408021,9408021,,8,0,4,4
9309113,9309113,,8,1,0,1
9408024,9408024,,8,1,3,4
9408026,9408026,,1,0,4,4
9408030,9408030,,6,2,10,12
9408031,9408031,,7,1,10,11
9408042,9408042,,8,0,1,1
9408047,9408047,,6,1,2,3
9408050,9408050,,11,0,1,1
9408051,9408051,,37,0,1,1
9408055,9408055,,6,0,3,3
9208014,9208014,,6,2,0,2
9408059,9408059,,7,1,1,2
9408063,9408063,,31,0,6,6
9408069,9408069,,1,0,6,6
9211128,9211128,,8,1,0,1
9408084,9408084,,2,1,2,3
9408094,9408094,,4,0,3,3
9408108,9408108,,16,1,2,3
9408110,9408110,,54,0,1,1
9408111,9408111,,7,0,1,1
9408123,9408123,,7,0,1,1
9408130,9408130,,62,0,6,6
9408131,9408131,,62,0,5,5
9408138,9408138,,62,1,1,2
9408139,9408139,,62,0,2,2
9408140,9408140,,16,0,7,7
9408142,9408142,,1,0,5,5
9408143,9408143,,62,0,1,1
9408144,9408144,,1,1,7,8
9408150,9408150,,16,1,1,2
9408153,9408153,,8,0,1,1
9408154,9408154,,19,0,1,1
9408157,9408157,,3,0,1,1
9408165,9408165,,7,1,1,2
9408170,9408170,,7,0,2,2
9408171,9408171,,54,0,6,6
9408174,9408174,,16,0,1,1
9408179,9408179,,7,0,8,8
9409002,9409002,,6,0,2,2
9409005,9409005,,1,2,1,3
9409007,9409007,,8,0,3,3
9409008,9409008,,8,0,1,1
9409017,9409017,,8,0,4,4
9409031,9409031,,16,1,6,7
9409032,9409032,,25,0,2,2
9409038,9409038,,19,1,1,2
9409040,9409040,,62,0,4,4
9409045,9409045,,7,0,1,1
9409056,9409056,,7,0,5,5
9409057,9409057,,7,0,5,5
9409059,9409059,,7,0,3,3
9409061,9409061,,2,0,6,6
9409063,9409063,,37,0,3,3
9409073,9409073,,11,0,1,1
9409077,9409077,,65,0,1,1
9409079,9409079,,62,0,19,19
9212039,9212039,,62,1,0,1
9305180,9305180,,62,1,0,1
9307032,9307032,,62,1,0,1
9409090,9409090,,62,0,3,3
9409036,9409036,,62,2,0,2
9409092,9409092,,37,0,1,1
9409095,9409095,,54,0,19,19
9409097,9409097,,62,2,2,4
9409100,9409100,,7,0,4,4
9401114,9401114,,7,1,0,1
9409118,9409118,,37,0,2,2
9409121,9409121,,31,0,3,3
9409122,9409122,,8,3,6,9
9409123,9409123,,0,0,2,2
9409124,9409124,,54,2,5,7
9409125,9409125,,62,0,4,4
9409126,9409126,,62,1,7,8
9409127,9409127,,62,0,4,4
9409132,9409132,,7,0,3,3
9409136,9409136,,7,0,3,3
9409140,9409140,,7,0,3,3
9409146,9409146,,6,0,1,1
9409149,9409149,,97,1,1,2
9409148,9409148,,97,2,0,2
9409150,9409150,,97,0,3,3
9409155,9409155,,62,0,2,2
9409156,9409156,,14,0,2,2
9207076,9207076,,14,2,0,2
9409157,9409157,,16,0,10,10
9409163,9409163,,7,0,4,4
9310171,9310171,,7,4,0,4
9310189,9310189,,7,4,0,4
9409166,9409166,,37,2,9,11
9409170,9409170,,8,3,5,8
9409174,9409174,,16,0,1,1
9409175,9409175,,54,0,3,3
9409180,9409180,,7,4,4,8
9409186,9409186,,8,3,11,14
9409189,9409189,,8,1,4,5
9409191,9409191,,7,0,2,2
9409200,9409200,,19,0,8,8
9410001,9410001,,19,0,2,2
9410004,9410004,,16,2,10,12
9410006,9410006,,1,0,3,3
9410007,9410007,,1,1,1,2
9410013,9410013,,8,2,9,11
9405116,9405116,,62,2,0,2
9410018,9410018,,54,0,3,3
9410021,9410021,,62,0,4,4
9410028,9410028,,25,0,2,2
9410030,9410030,,25,0,3,3
9410039,9410039,,7,0,2,2
9410044,9410044,,62,0,2,2
9410075,9410075,,25,0,1,1
9410076,9410076,,11,1,2,3
9410086,9410086,,11,0,6,6
9410059,9410059,,16,3,0,3
9410088,9410088,,14,2,8,10
9410090,9410090,,19,1,3,4
9410096,9410096,,7,1,2,3
9410097,9410097,,7,0,2,2
9410102,9410102,,37,0,1,1
9410108,9410108,,4,1,2,3
9410111,9410111,,98,0,1,1
9310059,9310059,,98,1,0,1
9410113,9410113,,25,4,3,7
9410116,9410116,,6,0,3,3
9410120,9410120,,16,0,1,1
9410124,9410124,,3,0,5,5
9410127,9410127,,37,0,1,1
9410135,9410135,,7,1,3,4
9410139,9410139,,1,0,1,1
9410145,9410145,,7,1,1,2
9410148,9410148,,54,0,5,5
9410154,9410154,,4,0,2,2
9410155,9410155,,25,0,2,2
9410156,9410156,,62,0,11,11
9410159,9410159,,11,0,1,1
9410161,9410161,,99,0,1,1
9401054,9401054,,99,2,0,2
9410170,9410170,,8,0,6,6
9410171,9410171,,62,0,4,4
9410179,9410179,,2,2,1,3
9410182,9410182,,19,0,2,2
9410183,9410183,,14,1,3,4
9410186,9410186,,7,1,1,2
9410193,9410193,,7,1,3,4
9407050,9407050,,7,1,0,1
9410194,9410194,,16,1,1,2
9410195,9410195,,7,2,2,4
9410196,9410196,,16,0,7,7
9410198,9410198,,19,0,1,1
9410200,9410200,,2,2,1,3
9410204,9410204,,25,0,2,2
9410207,9410207,,16,0,5,5
9410058,9410058,,16,3,0,3
9410060,9410060,,16,2,0,2
9410061,9410061,,16,2,0,2
9410062,9410062,,16,2,0,2
9410222,9410222,,2,0,3,3
9410224,9410224,,8,0,6,6
9410226,9410226,,2,1,1,2
9410232,9410232,,2,0,2,2
9410233,9410233,,25,2,6,8
9410235,9410235,,16,3,9,12
9410240,9410240,,16,0,1,1
9410242,9410242,,4,0,2,2
9410243,9410243,,16,1,2,3
9411006,9411006,,7,0,5,5
9411014,9411014,,25,0,7,7
9411023,9411023,,7,1,2,3
9307094,9307094,,7,1,0,1
9411024,9411024,,25,4,5,9
9411034,9411034,,7,0,1,1
9411035,9411035,,62,1,1,2
9411036,9411036,,62,0,2,2
9411038,9411038,,62,0,6,6
9311142,9311142,,62,1,0,1
9405150,9405150,,62,1,0,1
9411043,9411043,,65,1,1,2
9411046,9411046,,62,0,7,7
9411056,9411056,,37,0,7,7
9411059,9411059,,62,0,3,3
9305149,9305149,,62,1,0,1
9411060,9411060,,65,0,1,1
9410110,9410110,,65,2,0,2
9411063,9411063,,1,4,2,6
9411067,9411067,,7,1,1,2
9411071,9411071,,7,0,2,2
9411075,9411075,,3,0,5,5
9411082,9411082,,7,1,8,9
9411097,9411097,,25,0,7,7
9411098,9411098,,100,0,1,1
9305183,9305183,,100,1,0,1
9411107,9411107,,4,0,6,6
9411121,9411121,,62,2,9,11
9411123,9411123,,7,0,5,5
9411133,9411133,,19,0,6,6
9308044,9308044,,19,2,0,2
9411137,9411137,,0,4,1,5
9411141,9411141,,7,4,1,5
9411142,9411142,,6,3,3,6
9409194,9409194,,6,1,0,1
9411143,9411143,,16,3,5,8
9411147,9411147,,62,0,1,1
9411151,9411151,,3,1,2,3
9411156,9411156,,8,4,14,18
9411158,9411158,,3,0,1,1
9411159,9411159,,7,0,2,2
9411161,9411161,,19,0,1,1
9411162,9411162,,7,0,1,1
9411165,9411165,,4,1,3,4
9408008,9408008,,62,1,0,1
9411181,9411181,,62,0,2,2
9411182,9411182,,6,2,1,3
9212056,9212056,,6,3,0,3
9411186,9411186,,7,0,5,5
9411189,9411189,,7,1,1,2
9411192,9411192,,37,0,5,5
9411193,9411193,,25,0,2,2
9411196,9411196,,8,0,1,1
9411197,9411197,,101,0,2,2
9304008,9304008,,101,1,0,1
9411199,9411199,,1,0,3,3
9411206,9411206,,54,0,3,3
9411207,9411207,,62,0,3,3
9411213,9411213,,25,0,4,4
9303028,9303028,,25,2,0,2
9411215,9411215,,11,0,2,2
9401079,9401079,,11,1,0,1
9411217,9411217,,1,1,6,7
9411220,9411220,,11,0,4,4
9411222,9411222,,54,0,1,1
9312128,9312128,,7,2,0,2
9411237,9411237,,0,0,3,3
9308085,9308085,,0,2,0,2
9411240,9411240,,7,0,1,1
9411241,9411241,,62,0,3,3
9412003,9412003,,25,3,8,11
9412004,9412004,,62,1,1,2
9412005,9412005,,62,0,2,2
9412010,9412010,,0,2,3,5
9412013,9412013,,62,0,3,3
9412016,9412016,,7,0,2,2
9412023,9412023,,16,2,5,7
9412025,9412025,,37,0,1,1
9412029,9412029,,7,0,5,5
9412035,9412035,,25,0,8,8
9212156,9212156,,25,2,0,2
9412039,9412039,,62,2,1,3
9412041,9412041,,0,0,2,2
9412043,9412043,,25,0,7,7
9404055,9404055,,25,2,0,2
9412044,9412044,,1,0,14,14
9412052,9412052,,11,2,2,4
9301095,9301095,,11,1,0,1
9412057,9412057,,102,0,1,1
9211004,9211004,,102,1,0,1
9412060,9412060,,7,0,5,5
9412063,9412063,,9,0,1,1
9412067,9412067,,103,0,2,2
9406143,9406143,,103,1,0,1
9412070,9412070,,25,0,4,4
9412080,9412080,,16,1,5,6
9412082,9412082,,7,0,1,1
9412087,9412087,,34,0,3,3
9207113,9207113,,34,1,0,1
9412091,9412091,,62,1,2,3
9411001,9411001,,62,2,0,2
9412096,9412096,,16,0,2,2
9412098,9412098,,7,0,1,1
9412099,9412099,,7,0,2,2
9412103,9412103,,16,1,1,2
9412105,9412105,,7,0,1,1
9412107,9412107,,11,0,2,2
9412112,9412112,,54,0,8,8
9412116,9412116,,62,1,1,2
9412118,9412118,,65,0,4,4
9412121,9412121,,19,0,1,1
9407174,9407174,,19,3,0,3
9412123,9412123,,1,0,2,2
9412126,9412126,,65,0,3,3
9412135,9412135,,37,0,9,9
9412137,9412137,,7,0,1,1
9412150,9412150,,2,0,4,4
9412151,9412151,,11,0,2,2
9412155,9412155,,34,2,8,10
9412160,9412160,,8,1,7,8
9412168,9412168,,1,0,6,6
9412171,9412171,,6,3,2,5
9412172,9412172,,2,0,1,1
9412183,9412183,,34,0,1,1
9412186,9412186,,0,0,1,1
9307141,9307141,,37,1,0,1
9412189,9412189,,25,0,19,19
9412190,9412190,,37,0,1,1
9412191,9412191,,62,0,4,4
9412197,9412197,,62,0,1,1
9412206,9412206,,37,1,4,5
9412215,9412215,,19,0,4,4
9412217,9412217,,6,1,1,2
9412219,9412219,,54,0,1,1
9412221,9412221,,7,1,5,6
9412235,9412235,,2,1,10,11
9412241,9412241,,16,1,4,5
9409078,9409078,,6,1,0,1
9501008,9501008,,6,0,1,1
9501009,9501009,,16,3,1,4
9501010,9501010,,16,1,1,2
9501011,9501011,,25,0,7,7
9308035,9308035,,62,2,0,2
9501033,9501033,,62,1,4,5
9501046,9501046,,16,0,1,1
9501051,9501051,,25,0,7,7
9501060,9501060,,16,0,5,5
9410049,9410049,,62,4,0,4
9501074,9501074,,2,0,4,4
9501076,9501076,,62,0,7,7
9501082,9501082,,4,0,5,5
9501086,9501086,,16,0,1,1
9501090,9501090,,25,3,25,28
9501091,9501091,,1,1,8,9
9501094,9501094,,2,1,2,3
9501100,9501100,,8,3,1,4
9501108,9501108,,8,1,1,2
9501109,9501109,,62,0,12,12
9501116,9501116,,62,1,4,5
9501120,9501120,,37,2,5,7
9501123,9501123,,11,3,1,4
9501125,9501125,,62,1,6,7
9411225,9411225,,62,1,0,1
9501126,9501126,,8,0,6,6
9501128,9501128,,62,1,2,3
9501129,9501129,,6,0,2,2
9605123,9605123,,62,1,2,3
9501139,9501139,,6,0,1,1
9501143,9501143,,7,5,4,9
9502005,9502005,,6,0,1,1
9502020,9502020,,19,0,2,2
9502023,9502023,,25,0,4,4
9502026,9502026,,7,0,3,3
9502027,9502027,,25,0,1,1
9502036,9502036,,16,2,5,7
9502037,9502037,,16,0,6,6
9502039,9502039,,62,0,4,4
9502043,9502043,,16,0,2,2
9502050,9502050,,7,0,14,14
9502052,9502052,,11,1,2,3
9502059,9502059,,19,0,10,10
9502062,9502062,,25,0,5,5
9305108,9305108,,62,1,0,1
9502064,9502064,,1,0,2,2
9207023,9207023,,1,1,0,1
9502086,9502086,,25,0,3,3
9502090,9502090,,8,0,5,5
9502093,9502093,,31,0,2,2
9502101,9502101,,25,3,3,6
9502105,9502105,,19,1,7,8
9502108,9502108,,8,4,11,15
9502112,9502112,,104,0,1,1
9308070,9308070,,104,1,0,1
9502121,9502121,,7,3,4,7
9502123,9502123,,16,0,3,3
9502127,9502127,,6,2,6,8
9502131,9502131,,25,1,5,6
9502134,9502134,,62,1,2,3
9502142,9502142,,19,1,1,2
9502147,9502147,,6,1,11,12
9203015,9203015,,6,1,0,1
9502150,9502150,,1,0,12,12
9502152,9502152,,6,4,1,5
9502153,9502153,,54,0,1,1
9502154,9502154,,7,0,4,4
9502159,9502159,,0,0,4,4
9306144,9306144,,0,1,0,1
9502160,9502160,,8,1,6,7
9503008,9503008,,16,0,1,1
9503009,9503009,,25,3,3,6
9503013,9503013,,16,0,6,6
9503026,9503026,,62,0,1,1
9503031,9503031,,25,0,3,3
9503037,9503037,,62,1,4,5
9503039,9503039,,37,0,3,3
9503047,9503047,,62,0,14,14
9503048,9503048,,16,0,17,17
9503049,9503049,,16,0,4,4
9503058,9503058,,0,2,1,3
9503066,9503066,,37,0,3,3
9503067,9503067,,7,0,4,4
9503103,9503103,,3,1,5,6
9503107,9503107,,62,1,8,9
9210100,9210100,,1,2,0,2
9503111,9503111,,19,0,3,3
9503118,9503118,,8,6,7,13
9503122,9503122,,2,0,9,9
9503123,9503123,,11,0,1,1
9503129,9503129,,54,1,9,10
9503130,9503130,,25,0,18,18
9503131,9503131,,6,0,1,1
9503139,9503139,,62,1,3,4
9503144,9503144,,105,0,5,5
9503158,9503158,,8,1,10,11
9503159,9503159,,8,1,13,14
9503164,9503164,,62,0,6,6
9503166,9503166,,8,0,8,8
9503167,9503167,,1,0,9,9
9503169,9503169,,16,0,1,1
9503174,9503174,,65,1,6,7
9503191,9503191,,62,2,6,8
9503196,9503196,,106,0,1,1
9304145,9304145,,106,1,0,1
9503199,9503199,,19,0,4,4
9502128,9502128,,19,3,0,3
9503200,9503200,,1,1,4,5
9503202,9503202,,2,8,4,12
9503206,9503206,,11,2,4,6
9503215,9503215,,6,1,3,4
9503223,9503223,,37,0,1,1
9503231,9503231,,2,2,13,15
9404074,9404074,,2,2,0,2
9503233,9503233,,7,1,2,3
9504003,9504003,,8,1,4,5
9504004,9504004,,16,2,9,11
9504008,9504008,,7,0,2,2
9410144,9410144,,7,1,0,1
9504016,9504016,,6,0,3,3
9504023,9504023,,8,0,12,12
9504035,9504035,,62,1,2,3
9504040,9504040,,1,1,4,5
9504041,9504041,,62,1,3,4
9504042,9504042,,62,3,0,3
9504043,9504043,,11,1,2,3
9504044,9504044,,11,0,2,2
9504058,9504058,,107,0,1,1
9401082,9401082,,107,1,0,1
9504062,9504062,,108,0,1,1
9308117,9308117,,108,1,0,1
9504068,9504068,,16,0,2,2
9210154,9210154,,16,1,0,1
9504069,9504069,,62,0,11,11
9504076,9504076,,16,2,2,4
9504079,9504079,,16,1,2,3
9504092,9504092,,11,1,3,4
9504093,9504093,,25,1,23,24
9504096,9504096,,62,0,4,4
9504110,9504110,,7,1,4,5
9504112,9504112,,4,1,8,9
9504119,9504119,,62,1,3,4
9504126,9504126,,25,0,3,3
9504133,9504133,,4,1,6,7
9504135,9504135,,16,0,2,2
9504136,9504136,,7,5,2,7
9407142,9407142,,7,5,0,5
9411066,9411066,,7,6,0,6
9504149,9504149,,8,2,31,33
9504156,9504156,,25,0,1,1
9504161,9504161,,2,1,23,24
9504163,9504163,,90,0,1,1
9505001,9505001,,11,2,1,3
9505002,9505002,,8,1,1,2
9502151,9502151,,8,1,0,1
9505007,9505007,,62,0,10,10
9410066,9410066,,62,1,0,1
9505008,9505008,,62,2,2,4
9505011,9505011,,7,2,6,8
9412233,9412233,,0,5,0,5
9505026,9505026,,62,1,5,6
9505028,9505028,,16,0,6,6
9505033,9505033,,1,0,12,12
9505034,9505034,,8,2,3,5
9505036,9505036,,25,1,4,5
9505043,9505043,,19,1,7,8
9404015,9404015,,19,1,0,1
9505044,9505044,,19,1,8,9
9505048,9505048,,16,1,1,2
9505056,9505056,,8,2,5,7
9505057,9505057,,37,0,2,2
9505066,9505066,,62,0,1,1
9505071,9505071,,7,2,5,7
9505076,9505076,,16,1,2,3
9505079,9505079,,16,1,1,2
9410037,9410037,,62,1,0,1
9505089,9505089,,8,1,22,23
9307078,9307078,,8,2,0,2
9401150,9401150,,8,2,0,2
9406145,9406145,,8,1,0,1
9504118,9504118,,8,2,0,2
9505090,9505090,,2,0,2,2
9505094,9505094,,11,1,3,4
9505103,9505103,,1,0,9,9
9505108,9505108,,19,1,6,7
9505109,9505109,,6,1,1,2
9505110,9505110,,34,1,1,2
9405123,9405123,,34,4,0,4
9505114,9505114,,0,0,1,1
9505118,9505118,,62,0,1,1
9505130,9505130,,62,4,1,5
9505132,9505132,,25,3,12,15
9505137,9505137,,16,0,1,1
9505142,9505142,,8,3,6,9
9505155,9505155,,62,0,7,7
9505163,9505163,,2,0,3,3
9505191,9505191,,109,0,1,1
9409171,9409171,,109,1,0,1
9506012,9506012,,2,0,2,2
9506013,9506013,,11,0,2,2
9506025,9506025,,62,2,2,4
9506028,9506028,,54,0,2,2
9506029,9506029,,6,1,1,2
9506034,9506034,,37,1,3,4
9506039,9506039,,8,0,1,1
9506045,9506045,,31,0,12,12
9506046,9506046,,16,0,4,4
9409084,9409084,,16,1,0,1
9506047,9506047,,8,1,6,7
9506051,9506051,,37,0,2,2
9506053,9506053,,8,1,4,5
9410025,9410025,,8,2,0,2
9506054,9506054,,62,0,3,3
9506055,9506055,,16,0,2,2
9506068,9506068,,11,0,1,1
9506070,9506070,,37,0,3,3
9506080,9506080,,1,0,6,6
9506088,9506088,,8,2,3,5
9506092,9506092,,110,0,1,1
9409003,9409003,,110,1,0,1
9410094,9410094,,54,2,0,2
9506096,9506096,,62,1,17,18
9506103,9506103,,16,1,9,10
9506124,9506124,,37,2,10,12
9506127,9506127,,25,0,2,2
9506130,9506130,,25,1,4,5
9411120,9411120,,25,1,0,1
9505178,9505178,,25,4,0,4
9506133,9506133,,62,5,25,30
9506134,9506134,,111,3,1,4
9412001,9412001,,111,4,0,4
9506149,9506149,,54,0,5,5
9506155,9506155,,19,1,9,10
9506161,9506161,,9,2,1,3
9506162,9506162,,37,0,5,5
9506165,9506165,,112,0,1,1
9302105,9302105,,112,1,0,1
9307069,9307069,,8,1,0,1
9307112,9307112,,8,1,0,1
9412102,9412102,,8,1,0,1
9506173,9506173,,54,0,2,2
9506197,9506197,,37,0,4,4
9506201,9506201,,62,0,4,4
9506202,9506202,,25,1,4,5
9506208,9506208,,6,0,1,1
9506213,9506213,,2,3,13,16
9304002,9304002,,1,2,0,2
9507004,9507004,,8,2,10,12
9507019,9507019,,37,0,4,4
9412094,9412094,,62,1,0,1
9507031,9507031,,113,0,1,1
9404048,9404048,,113,1,0,1
9507033,9507033,,6,4,2,6
9507034,9507034,,19,1,4,5
9507054,9507054,,25,0,3,3
9507061,9507061,,2,4,6,10
9507065,9507065,,16,0,2,2
9507075,9507075,,54,2,7,9
9507078,9507078,,7,0,3,3
9507080,9507080,,25,0,1,1
9507081,9507081,,16,0,1,1
9412038,9412038,,65,1,0,1
9507086,9507086,,114,0,1,1
9501025,9501025,,114,1,0,1
9507102,9507102,,37,0,5,5
9507108,9507108,,54,0,12,12
9507116,9507116,,7,0,3,3
9507117,9507117,,16,0,2,2
9507119,9507119,,7,1,2,3
9507120,9507120,,37,0,3,3
9507122,9507122,,16,1,7,8
9507123,9507123,,62,0,3,3
9507126,9507126,,25,2,6,8
9507127,9507127,,1,0,5,5
9507128,9507128,,62,0,2,2
9306116,9306116,,62,2,0,2
9507129,9507129,,31,0,4,4
9507134,9507134,,19,2,1,3
9507138,9507138,,7,0,4,4
9507142,9507142,,16,0,2,2
9507146,9507146,,65,0,5,5
9507149,9507149,,7,0,1,1
9507154,9507154,,7,2,1,3
9507157,9507157,,4,0,4,4
9508007,9508007,,62,0,7,7
9508014,9508014,,34,0,3,3
9508018,9508018,,11,0,4,4
9508019,9508019,,7,0,2,2
9508022,9508022,,7,0,2,2
9508023,9508023,,34,1,2,3
9508024,9508024,,14,0,9,9
9508026,9508026,,37,0,8,8
9508027,9508027,,1,0,5,5
9508029,9508029,,31,0,8,8
9508037,9508037,,115,0,1,1
9405177,9405177,,115,1,0,1
9508039,9508039,,2,5,8,13
9508054,9508054,,8,1,14,15
9508057,9508057,,7,1,1,2
9508059,9508059,,16,0,3,3
9508060,9508060,,25,0,3,3
9508067,9508067,,16,0,4,4
9508092,9508092,,2,1,7,8
9508093,9508093,,8,1,1,2
9508095,9508095,,65,0,11,11
9508106,9508106,,7,1,3,4
9508109,9508109,,62,0,7,7
9508115,9508115,,7,1,2,3
9508118,9508118,,16,1,4,5
9508120,9508120,,25,0,1,1
9508121,9508121,,25,0,2,2
9508122,9508122,,25,0,1,1
9508123,9508123,,25,0,1,1
9508126,9508126,,8,0,5,5
9508127,9508127,,16,1,3,4
9508130,9508130,,62,0,3,3
9508145,9508145,,62,2,3,5
9508146,9508146,,6,1,1,2
9508147,9508147,,7,0,4,4
9508152,9508152,,25,0,9,9
9508157,9508157,,11,0,1,1
9508169,9508169,,62,0,1,1
9508179,9508179,,6,1,3,4
9509001,9509001,,37,1,9,10
9509010,9509010,,16,0,2,2
9509014,9509014,,54,0,3,3
9509018,9509018,,4,1,1,2
9509025,9509025,,25,1,19,20
9509039,9509039,,62,1,4,5
9509046,9509046,,19,0,2,2
9509051,9509051,,54,0,1,1
9509055,9509055,,16,1,2,3
9509061,9509061,,8,0,6,6
9509063,9509063,,0,0,1,1
9403034,9403034,,0,2,0,2
9509064,9509064,,25,0,13,13
9509065,9509065,,25,0,9,9
9308074,9308074,,16,2,0,2
9509069,9509069,,6,2,6,8
9503195,9503195,,6,2,0,2
9509071,9509071,,62,1,6,7
9509087,9509087,,16,0,9,9
9509089,9509089,,1,1,1,2
9509093,9509093,,2,3,4,7
9509094,9509094,,8,0,2,2
9509100,9509100,,116,0,1,1
9507174,9507174,,116,1,0,1
9509103,9509103,,8,1,9,10
9508101,9508101,,19,1,0,1
9509111,9509111,,6,1,5,6
9509112,9509112,,25,3,16,19
9509113,9509113,,7,1,6,7
9509116,9509116,,19,0,1,1
9509120,9509120,,62,2,6,8
9509121,9509121,,8,0,11,11
9509122,9509122,,3,0,1,1
9509126,9509126,,8,0,11,11
9509128,9509128,,7,0,1,1
9509129,9509129,,11,1,3,4
9509134,9509134,,8,0,13,13
9509138,9509138,,19,0,2,2
9509154,9509154,,11,1,1,2
9504100,9504100,,7,1,0,1
9509164,9509164,,34,0,4,4
9503015,9503015,,34,2,0,2
9510010,9510010,,62,1,4,5
9510012,9510012,,16,0,9,9
9510015,9510015,,7,0,2,2
9510020,9510020,,25,0,6,6
9510024,9510024,,0,0,1,1
9510025,9510025,,62,0,2,2
9510031,9510031,,11,0,1,1
9510032,9510032,,62,0,1,1
9510040,9510040,,16,1,5,6
9510043,9510043,,16,0,3,3
9510048,9510048,,62,0,2,2
9510049,9510049,,62,0,2,2
9510058,9510058,,8,0,1,1
9510061,9510061,,8,1,14,15
9503128,9503128,,37,1,0,1
9510064,9510064,,16,1,7,8
9510057,9510057,,7,1,0,1
9510067,9510067,,0,4,9,13
9207014,9207014,,0,1,0,1
9510072,9510072,,8,1,13,14
9510075,9510075,,62,0,10,10
9406124,9406124,,62,1,0,1
9510076,9510076,,19,1,9,10
9510088,9510088,,54,0,5,5
9510102,9510102,,165,0,2,2
9308012,9308012,,165,2,0,2
9308063,9308063,,165,2,0,2
9510113,9510113,,34,0,2,2
9510118,9510118,,2,0,4,4
9510120,9510120,,25,0,3,3
9510122,9510122,,25,1,3,4
9510125,9510125,,14,0,3,3
9510126,9510126,,25,0,5,5
9510139,9510139,,16,2,6,8
9510146,9510146,,9,1,2,3
9510160,9510160,,7,1,1,2
9510163,9510163,,37,0,1,1
9510164,9510164,,54,0,3,3
9510172,9510172,,16,1,1,2
9510174,9510174,,62,2,2,4
9510176,9510176,,54,1,4,5
9512162,9512162,,2,1,0,1
9412056,9412056,,16,2,0,2
9510194,9510194,,16,1,10,11
9510198,9510198,,8,0,3,3
9510211,9510211,,7,1,3,4
9510212,9510212,,7,0,5,5
9510219,9510219,,19,1,1,2
9510230,9510230,,7,1,1,2
9510233,9510233,,54,1,26,27
9510236,9510236,,37,0,2,2
9507067,9507067,,19,1,0,1
9510238,9510238,,19,0,1,1
9511001,9511001,,6,0,2,2
9511003,9511003,,6,1,3,4
9511016,9511016,,54,1,6,7
9511017,9511017,,54,0,24,24
9511018,9511018,,7,1,7,8
9511019,9511019,,54,0,7,7
9511034,9511034,,16,1,1,2
9511036,9511036,,54,0,3,3
9511041,9511041,,11,2,4,6
9511044,9511044,,65,1,3,4
9511050,9511050,,8,0,9,9
9511074,9511074,,7,0,4,4
9511076,9511076,,16,0,4,4
9511083,9511083,,25,0,10,10
9511084,9511084,,8,0,1,1
9511086,9511086,,54,0,10,10
9511089,9511089,,65,0,2,2
9511114,9511114,,37,0,3,3
9511121,9511121,,19,0,1,1
9511123,9511123,,54,0,4,4
9511127,9511127,,25,0,8,8
9511132,9511132,,6,0,2,2
9509068,9509068,,6,2,0,2
9511137,9511137,,7,0,4,4
9511144,9511144,,7,0,2,2
9511146,9511146,,1,0,1,1
9511147,9511147,,25,1,5,6
9511149,9511149,,31,1,4,5
9511150,9511150,,117,0,1,1
9209069,9209069,,117,1,0,1
9511155,9511155,,7,0,1,1
9511161,9511161,,1,0,1,1
9511177,9511177,,11,0,4,4
9511181,9511181,,7,1,1,2
9511182,9511182,,8,1,1,2
9511183,9511183,,8,0,2,2
9511186,9511186,,8,0,11,11
9511199,9511199,,16,2,6,8
9511200,9511200,,8,0,4,4
9511214,9511214,,25,1,31,32
9511216,9511216,,62,0,1,1
9511225,9511225,,62,0,7,7
9512009,9512009,,16,0,17,17
9512014,9512014,,8,0,4,4
9512027,9512027,,8,1,1,2
9512035,9512035,,8,1,5,6
9512037,9512037,,16,0,1,1
9512039,9512039,,4,0,15,15
9512051,9512051,,19,2,2,4
9512055,9512055,,8,2,4,6
9512058,9512058,,6,2,2,4
9512063,9512063,,37,2,17,19
9512072,9512072,,19,0,1,1
9512087,9512087,,62,1,3,4
9512093,9512093,,62,0,1,1
9512111,9512111,,65,1,2,3
9512119,9512119,,62,0,6,6
9512122,9512122,,34,0,2,2
9504106,9504106,,34,1,0,1
9512132,9512132,,11,0,1,1
9509131,9509131,,11,2,0,2
9512133,9512133,,8,0,1,1
9512134,9512134,,1,0,3,3
9512136,9512136,,1,0,3,3
9512144,9512144,,11,0,2,2
9512146,9512146,,6,0,1,1
9512149,9512149,,37,0,16,16
9512160,9512160,,7,0,10,10
9512167,9512167,,8,0,2,2
9407156,9407156,,8,2,0,2
9512169,9512169,,2,0,7,7
9512176,9512176,,7,2,1,3
9512192,9512192,,54,0,10,10
9512194,9512194,,8,0,3,3
9512195,9512195,,54,0,2,2
9512198,9512198,,8,1,4,5
9512202,9512202,,19,0,3,3
9512206,9512206,,25,1,5,6
9512207,9512207,,2,0,10,10
9512213,9512213,,0,0,2,2
9512214,9512214,,8,0,6,6
9512221,9512221,,65,0,1,1
9601001,9601001,,8,0,3,3
9601005,9601005,,118,0,2,2
9601008,9601008,,119,0,1,1
9401142,9401142,,119,1,0,1
9601018,9601018,,19,0,5,5
9601021,9601021,,19,0,1,1
9601052,9601052,,19,3,5,8
9503090,9503090,,19,3,0,3
9601054,9601054,,16,3,4,7
9601061,9601061,,25,0,8,8
9601063,9601063,,8,0,2,2
9601066,9601066,,16,0,1,1
9601071,9601071,,16,1,2,3
9307067,9307067,,16,2,0,2
9512159,9512159,,16,2,0,2
9601074,9601074,,2,0,6,6
9601079,9601079,,65,0,9,9
9601084,9601084,,3,1,3,4
9410231,9410231,,3,2,0,2
9601101,9601101,,25,0,3,3
9601103,9601103,,134,2,1,3
9508051,9508051,,134,2,0,2
9601110,9601110,,8,0,5,5
9410089,9410089,,65,1,0,1
9601119,9601119,,7,0,3,3
9601121,9601121,,65,0,1,1
9601130,9601130,,2,0,7,7
9601142,9601142,,11,5,1,6
9411191,9411191,,11,1,0,1
9601145,9601145,,54,0,10,10
9601149,9601149,,120,0,1,1
9308096,9308096,,120,1,0,1
9202066,9202066,,1,1,0,1
9601178,9601178,,1,1,7,8
9503189,9503189,,1,1,0,1
9602028,9602028,,16,1,16,17
9602034,9602034,,11,0,3,3
9602039,9602039,,11,0,7,7
9602040,9602040,,8,0,1,1
9602041,9602041,,62,2,5,7
9410221,9410221,,62,4,0,4
9602056,9602056,,8,1,4,5
9602069,9602069,,16,1,8,9
9602076,9602076,,62,0,2,2
9602079,9602079,,25,0,9,9
9602090,9602090,,19,1,1,2
9602094,9602094,,7,3,12,15
9602095,9602095,,7,0,3,3
9602099,9602099,,8,0,8,8
9602100,9602100,,11,2,1,3
9602103,9602103,,25,1,12,13
9602116,9602116,,65,2,4,6
9602124,9602124,,25,0,7,7
9602125,9602125,,25,0,10,10
9602130,9602130,,6,4,1,5
9602131,9602131,,6,0,1,1
9602132,9602132,,54,0,13,13
9602133,9602133,,7,0,5,5
9602141,9602141,,16,1,9,10
9602142,9602142,,6,0,2,2
9602143,9602143,,6,0,2,2
9602150,9602150,,25,0,15,15
9602152,9602152,,6,0,5,5
9602153,9602153,,2,0,29,29
9602158,9602158,,7,0,1,1
9602164,9602164,,62,1,2,3
9603007,9603007,,11,0,5,5
9603008,9603008,,1,0,9,9
9603017,9603017,,25,0,21,21
9603018,9603018,,11,2,2,4
9603022,9603022,,99,0,1,1
9603027,9603027,,2,0,2,2
9603032,9603032,,7,0,1,1
9603038,9603038,,16,0,1,1
9603041,9603041,,11,3,2,5
9603046,9603046,,62,0,2,2
9603048,9603048,,37,1,1,2
9603050,9603050,,7,0,3,3
9603058,9603058,,25,0,1,1
9603059,9603059,,54,0,23,23
9603063,9603063,,9,0,2,2
9603066,9603066,,37,0,7,7
9603079,9603079,,2,0,1,1
9603085,9603085,,54,2,8,10
9603091,9603091,,121,0,1,1
9512164,9512164,,121,1,0,1
9603105,9603105,,62,1,3,4
9603110,9603110,,2,0,16,16
9603114,9603114,,62,1,2,3
9405097,9405097,,62,1,0,1
9603118,9603118,,2,0,20,20
9603120,9603120,,122,0,1,1
9510056,9510056,,122,1,0,1
9603121,9603121,,3,0,6,6
9603124,9603124,,11,1,1,2
9603130,9603130,,7,0,3,3
9603131,9603131,,37,1,6,7
9502055,9502055,,37,1,0,1
9603132,9603132,,7,0,2,2
9603137,9603137,,65,1,2,3
9603138,9603138,,62,2,6,8
9503110,9503110,,62,3,0,3
9401085,9401085,,7,1,0,1
9603144,9603144,,6,3,8,11
9603153,9603153,,6,0,2,2
9603171,9603171,,6,0,1,1
9410197,9410197,,16,2,0,2
9509150,9509150,,7,3,0,3
9603182,9603182,,1,1,8,9
9603184,9603184,,2,0,9,9
9603192,9603192,,6,0,1,1
9603196,9603196,,62,0,3,3
9603197,9603197,,8,0,1,1
9603198,9603198,,65,1,7,8
9509023,9509023,,8,3,0,3
9603201,9603201,,11,0,4,4
9604001,9604001,,37,1,2,3
9604010,9604010,,4,1,7,8
9604016,9604016,,62,0,14,14
9604020,9604020,,11,0,4,4
9408052,9408052,,25,1,0,1
9604049,9604049,,123,0,2,2
9408105,9408105,,123,1,0,1
9408145,9408145,,123,1,0,1
9604050,9604050,,0,0,2,2
9604060,9604060,,11,0,2,2
9604061,9604061,,6,3,11,14
9208060,9208060,,25,1,0,1
9604066,9604066,,65,0,3,3
9604067,9604067,,16,3,14,17
9604073,9604073,,16,0,17,17
9604079,9604079,,62,0,4,4
9604082,9604082,,19,0,1,1
9604086,9604086,,3,0,1,1
9604088,9604088,,6,0,9,9
9604092,9604092,,124,0,1,1
9603039,9603039,,124,1,0,1
9604093,9604093,,25,1,10,11
9604100,9604100,,62,3,1,4
9604101,9604101,,37,2,11,13
9604106,9604106,,25,0,1,1
9604107,9604107,,2,1,5,6
9604109,9604109,,7,0,4,4
9604110,9604110,,2,0,9,9
9604116,9604116,,1,0,4,4
9604137,9604137,,3,1,1,2
9306115,9306115,,3,2,0,2
9604145,9604145,,7,1,4,5
9604153,9604153,,62,4,2,6
9604160,9604160,,25,0,5,5
9604170,9604170,,25,2,5,7
9604172,9604172,,6,0,2,2
9604173,9604173,,34,0,2,2
9604174,9604174,,62,0,28,28
9604187,9604187,,7,0,2,2
9604188,9604188,,37,0,1,1
9604194,9604194,,25,0,2,2
9604201,9604201,,2,1,2,3
9605002,9605002,,16,0,7,7
9605010,9605010,,2,1,15,16
9605014,9605014,,7,0,1,1
9605015,9605015,,19,0,1,1
9605025,9605025,,25,0,3,3
9605029,9605029,,8,0,21,21
9605041,9605041,,62,1,2,3
9605052,9605052,,62,1,9,10
9605055,9605055,,7,2,4,6
9605057,9605057,,25,0,3,3
9605063,9605063,,25,0,6,6
9605064,9605064,,7,2,9,11
9605068,9605068,,16,0,2,2
9407170,9407170,,16,2,0,2
9507124,9507124,,16,1,0,1
9605070,9605070,,65,1,18,19
9605076,9605076,,7,0,2,2
9605078,9605078,,25,0,1,1
9605083,9605083,,7,0,9,9
9603070,9603070,,7,2,0,2
9605095,9605095,,16,0,5,5
9605098,9605098,,16,0,8,8
9605117,9605117,,2,0,14,14
9605122,9605122,,16,1,3,4
9605125,9605125,,62,0,1,1
9605130,9605130,,62,0,4,4
9605133,9605133,,7,1,5,6
9605138,9605138,,6,1,6,7
9605164,9605164,,34,0,9,9
9605165,9605165,,125,0,1,1
9602003,9602003,,125,2,0,2
9605177,9605177,,19,1,3,4
9605179,9605179,,7,0,3,3
9605185,9605185,,16,1,4,5
9605188,9605188,,111,3,2,5
9605189,9605189,,126,1,2,3
9604029,9604029,,126,2,0,2
9604036,9604036,,126,2,0,2
9605190,9605190,,127,0,1,1
9605132,9605132,,127,1,0,1
9605193,9605193,,62,0,9,9
9605196,9605196,,7,0,3,3
9605197,9605197,,11,1,7,8
9605198,9605198,,19,0,1,1
9507037,9507037,,19,2,0,2
9605202,9605202,,2,0,4,4
9605205,9605205,,62,0,2,2
9605210,9605210,,16,0,9,9
9605230,9605230,,126,0,3,3
9605235,9605235,,62,0,13,13
9412178,9412178,,62,1,0,1
9606005,9606005,,6,0,4,4
9606006,9606006,,8,0,3,3
9606010,9606010,,2,0,5,5
9606019,9606019,,7,1,3,4
9606021,9606021,,19,1,2,3
9606035,9606035,,2,0,11,11
9606038,9606038,,19,0,1,1
9606048,9606048,,9,0,3,3
9606057,9606057,,2,3,9,12
9606060,9606060,,25,1,5,6
9606065,9606065,,6,0,8,8
9606069,9606069,,0,0,9,9
9606070,9606070,,37,0,12,12
9606074,9606074,,6,0,2,2
9606075,9606075,,9,1,2,3
9404102,9404102,,9,2,0,2
9312020,9312020,,8,1,0,1
9606083,9606083,,16,0,6,6
9606085,9606085,,16,0,2,2
9606088,9606088,,62,1,5,6
9606094,9606094,,62,0,5,5
9606096,9606096,,37,0,13,13
9606103,9606103,,19,0,1,1
9606106,9606106,,25,4,6,10
9606110,9606110,,11,2,1,3
9606119,9606119,,31,0,11,11
9606123,9606123,,16,0,21,21
9606127,9606127,,6,0,1,1
9606128,9606128,,8,0,1,1
9606129,9606129,,16,3,7,10
9606140,9606140,,16,1,6,7
9606147,9606147,,2,1,7,8
9606151,9606151,,1,1,6,7
9606152,9606152,,25,2,24,26
9606158,9606158,,1,1,3,4
9606161,9606161,,54,0,10,10
9606170,9606170,,7,0,1,1
9606179,9606179,,2,0,3,3
9306084,9306084,,11,1,0,1
9606197,9606197,,19,1,2,3
9606198,9606198,,25,1,3,4
9607006,9607006,,11,0,7,7
9607008,9607008,,7,1,5,6
9607012,9607012,,62,0,1,1
9607016,9607016,,65,0,4,4
9607018,9607018,,65,0,4,4
9607028,9607028,,2,1,1,2
9607031,9607031,,62,0,4,4
9607035,9607035,,7,2,4,6
9607042,9607042,,11,0,1,1
9607047,9607047,,7,1,6,7
9607055,9607055,,65,1,5,6
9607059,9607059,,25,0,2,2
9607068,9607068,,7,0,1,1
9607069,9607069,,3,1,5,6
9607072,9607072,,16,1,11,12
9607075,9607075,,128,0,1,1
9411239,9411239,,128,2,0,2
9607079,9607079,,6,1,4,5
9607080,9607080,,62,2,1,3
9607084,9607084,,1,1,6,7
9607097,9607097,,34,0,2,2
9607098,9607098,,34,0,2,2
9607100,9607100,,19,0,2,2
9307193,9307193,,19,1,0,1
9607111,9607111,,2,2,1,3
9607130,9607130,,16,0,1,1
9607136,9607136,,16,1,9,10
9607142,9607142,,62,0,3,3
9607162,9607162,,62,1,3,4
9410077,9410077,,62,1,0,1
9607166,9607166,,25,0,2,2
9607169,9607169,,37,0,9,9
9607178,9607178,,25,0,3,3
9607179,9607179,,2,0,1,1
9607180,9607180,,2,0,10,10
9607191,9607191,,6,0,2,2
9607225,9607225,,1,0,9,9
9212142,9212142,,1,1,0,1
9607228,9607228,,16,0,5,5
9607237,9607237,,3,1,6,7
9607241,9607241,,7,0,1,1
9607242,9607242,,7,5,1,6
9608001,9608001,,16,0,1,1
9608002,9608002,,62,0,4,4
9608004,9608004,,1,1,3,4
9608007,9608007,,25,2,1,3
9608032,9608032,,2,0,2,2
9608036,9608036,,62,0,6,6
9608044,9608044,,2,0,22,22
9608049,9608049,,25,1,9,10
9608051,9608051,,11,0,1,1
9608052,9608052,,6,0,1,1
9608062,9608062,,16,0,7,7
9608065,9608065,,8,1,8,9
9608067,9608067,,25,0,1,1
9608069,9608069,,19,0,4,4
9608073,9608073,,8,0,6,6
9608075,9608075,,54,2,6,8
9608080,9608080,,129,0,1,1
9412068,9412068,,129,1,0,1
9608081,9608081,,130,0,1,1
9512088,9512088,,130,1,0,1
9608087,9608087,,11,0,2,2
9608098,9608098,,54,0,2,2
9608100,9608100,,6,2,2,4
9608112,9608112,,37,0,3,3
9608114,9608114,,37,0,13,13
9608115,9608115,,125,0,1,1
9608119,9608119,,6,1,1,2
9608120,9608120,,131,1,1,2
9507039,9507039,,131,2,0,2
9608123,9608123,,16,1,3,4
9608132,9608132,,16,0,8,8
9608133,9608133,,6,0,7,7
9608141,9608141,,25,1,1,2
9608146,9608146,,132,0,1,1
9408126,9408126,,132,1,0,1
9608149,9608149,,6,0,1,1
9608152,9608152,,16,2,4,6
9608158,9608158,,4,0,2,2
9608164,9608164,,2,0,1,1
9608165,9608165,,19,1,3,4
9608166,9608166,,62,1,2,3
9608168,9608168,,3,2,10,12
9608170,9608170,,25,0,5,5
9608184,9608184,,54,0,5,5
9609007,9609007,,16,0,12,12
9609009,9609009,,16,1,1,2
9609011,9609011,,11,0,4,4
9609012,9609012,,7,1,1,2
9609015,9609015,,54,0,13,13
9312028,9312028,,7,2,0,2
9312029,9312029,,7,2,0,2
9609036,9609036,,37,2,1,3
9609044,9609044,,62,1,1,2
9607053,9607053,,62,1,0,1
9609054,9609054,,0,1,5,6
9609058,9609058,,34,0,1,1
9609060,9609060,,54,1,3,4
9609067,9609067,,16,0,5,5
9609072,9609072,,34,0,1,1
9609078,9609078,,2,0,13,13
9609088,9609088,,19,0,2,2
9609091,9609091,,7,0,4,4
9609093,9609093,,16,0,2,2
9205112,9205112,,16,1,0,1
9609096,9609096,,19,0,1,1
9602042,9602042,,19,4,0,4
9609097,9609097,,19,1,4,5
9609098,9609098,,19,0,7,7
9609106,9609106,,8,0,2,2
9609110,9609110,,140,2,1,3
9601100,9601100,,140,2,0,2
9609120,9609120,,8,2,1,3
9609129,9609129,,9,0,1,1
9609134,9609134,,62,1,4,5
9605040,9605040,,62,3,0,3
9609144,9609144,,19,0,10,10
9609156,9609156,,37,0,1,1
9609158,9609158,,0,0,4,4
9609163,9609163,,54,1,9,10
9609164,9609164,,62,0,3,3
9609165,9609165,,62,0,8,8
9604046,9604046,,62,1,0,1
9609170,9609170,,11,2,3,5
9408072,9408072,,16,2,0,2
9609179,9609179,,37,0,7,7
9608016,9608016,,37,1,0,1
9609182,9609182,,8,2,10,12
9609184,9609184,,1,1,3,4
9609186,9609186,,6,1,3,4
9609187,9609187,,25,0,1,1
9609189,9609189,,11,0,2,2
9609121,9609121,,11,1,0,1
9609199,9609199,,7,0,2,2
9609200,9609200,,14,0,1,1
9609215,9609215,,54,0,6,6
9609227,9609227,,7,0,4,4
9609237,9609237,,16,0,14,14
9610004,9610004,,7,0,3,3
9610010,9610010,,133,0,1,1
9607150,9607150,,133,1,0,1
9610015,9610015,,62,0,3,3
9610033,9610033,,7,0,1,1
9610042,9610042,,54,0,18,18
9412193,9412193,,16,2,0,2
9412240,9412240,,16,1,0,1
9610047,9610047,,0,0,4,4
9610063,9610063,,1,0,14,14
9610072,9610072,,3,0,2,2
9610073,9610073,,3,0,1,1
9610075,9610075,,25,0,3,3
9610078,9610078,,7,0,7,7
9610083,9610083,,6,0,8,8
9610085,9610085,,54,0,33,33
9610086,9610086,,25,1,11,12
9610088,9610088,,25,1,6,7
9610093,9610093,,3,0,6,6
9610096,9610096,,16,1,2,3
9607133,9607133,,16,2,0,2
9610097,9610097,,7,1,5,6
9610110,9610110,,2,0,7,7
9203011,9203011,,3,1,0,1
9610115,9610115,,134,0,1,1
9610116,9610116,,134,0,2,2
9610119,9610119,,54,0,22,22
9610127,9610127,,11,0,3,3
9412049,9412049,,11,1,0,1
9610130,9610130,,8,0,2,2
9610133,9610133,,25,0,4,4
9610135,9610135,,34,1,1,2
9610137,9610137,,37,0,5,5
9610146,9610146,,11,0,3,3
9610147,9610147,,16,1,3,4
9610158,9610158,,34,0,3,3
9610159,9610159,,2,0,9,9
9610161,9610161,,62,0,2,2
9610164,9610164,,7,2,4,6
9309073,9309073,,54,1,0,1
9610174,9610174,,54,0,15,15
9610181,9610181,,2,0,13,13
9610184,9610184,,135,0,1,1
9601032,9601032,,135,1,0,1
9610185,9610185,,8,0,2,2
9610186,9610186,,2,0,9,9
9610188,9610188,,62,0,2,2
9508171,9508171,,8,2,0,2
9610203,9610203,,136,0,1,1
9209026,9209026,,136,1,0,1
9610206,9610206,,16,0,8,8
9309158,9309158,,2,1,0,1
9610210,9610210,,7,0,1,1
9610212,9610212,,1,0,4,4
9610217,9610217,,62,0,1,1
9610218,9610218,,62,0,2,2
9610228,9610228,,0,0,1,1
9610231,9610231,,2,1,2,3
9610233,9610233,,37,0,1,1
9610235,9610235,,54,0,10,10
9604122,9604122,,54,1,0,1
9611009,9611009,,8,1,3,4
9611018,9611018,,8,0,21,21
9304049,9304049,,8,1,0,1
9611021,9611021,,6,1,1,2
9509144,9509144,,6,2,0,2
9611028,9611028,,25,0,7,7
9611032,9611032,,34,0,2,2
9611035,9611035,,54,0,4,4
9611037,9611037,,6,0,1,1
9611044,9611044,,8,0,12,12
9611048,9611048,,11,0,1,1
9611057,9611057,,1,0,6,6
9611059,9611059,,16,0,2,2
9611069,9611069,,7,0,5,5
9611073,9611073,,16,1,1,2
9611076,9611076,,2,0,15,15
9611080,9611080,,3,1,3,4
9611085,9611085,,6,0,1,1
9611089,9611089,,25,0,2,2
9611091,9611091,,0,0,4,4
9611093,9611093,,54,0,16,16
9611098,9611098,,0,1,5,6
9611109,9611109,,11,0,2,2
9611121,9611121,,25,0,6,6
9611128,9611128,,11,0,2,2
9611130,9611130,,54,3,14,17
9611131,9611131,,65,0,2,2
9611135,9611135,,2,0,5,5
9512114,9512114,,19,1,0,1
9611139,9611139,,37,0,1,1
9611141,9611141,,6,0,3,3
9611144,9611144,,7,0,3,3
9611148,9611148,,62,2,7,9
9611153,9611153,,19,0,3,3
9611154,9611154,,6,2,3,5
9611156,9611156,,11,2,1,3
9611168,9611168,,6,0,3,3
9611177,9611177,,37,1,2,3
9611178,9611178,,25,2,8,10
9611191,9611191,,16,0,12,12
9504103,9504103,,16,1,0,1
9611192,9611192,,37,0,1,1
9611206,9611206,,25,0,1,1
9611217,9611217,,11,0,1,1
9611218,9611218,,2,0,16,16
9611220,9611220,,2,0,4,4
9611221,9611221,,2,0,5,5
9611226,9611226,,7,0,1,1
9611231,9611231,,65,1,5,6
9611234,9611234,,37,0,2,2
9610169,9610169,,37,1,0,1
9611235,9611235,,16,0,20,20
9612001,9612001,,19,0,1,1
9612003,9612003,,8,0,7,7
9612016,9612016,,62,0,5,5
9612020,9612020,,14,0,1,1
9612023,9612023,,2,0,2,2
9612024,9612024,,2,0,2,2
9604033,9604033,,2,1,0,1
9612026,9612026,,16,1,2,3
9612042,9612042,,6,3,12,15
9612043,9612043,,8,1,8,9
9612044,9612044,,8,0,3,3
9612047,9612047,,11,0,3,3
9612050,9612050,,16,0,1,1
9612056,9612056,,2,1,11,12
9612057,9612057,,37,0,4,4
9612067,9612067,,54,1,15,16
9612071,9612071,,8,0,11,11
9612072,9612072,,19,0,1,1
9612075,9612075,,54,0,5,5
9612079,9612079,,19,3,5,8
9507130,9507130,,19,4,0,4
9507131,9507131,,19,4,0,4
9612092,9612092,,7,1,5,6
9612094,9612094,,37,0,3,3
9612098,9612098,,8,0,8,8
9612106,9612106,,11,0,1,1
9510046,9510046,,11,2,0,2
9612123,9612123,,2,1,3,4
9612132,9612132,,19,0,5,5
9612136,9612136,,25,0,1,1
9509030,9509030,,7,1,0,1
9612147,9612147,,34,1,2,3
9612151,9612151,,1,0,1,1
9612152,9612152,,16,0,15,15
9612158,9612158,,11,1,12,13
9612165,9612165,,9,3,4,7
9612166,9612166,,16,0,1,1
9612167,9612167,,2,0,17,17
9612169,9612169,,19,0,6,6
9402087,9402087,,19,1,0,1
9407120,9407120,,19,1,0,1
9612177,9612177,,16,0,1,1
9612179,9612179,,2,0,8,8
9612184,9612184,,37,0,1,1
9612185,9612185,,7,0,2,2
9612189,9612189,,7,0,2,2
9612190,9612190,,19,0,14,14
9407153,9407153,,2,2,0,2
9612209,9612209,,16,0,5,5
9608159,9608159,,19,3,0,3
9612230,9612230,,37,0,2,2
9612232,9612232,,2,0,7,7
9612235,9612235,,62,2,7,9
9612239,9612239,,54,1,25,26
9612243,9612243,,54,1,3,4
9612244,9612244,,19,1,6,7
9612245,9612245,,62,0,6,6
9612247,9612247,,7,0,2,2
9612253,9612253,,7,0,4,4
9701001,9701001,,62,0,2,2
9701002,9701002,,19,0,5,5
9701006,9701006,,16,0,7,7
9701016,9701016,,62,0,4,4
9701036,9701036,,16,0,3,3
9701056,9701056,,19,0,7,7
9701059,9701059,,2,0,3,3
9701066,9701066,,62,0,2,2
9701068,9701068,,11,0,1,1
9701070,9701070,,6,0,1,1
9701071,9701071,,65,0,3,3
9701074,9701074,,11,1,5,6
9607192,9607192,,19,2,0,2
9701090,9701090,,137,0,2,2
9405191,9405191,,137,1,0,1
9701044,9701044,,137,1,0,1
9701094,9701094,,54,2,23,25
9701098,9701098,,19,0,2,2
9701108,9701108,,7,1,4,5
9412148,9412148,,7,1,0,1
9510019,9510019,,37,2,0,2
9701114,9701114,,7,0,4,4
9701121,9701121,,34,0,27,27
9206022,9206022,,34,1,0,1
9701126,9701126,,2,0,5,5
9701132,9701132,,19,1,10,11
9701133,9701133,,62,0,3,3
9701135,9701135,,7,0,1,1
9701145,9701145,,16,0,3,3
9701153,9701153,,2,0,14,14
9701161,9701161,,25,0,12,12
9701174,9701174,,62,0,8,8
9701176,9701176,,25,0,3,3
9701181,9701181,,25,0,2,2
9607189,9607189,,25,5,0,5
9701183,9701183,,6,0,6,6
9701189,9701189,,7,0,1,1
9701192,9701192,,7,0,1,1
9701193,9701193,,138,0,1,1
9503219,9503219,,138,1,0,1
9702001,9702001,,7,0,2,2
9702004,9702004,,7,0,1,1
9702011,9702011,,54,0,2,2
9702013,9702013,,62,0,3,3
9702016,9702016,,62,1,1,2
9702020,9702020,,7,0,4,4
9702022,9702022,,11,1,1,2
9702028,9702028,,62,1,4,5
9702032,9702032,,19,0,3,3
9702040,9702040,,62,0,3,3
9702051,9702051,,8,0,13,13
9702063,9702063,,37,0,3,3
9702070,9702070,,1,0,3,3
9702071,9702071,,139,0,1,1
9410131,9410131,,139,1,0,1
9702074,9702074,,8,1,12,13
9702078,9702078,,1,0,7,7
9702080,9702080,,7,0,5,5
9506209,9506209,,16,1,0,1
9702090,9702090,,62,0,6,6
9702091,9702091,,16,0,4,4
9702112,9702112,,16,0,6,6
9702116,9702116,,37,0,2,2
9702124,9702124,,19,0,1,1
9612206,9612206,,11,4,0,4
9702127,9702127,,7,1,16,17
9702128,9702128,,19,0,2,2
9702129,9702129,,16,0,2,2
9702131,9702131,,7,0,1,1
9702132,9702132,,1,0,10,10
9702137,9702137,,94,2,1,3
9702140,9702140,,16,0,2,2
9702142,9702142,,2,3,14,17
9702146,9702146,,11,0,1,1
9702149,9702149,,11,0,5,5
9702150,9702150,,25,1,2,3
9702158,9702158,,2,0,7,7
9702159,9702159,,2,1,24,25
9702181,9702181,,16,1,4,5
9702183,9702183,,8,0,6,6
9402058,9402058,,8,1,0,1
9702185,9702185,,1,0,3,3
9702193,9702193,,6,0,7,7
9703004,9703004,,2,0,10,10
9703011,9703011,,19,0,1,1
9703015,9703015,,25,1,2,3
9703021,9703021,,1,0,6,6
9703032,9703032,,54,0,1,1
9703033,9703033,,65,0,2,2
9703034,9703034,,19,0,1,1
9703043,9703043,,3,1,12,13
9703047,9703047,,2,0,14,14
9703054,9703054,,6,0,19,19
9703058,9703058,,37,0,2,2
9703061,9703061,,131,0,2,2
9703064,9703064,,31,0,4,4
9703065,9703065,,62,2,12,14
9703088,9703088,,25,0,4,4
9703091,9703091,,1,0,8,8
9703095,9703095,,37,0,15,15
9703108,9703108,,16,0,15,15
9703113,9703113,,54,0,1,1
9703116,9703116,,19,0,4,4
9703117,9703117,,65,0,4,4
9703119,9703119,,37,0,10,10
9703120,9703120,,16,0,3,3
9703138,9703138,,2,2,23,25
9703140,9703140,,62,0,5,5
9703151,9703151,,7,0,8,8
9703153,9703153,,16,0,9,9
9703155,9703155,,2,1,3,4
9703161,9703161,,37,0,2,2
9703169,9703169,,111,0,3,3
9703170,9703170,,8,0,15,15
9703199,9703199,,6,0,12,12
9703203,9703203,,8,0,1,1
9703207,9703207,,62,0,4,4
9703212,9703212,,62,0,1,1
9703220,9703220,,6,0,3,3
9703225,9703225,,7,0,5,5
9703227,9703227,,37,1,7,8
9704001,9704001,,25,0,3,3
9603119,9603119,,25,1,0,1
9604081,9604081,,25,1,0,1
9704004,9704004,,37,0,4,4
9704007,9704007,,2,0,15,15
9704015,9704015,,62,0,10,10
9704020,9704020,,16,0,5,5
9704024,9704024,,62,0,12,12
9704031,9704031,,3,0,17,17
9704033,9704033,,2,2,1,3
9704038,9704038,,9,0,2,2
9704048,9704048,,13,0,1,1
9704060,9704060,,7,0,1,1
9704062,9704062,,37,1,1,2
9704066,9704066,,37,0,9,9
9704077,9704077,,2,0,13,13
9704091,9704091,,19,0,7,7
9704099,9704099,,19,0,1,1
9410236,9410236,,19,4,0,4
9704100,9704100,,7,1,5,6
9704105,9704105,,9,2,1,3
9704107,9704107,,62,0,5,5
9704121,9704121,,7,0,2,2
9704122,9704122,,8,0,1,1
9704126,9704126,,62,0,13,13
9704130,9704130,,62,1,10,11
9704138,9704138,,16,1,1,2
9704141,9704141,,4,2,7,9
9704152,9704152,,62,1,5,6
9704180,9704180,,2,1,2,3
9704181,9704181,,7,1,2,3
9704182,9704182,,7,1,7,8
9704183,9704183,,8,0,6,6
9412134,9412134,,8,1,0,1
9704187,9704187,,37,0,6,6
9511215,9511215,,37,1,0,1
9704196,9704196,,37,1,9,10
9704200,9704200,,3,0,1,1
9704211,9704211,,16,2,7,9
9704215,9704215,,16,9,9,18
9609100,9609100,,1,1,0,1
9705012,9705012,,54,0,14,14
9601015,9601015,,65,1,0,1
9705026,9705026,,16,0,5,5
9705039,9705039,,65,0,2,2
9705045,9705045,,16,2,11,13
9705051,9705051,,54,0,2,2
9705066,9705066,,2,0,7,7
9705067,9705067,,2,0,15,15
9705071,9705071,,37,0,27,27
9705072,9705072,,16,3,3,6
9705082,9705082,,7,0,2,2
9705083,9705083,,1,0,1,1
9705086,9705086,,7,0,2,2
9705109,9705109,,2,0,6,6
9705114,9705114,,37,0,15,15
9705115,9705115,,2,0,6,6
9705119,9705119,,11,0,6,6
9607023,9607023,,11,2,0,2
9705121,9705121,,37,0,3,3
9705125,9705125,,7,0,1,1
9705133,9705133,,16,1,1,2
9705134,9705134,,25,0,4,4
9705135,9705135,,25,1,2,3
9705140,9705140,,62,1,3,4
9705143,9705143,,54,0,22,22
9705164,9705164,,37,1,16,17
9705168,9705168,,19,2,2,4
9705170,9705170,,2,1,13,14
9705171,9705171,,7,2,1,3
9705177,9705177,,11,0,1,1
9705178,9705178,,140,1,2,3
9705191,9705191,,6,1,1,2
9705195,9705195,,3,1,4,5
9705196,9705196,,19,1,3,4
9705203,9705203,,6,0,11,11
9705204,9705204,,3,0,4,4
9705207,9705207,,25,1,2,3
9705217,9705217,,19,0,7,7
9705227,9705227,,7,0,4,4
9705228,9705228,,6,1,7,8
9705238,9705238,,54,0,26,26
9706003,9706003,,141,0,1,1
9609081,9609081,,141,1,0,1
9706008,9706008,,34,0,1,1
9706011,9706011,,25,0,5,5
9706034,9706034,,16,0,2,2
9706028,9706028,,54,1,0,1
9706037,9706037,,16,0,2,2
9706052,9706052,,16,1,1,2
9706055,9706055,,16,0,5,5
9706058,9706058,,54,1,3,4
9706063,9706063,,16,0,11,11
9706067,9706067,,7,0,5,5
9706080,9706080,,25,2,5,7
9706106,9706106,,6,0,1,1
9706111,9706111,,2,0,9,9
9706113,9706113,,62,1,2,3
9706116,9706116,,1,0,5,5
9706118,9706118,,7,0,4,4
9706122,9706122,,2,0,5,5
9706128,9706128,,4,2,7,9
9706134,9706134,,16,0,8,8
9706135,9706135,,16,0,4,4
9706136,9706136,,6,0,5,5
9706137,9706137,,6,0,2,2
9706138,9706138,,2,0,3,3
9706146,9706146,,2,1,8,9
9706149,9706149,,16,1,1,2
9706160,9706160,,6,0,2,2
9706161,9706161,,62,0,8,8
9706162,9706162,,9,1,1,2
9706164,9706164,,7,0,5,5
9706178,9706178,,16,1,4,5
9411174,9411174,,16,1,0,1
9706183,9706183,,16,0,23,23
9706191,9706191,,25,0,13,13
9706202,9706202,,6,0,3,3
9704085,9704085,,6,1,0,1
9704140,9704140,,6,1,0,1
9706209,9706209,,142,0,1,1
9705235,9705235,,142,1,0,1
9706222,9706222,,37,1,6,7
9706224,9706224,,2,0,9,9
9707006,9707006,,2,0,4,4
9707010,9707010,,62,0,2,2
9707022,9707022,,37,1,50,51
9707026,9707026,,19,0,3,3
9707032,9707032,,2,0,8,8
9707036,9707036,,37,0,9,9
9707037,9707037,,11,0,7,7
9206062,9206062,,11,1,0,1
9707038,9707038,,11,0,3,3
9707050,9707050,,62,0,6,6
9707065,9707065,,62,0,7,7
9707076,9707076,,37,3,39,42
9707078,9707078,,19,0,13,13
9707089,9707089,,54,0,29,29
9707103,9707103,,14,0,2,2
9707104,9707104,,16,0,3,3
9707107,9707107,,8,2,1,3
9707114,9707114,,16,0,2,2
9707116,9707116,,11,0,2,2
9707127,9707127,,8,1,3,4
9707132,9707132,,2,1,24,25
9707138,9707138,,25,0,2,2
9707145,9707145,,37,0,3,3
9707146,9707146,,2,1,17,18
9707151,9707151,,62,0,5,5
9707152,9707152,,16,0,2,2
9707161,9707161,,9,1,3,4
9707055,9707055,,7,1,0,1
9707172,9707172,,7,0,7,7
9707173,9707173,,8,1,7,8
9707177,9707177,,19,2,2,4
9707191,9707191,,6,0,13,13
9707193,9707193,,6,0,2,2
9707195,9707195,,2,1,18,19
9707196,9707196,,65,0,1,1
9707206,9707206,,25,0,4,4
9707213,9707213,,37,0,3,3
9707216,9707216,,7,0,7,7
9707238,9707238,,6,0,1,1
9707240,9707240,,8,0,25,25
9707252,9707252,,7,0,9,9
9707255,9707255,,8,0,4,4
9707256,9707256,,8,1,10,11
9708013,9708013,,2,1,7,8
9708014,9708014,,2,2,6,8
9708018,9708018,,34,0,1,1
9708024,9708024,,1,0,6,6
9708026,9708026,,8,0,8,8
9708028,9708028,,143,0,1,1
9501133,9501133,,143,1,0,1
9708038,9708038,,6,0,6,6
9708043,9708043,,144,0,1,1
9310195,9310195,,144,1,0,1
9708050,9708050,,65,0,8,8
9708057,9708057,,8,0,2,2
9708058,9708058,,62,1,1,2
9708059,9708059,,62,0,1,1
9708066,9708066,,7,3,3,6
9708070,9708070,,2,0,8,8
9708071,9708071,,3,0,6,6
9708079,9708079,,11,0,6,6
9708084,9708084,,4,0,5,5
9708088,9708088,,65,0,2,2
9706215,9706215,,65,1,0,1
9708092,9708092,,7,1,3,4
9708095,9708095,,62,4,2,6
9708096,9708096,,7,2,2,4
9708105,9708105,,2,0,12,12
9708107,9708107,,62,0,3,3
9708111,9708111,,11,0,6,6
9708125,9708125,,6,2,2,4
9708128,9708128,,25,0,5,5
9708132,9708132,,62,0,2,2
9708133,9708133,,25,1,7,8
9708142,9708142,,2,0,11,11
9708143,9708143,,37,0,6,6
9708144,9708144,,6,1,2,3
9708151,9708151,,34,0,1,1
9708156,9708156,,145,0,1,1
9508069,9508069,,145,1,0,1
9708158,9708158,,25,0,7,7
9708161,9708161,,2,0,2,2
9708162,9708162,,2,1,4,5
9410122,9410122,,2,2,0,2
9708167,9708167,,8,0,8,8
9708169,9708169,,2,1,23,24
9709008,9709008,,34,0,10,10
9709016,9709016,,62,1,5,6
9709018,9709018,,9,0,3,3
9709026,9709026,,37,0,2,2
9709031,9709031,,11,2,6,8
9709041,9709041,,25,0,1,1
9709045,9709045,,34,0,6,6
9709046,9709046,,128,0,1,1
9709052,9709052,,6,0,3,3
9709056,9709056,,54,0,5,5
9709057,9709057,,19,1,2,3
9709073,9709073,,37,0,6,6
9709075,9709075,,7,2,5,7
9709076,9709076,,65,0,8,8
9211069,9211069,,65,1,0,1
9709083,9709083,,2,1,3,4
9709085,9709085,,6,0,6,6
9709086,9709086,,19,0,3,3
9709095,9709095,,19,0,2,2
9611225,9611225,,2,1,0,1
9709112,9709112,,146,1,1,2
9709051,9709051,,146,2,0,2
9709117,9709117,,7,0,1,1
9709120,9709120,,19,0,9,9
9709121,9709121,,19,0,11,11
9709124,9709124,,2,0,14,14
9709125,9709125,,6,1,1,2
9709126,9709126,,4,1,8,9
9709128,9709128,,25,0,1,1
9709136,9709136,,62,0,2,2
9709140,9709140,,11,2,1,3
9709153,9709153,,11,0,2,2
9709156,9709156,,9,0,1,1
9709164,9709164,,4,0,4,4
9709168,9709168,,62,0,3,3
9709169,9709169,,25,0,14,14
9709170,9709170,,16,0,1,1
9709172,9709172,,2,0,99,99
9709176,9709176,,7,0,6,6
9709179,9709179,,62,0,1,1
9709183,9709183,,8,0,4,4
9709185,9709185,,11,0,4,4
9709190,9709190,,2,0,9,9
9709191,9709191,,2,0,7,7
9709197,9709197,,62,0,1,1
9709204,9709204,,62,0,3,3
9706147,9706147,,62,1,0,1
9709215,9709215,,4,0,17,17
9709218,9709218,,37,0,2,2
9709223,9709223,,11,0,1,1
9710003,9710003,,16,2,2,4
9710008,9710008,,2,0,4,4
9612124,9612124,,2,2,0,2
9710012,9710012,,11,0,1,1
9710013,9710013,,37,1,19,20
9406006,9406006,,37,1,0,1
9611010,9611010,,37,1,0,1
9710017,9710017,,62,0,1,1
9710043,9710043,,16,0,4,4
9710044,9710044,,16,0,7,7
9710045,9710045,,62,0,4,4
9710055,9710055,,11,0,2,2
9505031,9505031,,11,3,0,3
9710056,9710056,,19,0,1,1
9710052,9710052,,2,1,0,1
9710059,9710059,,2,0,14,14
9710081,9710081,,3,0,1,1
9710083,9710083,,147,0,1,1
9703093,9703093,,147,1,0,1
9710089,9710089,,54,1,1,2
9510110,9510110,,54,1,0,1
9608029,9608029,,11,1,0,1
9710094,9710094,,62,3,4,7
9710106,9710106,,62,0,4,4
9710111,9710111,,7,0,2,2
9710113,9710113,,19,0,2,2
9710115,9710115,,7,0,1,1
9710117,9710117,,148,0,1,1
9704103,9704103,,148,1,0,1
9710118,9710118,,62,0,10,10
9710143,9710143,,111,0,3,3
9710154,9710154,,3,0,9,9
9710156,9710156,,62,0,2,2
9710160,9710160,,37,0,29,29
9710164,9710164,,11,1,1,2
9709070,9709070,,11,2,0,2
9710170,9710170,,8,0,4,4
9710173,9710173,,9,0,3,3
9710177,9710177,,37,1,17,18
9710182,9710182,,37,0,1,1
9710184,9710184,,8,0,3,3
9710193,9710193,,19,1,10,11
9710194,9710194,,11,1,4,5
9710195,9710195,,8,0,2,2
9710200,9710200,,7,0,6,6
9710201,9710201,,2,0,3,3
9710202,9710202,,94,0,2,2
9710211,9710211,,0,0,1,1
9710216,9710216,,7,0,4,4
9710224,9710224,,6,0,7,7
9710228,9710228,,2,2,21,23
9710235,9710235,,11,5,2,7
9710238,9710238,,25,0,4,4
9711018,9711018,,2,1,7,8
9711019,9711019,,16,2,21,23
9711050,9711050,,6,1,1,2
9711060,9711060,,0,0,1,1
9711062,9711062,,7,0,12,12
9711066,9711066,,2,0,1,1
9711075,9711075,,16,1,4,5
9711079,9711079,,11,0,3,3
9711101,9711101,,16,1,6,7
9711114,9711114,,2,0,18,18
9711118,9711118,,7,0,1,1
9711119,9711119,,7,0,1,1
9711123,9711123,,19,1,6,7
9711125,9711125,,54,1,12,13
9711141,9711141,,37,0,3,3
9711142,9711142,,6,1,11,12
9711148,9711148,,62,0,28,28
9505179,9505179,,62,1,0,1
9711149,9711149,,37,0,5,5
9711152,9711152,,19,0,3,3
9711154,9711154,,34,1,1,2
9711164,9711164,,25,1,3,4
9711176,9711176,,94,0,1,1
9711180,9711180,,6,0,3,3
9711192,9711192,,54,0,8,8
9711195,9711195,,19,1,1,2
9701130,9701130,,37,1,0,1
9711204,9711204,,7,0,7,7
9712001,9712001,,25,0,3,3
9712002,9712002,,2,0,3,3
9712003,9712003,,11,0,6,6
9712014,9712014,,6,0,4,4
9712016,9712016,,19,1,2,3
9712027,9712027,,37,0,3,3
9712037,9712037,,19,0,3,3
9712044,9712044,,16,0,4,4
9712052,9712052,,0,0,2,2
9712060,9712060,,25,0,10,10
9712069,9712069,,7,0,4,4
9712076,9712076,,19,0,15,15
9712093,9712093,,11,0,2,2
9712098,9712098,,11,0,2,2
9712101,9712101,,2,1,0,1
9712107,9712107,,8,0,12,12
9712113,9712113,,7,0,1,1
9712114,9712114,,8,0,3,3
9712136,9712136,,2,0,13,13
9712138,9712138,,6,0,3,3
9712142,9712142,,2,0,24,24
9712151,9712151,,8,0,15,15
9712152,9712152,,37,0,13,13
9712153,9712153,,149,0,1,1
9610071,9610071,,149,1,0,1
9712154,9712154,,8,0,3,3
9601106,9601106,,65,1,0,1
9703037,9703037,,65,1,0,1
9706045,9706045,,65,1,0,1
9712175,9712175,,2,0,4,4
9712184,9712184,,37,0,33,33
9712190,9712190,,37,0,3,3
9712192,9712192,,37,0,3,3
9712196,9712196,,2,0,19,19
9712204,9712204,,6,1,11,12
9712207,9712207,,1,0,4,4
9712208,9712208,,25,1,3,4
9712217,9712217,,146,0,2,2
9712224,9712224,,2,1,12,13
9712227,9712227,,62,0,8,8
9712228,9712228,,11,0,2,2
9712233,9712233,,54,1,24,25
9712234,9712234,,6,0,3,3
9712237,9712237,,15,0,1,1
9712255,9712255,,7,0,3,3
9801005,9801005,,19,2,6,8
9709212,9709212,,19,3,0,3
9801012,9801012,,19,0,5,5
9801013,9801013,,2,0,3,3
9801015,9801015,,2,1,6,7
9801025,9801025,,25,0,4,4
9801028,9801028,,7,0,1,1
9801050,9801050,,11,0,4,4
9801055,9801055,,11,0,5,5
9801059,9801059,,19,0,3,3
9801063,9801063,,34,1,5,6
9801068,9801068,,25,0,1,1
9801069,9801069,,9,0,2,2
9801071,9801071,,2,0,11,11
9801074,9801074,,2,0,22,22
9801086,9801086,,19,0,4,4
9801089,9801089,,62,0,6,6
9801095,9801095,,2,0,40,40
9801098,9801098,,16,0,1,1
9801103,9801103,,11,0,1,1
9801109,9801109,,2,0,25,25
9801111,9801111,,54,0,10,10
9801113,9801113,,2,0,12,12
9801116,9801116,,2,0,35,35
9801136,9801136,,16,0,2,2
9801138,9801138,,2,1,8,9
9801150,9801150,,16,0,2,2
9801154,9801154,,2,1,12,13
9801156,9801156,,37,1,12,13
9801164,9801164,,3,1,5,6
9801177,9801177,,2,0,2,2
9801178,9801178,,2,1,1,2
9801198,9801198,,3,0,2,2
9802002,9802002,,37,0,4,4
9802006,9802006,,16,0,3,3
9501104,9501104,,16,1,0,1
9802008,9802008,,19,1,5,6
9802017,9802017,,37,3,15,18
9802021,9802021,,3,0,1,1
9802028,9802028,,25,0,3,3
9802031,9802031,,11,0,4,4
9802034,9802034,,2,1,7,8
9802035,9802035,,16,0,1,1
9802048,9802048,,16,0,13,13
9802053,9802053,,8,0,2,2
9802054,9802054,,25,0,1,1
9802059,9802059,,25,0,2,2
9809198,9809198,,25,1,0,1
9802075,9802075,,19,0,10,10
9802078,9802078,,62,0,2,2
9802079,9802079,,65,0,4,4
9802089,9802089,,37,1,10,11
9802095,9802095,,37,0,15,15
9802098,9802098,,11,0,1,1
9802104,9802104,,2,0,1,1
9802110,9802110,,2,0,7,7
9802134,9802134,,11,0,4,4
9802153,9802153,,2,0,15,15
9802155,9802155,,37,1,14,15
9802156,9802156,,37,1,3,4
9802157,9802157,,0,0,1,1
9802161,9802161,,34,0,1,1
9802170,9802170,,54,0,14,14
9802171,9802171,,11,0,2,2
9802176,9802176,,2,1,26,27
9802177,9802177,,3,0,3,3
9802182,9802182,,16,0,14,14
9802184,9802184,,7,0,1,1
9802192,9802192,,6,0,4,4
9802200,9802200,,62,0,2,2
9802201,9802201,,8,1,13,14
9803016,9803016,,31,0,2,2
9803017,9803017,,37,3,5,8
9803037,9803037,,1,0,3,3
9803045,9803045,,6,1,9,10
9803047,9803047,,62,0,9,9
9803055,9803055,,16,0,3,3
9803062,9803062,,150,0,1,1
9611129,9611129,,150,1,0,1
9803070,9803070,,11,0,1,1
9803089,9803089,,11,2,1,3
9803093,9803093,,2,0,12,12
9803095,9803095,,37,0,8,8
9803100,9803100,,2,1,9,10
9803102,9803102,,34,0,3,3
9803110,9803110,,2,0,10,10
9803150,9803150,,2,0,27,27
9803172,9803172,,6,0,6,6
9803180,9803180,,2,0,16,16
9803190,9803190,,11,0,5,5
9803195,9803195,,2,1,9,10
9803213,9803213,,7,0,4,4
9803215,9803215,,2,1,27,28
9803219,9803219,,25,1,1,2
9803225,9803225,,37,2,18,20
9803236,9803236,,19,0,6,6
9803238,9803238,,25,0,4,4
9803241,9803241,,54,0,4,4
9803245,9803245,,62,1,4,5
9803246,9803246,,2,0,2,2
9803256,9803256,,11,0,3,3
9803261,9803261,,2,0,11,11
9804003,9804003,,1,1,6,7
9804008,9804008,,16,0,9,9
9804017,9804017,,62,0,3,3
9406104,9406104,,62,1,0,1
9804020,9804020,,37,0,19,19
9804039,9804039,,2,0,10,10
9804043,9804043,,37,0,19,19
9804044,9804044,,7,0,4,4
9804046,9804046,,3,0,3,3
9804055,9804055,,2,1,30,31
9804059,9804059,,54,1,39,40
9804077,9804077,,11,0,3,3
9804078,9804078,,65,0,6,6
9804082,9804082,,31,0,11,11
9804090,9804090,,2,1,1,2
9804107,9804107,,6,0,2,2
9804117,9804117,,7,0,1,1
9804127,9804127,,2,0,2,2
9804134,9804134,,19,0,2,2
9804137,9804137,,7,0,2,2
9804140,9804140,,2,0,5,5
9804145,9804145,,7,0,9,9
9804146,9804146,,2,0,4,4
9804150,9804150,,11,2,24,26
9804162,9804162,,37,0,8,8
9804165,9804165,,7,0,4,4
9804178,9804178,,54,0,4,4
9804183,9804183,,2,0,22,22
9804187,9804187,,19,0,3,3
9804189,9804189,,19,0,3,3
9804191,9804191,,16,0,3,3
9804194,9804194,,14,0,3,3
9804195,9804195,,19,0,1,1
9804196,9804196,,2,0,7,7
9804198,9804198,,2,0,7,7
9804203,9804203,,14,0,7,7
9805001,9805001,,16,1,6,7
9805002,9805002,,16,1,2,3
9805016,9805016,,37,0,3,3
9805017,9805017,,2,0,7,7
9805033,9805033,,11,2,2,4
9802081,9802081,,11,1,0,1
9805039,9805039,,19,0,11,11
9505013,9505013,,19,1,0,1
9805042,9805042,,2,0,7,7
9805048,9805048,,37,0,19,19
9805053,9805053,,37,0,11,11
9805062,9805062,,25,0,3,3
9805068,9805068,,0,0,10,10
9805074,9805074,,65,1,12,13
9805075,9805075,,6,0,23,23
9805092,9805092,,11,0,6,6
9805100,9805100,,8,0,4,4
9805103,9805103,,19,1,2,3
9711188,9711188,,9,4,0,4
9805135,9805135,,62,0,3,3
9805147,9805147,,2,0,8,8
9805186,9805186,,7,0,2,2
9805196,9805196,,6,0,1,1
9805202,9805202,,2,0,7,7
9805210,9805210,,11,0,4,4
9806020,9806020,,37,0,6,6
9806025,9806025,,19,0,3,3
9803211,9803211,,19,1,0,1
9806029,9806029,,25,0,6,6
9806031,9806031,,37,0,4,4
9806045,9806045,,16,0,4,4
9804100,9804100,,16,1,0,1
9806046,9806046,,3,1,3,4
9806060,9806060,,2,0,6,6
9806063,9806063,,16,1,6,7
9806064,9806064,,2,0,1,1
9806067,9806067,,6,0,2,2
9806076,9806076,,37,0,13,13
9806079,9806079,,37,0,15,15
9806093,9806093,,31,0,8,8
9806101,9806101,,34,0,2,2
9806102,9806102,,11,0,1,1
9806105,9806105,,2,0,10,10
9607024,9607024,,2,1,0,1
9806116,9806116,,54,0,6,6
9806137,9806137,,37,0,8,8
9806142,9806142,,37,0,14,14
9806145,9806145,,34,1,2,3
9806150,9806150,,11,1,17,18
9806179,9806179,,16,0,29,29
9806185,9806185,,0,0,2,2
9806196,9806196,,16,1,5,6
9806200,9806200,,19,0,2,2
9806202,9806202,,1,0,3,3
9806205,9806205,,6,0,5,5
9806208,9806208,,19,0,6,6
9806209,9806209,,16,1,6,7
9302045,9302045,,6,1,0,1
9806211,9806211,,16,0,14,14
9806215,9806215,,3,0,3,3
9806218,9806218,,16,0,5,5
9806219,9806219,,16,0,5,5
9806229,9806229,,37,0,16,16
9806242,9806242,,2,2,24,26
9806245,9806245,,2,0,17,17
9807001,9807001,,62,0,5,5
9807002,9807002,,34,0,12,12
9807010,9807010,,11,0,2,2
9607022,9607022,,11,1,0,1
9807027,9807027,,54,0,3,3
9807032,9807032,,11,0,4,4
9807036,9807036,,19,0,2,2
9807045,9807045,,62,0,6,6
9807047,9807047,,7,1,2,3
9807048,9807048,,7,1,2,3
9807057,9807057,,54,1,7,8
9807061,9807061,,16,0,3,3
9807062,9807062,,54,0,44,44
9807068,9807068,,11,1,1,2
9702034,9702034,,11,1,0,1
9807074,9807074,,62,0,3,3
9807084,9807084,,25,0,1,1
9807089,9807089,,3,0,3,3
9807095,9807095,,37,0,9,9
9807103,9807103,,16,0,1,1
9807105,9807105,,65,0,10,10
9807110,9807110,,14,0,3,3
9807114,9807114,,2,0,5,5
9807118,9807118,,11,0,1,1
9807119,9807119,,9,0,2,2
9807120,9807120,,34,0,4,4
9807126,9807126,,25,0,13,13
9807130,9807130,,7,0,3,3
9807131,9807131,,7,0,3,3
9807132,9807132,,7,0,2,2
9807141,9807141,,31,0,2,2
9807145,9807145,,11,0,3,3
9710054,9710054,,11,2,0,2
9807152,9807152,,19,0,5,5
9807154,9807154,,3,0,19,19
9807167,9807167,,11,0,4,4
9807168,9807168,,2,0,24,24
9807174,9807174,,2,0,15,15
9807177,9807177,,11,0,1,1
9807184,9807184,,25,0,22,22
9807193,9807193,,16,0,6,6
9807201,9807201,,62,1,5,6
9807209,9807209,,2,0,14,14
9807219,9807219,,65,0,2,2
9807220,9807220,,62,0,4,4
9807224,9807224,,37,0,17,17
9807227,9807227,,62,0,7,7
9807228,9807228,,11,0,3,3
9807233,9807233,,11,1,17,18
9807237,9807237,,37,0,5,5
9807238,9807238,,19,0,2,2
9808007,9808007,,16,0,15,15
9808008,9808008,,11,0,1,1
9808009,9808009,,11,0,2,2
9808021,9808021,,11,0,1,1
9808028,9808028,,11,0,5,5
9808044,9808044,,11,0,5,5
9808046,9808046,,2,1,13,14
9808047,9808047,,19,1,5,6
9808063,9808063,,31,0,7,7
9808072,9808072,,2,1,3,4
9808076,9808076,,6,1,8,9
9808077,9808077,,16,0,6,6
9808078,9808078,,11,0,13,13
9406074,9406074,,11,2,0,2
9811158,9811158,,11,1,4,5
9809078,9809078,,11,1,6,7
9808082,9808082,,11,2,4,6
9808089,9808089,,11,1,5,6
9808091,9808091,,6,0,2,2
9808098,9808098,,19,0,13,13
9808099,9808099,,11,0,1,1
9808105,9808105,,19,2,3,5
9808108,9808108,,2,0,2,2
9808112,9808112,,25,0,2,2
9808116,9808116,,151,0,1,1
9508066,9508066,,151,1,0,1
9808118,9808118,,62,1,2,3
9808123,9808123,,140,0,2,2
9808132,9808132,,25,0,13,13
9808133,9808133,,6,0,3,3
9808148,9808148,,19,0,11,11
9808150,9808150,,62,0,6,6
9808152,9808152,,11,1,1,2
9808155,9808155,,11,0,2,2
9808167,9808167,,11,0,3,3
9808170,9808170,,16,0,2,2
9808186,9808186,,11,0,7,7
9808193,9808193,,16,0,1,1
9809003,9809003,,62,0,11,11
9809005,9809005,,16,2,16,18
9809008,9809008,,37,0,8,8
9809010,9809010,,11,1,2,3
9809028,9809028,,62,0,3,3
9809038,9809038,,152,0,1,1
9405179,9405179,,152,1,0,1
9809044,9809044,,54,0,14,14
9809048,9809048,,153,1,1,2
9802025,9802025,,153,2,0,2
9809054,9809054,,19,0,7,7
9809058,9809058,,62,0,8,8
9809059,9809059,,34,3,22,25
9809071,9809071,,19,0,4,4
9809075,9809075,,2,0,17,17
9809077,9809077,,2,0,4,4
9809079,9809079,,16,1,6,7
9809086,9809086,,11,0,14,14
9809087,9809087,,11,0,9,9
9809089,9809089,,2,0,6,6
9809091,9809091,,16,0,5,5
9511082,9511082,,16,1,0,1
9809092,9809092,,6,0,5,5
9809094,9809094,,11,1,3,4
9809104,9809104,,7,0,22,22
9809115,9809115,,7,0,1,1
9809116,9809116,,16,0,3,3
9809120,9809120,,1,1,2,3
9809129,9809129,,16,1,4,5
9809134,9809134,,11,1,2,3
9809138,9809138,,11,0,2,2
9809139,9809139,,2,1,9,10
9809143,9809143,,16,1,9,10
9809146,9809146,,2,0,2,2
9809148,9809148,,3,1,2,3
9809150,9809150,,6,0,3,3
9809155,9809155,,7,0,1,1
9809156,9809156,,8,0,1,1
9809166,9809166,,3,0,5,5
9809169,9809169,,6,0,7,7
9809181,9809181,,37,0,37,37
9809186,9809186,,54,0,7,7
9809191,9809191,,8,1,2,3
9305177,9305177,,8,1,0,1
9809200,9809200,,25,0,1,1
9809201,9809201,,11,0,5,5
9809203,9809203,,19,1,19,20
9809205,9809205,,2,0,1,1
9809211,9809211,,25,0,15,15
9807162,9807162,,8,1,0,1
9809216,9809216,,25,1,2,3
9810007,9810007,,6,0,2,2
9810009,9810009,,25,0,2,2
9810016,9810016,,6,0,8,8
9810023,9810023,,2,0,23,23
9810027,9810027,,16,0,24,24
9810036,9810036,,16,0,5,5
9810039,9810039,,2,0,3,3
9810045,9810045,,62,0,3,3
9707254,9707254,,62,1,0,1
9810047,9810047,,2,0,5,5
9810052,9810052,,16,0,14,14
9810054,9810054,,1,0,2,2
9810056,9810056,,11,0,10,10
9810060,9810060,,2,0,29,29
9810071,9810071,,16,0,8,8
9810073,9810073,,14,2,9,11
9810074,9810074,,7,0,2,2
9810077,9810077,,25,0,2,2
9802172,9802172,,25,1,0,1
9810079,9810079,,111,0,1,1
9810082,9810082,,25,0,5,5
9810083,9810083,,34,0,28,28
9810096,9810096,,62,0,4,4
9810097,9810097,,2,0,5,5
9810100,9810100,,7,0,3,3
9810108,9810108,,11,1,1,2
9810111,9810111,,37,0,2,2
9810122,9810122,,154,0,1,1
9804207,9804207,,154,1,0,1
9810124,9810124,,62,0,2,2
9810133,9810133,,8,0,1,1
9810143,9810143,,8,0,5,5
9810162,9810162,,11,0,3,3
9810166,9810166,,6,0,2,2
9810172,9810172,,8,0,2,2
9810173,9810173,,19,0,2,2
9810180,9810180,,2,0,23,23
9810197,9810197,,19,0,1,1
9810208,9810208,,8,0,4,4
9810209,9810209,,8,0,1,1
9810216,9810216,,37,0,1,1
9810217,9810217,,6,0,7,7
9810218,9810218,,9,0,2,2
9810222,9810222,,11,0,14,14
9810232,9810232,,8,0,1,1
9810247,9810247,,156,2,1,3
9809170,9809170,,156,3,0,3
9810249,9810249,,6,0,2,2
9810252,9810252,,34,0,2,2
9811003,9811003,,7,0,12,12
9811009,9811009,,65,0,9,9
9811014,9811014,,7,0,3,3
9811018,9811018,,6,2,1,3
9811020,9811020,,7,0,1,1
9811029,9811029,,2,0,2,2
9811040,9811040,,37,0,1,1
9811046,9811046,,25,0,2,2
9811061,9811061,,62,0,1,1
9811078,9811078,,25,0,12,12
9811080,9811080,,54,0,16,16
9811085,9811085,,19,0,2,2
9811086,9811086,,37,0,1,1
9811091,9811091,,8,0,1,1
9811093,9811093,,2,0,86,86
9811095,9811095,,25,0,3,3
9810033,9810033,,25,1,0,1
9811104,9811104,,6,0,2,2
9811115,9811115,,11,0,7,7
9811123,9811123,,8,0,1,1
9811124,9811124,,37,0,7,7
9811125,9811125,,11,1,2,3
9508172,9508172,,11,1,0,1
9811127,9811127,,37,0,3,3
9811135,9811135,,3,0,1,1
9811136,9811136,,65,0,2,2
9811137,9811137,,6,1,1,2
9811142,9811142,,155,0,1,1
9806172,9806172,,155,1,0,1
9811153,9811153,,7,0,1,1
9811190,9811190,,6,0,2,2
9811197,9811197,,37,0,2,2
9811200,9811200,,37,1,17,18
9811202,9811202,,0,0,6,6
9811204,9811204,,2,0,10,10
9811205,9811205,,16,0,12,12
9811206,9811206,,16,0,4,4
9811221,9811221,,19,1,7,8
9811227,9811227,,62,0,3,3
9811242,9811242,,25,0,5,5
9811247,9811247,,7,0,2,2
9811249,9811249,,11,1,26,27
9811250,9811250,,19,0,1,1
9811253,9811253,,19,0,6,6
9811255,9811255,,16,0,9,9
9812001,9812001,,6,0,7,7
9812018,9812018,,2,0,4,4
9812020,9812020,,6,0,4,4
9812033,9812033,,6,0,12,12
9812053,9812053,,2,0,15,15
9812058,9812058,,6,1,8,9
9812079,9812079,,34,0,11,11
9511211,9511211,,19,1,0,1
9812102,9812102,,19,0,3,3
9812122,9812122,,11,0,3,3
9812131,9812131,,6,1,3,4
9812134,9812134,,34,0,8,8
9812142,9812142,,2,0,17,17
9812151,9812151,,8,0,8,8
9812152,9812152,,8,0,7,7
9812156,9812156,,54,0,3,3
9812168,9812168,,2,1,1,2
9812176,9812176,,11,1,2,3
9812178,9812178,,7,0,1,1
9812181,9812181,,54,1,9,10
9812182,9812182,,54,0,1,1
9812183,9812183,,16,0,15,15
9812185,9812185,,11,0,4,4
9812200,9812200,,2,1,18,19
9812201,9812201,,2,0,10,10
9812220,9812220,,1,0,11,11
9812222,9812222,,25,0,3,3
9812244,9812244,,8,0,6,6
9812246,9812246,,156,1,2,3
9812248,9812248,,11,0,1,1
9812254,9812254,,156,1,3,4
9901005,9901005,,54,0,11,11
9901013,9901013,,156,0,1,1
9901015,9901015,,62,0,1,1
9901019,9901019,,19,0,3,3
9901024,9901024,,16,1,10,11
9901062,9901062,,2,0,5,5
9901070,9901070,,19,3,3,6
9901127,9901127,,2,0,4,4
9901138,9901138,,19,1,4,5
9901155,9901155,,16,0,14,14
9901156,9901156,,11,0,2,2
9901165,9901165,,6,2,2,4
9902009,9902009,,2,0,1,1
9902019,9902019,,8,0,9,9
9902021,9902021,,157,0,1,1
9305102,9305102,,157,1,0,1
9902025,9902025,,19,1,4,5
9902026,9902026,,7,0,7,7
9902036,9902036,,16,0,12,12
9902041,9902041,,37,1,1,2
9902061,9902061,,158,0,1,1
9807073,9807073,,158,1,0,1
9902077,9902077,,31,0,2,2
9902078,9902078,,2,0,6,6
9902089,9902089,,16,0,25,25
9902092,9902092,,54,0,23,23
9902096,9902096,,6,0,1,1
9902103,9902103,,16,0,21,21
9902136,9902136,,11,0,1,1
9902148,9902148,,2,0,20,20
9902151,9902151,,62,0,19,19
9902159,9902159,,7,0,2,2
9902164,9902164,,6,0,7,7
9902169,9902169,,2,0,12,12
9902174,9902174,,4,0,1,1
9902185,9902185,,0,0,2,2
9902198,9902198,,2,0,4,4
9811114,9811114,,19,1,0,1
9902203,9902203,,37,0,7,7
9902206,9902206,,2,0,14,14
9903004,9903004,,11,0,1,1
9903013,9903013,,37,0,2,2
9903015,9903015,,2,1,14,15
9903024,9903024,,37,0,14,14
9903034,9903034,,159,0,1,1
9711147,9711147,,159,1,0,1
9903062,9903062,,153,0,3,3
9210035,9210035,,153,1,0,1
9903063,9903063,,14,2,4,6
9903069,9903069,,11,1,39,40
9903071,9903071,,34,0,3,3
9903074,9903074,,25,0,6,6
9903084,9903084,,162,1,1,2
9803008,9803008,,162,2,0,2
9903100,9903100,,54,0,2,2
9903108,9903108,,2,0,17,17
9903114,9903114,,37,0,4,4
9903115,9903115,,3,1,12,13
9903141,9903141,,7,0,15,15
9903154,9903154,,2,0,6,6
9903159,9903159,,4,0,5,5
9903175,9903175,,37,0,3,3
9903177,9903177,,37,0,5,5
9903179,9903179,,161,1,1,2
9903171,9903171,,161,2,0,2
9903180,9903180,,6,0,1,1
9903191,9903191,,62,0,7,7
9903197,9903197,,16,0,10,10
9903211,9903211,,11,0,4,4
9903218,9903218,,8,3,2,5
9903233,9903233,,2,0,23,23
9903235,9903235,,14,1,4,5
9903262,9903262,,65,0,7,7
9903265,9903265,,25,0,3,3
9207087,9207087,,25,1,0,1
9903268,9903268,,2,0,106,106
9904006,9904006,,2,0,1,1
9703173,9703173,,2,1,0,1
9904034,9904034,,34,0,12,12
9904046,9904046,,19,1,1,2
9904049,9904049,,62,0,2,2
9904051,9904051,,34,0,7,7
9904060,9904060,,37,0,5,5
9904066,9904066,,54,0,11,11
9904067,9904067,,8,0,3,3
9904099,9904099,,2,0,5,5
9904111,9904111,,2,0,13,13
9408168,9408168,,37,1,0,1
9904127,9904127,,31,0,13,13
9904128,9904128,,2,0,7,7
9904140,9904140,,16,0,6,6
9904144,9904144,,19,1,5,6
9904154,9904154,,19,0,7,7
9904156,9904156,,19,0,2,2
9904161,9904161,,1,0,2,2
9904163,9904163,,34,0,2,2
9904165,9904165,,1,0,28,28
9904166,9904166,,3,0,2,2
9904170,9904170,,160,0,1,1
9812036,9812036,,160,1,0,1
9904205,9904205,,6,1,4,5
9904212,9904212,,54,0,1,1
9904216,9904216,,54,1,6,7
9904215,9904215,,6,0,2,2
9905003,9905003,,8,0,2,2
9905017,9905017,,8,1,3,4
9905021,9905021,,3,0,1,1
9905023,9905023,,2,0,8,8
9905028,9905028,,11,0,8,8
9905035,9905035,,16,0,5,5
9905040,9905040,,1,0,1,1
9905045,9905045,,1,0,3,3
9905052,9905052,,37,0,6,6
9905058,9905058,,0,0,6,6
9905060,9905060,,161,0,2,2
9905066,9905066,,11,0,7,7
9905074,9905074,,19,0,4,4
9905082,9905082,,19,0,3,3
9905090,9905090,,11,1,2,3
9905101,9905101,,0,0,3,3
9905102,9905102,,62,0,2,2
9905106,9905106,,16,0,3,3
9905107,9905107,,16,0,5,5
9905120,9905120,,19,0,6,6
9905123,9905123,,7,0,4,4
9905128,9905128,,8,0,6,6
9905145,9905145,,6,0,6,6
9905160,9905160,,3,0,19,19
9905164,9905164,,65,0,1,1
9905188,9905188,,16,0,2,2
9905197,9905197,,62,0,12,12
9905199,9905199,,16,0,8,8
9905207,9905207,,16,0,2,2
9905216,9905216,,8,0,3,3
9905231,9905231,,34,0,5,5
9906014,9906014,,19,0,4,4
9906015,9906015,,19,0,2,2
9906024,9906024,,25,0,6,6
9906025,9906025,,1,0,3,3
9906028,9906028,,54,0,16,16
9906042,9906042,,2,0,12,12
9906045,9906045,,2,1,9,10
9906078,9906078,,34,0,30,30
9906082,9906082,,37,0,5,5
9906084,9906084,,2,0,26,26
9906086,9906086,,6,2,1,3
9906088,9906088,,2,0,1,1
9906097,9906097,,162,0,2,2
9906100,9906100,,19,0,1,1
9906104,9906104,,25,0,6,6
9906107,9906107,,62,0,2,2
9906110,9906110,,9,0,1,1
9906117,9906117,,11,0,3,3
9906132,9906132,,3,0,3,3
9906133,9906133,,163,0,1,1
9902020,9902020,,163,1,0,1
9906138,9906138,,62,0,5,5
9906150,9906150,,16,0,4,4
9906158,9906158,,0,0,2,2
9906159,9906159,,62,0,9,9
9906171,9906171,,0,0,1,1
9906177,9906177,,2,1,8,9
9906178,9906178,,8,0,3,3
9906180,9906180,,16,0,18,18
9906205,9906205,,62,1,5,6
9906213,9906213,,11,1,2,3
9906231,9906231,,0,0,3,3
9906233,9906233,,62,0,1,1
9906238,9906238,,2,1,12,13
9906245,9906245,,11,0,1,1
9907018,9907018,,62,0,1,1
9907033,9907033,,2,0,20,20
9907036,9907036,,2,0,28,28
9907037,9907037,,2,0,5,5
9907040,9907040,,62,0,7,7
9907056,9907056,,37,0,2,2
9907064,9907064,,7,0,3,3
9907068,9907068,,62,0,10,10
9907069,9907069,,62,1,10,11
9907097,9907097,,8,0,3,3
9907104,9907104,,37,1,2,3
9907105,9907105,,62,0,6,6
9907121,9907121,,8,0,5,5
9907127,9907127,,11,0,4,4
9907130,9907130,,2,0,22,22
9907149,9907149,,6,0,7,7
9907150,9907150,,54,0,3,3
9907167,9907167,,62,2,5,7
9907172,9907172,,16,0,11,11
9907173,9907173,,14,1,11,12
9907174,9907174,,14,0,12,12
9907187,9907187,,2,0,1,1
9907193,9907193,,2,0,3,3
9907195,9907195,,11,0,2,2
9907196,9907196,,11,0,2,2
9907198,9907198,,31,1,0,1
9908002,9908002,,2,0,6,6
9908015,9908015,,9,1,2,3
9908026,9908026,,16,0,6,6
9908039,9908039,,2,0,8,8
9908049,9908049,,54,0,63,63
9908051,9908051,,11,0,28,28
9908053,9908053,,2,0,10,10
9908057,9908057,,19,0,5,5
9908058,9908058,,19,0,2,2
9708155,9708155,,19,1,0,1
9908059,9908059,,19,0,13,13
9908061,9908061,,34,1,8,9
9908063,9908063,,2,0,12,12
9908068,9908068,,25,0,7,7
9908071,9908071,,2,0,13,13
9908077,9908077,,34,0,14,14
9908078,9908078,,9,0,2,2
9908079,9908079,,19,1,3,4
9908081,9908081,,11,0,5,5
9908083,9908083,,3,0,8,8
9908086,9908086,,37,0,6,6
9908098,9908098,,7,0,3,3
9908103,9908103,,8,0,3,3
9908108,9908108,,2,0,5,5
9908111,9908111,,19,0,5,5
9908117,9908117,,8,0,1,1
9908118,9908118,,37,0,7,7
9908122,9908122,,54,0,4,4
9908159,9908159,,62,0,3,3
9908164,9908164,,2,0,6,6
9908168,9908168,,37,0,2,2
9908183,9908183,,34,0,3,3
9908185,9908185,,65,0,6,6
9908190,9908190,,37,0,5,5
9908191,9908191,,25,0,1,1
9908194,9908194,,11,0,1,1
9908195,9908195,,16,0,3,3
9908199,9908199,,2,0,90,90
9908200,9908200,,9,0,3,3
9908205,9908205,,26,0,2,2
9902050,9902050,,26,1,0,1
9908206,9908206,,8,0,1,1
9908207,9908207,,16,0,2,2
9908209,9908209,,2,0,14,14
9909002,9909002,,7,0,12,12
9401168,9401168,,7,1,0,1
9403184,9403184,,7,1,0,1
9909008,9909008,,37,0,2,2
9909009,9909009,,11,0,4,4
9909012,9909012,,34,0,5,5
9909024,9909024,,9,0,3,3
9909029,9909029,,19,0,8,8
9909045,9909045,,8,0,4,4
9810037,9810037,,8,1,0,1
9909050,9909050,,37,0,8,8
9909054,9909054,,54,0,11,11
9909055,9909055,,6,0,6,6
9909060,9909060,,2,2,3,5
9909066,9909066,,6,1,8,9
9909069,9909069,,34,0,8,8
9909074,9909074,,19,0,1,1
9909083,9909083,,7,0,1,1
9909084,9909084,,19,0,5,5
9909090,9909090,,14,0,10,10
9909093,9909093,,34,0,4,4
9909096,9909096,,2,0,7,7
9909100,9909100,,6,0,5,5
9909105,9909105,,2,0,16,16
9909113,9909113,,16,0,2,2
9606020,9606020,,16,1,0,1
9909115,9909115,,6,0,11,11
9909117,9909117,,34,0,3,3
9811102,9811102,,34,1,0,1
9909128,9909128,,62,0,12,12
9909131,9909131,,37,0,7,7
9909133,9909133,,11,0,4,4
9909151,9909151,,7,0,1,1
9909157,9909157,,2,0,11,11
9909168,9909168,,37,1,2,3
9909175,9909175,,8,0,2,2
9909181,9909181,,37,0,3,3
9909190,9909190,,7,0,2,2
9909192,9909192,,37,0,14,14
9909195,9909195,,2,0,1,1
9909200,9909200,,16,0,5,5
9909208,9909208,,11,0,7,7
9909211,9909211,,11,0,4,4
9909217,9909217,,19,0,2,2
9909225,9909225,,7,0,3,3
9910005,9910005,,3,0,7,7
9910010,9910010,,1,0,2,2
9910012,9910012,,16,0,26,26
9910014,9910014,,16,0,1,1
9910029,9910029,,6,0,2,2
9910032,9910032,,11,0,2,2
9910039,9910039,,16,0,3,3
9910044,9910044,,11,0,3,3
9910051,9910051,,164,0,1,1
9910009,9910009,,164,1,0,1
9910080,9910080,,6,2,3,5
9910061,9910061,,37,0,3,3
9910062,9910062,,3,0,29,29
9910069,9910069,,6,0,6,6
9910078,9910078,,1,0,1,1
9910106,9910106,,34,0,31,31
9910119,9910119,,34,0,2,2
9910121,9910121,,8,0,18,18
9910127,9910127,,16,0,5,5
9910130,9910130,,2,0,1,1
9910137,9910137,,11,0,5,5
9910142,9910142,,11,0,11,11
9910153,9910153,,34,0,6,6
9910162,9910162,,6,0,6,6
9910163,9910163,,2,0,11,11
9910191,9910191,,6,0,6,6
9910193,9910193,,2,0,6,6
9910195,9910195,,16,0,6,6
9910210,9910210,,54,0,9,9
9910211,9910211,,2,0,8,8
9910214,9910214,,7,0,8,8
9910230,9910230,,19,0,6,6
9910234,9910234,,20,0,1,1
9910235,9910235,,8,2,3,5
9910253,9910253,,62,1,1,2
9910257,9910257,,6,0,1,1
9910259,9910259,,16,0,5,5
9910260,9910260,,2,0,11,11
9910261,9910261,,2,0,11,11
9910262,9910262,,2,0,4,4
9911005,9911005,,34,0,8,8
9911006,9911006,,19,0,5,5
9911008,9911008,,8,0,6,6
9911010,9911010,,34,0,9,9
9911033,9911033,,19,0,5,5
9911034,9911034,,37,0,47,47
9911052,9911052,,2,0,24,24
9911058,9911058,,65,0,3,3
9911061,9911061,,11,0,7,7
9911070,9911070,,2,0,2,2
9911103,9911103,,6,0,7,7
9911106,9911106,,67,0,1,1
9911127,9911127,,6,0,2,2
9911145,9911145,,11,0,5,5
9911155,9911155,,2,0,13,13
9911159,9911159,,0,0,2,2
9911176,9911176,,6,0,8,8
9911184,9911184,,37,0,12,12
9911185,9911185,,2,0,12,12
9911196,9911196,,9,0,9,9
9911198,9911198,,16,0,1,1
9911201,9911201,,2,0,32,32
9911202,9911202,,34,0,14,14
9911204,9911204,,7,0,7,7
9911213,9911213,,62,0,9,9
9911224,9911224,,11,0,1,1
9911227,9911227,,6,0,7,7
9911232,9911232,,62,0,7,7
9911241,9911241,,34,0,2,2
9911248,9911248,,25,0,10,10
9911252,9911252,,2,0,18,18
9912009,9912009,,11,0,10,10
9912010,9912010,,2,0,31,31
9912014,9912014,,165,0,2,2
9912026,9912026,,19,0,2,2
9912041,9912041,,6,0,6,6
9912048,9912048,,11,0,5,5
9905140,9905140,,11,1,0,1
9912056,9912056,,11,0,4,4
9912057,9912057,,2,0,7,7
9912068,9912068,,37,0,4,4
9912069,9912069,,25,0,8,8
9912071,9912071,,19,0,2,2
9912089,9912089,,8,0,8,8
9910008,9910008,,8,1,0,1
9912091,9912091,,7,0,14,14
9912095,9912095,,6,0,1,1
9912109,9912109,,37,0,5,5
9912110,9912110,,19,0,4,4
9912115,9912115,,37,0,1,1
9912116,9912116,,11,0,3,3
9912117,9912117,,4,0,6,6
9912126,9912126,,0,0,2,2
9912134,9912134,,8,0,2,2
9912136,9912136,,11,0,4,4
9912138,9912138,,166,0,1,1
9601122,9601122,,166,1,0,1
9912148,9912148,,19,0,3,3
9412007,9412007,,19,1,0,1
9912171,9912171,,3,0,36,36
9912192,9912192,,54,0,5,5
9912219,9912219,,62,1,8,9
9912228,9912228,,27,0,1,1
9912235,9912235,,62,0,7,7
9912240,9912240,,6,0,17,17
9508161,9508161,,6,1,0,1
9912252,9912252,,62,0,6,6
9912260,9912260,,2,0,6,6
9912270,9912270,,37,0,1,1
9912286,9912286,,0,0,8,8
